,complexity,token_count,loc,lloc,sloc,comments,multi,blank,code_comment,h1,h2,N1,N2,vocabulary,length,calculated_length,volume,difficulty,effort,time,bugs,change_type,added,removed,defect
0,19,473,182,127,129,0,0,53,182,5,39,21,42,44,63,217,343,2,926,51,0,0,80,0,1
1,19,473,1165,710,800,67,119,181,1232,18,243,153,282,261,435,2000,3492,10,36473,2026,1,0,80,0,1
2,12,234,1392,870,1177,35,17,170,1427,14,494,280,531,508,811,4473,7289,7,54850,3047,2,0,40,0,1
3,62,1372,773,419,590,28,0,166,801,10,204,113,217,214,330,1598,2554,5,13587,754,0,0,282,0,1
4,62,1372,421,273,302,44,34,57,465,17,81,59,107,98,166,583,1098,11,12329,684,0,0,282,0,1
5,9,297,182,127,129,0,0,53,182,5,39,21,42,44,63,217,343,2,926,51,0,0,51,0,1
6,43,971,1392,870,1177,35,17,170,1427,14,494,280,531,508,811,4473,7289,7,54850,3047,2,0,208,0,1
7,40,1319,773,419,590,28,0,166,801,10,204,113,217,214,330,1598,2554,5,13587,754,0,0,283,0,1
8,1,28,127,75,83,2,11,30,129,4,14,7,14,18,21,61,87,2,175,9,0,0,5,0,1
9,1,28,652,304,544,16,6,88,668,6,89,51,101,95,152,591,998,3,3399,188,0,0,5,0,1
10,1,28,2,2,2,0,0,0,2,0,0,0,0,0,0,0,0,0,0,0,0,0,5,0,1
11,1,28,8,5,5,0,0,3,8,0,0,0,0,0,0,0,0,0,0,0,0,0,5,0,1
12,1,28,2,2,2,0,0,0,2,0,0,0,0,0,0,0,0,0,0,0,0,0,5,0,1
13,1,28,14,8,8,0,0,6,14,0,0,0,0,0,0,0,0,0,0,0,0,0,5,0,1
14,1,28,6,4,4,0,0,2,6,0,0,0,0,0,0,0,0,0,0,0,0,0,5,0,1
15,1,28,6,4,4,0,0,2,6,1,2,1,2,3,3,2,4,0,2,0,0,0,5,0,1
16,1,28,6,4,4,0,0,2,6,0,0,0,0,0,0,0,0,0,0,0,0,0,5,0,1
17,1,28,7,5,5,0,0,2,7,0,0,0,0,0,0,0,0,0,0,0,0,0,5,0,1
18,1,28,6,4,4,0,0,2,6,0,0,0,0,0,0,0,0,0,0,0,0,0,5,0,1
19,1,28,10,6,6,0,0,4,10,0,0,0,0,0,0,0,0,0,0,0,0,0,5,0,1
20,1,28,1,1,1,0,0,0,1,0,0,0,0,0,0,0,0,0,0,0,0,0,5,0,1
21,1,28,1,1,1,0,0,0,1,0,0,0,0,0,0,0,0,0,0,0,0,0,5,0,1
22,1,28,14,10,10,0,0,4,14,1,1,1,1,2,2,0,2,0,1,0,0,0,5,0,1
23,1,28,46,26,30,3,0,12,49,3,6,3,6,9,9,20,28,1,42,2,0,0,5,0,1
24,307,7640,1455,414,1257,16,76,112,1471,5,41,23,46,46,69,231,381,2,1069,59,0,0,2672,0,1
25,307,7640,669,365,481,22,61,110,691,15,103,63,122,118,185,747,1273,8,11311,628,0,0,2672,0,1
26,25,593,1455,414,1257,16,76,112,1471,5,41,23,46,46,69,231,381,2,1069,59,0,0,2394,0,1
27,71,1529,127,75,83,2,11,30,129,4,14,7,14,18,21,61,87,2,175,9,0,0,240,0,1
28,71,1529,652,304,544,16,6,88,668,6,89,51,101,95,152,591,998,3,3399,188,0,0,240,0,1
29,71,1529,2,2,2,0,0,0,2,0,0,0,0,0,0,0,0,0,0,0,0,0,240,0,1
30,71,1529,8,5,5,0,0,3,8,0,0,0,0,0,0,0,0,0,0,0,0,0,240,0,1
31,71,1529,2,2,2,0,0,0,2,0,0,0,0,0,0,0,0,0,0,0,0,0,240,0,1
32,71,1529,14,8,8,0,0,6,14,0,0,0,0,0,0,0,0,0,0,0,0,0,240,0,1
33,71,1529,6,4,4,0,0,2,6,0,0,0,0,0,0,0,0,0,0,0,0,0,240,0,1
34,71,1529,6,4,4,0,0,2,6,1,2,1,2,3,3,2,4,0,2,0,0,0,240,0,1
35,71,1529,6,4,4,0,0,2,6,0,0,0,0,0,0,0,0,0,0,0,0,0,240,0,1
36,71,1529,7,5,5,0,0,2,7,0,0,0,0,0,0,0,0,0,0,0,0,0,240,0,1
37,71,1529,6,4,4,0,0,2,6,0,0,0,0,0,0,0,0,0,0,0,0,0,240,0,1
38,71,1529,10,6,6,0,0,4,10,0,0,0,0,0,0,0,0,0,0,0,0,0,240,0,1
39,71,1529,1,1,1,0,0,0,1,0,0,0,0,0,0,0,0,0,0,0,0,0,240,0,1
40,71,1529,1,1,1,0,0,0,1,0,0,0,0,0,0,0,0,0,0,0,0,0,240,0,1
41,71,1529,14,10,10,0,0,4,14,1,1,1,1,2,2,0,2,0,1,0,0,0,240,0,1
42,71,1529,46,26,30,3,0,12,49,3,6,3,6,9,9,20,28,1,42,2,0,0,240,0,1
43,35,478,282,196,195,3,0,86,285,8,130,71,141,138,212,936,1507,4,6538,363,0,0,120,0,1
44,1,96,13,10,10,0,0,3,13,1,2,1,2,3,3,2,4,0,2,0,0,0,12,0,1
45,7,111,44,19,17,0,16,11,44,3,14,7,14,17,21,58,85,1,128,7,0,0,42,0,1
46,4,431,652,304,544,16,6,88,668,6,89,51,101,95,152,591,998,3,3399,188,0,0,74,0,1
47,19,557,14,9,9,0,0,5,14,0,0,0,0,0,0,0,0,0,0,0,0,0,102,0,1
48,19,557,16,9,9,0,0,7,16,0,0,0,0,0,0,0,0,0,0,0,0,0,102,0,1
49,17,403,1513,682,1277,25,13,200,1538,11,199,116,219,210,335,1557,2584,6,15641,868,0,0,74,0,1
50,17,403,819,519,539,24,98,155,843,15,96,57,106,111,163,690,1107,8,9171,509,0,0,74,0,1
51,14,747,1513,682,1277,25,13,200,1538,11,199,116,219,210,335,1557,2584,6,15641,868,0,0,129,0,1
52,7,179,1450,624,1228,12,26,181,1462,14,306,186,354,320,540,2580,4493,8,36391,2021,1,0,31,0,1
53,4,116,447,308,343,6,5,95,453,7,96,59,111,103,170,651,1136,4,4600,255,0,0,26,0,1
54,4,116,322,174,179,16,74,51,338,10,41,26,46,51,72,252,408,5,2291,127,0,0,26,0,1
55,23,383,1450,624,1228,12,26,181,1462,14,306,186,354,320,540,2580,4493,8,36391,2021,1,0,98,0,1
56,7,305,1513,682,1277,25,13,200,1538,11,199,116,219,210,335,1557,2584,6,15641,868,0,0,49,0,1
57,7,305,819,519,539,24,98,155,843,15,96,57,106,111,163,690,1107,8,9171,509,0,0,49,0,1
58,9,378,15,9,9,0,0,6,15,0,0,0,0,0,0,0,0,0,0,0,0,0,79,0,1
59,158,2888,1338,495,1086,10,64,173,1348,11,122,82,157,133,239,883,1686,7,11934,663,0,0,526,0,1
60,6,264,207,111,150,11,0,50,218,5,26,19,36,31,55,133,272,3,943,52,0,0,58,0,1
61,6,264,410,198,237,31,55,97,441,11,63,38,72,74,110,414,683,6,4293,238,0,0,58,0,1
62,30,664,1457,730,1242,11,6,188,1468,10,292,166,329,302,495,2424,4078,5,22973,1276,1,0,148,0,1
63,30,664,74,35,59,1,0,14,75,3,14,7,14,17,21,58,85,1,128,7,0,0,148,0,1
64,30,664,245,125,200,5,7,34,250,7,30,17,34,37,51,166,265,3,1053,58,0,0,148,0,1
65,4,109,1455,414,1257,16,76,112,1471,5,41,23,46,46,69,231,381,2,1069,59,0,0,33,0,1
66,4,109,669,365,481,22,61,110,691,15,103,63,122,118,185,747,1273,8,11311,628,0,0,33,0,1
67,6,202,256,139,192,9,7,47,265,4,23,12,24,27,36,112,171,2,357,19,0,0,39,0,1
68,1,129,1457,730,1242,11,6,188,1468,10,292,166,329,302,495,2424,4078,5,22973,1276,1,0,24,0,1
69,53,870,373,158,315,8,0,51,381,5,76,44,79,81,123,486,779,2,2026,112,0,0,154,0,1
70,126,3063,1943,715,1694,26,18,214,1969,12,185,120,237,197,357,1436,2721,7,20915,1161,0,0,479,0,1
71,126,3063,1168,838,957,57,25,144,1225,19,348,224,416,367,640,3018,5452,11,61921,3440,1,0,479,0,1
72,4,217,207,111,150,11,0,50,218,5,26,19,36,31,55,133,272,3,943,52,0,0,51,0,1
73,7,467,1457,730,1242,11,6,188,1468,10,292,166,329,302,495,2424,4078,5,22973,1276,1,0,74,0,1
74,4,184,1455,414,1257,16,76,112,1471,5,41,23,46,46,69,231,381,2,1069,59,0,0,43,0,1
75,35,2376,373,158,315,8,0,51,381,5,76,44,79,81,123,486,779,2,2026,112,0,0,389,0,1
76,67,1751,477,336,357,30,23,73,507,16,194,134,250,210,384,1538,2962,10,30538,1696,0,0,291,0,1
77,12,285,1523,757,1297,19,12,193,1542,12,193,117,230,205,347,1508,2664,7,19053,1058,0,0,58,0,1
78,12,285,701,378,504,33,58,109,734,13,110,68,126,123,194,794,1346,7,10027,557,0,0,58,0,1
79,1,85,13,10,10,0,0,3,13,1,2,1,2,3,3,2,4,0,2,0,0,2,1,1,1
80,4,403,652,304,544,16,6,88,668,6,89,51,101,95,152,591,998,3,3399,188,0,2,2,3,1
81,4,89,1943,715,1694,26,18,214,1969,12,185,120,237,197,357,1436,2721,7,20915,1161,0,0,21,0,1
82,153,2747,1338,495,1086,10,64,173,1348,11,122,82,157,133,239,883,1686,7,11934,663,0,2,16,35,1
83,69,1398,1457,730,1242,11,6,188,1468,10,292,166,329,302,495,2424,4078,5,22973,1276,1,2,201,61,1
84,69,1398,74,35,59,1,0,14,75,3,14,7,14,17,21,58,85,1,128,7,0,2,201,61,1
85,69,1398,245,125,200,5,7,34,250,7,30,17,34,37,51,166,265,3,1053,58,0,2,201,61,1
86,40,618,373,158,315,8,0,51,381,5,76,44,79,81,123,486,779,2,2026,112,0,2,2,39,1
87,74,1856,1943,715,1694,26,18,214,1969,12,185,120,237,197,357,1436,2721,7,20915,1161,0,2,9,197,1
88,74,1856,1168,838,957,57,25,144,1225,19,348,224,416,367,640,3018,5452,11,61921,3440,1,2,9,197,1
89,42,2602,1457,730,1242,11,6,188,1468,10,292,166,329,302,495,2424,4078,5,22973,1276,1,2,265,0,1
90,4,190,1455,414,1257,16,76,112,1471,5,41,23,46,46,69,231,381,2,1069,59,0,2,2,2,1
91,34,2129,373,158,315,8,0,51,381,5,76,44,79,81,123,486,779,2,2026,112,0,2,21,48,1
92,40,612,373,158,315,8,0,51,381,5,76,44,79,81,123,486,779,2,2026,112,0,2,6,7,0
93,73,1454,1457,730,1242,11,6,188,1468,10,292,166,329,302,495,2424,4078,5,22973,1276,1,2,12,1,0
94,73,1454,74,35,59,1,0,14,75,3,14,7,14,17,21,58,85,1,128,7,0,2,12,1,0
95,73,1454,245,125,200,5,7,34,250,7,30,17,34,37,51,166,265,3,1053,58,0,2,12,1,0
96,44,2661,1457,730,1242,11,6,188,1468,10,292,166,329,302,495,2424,4078,5,22973,1276,1,2,23,5,0
97,74,1467,1457,730,1242,11,6,188,1468,10,292,166,329,302,495,2424,4078,5,22973,1276,1,2,3,1,1
98,74,1467,74,35,59,1,0,14,75,3,14,7,14,17,21,58,85,1,128,7,0,2,3,1,1
99,74,1467,245,125,200,5,7,34,250,7,30,17,34,37,51,166,265,3,1053,58,0,2,3,1,1
100,153,2741,1338,495,1086,10,64,173,1348,11,122,82,157,133,239,883,1686,7,11934,663,0,2,3,3,0
101,17,403,1513,682,1277,25,13,200,1538,11,199,116,219,210,335,1557,2584,6,15641,868,0,2,1,0,0
102,17,403,819,519,539,24,98,155,843,15,96,57,106,111,163,690,1107,8,9171,509,0,2,1,0,0
103,5,104,1943,715,1694,26,18,214,1969,12,185,120,237,197,357,1436,2721,7,20915,1161,0,2,8,4,0
104,44,2697,1457,730,1242,11,6,188,1468,10,292,166,329,302,495,2424,4078,5,22973,1276,1,2,4,2,0
105,74,1599,127,75,83,2,11,30,129,4,14,7,14,18,21,61,87,2,175,9,0,2,23,7,0
106,74,1599,652,304,544,16,6,88,668,6,89,51,101,95,152,591,998,3,3399,188,0,2,23,7,0
107,74,1599,2,2,2,0,0,0,2,0,0,0,0,0,0,0,0,0,0,0,0,2,23,7,0
108,74,1599,8,5,5,0,0,3,8,0,0,0,0,0,0,0,0,0,0,0,0,2,23,7,0
109,74,1599,2,2,2,0,0,0,2,0,0,0,0,0,0,0,0,0,0,0,0,2,23,7,0
110,74,1599,14,8,8,0,0,6,14,0,0,0,0,0,0,0,0,0,0,0,0,2,23,7,0
111,74,1599,6,4,4,0,0,2,6,0,0,0,0,0,0,0,0,0,0,0,0,2,23,7,0
112,74,1599,6,4,4,0,0,2,6,1,2,1,2,3,3,2,4,0,2,0,0,2,23,7,0
113,74,1599,6,4,4,0,0,2,6,0,0,0,0,0,0,0,0,0,0,0,0,2,23,7,0
114,74,1599,7,5,5,0,0,2,7,0,0,0,0,0,0,0,0,0,0,0,0,2,23,7,0
115,74,1599,6,4,4,0,0,2,6,0,0,0,0,0,0,0,0,0,0,0,0,2,23,7,0
116,74,1599,10,6,6,0,0,4,10,0,0,0,0,0,0,0,0,0,0,0,0,2,23,7,0
117,74,1599,1,1,1,0,0,0,1,0,0,0,0,0,0,0,0,0,0,0,0,2,23,7,0
118,74,1599,1,1,1,0,0,0,1,0,0,0,0,0,0,0,0,0,0,0,0,2,23,7,0
119,74,1599,14,10,10,0,0,4,14,1,1,1,1,2,2,0,2,0,1,0,0,2,23,7,0
120,74,1599,46,26,30,3,0,12,49,3,6,3,6,9,9,20,28,1,42,2,0,2,23,7,0
121,5,535,652,304,544,16,6,88,668,6,89,51,101,95,152,591,998,3,3399,188,0,2,15,0,0
122,74,1848,1943,715,1694,26,18,214,1969,12,185,120,237,197,357,1436,2721,7,20915,1161,0,2,0,1,0
123,74,1848,1168,838,957,57,25,144,1225,19,348,224,416,367,640,3018,5452,11,61921,3440,1,2,0,1,0
124,20,484,182,127,129,0,0,53,182,5,39,21,42,44,63,217,343,2,926,51,0,2,4,1,0
125,20,484,1165,710,800,67,119,181,1232,18,243,153,282,261,435,2000,3492,10,36473,2026,1,2,4,1,0
126,154,2757,1338,495,1086,10,64,173,1348,11,122,82,157,133,239,883,1686,7,11934,663,0,2,6,1,0
127,20,486,182,127,129,0,0,53,182,5,39,21,42,44,63,217,343,2,926,51,0,2,1,1,0
128,20,486,1165,710,800,67,119,181,1232,18,243,153,282,261,435,2000,3492,10,36473,2026,1,2,1,1,0
129,10,344,182,127,129,0,0,53,182,5,39,21,42,44,63,217,343,2,926,51,0,2,6,0,0
130,75,1511,1457,730,1242,11,6,188,1468,10,292,166,329,302,495,2424,4078,5,22973,1276,1,2,8,1,0
131,75,1511,74,35,59,1,0,14,75,3,14,7,14,17,21,58,85,1,128,7,0,2,8,1,0
132,75,1511,245,125,200,5,7,34,250,7,30,17,34,37,51,166,265,3,1053,58,0,2,8,1,0
133,75,1611,127,75,83,2,11,30,129,4,14,7,14,18,21,61,87,2,175,9,0,2,7,3,1
134,75,1611,652,304,544,16,6,88,668,6,89,51,101,95,152,591,998,3,3399,188,0,2,7,3,1
135,75,1611,2,2,2,0,0,0,2,0,0,0,0,0,0,0,0,0,0,0,0,2,7,3,1
136,75,1611,8,5,5,0,0,3,8,0,0,0,0,0,0,0,0,0,0,0,0,2,7,3,1
137,75,1611,2,2,2,0,0,0,2,0,0,0,0,0,0,0,0,0,0,0,0,2,7,3,1
138,75,1611,14,8,8,0,0,6,14,0,0,0,0,0,0,0,0,0,0,0,0,2,7,3,1
139,75,1611,6,4,4,0,0,2,6,0,0,0,0,0,0,0,0,0,0,0,0,2,7,3,1
140,75,1611,6,4,4,0,0,2,6,1,2,1,2,3,3,2,4,0,2,0,0,2,7,3,1
141,75,1611,6,4,4,0,0,2,6,0,0,0,0,0,0,0,0,0,0,0,0,2,7,3,1
142,75,1611,7,5,5,0,0,2,7,0,0,0,0,0,0,0,0,0,0,0,0,2,7,3,1
143,75,1611,6,4,4,0,0,2,6,0,0,0,0,0,0,0,0,0,0,0,0,2,7,3,1
144,75,1611,10,6,6,0,0,4,10,0,0,0,0,0,0,0,0,0,0,0,0,2,7,3,1
145,75,1611,1,1,1,0,0,0,1,0,0,0,0,0,0,0,0,0,0,0,0,2,7,3,1
146,75,1611,1,1,1,0,0,0,1,0,0,0,0,0,0,0,0,0,0,0,0,2,7,3,1
147,75,1611,14,10,10,0,0,4,14,1,1,1,1,2,2,0,2,0,1,0,0,2,7,3,1
148,75,1611,46,26,30,3,0,12,49,3,6,3,6,9,9,20,28,1,42,2,0,2,7,3,1
149,75,1516,1457,730,1242,11,6,188,1468,10,292,166,329,302,495,2424,4078,5,22973,1276,1,2,1,0,0
150,75,1516,74,35,59,1,0,14,75,3,14,7,14,17,21,58,85,1,128,7,0,2,1,0,0
151,75,1516,245,125,200,5,7,34,250,7,30,17,34,37,51,166,265,3,1053,58,0,2,1,0,0
152,63,1425,1457,730,1242,11,6,188,1468,10,292,166,329,302,495,2424,4078,5,22973,1276,1,2,1,26,1
153,63,1425,74,35,59,1,0,14,75,3,14,7,14,17,21,58,85,1,128,7,0,2,1,26,1
154,63,1425,245,125,200,5,7,34,250,7,30,17,34,37,51,166,265,3,1053,58,0,2,1,26,1
155,49,681,373,158,315,8,0,51,381,5,76,44,79,81,123,486,779,2,2026,112,0,2,15,0,1
156,44,2697,1457,730,1242,11,6,188,1468,10,292,166,329,302,495,2424,4078,5,22973,1276,1,2,3,1,1
157,28,1795,373,158,315,8,0,51,381,5,76,44,79,81,123,486,779,2,2026,112,0,2,33,81,1
158,63,1425,1457,730,1242,11,6,188,1468,10,292,166,329,302,495,2424,4078,5,22973,1276,1,2,1,1,0
159,63,1425,74,35,59,1,0,14,75,3,14,7,14,17,21,58,85,1,128,7,0,2,1,1,0
160,63,1425,245,125,200,5,7,34,250,7,30,17,34,37,51,166,265,3,1053,58,0,2,1,1,0
161,62,1381,1457,730,1242,11,6,188,1468,10,292,166,329,302,495,2424,4078,5,22973,1276,1,2,0,7,0
162,62,1381,74,35,59,1,0,14,75,3,14,7,14,17,21,58,85,1,128,7,0,2,0,7,0
163,62,1381,245,125,200,5,7,34,250,7,30,17,34,37,51,166,265,3,1053,58,0,2,0,7,0
164,64,1421,1457,730,1242,11,6,188,1468,10,292,166,329,302,495,2424,4078,5,22973,1276,1,2,8,0,0
165,64,1421,74,35,59,1,0,14,75,3,14,7,14,17,21,58,85,1,128,7,0,2,8,0,0
166,64,1421,245,125,200,5,7,34,250,7,30,17,34,37,51,166,265,3,1053,58,0,2,8,0,0
167,63,1405,1457,730,1242,11,6,188,1468,10,292,166,329,302,495,2424,4078,5,22973,1276,1,2,0,4,0
168,63,1405,74,35,59,1,0,14,75,3,14,7,14,17,21,58,85,1,128,7,0,2,0,4,0
169,63,1405,245,125,200,5,7,34,250,7,30,17,34,37,51,166,265,3,1053,58,0,2,0,4,0
170,43,2647,1457,730,1242,11,6,188,1468,10,292,166,329,302,495,2424,4078,5,22973,1276,1,2,0,5,0
171,307,7644,1455,414,1257,16,76,112,1471,5,41,23,46,46,69,231,381,2,1069,59,0,2,1,1,0
172,307,7644,669,365,481,22,61,110,691,15,103,63,122,118,185,747,1273,8,11311,628,0,2,1,1,0
173,75,1589,127,75,83,2,11,30,129,4,14,7,14,18,21,61,87,2,175,9,0,2,0,3,0
174,75,1589,652,304,544,16,6,88,668,6,89,51,101,95,152,591,998,3,3399,188,0,2,0,3,0
175,75,1589,2,2,2,0,0,0,2,0,0,0,0,0,0,0,0,0,0,0,0,2,0,3,0
176,75,1589,8,5,5,0,0,3,8,0,0,0,0,0,0,0,0,0,0,0,0,2,0,3,0
177,75,1589,2,2,2,0,0,0,2,0,0,0,0,0,0,0,0,0,0,0,0,2,0,3,0
178,75,1589,14,8,8,0,0,6,14,0,0,0,0,0,0,0,0,0,0,0,0,2,0,3,0
179,75,1589,6,4,4,0,0,2,6,0,0,0,0,0,0,0,0,0,0,0,0,2,0,3,0
180,75,1589,6,4,4,0,0,2,6,1,2,1,2,3,3,2,4,0,2,0,0,2,0,3,0
181,75,1589,6,4,4,0,0,2,6,0,0,0,0,0,0,0,0,0,0,0,0,2,0,3,0
182,75,1589,7,5,5,0,0,2,7,0,0,0,0,0,0,0,0,0,0,0,0,2,0,3,0
183,75,1589,6,4,4,0,0,2,6,0,0,0,0,0,0,0,0,0,0,0,0,2,0,3,0
184,75,1589,10,6,6,0,0,4,10,0,0,0,0,0,0,0,0,0,0,0,0,2,0,3,0
185,75,1589,1,1,1,0,0,0,1,0,0,0,0,0,0,0,0,0,0,0,0,2,0,3,0
186,75,1589,1,1,1,0,0,0,1,0,0,0,0,0,0,0,0,0,0,0,0,2,0,3,0
187,75,1589,14,10,10,0,0,4,14,1,1,1,1,2,2,0,2,0,1,0,0,2,0,3,0
188,75,1589,46,26,30,3,0,12,49,3,6,3,6,9,9,20,28,1,42,2,0,2,0,3,0
189,20,491,182,127,129,0,0,53,182,5,39,21,42,44,63,217,343,2,926,51,0,2,9,0,0
190,20,491,1165,710,800,67,119,181,1232,18,243,153,282,261,435,2000,3492,10,36473,2026,1,2,9,0,0
191,12,236,1392,870,1177,35,17,170,1427,14,494,280,531,508,811,4473,7289,7,54850,3047,2,2,8,0,0
192,23,517,1513,682,1277,25,13,200,1538,11,199,116,219,210,335,1557,2584,6,15641,868,0,2,41,1,0
193,23,517,819,519,539,24,98,155,843,15,96,57,106,111,163,690,1107,8,9171,509,0,2,41,1,0
194,18,917,1513,682,1277,25,13,200,1538,11,199,116,219,210,335,1557,2584,6,15641,868,0,2,27,0,0
195,19,455,1513,682,1277,25,13,200,1538,11,199,116,219,210,335,1557,2584,6,15641,868,0,2,0,14,0
196,19,455,819,519,539,24,98,155,843,15,96,57,106,111,163,690,1107,8,9171,509,0,2,0,14,0
197,18,919,1513,682,1277,25,13,200,1538,11,199,116,219,210,335,1557,2584,6,15641,868,0,2,5,5,1
198,154,2757,1338,495,1086,10,64,173,1348,11,122,82,157,133,239,883,1686,7,11934,663,0,2,1,5,1
199,28,1795,373,158,315,8,0,51,381,5,76,44,79,81,123,486,779,2,2026,112,0,2,1,1,1
200,22,1090,1513,682,1277,25,13,200,1538,11,199,116,219,210,335,1557,2584,6,15641,868,0,2,54,32,1
201,23,1138,1513,682,1277,25,13,200,1538,11,199,116,219,210,335,1557,2584,6,15641,868,0,2,9,1,0
202,78,1665,127,75,83,2,11,30,129,4,14,7,14,18,21,61,87,2,175,9,0,2,35,25,1
203,78,1665,652,304,544,16,6,88,668,6,89,51,101,95,152,591,998,3,3399,188,0,2,35,25,1
204,78,1665,2,2,2,0,0,0,2,0,0,0,0,0,0,0,0,0,0,0,0,2,35,25,1
205,78,1665,8,5,5,0,0,3,8,0,0,0,0,0,0,0,0,0,0,0,0,2,35,25,1
206,78,1665,2,2,2,0,0,0,2,0,0,0,0,0,0,0,0,0,0,0,0,2,35,25,1
207,78,1665,14,8,8,0,0,6,14,0,0,0,0,0,0,0,0,0,0,0,0,2,35,25,1
208,78,1665,6,4,4,0,0,2,6,0,0,0,0,0,0,0,0,0,0,0,0,2,35,25,1
209,78,1665,6,4,4,0,0,2,6,1,2,1,2,3,3,2,4,0,2,0,0,2,35,25,1
210,78,1665,6,4,4,0,0,2,6,0,0,0,0,0,0,0,0,0,0,0,0,2,35,25,1
211,78,1665,7,5,5,0,0,2,7,0,0,0,0,0,0,0,0,0,0,0,0,2,35,25,1
212,78,1665,6,4,4,0,0,2,6,0,0,0,0,0,0,0,0,0,0,0,0,2,35,25,1
213,78,1665,10,6,6,0,0,4,10,0,0,0,0,0,0,0,0,0,0,0,0,2,35,25,1
214,78,1665,1,1,1,0,0,0,1,0,0,0,0,0,0,0,0,0,0,0,0,2,35,25,1
215,78,1665,1,1,1,0,0,0,1,0,0,0,0,0,0,0,0,0,0,0,0,2,35,25,1
216,78,1665,14,10,10,0,0,4,14,1,1,1,1,2,2,0,2,0,1,0,0,2,35,25,1
217,78,1665,46,26,30,3,0,12,49,3,6,3,6,9,9,20,28,1,42,2,0,2,35,25,1
218,6,609,652,304,544,16,6,88,668,6,89,51,101,95,152,591,998,3,3399,188,0,2,13,1,1
219,78,1680,127,75,83,2,11,30,129,4,14,7,14,18,21,61,87,2,175,9,0,2,13,10,0
220,78,1680,652,304,544,16,6,88,668,6,89,51,101,95,152,591,998,3,3399,188,0,2,13,10,0
221,78,1680,2,2,2,0,0,0,2,0,0,0,0,0,0,0,0,0,0,0,0,2,13,10,0
222,78,1680,8,5,5,0,0,3,8,0,0,0,0,0,0,0,0,0,0,0,0,2,13,10,0
223,78,1680,2,2,2,0,0,0,2,0,0,0,0,0,0,0,0,0,0,0,0,2,13,10,0
224,78,1680,14,8,8,0,0,6,14,0,0,0,0,0,0,0,0,0,0,0,0,2,13,10,0
225,78,1680,6,4,4,0,0,2,6,0,0,0,0,0,0,0,0,0,0,0,0,2,13,10,0
226,78,1680,6,4,4,0,0,2,6,1,2,1,2,3,3,2,4,0,2,0,0,2,13,10,0
227,78,1680,6,4,4,0,0,2,6,0,0,0,0,0,0,0,0,0,0,0,0,2,13,10,0
228,78,1680,7,5,5,0,0,2,7,0,0,0,0,0,0,0,0,0,0,0,0,2,13,10,0
229,78,1680,6,4,4,0,0,2,6,0,0,0,0,0,0,0,0,0,0,0,0,2,13,10,0
230,78,1680,10,6,6,0,0,4,10,0,0,0,0,0,0,0,0,0,0,0,0,2,13,10,0
231,78,1680,1,1,1,0,0,0,1,0,0,0,0,0,0,0,0,0,0,0,0,2,13,10,0
232,78,1680,1,1,1,0,0,0,1,0,0,0,0,0,0,0,0,0,0,0,0,2,13,10,0
233,78,1680,14,10,10,0,0,4,14,1,1,1,1,2,2,0,2,0,1,0,0,2,13,10,0
234,78,1680,46,26,30,3,0,12,49,3,6,3,6,9,9,20,28,1,42,2,0,2,13,10,0
235,79,1683,127,75,83,2,11,30,129,4,14,7,14,18,21,61,87,2,175,9,0,2,45,40,0
236,79,1683,652,304,544,16,6,88,668,6,89,51,101,95,152,591,998,3,3399,188,0,2,45,40,0
237,79,1683,2,2,2,0,0,0,2,0,0,0,0,0,0,0,0,0,0,0,0,2,45,40,0
238,79,1683,8,5,5,0,0,3,8,0,0,0,0,0,0,0,0,0,0,0,0,2,45,40,0
239,79,1683,2,2,2,0,0,0,2,0,0,0,0,0,0,0,0,0,0,0,0,2,45,40,0
240,79,1683,14,8,8,0,0,6,14,0,0,0,0,0,0,0,0,0,0,0,0,2,45,40,0
241,79,1683,6,4,4,0,0,2,6,0,0,0,0,0,0,0,0,0,0,0,0,2,45,40,0
242,79,1683,6,4,4,0,0,2,6,1,2,1,2,3,3,2,4,0,2,0,0,2,45,40,0
243,79,1683,6,4,4,0,0,2,6,0,0,0,0,0,0,0,0,0,0,0,0,2,45,40,0
244,79,1683,7,5,5,0,0,2,7,0,0,0,0,0,0,0,0,0,0,0,0,2,45,40,0
245,79,1683,6,4,4,0,0,2,6,0,0,0,0,0,0,0,0,0,0,0,0,2,45,40,0
246,79,1683,10,6,6,0,0,4,10,0,0,0,0,0,0,0,0,0,0,0,0,2,45,40,0
247,79,1683,1,1,1,0,0,0,1,0,0,0,0,0,0,0,0,0,0,0,0,2,45,40,0
248,79,1683,1,1,1,0,0,0,1,0,0,0,0,0,0,0,0,0,0,0,0,2,45,40,0
249,79,1683,14,10,10,0,0,4,14,1,1,1,1,2,2,0,2,0,1,0,0,2,45,40,0
250,79,1683,46,26,30,3,0,12,49,3,6,3,6,9,9,20,28,1,42,2,0,2,45,40,0
251,7,611,652,304,544,16,6,88,668,6,89,51,101,95,152,591,998,3,3399,188,0,2,16,17,0
252,19,557,14,9,9,0,0,5,14,0,0,0,0,0,0,0,0,0,0,0,0,2,8,8,1
253,19,557,16,9,9,0,0,7,16,0,0,0,0,0,0,0,0,0,0,0,0,2,8,8,1
254,1,85,13,10,10,0,0,3,13,1,2,1,2,3,3,2,4,0,2,0,0,2,3,2,0
255,7,571,652,304,544,16,6,88,668,6,89,51,101,95,152,591,998,3,3399,188,0,2,10,9,0
256,150,2630,1338,495,1086,10,64,173,1348,11,122,82,157,133,239,883,1686,7,11934,663,0,2,0,21,0
257,6,203,256,139,192,9,7,47,265,4,23,12,24,27,36,112,171,2,357,19,0,2,1,1,0
258,49,683,373,158,315,8,0,51,381,5,76,44,79,81,123,486,779,2,2026,112,0,2,6,5,0
259,74,1822,1943,715,1694,26,18,214,1969,12,185,120,237,197,357,1436,2721,7,20915,1161,0,2,13,12,0
260,74,1822,1168,838,957,57,25,144,1225,19,348,224,416,367,640,3018,5452,11,61921,3440,1,2,13,12,0
261,4,200,1455,414,1257,16,76,112,1471,5,41,23,46,46,69,231,381,2,1069,59,0,2,2,1,0
262,28,1715,373,158,315,8,0,51,381,5,76,44,79,81,123,486,779,2,2026,112,0,2,17,16,0
263,150,2630,1338,495,1086,10,64,173,1348,11,122,82,157,133,239,883,1686,7,11934,663,0,2,1,1,0
264,152,2651,1338,495,1086,10,64,173,1348,11,122,82,157,133,239,883,1686,7,11934,663,0,2,29,24,0
265,63,1405,1457,730,1242,11,6,188,1468,10,292,166,329,302,495,2424,4078,5,22973,1276,1,2,2,2,0
266,63,1405,74,35,59,1,0,14,75,3,14,7,14,17,21,58,85,1,128,7,0,2,2,2,0
267,63,1405,245,125,200,5,7,34,250,7,30,17,34,37,51,166,265,3,1053,58,0,2,2,2,0
268,49,683,373,158,315,8,0,51,381,5,76,44,79,81,123,486,779,2,2026,112,0,2,1,1,0
269,74,1822,1943,715,1694,26,18,214,1969,12,185,120,237,197,357,1436,2721,7,20915,1161,0,2,4,4,0
270,74,1822,1168,838,957,57,25,144,1225,19,348,224,416,367,640,3018,5452,11,61921,3440,1,2,4,4,0
271,43,2647,1457,730,1242,11,6,188,1468,10,292,166,329,302,495,2424,4078,5,22973,1276,1,2,5,5,0
272,28,1715,373,158,315,8,0,51,381,5,76,44,79,81,123,486,779,2,2026,112,0,2,3,3,0
273,152,2651,1338,495,1086,10,64,173,1348,11,122,82,157,133,239,883,1686,7,11934,663,0,2,6,6,1
274,74,1822,1943,715,1694,26,18,214,1969,12,185,120,237,197,357,1436,2721,7,20915,1161,0,2,2,2,1
275,74,1822,1168,838,957,57,25,144,1225,19,348,224,416,367,640,3018,5452,11,61921,3440,1,2,2,2,1
276,4,200,1455,414,1257,16,76,112,1471,5,41,23,46,46,69,231,381,2,1069,59,0,2,1,1,1
277,61,1365,1457,730,1242,11,6,188,1468,10,292,166,329,302,495,2424,4078,5,22973,1276,1,2,0,8,0
278,61,1365,74,35,59,1,0,14,75,3,14,7,14,17,21,58,85,1,128,7,0,2,0,8,0
279,61,1365,245,125,200,5,7,34,250,7,30,17,34,37,51,166,265,3,1053,58,0,2,0,8,0
280,152,2651,1338,495,1086,10,64,173,1348,11,122,82,157,133,239,883,1686,7,11934,663,0,2,1,1,1
281,49,683,373,158,315,8,0,51,381,5,76,44,79,81,123,486,779,2,2026,112,0,2,1,1,1
282,74,1813,1943,715,1694,26,18,214,1969,12,185,120,237,197,357,1436,2721,7,20915,1161,0,2,1,2,1
283,74,1813,1168,838,957,57,25,144,1225,19,348,224,416,367,640,3018,5452,11,61921,3440,1,2,1,2,1
284,152,2659,1338,495,1086,10,64,173,1348,11,122,82,157,133,239,883,1686,7,11934,663,0,2,2,1,0
285,152,2655,1338,495,1086,10,64,173,1348,11,122,82,157,133,239,883,1686,7,11934,663,0,2,1,1,0
286,64,1432,1457,730,1242,11,6,188,1468,10,292,166,329,302,495,2424,4078,5,22973,1276,1,2,14,0,1
287,64,1432,74,35,59,1,0,14,75,3,14,7,14,17,21,58,85,1,128,7,0,2,14,0,1
288,64,1432,245,125,200,5,7,34,250,7,30,17,34,37,51,166,265,3,1053,58,0,2,14,0,1
289,44,2743,1457,730,1242,11,6,188,1468,10,292,166,329,302,495,2424,4078,5,22973,1276,1,2,13,1,1
290,62,1413,1457,730,1242,11,6,188,1468,10,292,166,329,302,495,2424,4078,5,22973,1276,1,2,2,6,0
291,62,1413,74,35,59,1,0,14,75,3,14,7,14,17,21,58,85,1,128,7,0,2,2,6,0
292,62,1413,245,125,200,5,7,34,250,7,30,17,34,37,51,166,265,3,1053,58,0,2,2,6,0
293,44,2833,1457,730,1242,11,6,188,1468,10,292,166,329,302,495,2424,4078,5,22973,1276,1,2,23,15,0
294,29,1741,373,158,315,8,0,51,381,5,76,44,79,81,123,486,779,2,2026,112,0,2,4,0,0
295,44,2848,1457,730,1242,11,6,188,1468,10,292,166,329,302,495,2424,4078,5,22973,1276,1,2,4,2,0
296,44,2906,1457,730,1242,11,6,188,1468,10,292,166,329,302,495,2424,4078,5,22973,1276,1,2,8,3,0
297,79,1690,127,75,83,2,11,30,129,4,14,7,14,18,21,61,87,2,175,9,0,2,1,0,0
298,79,1690,652,304,544,16,6,88,668,6,89,51,101,95,152,591,998,3,3399,188,0,2,1,0,0
299,79,1690,2,2,2,0,0,0,2,0,0,0,0,0,0,0,0,0,0,0,0,2,1,0,0
300,79,1690,8,5,5,0,0,3,8,0,0,0,0,0,0,0,0,0,0,0,0,2,1,0,0
301,79,1690,2,2,2,0,0,0,2,0,0,0,0,0,0,0,0,0,0,0,0,2,1,0,0
302,79,1690,14,8,8,0,0,6,14,0,0,0,0,0,0,0,0,0,0,0,0,2,1,0,0
303,79,1690,6,4,4,0,0,2,6,0,0,0,0,0,0,0,0,0,0,0,0,2,1,0,0
304,79,1690,6,4,4,0,0,2,6,1,2,1,2,3,3,2,4,0,2,0,0,2,1,0,0
305,79,1690,6,4,4,0,0,2,6,0,0,0,0,0,0,0,0,0,0,0,0,2,1,0,0
306,79,1690,7,5,5,0,0,2,7,0,0,0,0,0,0,0,0,0,0,0,0,2,1,0,0
307,79,1690,6,4,4,0,0,2,6,0,0,0,0,0,0,0,0,0,0,0,0,2,1,0,0
308,79,1690,10,6,6,0,0,4,10,0,0,0,0,0,0,0,0,0,0,0,0,2,1,0,0
309,79,1690,1,1,1,0,0,0,1,0,0,0,0,0,0,0,0,0,0,0,0,2,1,0,0
310,79,1690,1,1,1,0,0,0,1,0,0,0,0,0,0,0,0,0,0,0,0,2,1,0,0
311,79,1690,14,10,10,0,0,4,14,1,1,1,1,2,2,0,2,0,1,0,0,2,1,0,0
312,79,1690,46,26,30,3,0,12,49,3,6,3,6,9,9,20,28,1,42,2,0,2,1,0,0
313,8,660,652,304,544,16,6,88,668,6,89,51,101,95,152,591,998,3,3399,188,0,2,15,0,0
314,79,1690,127,75,83,2,11,30,129,4,14,7,14,18,21,61,87,2,175,9,0,2,2,2,0
315,79,1690,652,304,544,16,6,88,668,6,89,51,101,95,152,591,998,3,3399,188,0,2,2,2,0
316,79,1690,2,2,2,0,0,0,2,0,0,0,0,0,0,0,0,0,0,0,0,2,2,2,0
317,79,1690,8,5,5,0,0,3,8,0,0,0,0,0,0,0,0,0,0,0,0,2,2,2,0
318,79,1690,2,2,2,0,0,0,2,0,0,0,0,0,0,0,0,0,0,0,0,2,2,2,0
319,79,1690,14,8,8,0,0,6,14,0,0,0,0,0,0,0,0,0,0,0,0,2,2,2,0
320,79,1690,6,4,4,0,0,2,6,0,0,0,0,0,0,0,0,0,0,0,0,2,2,2,0
321,79,1690,6,4,4,0,0,2,6,1,2,1,2,3,3,2,4,0,2,0,0,2,2,2,0
322,79,1690,6,4,4,0,0,2,6,0,0,0,0,0,0,0,0,0,0,0,0,2,2,2,0
323,79,1690,7,5,5,0,0,2,7,0,0,0,0,0,0,0,0,0,0,0,0,2,2,2,0
324,79,1690,6,4,4,0,0,2,6,0,0,0,0,0,0,0,0,0,0,0,0,2,2,2,0
325,79,1690,10,6,6,0,0,4,10,0,0,0,0,0,0,0,0,0,0,0,0,2,2,2,0
326,79,1690,1,1,1,0,0,0,1,0,0,0,0,0,0,0,0,0,0,0,0,2,2,2,0
327,79,1690,1,1,1,0,0,0,1,0,0,0,0,0,0,0,0,0,0,0,0,2,2,2,0
328,79,1690,14,10,10,0,0,4,14,1,1,1,1,2,2,0,2,0,1,0,0,2,2,2,0
329,79,1690,46,26,30,3,0,12,49,3,6,3,6,9,9,20,28,1,42,2,0,2,2,2,0
330,47,2925,1457,730,1242,11,6,188,1468,10,292,166,329,302,495,2424,4078,5,22973,1276,1,2,11,7,0
331,87,1812,127,75,83,2,11,30,129,4,14,7,14,18,21,61,87,2,175,9,0,2,22,4,0
332,87,1812,652,304,544,16,6,88,668,6,89,51,101,95,152,591,998,3,3399,188,0,2,22,4,0
333,87,1812,2,2,2,0,0,0,2,0,0,0,0,0,0,0,0,0,0,0,0,2,22,4,0
334,87,1812,8,5,5,0,0,3,8,0,0,0,0,0,0,0,0,0,0,0,0,2,22,4,0
335,87,1812,2,2,2,0,0,0,2,0,0,0,0,0,0,0,0,0,0,0,0,2,22,4,0
336,87,1812,14,8,8,0,0,6,14,0,0,0,0,0,0,0,0,0,0,0,0,2,22,4,0
337,87,1812,6,4,4,0,0,2,6,0,0,0,0,0,0,0,0,0,0,0,0,2,22,4,0
338,87,1812,6,4,4,0,0,2,6,1,2,1,2,3,3,2,4,0,2,0,0,2,22,4,0
339,87,1812,6,4,4,0,0,2,6,0,0,0,0,0,0,0,0,0,0,0,0,2,22,4,0
340,87,1812,7,5,5,0,0,2,7,0,0,0,0,0,0,0,0,0,0,0,0,2,22,4,0
341,87,1812,6,4,4,0,0,2,6,0,0,0,0,0,0,0,0,0,0,0,0,2,22,4,0
342,87,1812,10,6,6,0,0,4,10,0,0,0,0,0,0,0,0,0,0,0,0,2,22,4,0
343,87,1812,1,1,1,0,0,0,1,0,0,0,0,0,0,0,0,0,0,0,0,2,22,4,0
344,87,1812,1,1,1,0,0,0,1,0,0,0,0,0,0,0,0,0,0,0,0,2,22,4,0
345,87,1812,14,10,10,0,0,4,14,1,1,1,1,2,2,0,2,0,1,0,0,2,22,4,0
346,87,1812,46,26,30,3,0,12,49,3,6,3,6,9,9,20,28,1,42,2,0,2,22,4,0
347,10,824,652,304,544,16,6,88,668,6,89,51,101,95,152,591,998,3,3399,188,0,2,24,0,0
348,63,1436,1457,730,1242,11,6,188,1468,10,292,166,329,302,495,2424,4078,5,22973,1276,1,2,5,2,0
349,63,1436,74,35,59,1,0,14,75,3,14,7,14,17,21,58,85,1,128,7,0,2,5,2,0
350,63,1436,245,125,200,5,7,34,250,7,30,17,34,37,51,166,265,3,1053,58,0,2,5,2,0
351,50,2993,1457,730,1242,11,6,188,1468,10,292,166,329,302,495,2424,4078,5,22973,1276,1,2,15,0,0
352,62,1440,1457,730,1242,11,6,188,1468,10,292,166,329,302,495,2424,4078,5,22973,1276,1,2,7,8,0
353,62,1440,74,35,59,1,0,14,75,3,14,7,14,17,21,58,85,1,128,7,0,2,7,8,0
354,62,1440,245,125,200,5,7,34,250,7,30,17,34,37,51,166,265,3,1053,58,0,2,7,8,0
355,62,1413,1457,730,1242,11,6,188,1468,10,292,166,329,302,495,2424,4078,5,22973,1276,1,2,4,6,0
356,62,1413,74,35,59,1,0,14,75,3,14,7,14,17,21,58,85,1,128,7,0,2,4,6,0
357,62,1413,245,125,200,5,7,34,250,7,30,17,34,37,51,166,265,3,1053,58,0,2,4,6,0
358,47,2925,1457,730,1242,11,6,188,1468,10,292,166,329,302,495,2424,4078,5,22973,1276,1,2,0,15,0
359,63,1428,1457,730,1242,11,6,188,1468,10,292,166,329,302,495,2424,4078,5,22973,1276,1,2,4,0,0
360,63,1428,74,35,59,1,0,14,75,3,14,7,14,17,21,58,85,1,128,7,0,2,4,0,0
361,63,1428,245,125,200,5,7,34,250,7,30,17,34,37,51,166,265,3,1053,58,0,2,4,0,0
362,150,2618,1338,495,1086,10,64,173,1348,11,122,82,157,133,239,883,1686,7,11934,663,0,2,2,7,0
363,69,1548,1457,730,1242,11,6,188,1468,10,292,166,329,302,495,2424,4078,5,22973,1276,1,2,18,0,0
364,69,1548,74,35,59,1,0,14,75,3,14,7,14,17,21,58,85,1,128,7,0,2,18,0,0
365,69,1548,245,125,200,5,7,34,250,7,30,17,34,37,51,166,265,3,1053,58,0,2,18,0,0
366,48,3110,1457,730,1242,11,6,188,1468,10,292,166,329,302,495,2424,4078,5,22973,1276,1,2,24,0,0
367,29,1712,373,158,315,8,0,51,381,5,76,44,79,81,123,486,779,2,2026,112,0,2,2,5,0
368,68,1525,1457,730,1242,11,6,188,1468,10,292,166,329,302,495,2424,4078,5,22973,1276,1,2,2,8,0
369,68,1525,74,35,59,1,0,14,75,3,14,7,14,17,21,58,85,1,128,7,0,2,2,8,0
370,68,1525,245,125,200,5,7,34,250,7,30,17,34,37,51,166,265,3,1053,58,0,2,2,8,0
371,48,3109,1457,730,1242,11,6,188,1468,10,292,166,329,302,495,2424,4078,5,22973,1276,1,2,1,1,0
372,74,1795,1943,715,1694,26,18,214,1969,12,185,120,237,197,357,1436,2721,7,20915,1161,0,2,2,2,0
373,74,1795,1168,838,957,57,25,144,1225,19,348,224,416,367,640,3018,5452,11,61921,3440,1,2,2,2,0
374,68,1525,1457,730,1242,11,6,188,1468,10,292,166,329,302,495,2424,4078,5,22973,1276,1,2,3,2,0
375,68,1525,74,35,59,1,0,14,75,3,14,7,14,17,21,58,85,1,128,7,0,2,3,2,0
376,68,1525,245,125,200,5,7,34,250,7,30,17,34,37,51,166,265,3,1053,58,0,2,3,2,0
377,69,1539,1457,730,1242,11,6,188,1468,10,292,166,329,302,495,2424,4078,5,22973,1276,1,2,8,5,0
378,69,1539,74,35,59,1,0,14,75,3,14,7,14,17,21,58,85,1,128,7,0,2,8,5,0
379,69,1539,245,125,200,5,7,34,250,7,30,17,34,37,51,166,265,3,1053,58,0,2,8,5,0
380,48,3144,1457,730,1242,11,6,188,1468,10,292,166,329,302,495,2424,4078,5,22973,1276,1,2,4,0,0
381,88,1867,127,75,83,2,11,30,129,4,14,7,14,18,21,61,87,2,175,9,0,2,12,3,1
382,88,1867,652,304,544,16,6,88,668,6,89,51,101,95,152,591,998,3,3399,188,0,2,12,3,1
383,88,1867,2,2,2,0,0,0,2,0,0,0,0,0,0,0,0,0,0,0,0,2,12,3,1
384,88,1867,8,5,5,0,0,3,8,0,0,0,0,0,0,0,0,0,0,0,0,2,12,3,1
385,88,1867,2,2,2,0,0,0,2,0,0,0,0,0,0,0,0,0,0,0,0,2,12,3,1
386,88,1867,14,8,8,0,0,6,14,0,0,0,0,0,0,0,0,0,0,0,0,2,12,3,1
387,88,1867,6,4,4,0,0,2,6,0,0,0,0,0,0,0,0,0,0,0,0,2,12,3,1
388,88,1867,6,4,4,0,0,2,6,1,2,1,2,3,3,2,4,0,2,0,0,2,12,3,1
389,88,1867,6,4,4,0,0,2,6,0,0,0,0,0,0,0,0,0,0,0,0,2,12,3,1
390,88,1867,7,5,5,0,0,2,7,0,0,0,0,0,0,0,0,0,0,0,0,2,12,3,1
391,88,1867,6,4,4,0,0,2,6,0,0,0,0,0,0,0,0,0,0,0,0,2,12,3,1
392,88,1867,10,6,6,0,0,4,10,0,0,0,0,0,0,0,0,0,0,0,0,2,12,3,1
393,88,1867,1,1,1,0,0,0,1,0,0,0,0,0,0,0,0,0,0,0,0,2,12,3,1
394,88,1867,1,1,1,0,0,0,1,0,0,0,0,0,0,0,0,0,0,0,0,2,12,3,1
395,88,1867,14,10,10,0,0,4,14,1,1,1,1,2,2,0,2,0,1,0,0,2,12,3,1
396,88,1867,46,26,30,3,0,12,49,3,6,3,6,9,9,20,28,1,42,2,0,2,12,3,1
397,10,851,652,304,544,16,6,88,668,6,89,51,101,95,152,591,998,3,3399,188,0,2,8,6,1
398,88,1870,127,75,83,2,11,30,129,4,14,7,14,18,21,61,87,2,175,9,0,2,2,1,1
399,88,1870,652,304,544,16,6,88,668,6,89,51,101,95,152,591,998,3,3399,188,0,2,2,1,1
400,88,1870,2,2,2,0,0,0,2,0,0,0,0,0,0,0,0,0,0,0,0,2,2,1,1
401,88,1870,8,5,5,0,0,3,8,0,0,0,0,0,0,0,0,0,0,0,0,2,2,1,1
402,88,1870,2,2,2,0,0,0,2,0,0,0,0,0,0,0,0,0,0,0,0,2,2,1,1
403,88,1870,14,8,8,0,0,6,14,0,0,0,0,0,0,0,0,0,0,0,0,2,2,1,1
404,88,1870,6,4,4,0,0,2,6,0,0,0,0,0,0,0,0,0,0,0,0,2,2,1,1
405,88,1870,6,4,4,0,0,2,6,1,2,1,2,3,3,2,4,0,2,0,0,2,2,1,1
406,88,1870,6,4,4,0,0,2,6,0,0,0,0,0,0,0,0,0,0,0,0,2,2,1,1
407,88,1870,7,5,5,0,0,2,7,0,0,0,0,0,0,0,0,0,0,0,0,2,2,1,1
408,88,1870,6,4,4,0,0,2,6,0,0,0,0,0,0,0,0,0,0,0,0,2,2,1,1
409,88,1870,10,6,6,0,0,4,10,0,0,0,0,0,0,0,0,0,0,0,0,2,2,1,1
410,88,1870,1,1,1,0,0,0,1,0,0,0,0,0,0,0,0,0,0,0,0,2,2,1,1
411,88,1870,1,1,1,0,0,0,1,0,0,0,0,0,0,0,0,0,0,0,0,2,2,1,1
412,88,1870,14,10,10,0,0,4,14,1,1,1,1,2,2,0,2,0,1,0,0,2,2,1,1
413,88,1870,46,26,30,3,0,12,49,3,6,3,6,9,9,20,28,1,42,2,0,2,2,1,1
414,69,1539,1457,730,1242,11,6,188,1468,10,292,166,329,302,495,2424,4078,5,22973,1276,1,2,4,4,0
415,69,1539,74,35,59,1,0,14,75,3,14,7,14,17,21,58,85,1,128,7,0,2,4,4,0
416,69,1539,245,125,200,5,7,34,250,7,30,17,34,37,51,166,265,3,1053,58,0,2,4,4,0
417,48,3144,1457,730,1242,11,6,188,1468,10,292,166,329,302,495,2424,4078,5,22973,1276,1,2,11,11,0
418,69,1539,1457,730,1242,11,6,188,1468,10,292,166,329,302,495,2424,4078,5,22973,1276,1,2,1,1,0
419,69,1539,74,35,59,1,0,14,75,3,14,7,14,17,21,58,85,1,128,7,0,2,1,1,0
420,69,1539,245,125,200,5,7,34,250,7,30,17,34,37,51,166,265,3,1053,58,0,2,1,1,0
421,48,3144,1457,730,1242,11,6,188,1468,10,292,166,329,302,495,2424,4078,5,22973,1276,1,2,4,4,0
422,148,2598,1338,495,1086,10,64,173,1348,11,122,82,157,133,239,883,1686,7,11934,663,0,2,10,9,0
423,50,3161,1457,730,1242,11,6,188,1468,10,292,166,329,302,495,2424,4078,5,22973,1276,1,2,2,1,0
424,148,2599,1338,495,1086,10,64,173,1348,11,122,82,157,133,239,883,1686,7,11934,663,0,2,3,5,0
425,48,3144,1457,730,1242,11,6,188,1468,10,292,166,329,302,495,2424,4078,5,22973,1276,1,2,1,2,0
426,88,1875,127,75,83,2,11,30,129,4,14,7,14,18,21,61,87,2,175,9,0,2,1,1,1
427,88,1875,652,304,544,16,6,88,668,6,89,51,101,95,152,591,998,3,3399,188,0,2,1,1,1
428,88,1875,2,2,2,0,0,0,2,0,0,0,0,0,0,0,0,0,0,0,0,2,1,1,1
429,88,1875,8,5,5,0,0,3,8,0,0,0,0,0,0,0,0,0,0,0,0,2,1,1,1
430,88,1875,2,2,2,0,0,0,2,0,0,0,0,0,0,0,0,0,0,0,0,2,1,1,1
431,88,1875,14,8,8,0,0,6,14,0,0,0,0,0,0,0,0,0,0,0,0,2,1,1,1
432,88,1875,6,4,4,0,0,2,6,0,0,0,0,0,0,0,0,0,0,0,0,2,1,1,1
433,88,1875,6,4,4,0,0,2,6,1,2,1,2,3,3,2,4,0,2,0,0,2,1,1,1
434,88,1875,6,4,4,0,0,2,6,0,0,0,0,0,0,0,0,0,0,0,0,2,1,1,1
435,88,1875,7,5,5,0,0,2,7,0,0,0,0,0,0,0,0,0,0,0,0,2,1,1,1
436,88,1875,6,4,4,0,0,2,6,0,0,0,0,0,0,0,0,0,0,0,0,2,1,1,1
437,88,1875,10,6,6,0,0,4,10,0,0,0,0,0,0,0,0,0,0,0,0,2,1,1,1
438,88,1875,1,1,1,0,0,0,1,0,0,0,0,0,0,0,0,0,0,0,0,2,1,1,1
439,88,1875,1,1,1,0,0,0,1,0,0,0,0,0,0,0,0,0,0,0,0,2,1,1,1
440,88,1875,14,10,10,0,0,4,14,1,1,1,1,2,2,0,2,0,1,0,0,2,1,1,1
441,88,1875,46,26,30,3,0,12,49,3,6,3,6,9,9,20,28,1,42,2,0,2,1,1,1
442,69,1539,1457,730,1242,11,6,188,1468,10,292,166,329,302,495,2424,4078,5,22973,1276,1,2,9,9,0
443,69,1539,74,35,59,1,0,14,75,3,14,7,14,17,21,58,85,1,128,7,0,2,9,9,0
444,69,1539,245,125,200,5,7,34,250,7,30,17,34,37,51,166,265,3,1053,58,0,2,9,9,0
445,74,1795,1943,715,1694,26,18,214,1969,12,185,120,237,197,357,1436,2721,7,20915,1161,0,2,1,1,0
446,74,1795,1168,838,957,57,25,144,1225,19,348,224,416,367,640,3018,5452,11,61921,3440,1,2,1,1,0
447,88,1881,127,75,83,2,11,30,129,4,14,7,14,18,21,61,87,2,175,9,0,2,3,3,1
448,88,1881,652,304,544,16,6,88,668,6,89,51,101,95,152,591,998,3,3399,188,0,2,3,3,1
449,88,1881,2,2,2,0,0,0,2,0,0,0,0,0,0,0,0,0,0,0,0,2,3,3,1
450,88,1881,8,5,5,0,0,3,8,0,0,0,0,0,0,0,0,0,0,0,0,2,3,3,1
451,88,1881,2,2,2,0,0,0,2,0,0,0,0,0,0,0,0,0,0,0,0,2,3,3,1
452,88,1881,14,8,8,0,0,6,14,0,0,0,0,0,0,0,0,0,0,0,0,2,3,3,1
453,88,1881,6,4,4,0,0,2,6,0,0,0,0,0,0,0,0,0,0,0,0,2,3,3,1
454,88,1881,6,4,4,0,0,2,6,1,2,1,2,3,3,2,4,0,2,0,0,2,3,3,1
455,88,1881,6,4,4,0,0,2,6,0,0,0,0,0,0,0,0,0,0,0,0,2,3,3,1
456,88,1881,7,5,5,0,0,2,7,0,0,0,0,0,0,0,0,0,0,0,0,2,3,3,1
457,88,1881,6,4,4,0,0,2,6,0,0,0,0,0,0,0,0,0,0,0,0,2,3,3,1
458,88,1881,10,6,6,0,0,4,10,0,0,0,0,0,0,0,0,0,0,0,0,2,3,3,1
459,88,1881,1,1,1,0,0,0,1,0,0,0,0,0,0,0,0,0,0,0,0,2,3,3,1
460,88,1881,1,1,1,0,0,0,1,0,0,0,0,0,0,0,0,0,0,0,0,2,3,3,1
461,88,1881,14,10,10,0,0,4,14,1,1,1,1,2,2,0,2,0,1,0,0,2,3,3,1
462,88,1881,46,26,30,3,0,12,49,3,6,3,6,9,9,20,28,1,42,2,0,2,3,3,1
463,148,2605,1338,495,1086,10,64,173,1348,11,122,82,157,133,239,883,1686,7,11934,663,0,2,3,3,1
464,4,111,1455,414,1257,16,76,112,1471,5,41,23,46,46,69,231,381,2,1069,59,0,2,1,1,1
465,4,111,669,365,481,22,61,110,691,15,103,63,122,118,185,747,1273,8,11311,628,0,2,1,1,1
466,49,689,373,158,315,8,0,51,381,5,76,44,79,81,123,486,779,2,2026,112,0,2,3,3,1
467,74,1799,1943,715,1694,26,18,214,1969,12,185,120,237,197,357,1436,2721,7,20915,1161,0,2,2,2,1
468,74,1799,1168,838,957,57,25,144,1225,19,348,224,416,367,640,3018,5452,11,61921,3440,1,2,2,2,1
469,4,202,1455,414,1257,16,76,112,1471,5,41,23,46,46,69,231,381,2,1069,59,0,2,1,1,1
470,29,1712,373,158,315,8,0,51,381,5,76,44,79,81,123,486,779,2,2026,112,0,2,1,1,1
471,92,1971,127,75,83,2,11,30,129,4,14,7,14,18,21,61,87,2,175,9,0,2,20,8,0
472,92,1971,652,304,544,16,6,88,668,6,89,51,101,95,152,591,998,3,3399,188,0,2,20,8,0
473,92,1971,2,2,2,0,0,0,2,0,0,0,0,0,0,0,0,0,0,0,0,2,20,8,0
474,92,1971,8,5,5,0,0,3,8,0,0,0,0,0,0,0,0,0,0,0,0,2,20,8,0
475,92,1971,2,2,2,0,0,0,2,0,0,0,0,0,0,0,0,0,0,0,0,2,20,8,0
476,92,1971,14,8,8,0,0,6,14,0,0,0,0,0,0,0,0,0,0,0,0,2,20,8,0
477,92,1971,6,4,4,0,0,2,6,0,0,0,0,0,0,0,0,0,0,0,0,2,20,8,0
478,92,1971,6,4,4,0,0,2,6,1,2,1,2,3,3,2,4,0,2,0,0,2,20,8,0
479,92,1971,6,4,4,0,0,2,6,0,0,0,0,0,0,0,0,0,0,0,0,2,20,8,0
480,92,1971,7,5,5,0,0,2,7,0,0,0,0,0,0,0,0,0,0,0,0,2,20,8,0
481,92,1971,6,4,4,0,0,2,6,0,0,0,0,0,0,0,0,0,0,0,0,2,20,8,0
482,92,1971,10,6,6,0,0,4,10,0,0,0,0,0,0,0,0,0,0,0,0,2,20,8,0
483,92,1971,1,1,1,0,0,0,1,0,0,0,0,0,0,0,0,0,0,0,0,2,20,8,0
484,92,1971,1,1,1,0,0,0,1,0,0,0,0,0,0,0,0,0,0,0,0,2,20,8,0
485,92,1971,14,10,10,0,0,4,14,1,1,1,1,2,2,0,2,0,1,0,0,2,20,8,0
486,92,1971,46,26,30,3,0,12,49,3,6,3,6,9,9,20,28,1,42,2,0,2,20,8,0
487,92,1991,127,75,83,2,11,30,129,4,14,7,14,18,21,61,87,2,175,9,0,2,4,2,0
488,92,1991,652,304,544,16,6,88,668,6,89,51,101,95,152,591,998,3,3399,188,0,2,4,2,0
489,92,1991,2,2,2,0,0,0,2,0,0,0,0,0,0,0,0,0,0,0,0,2,4,2,0
490,92,1991,8,5,5,0,0,3,8,0,0,0,0,0,0,0,0,0,0,0,0,2,4,2,0
491,92,1991,2,2,2,0,0,0,2,0,0,0,0,0,0,0,0,0,0,0,0,2,4,2,0
492,92,1991,14,8,8,0,0,6,14,0,0,0,0,0,0,0,0,0,0,0,0,2,4,2,0
493,92,1991,6,4,4,0,0,2,6,0,0,0,0,0,0,0,0,0,0,0,0,2,4,2,0
494,92,1991,6,4,4,0,0,2,6,1,2,1,2,3,3,2,4,0,2,0,0,2,4,2,0
495,92,1991,6,4,4,0,0,2,6,0,0,0,0,0,0,0,0,0,0,0,0,2,4,2,0
496,92,1991,7,5,5,0,0,2,7,0,0,0,0,0,0,0,0,0,0,0,0,2,4,2,0
497,92,1991,6,4,4,0,0,2,6,0,0,0,0,0,0,0,0,0,0,0,0,2,4,2,0
498,92,1991,10,6,6,0,0,4,10,0,0,0,0,0,0,0,0,0,0,0,0,2,4,2,0
499,92,1991,1,1,1,0,0,0,1,0,0,0,0,0,0,0,0,0,0,0,0,2,4,2,0
500,92,1991,1,1,1,0,0,0,1,0,0,0,0,0,0,0,0,0,0,0,0,2,4,2,0
501,92,1991,14,10,10,0,0,4,14,1,1,1,1,2,2,0,2,0,1,0,0,2,4,2,0
502,92,1991,46,26,30,3,0,12,49,3,6,3,6,9,9,20,28,1,42,2,0,2,4,2,0
503,92,1995,127,75,83,2,11,30,129,4,14,7,14,18,21,61,87,2,175,9,0,2,2,1,0
504,92,1995,652,304,544,16,6,88,668,6,89,51,101,95,152,591,998,3,3399,188,0,2,2,1,0
505,92,1995,2,2,2,0,0,0,2,0,0,0,0,0,0,0,0,0,0,0,0,2,2,1,0
506,92,1995,8,5,5,0,0,3,8,0,0,0,0,0,0,0,0,0,0,0,0,2,2,1,0
507,92,1995,2,2,2,0,0,0,2,0,0,0,0,0,0,0,0,0,0,0,0,2,2,1,0
508,92,1995,14,8,8,0,0,6,14,0,0,0,0,0,0,0,0,0,0,0,0,2,2,1,0
509,92,1995,6,4,4,0,0,2,6,0,0,0,0,0,0,0,0,0,0,0,0,2,2,1,0
510,92,1995,6,4,4,0,0,2,6,1,2,1,2,3,3,2,4,0,2,0,0,2,2,1,0
511,92,1995,6,4,4,0,0,2,6,0,0,0,0,0,0,0,0,0,0,0,0,2,2,1,0
512,92,1995,7,5,5,0,0,2,7,0,0,0,0,0,0,0,0,0,0,0,0,2,2,1,0
513,92,1995,6,4,4,0,0,2,6,0,0,0,0,0,0,0,0,0,0,0,0,2,2,1,0
514,92,1995,10,6,6,0,0,4,10,0,0,0,0,0,0,0,0,0,0,0,0,2,2,1,0
515,92,1995,1,1,1,0,0,0,1,0,0,0,0,0,0,0,0,0,0,0,0,2,2,1,0
516,92,1995,1,1,1,0,0,0,1,0,0,0,0,0,0,0,0,0,0,0,0,2,2,1,0
517,92,1995,14,10,10,0,0,4,14,1,1,1,1,2,2,0,2,0,1,0,0,2,2,1,0
518,92,1995,46,26,30,3,0,12,49,3,6,3,6,9,9,20,28,1,42,2,0,2,2,1,0
519,93,1999,127,75,83,2,11,30,129,4,14,7,14,18,21,61,87,2,175,9,0,2,7,6,0
520,93,1999,652,304,544,16,6,88,668,6,89,51,101,95,152,591,998,3,3399,188,0,2,7,6,0
521,93,1999,2,2,2,0,0,0,2,0,0,0,0,0,0,0,0,0,0,0,0,2,7,6,0
522,93,1999,8,5,5,0,0,3,8,0,0,0,0,0,0,0,0,0,0,0,0,2,7,6,0
523,93,1999,2,2,2,0,0,0,2,0,0,0,0,0,0,0,0,0,0,0,0,2,7,6,0
524,93,1999,14,8,8,0,0,6,14,0,0,0,0,0,0,0,0,0,0,0,0,2,7,6,0
525,93,1999,6,4,4,0,0,2,6,0,0,0,0,0,0,0,0,0,0,0,0,2,7,6,0
526,93,1999,6,4,4,0,0,2,6,1,2,1,2,3,3,2,4,0,2,0,0,2,7,6,0
527,93,1999,6,4,4,0,0,2,6,0,0,0,0,0,0,0,0,0,0,0,0,2,7,6,0
528,93,1999,7,5,5,0,0,2,7,0,0,0,0,0,0,0,0,0,0,0,0,2,7,6,0
529,93,1999,6,4,4,0,0,2,6,0,0,0,0,0,0,0,0,0,0,0,0,2,7,6,0
530,93,1999,10,6,6,0,0,4,10,0,0,0,0,0,0,0,0,0,0,0,0,2,7,6,0
531,93,1999,1,1,1,0,0,0,1,0,0,0,0,0,0,0,0,0,0,0,0,2,7,6,0
532,93,1999,1,1,1,0,0,0,1,0,0,0,0,0,0,0,0,0,0,0,0,2,7,6,0
533,93,1999,14,10,10,0,0,4,14,1,1,1,1,2,2,0,2,0,1,0,0,2,7,6,0
534,93,1999,46,26,30,3,0,12,49,3,6,3,6,9,9,20,28,1,42,2,0,2,7,6,0
535,94,2025,127,75,83,2,11,30,129,4,14,7,14,18,21,61,87,2,175,9,0,2,3,0,0
536,94,2025,652,304,544,16,6,88,668,6,89,51,101,95,152,591,998,3,3399,188,0,2,3,0,0
537,94,2025,2,2,2,0,0,0,2,0,0,0,0,0,0,0,0,0,0,0,0,2,3,0,0
538,94,2025,8,5,5,0,0,3,8,0,0,0,0,0,0,0,0,0,0,0,0,2,3,0,0
539,94,2025,2,2,2,0,0,0,2,0,0,0,0,0,0,0,0,0,0,0,0,2,3,0,0
540,94,2025,14,8,8,0,0,6,14,0,0,0,0,0,0,0,0,0,0,0,0,2,3,0,0
541,94,2025,6,4,4,0,0,2,6,0,0,0,0,0,0,0,0,0,0,0,0,2,3,0,0
542,94,2025,6,4,4,0,0,2,6,1,2,1,2,3,3,2,4,0,2,0,0,2,3,0,0
543,94,2025,6,4,4,0,0,2,6,0,0,0,0,0,0,0,0,0,0,0,0,2,3,0,0
544,94,2025,7,5,5,0,0,2,7,0,0,0,0,0,0,0,0,0,0,0,0,2,3,0,0
545,94,2025,6,4,4,0,0,2,6,0,0,0,0,0,0,0,0,0,0,0,0,2,3,0,0
546,94,2025,10,6,6,0,0,4,10,0,0,0,0,0,0,0,0,0,0,0,0,2,3,0,0
547,94,2025,1,1,1,0,0,0,1,0,0,0,0,0,0,0,0,0,0,0,0,2,3,0,0
548,94,2025,1,1,1,0,0,0,1,0,0,0,0,0,0,0,0,0,0,0,0,2,3,0,0
549,94,2025,14,10,10,0,0,4,14,1,1,1,1,2,2,0,2,0,1,0,0,2,3,0,0
550,94,2025,46,26,30,3,0,12,49,3,6,3,6,9,9,20,28,1,42,2,0,2,3,0,0
551,74,1803,1943,715,1694,26,18,214,1969,12,185,120,237,197,357,1436,2721,7,20915,1161,0,2,9,5,0
552,74,1803,1168,838,957,57,25,144,1225,19,348,224,416,367,640,3018,5452,11,61921,3440,1,2,9,5,0
553,146,2579,1338,495,1086,10,64,173,1348,11,122,82,157,133,239,883,1686,7,11934,663,0,2,3,8,0
554,41,1388,773,419,590,28,0,166,801,10,204,113,217,214,330,1598,2554,5,13587,754,0,2,12,0,0
555,154,2728,1338,495,1086,10,64,173,1348,11,122,82,157,133,239,883,1686,7,11934,663,0,2,32,1,0
556,54,751,373,158,315,8,0,51,381,5,76,44,79,81,123,486,779,2,2026,112,0,2,16,5,0
557,30,1793,373,158,315,8,0,51,381,5,76,44,79,81,123,486,779,2,2026,112,0,2,14,2,0
558,52,722,373,158,315,8,0,51,381,5,76,44,79,81,123,486,779,2,2026,112,0,2,6,11,0
559,30,1793,373,158,315,8,0,51,381,5,76,44,79,81,123,486,779,2,2026,112,0,2,1,2,0
560,6,265,207,111,150,11,0,50,218,5,26,19,36,31,55,133,272,3,943,52,0,0,59,0,0
561,6,265,410,198,237,31,55,97,441,11,63,38,72,74,110,414,683,6,4293,238,0,0,59,0,0
562,4,225,207,111,150,11,0,50,218,5,26,19,36,31,55,133,272,3,943,52,0,0,53,0,0
563,154,2728,1338,495,1086,10,64,173,1348,11,122,82,157,133,239,883,1686,7,11934,663,0,2,1,1,0
564,154,2732,1338,495,1086,10,64,173,1348,11,122,82,157,133,239,883,1686,7,11934,663,0,2,1,1,0
565,13,259,1392,870,1177,35,17,170,1427,14,494,280,531,508,811,4473,7289,7,54850,3047,2,2,3,0,0
566,12,243,1392,870,1177,35,17,170,1427,14,494,280,531,508,811,4473,7289,7,54850,3047,2,2,1,4,0
567,31,1899,373,158,315,8,0,51,381,5,76,44,79,81,123,486,779,2,2026,112,0,2,21,0,1
568,152,2711,1338,495,1086,10,64,173,1348,11,122,82,157,133,239,883,1686,7,11934,663,0,2,1,4,0
569,148,2629,1338,495,1086,10,64,173,1348,11,122,82,157,133,239,883,1686,7,11934,663,0,2,5,16,0
570,59,833,373,158,315,8,0,51,381,5,76,44,79,81,123,486,779,2,2026,112,0,2,37,19,0
571,48,3132,1457,730,1242,11,6,188,1468,10,292,166,329,302,495,2424,4078,5,22973,1276,1,2,0,1,0
572,74,1813,1943,715,1694,26,18,214,1969,12,185,120,237,197,357,1436,2721,7,20915,1161,0,2,2,2,0
573,74,1813,1168,838,957,57,25,144,1225,19,348,224,416,367,640,3018,5452,11,61921,3440,1,2,2,2,0
574,74,1815,1943,715,1694,26,18,214,1969,12,185,120,237,197,357,1436,2721,7,20915,1161,0,2,1,1,0
575,74,1815,1168,838,957,57,25,144,1225,19,348,224,416,367,640,3018,5452,11,61921,3440,1,2,1,1,0
576,157,2724,1338,495,1086,10,64,173,1348,11,122,82,157,133,239,883,1686,7,11934,663,0,2,23,8,0
577,59,833,373,158,315,8,0,51,381,5,76,44,79,81,123,486,779,2,2026,112,0,2,1,1,0
578,32,1923,373,158,315,8,0,51,381,5,76,44,79,81,123,486,779,2,2026,112,0,2,13,10,0
579,59,840,373,158,315,8,0,51,381,5,76,44,79,81,123,486,779,2,2026,112,0,2,1,0,0
580,95,2040,127,75,83,2,11,30,129,4,14,7,14,18,21,61,87,2,175,9,0,2,3,2,0
581,95,2040,652,304,544,16,6,88,668,6,89,51,101,95,152,591,998,3,3399,188,0,2,3,2,0
582,95,2040,2,2,2,0,0,0,2,0,0,0,0,0,0,0,0,0,0,0,0,2,3,2,0
583,95,2040,8,5,5,0,0,3,8,0,0,0,0,0,0,0,0,0,0,0,0,2,3,2,0
584,95,2040,2,2,2,0,0,0,2,0,0,0,0,0,0,0,0,0,0,0,0,2,3,2,0
585,95,2040,14,8,8,0,0,6,14,0,0,0,0,0,0,0,0,0,0,0,0,2,3,2,0
586,95,2040,6,4,4,0,0,2,6,0,0,0,0,0,0,0,0,0,0,0,0,2,3,2,0
587,95,2040,6,4,4,0,0,2,6,1,2,1,2,3,3,2,4,0,2,0,0,2,3,2,0
588,95,2040,6,4,4,0,0,2,6,0,0,0,0,0,0,0,0,0,0,0,0,2,3,2,0
589,95,2040,7,5,5,0,0,2,7,0,0,0,0,0,0,0,0,0,0,0,0,2,3,2,0
590,95,2040,6,4,4,0,0,2,6,0,0,0,0,0,0,0,0,0,0,0,0,2,3,2,0
591,95,2040,10,6,6,0,0,4,10,0,0,0,0,0,0,0,0,0,0,0,0,2,3,2,0
592,95,2040,1,1,1,0,0,0,1,0,0,0,0,0,0,0,0,0,0,0,0,2,3,2,0
593,95,2040,1,1,1,0,0,0,1,0,0,0,0,0,0,0,0,0,0,0,0,2,3,2,0
594,95,2040,14,10,10,0,0,4,14,1,1,1,1,2,2,0,2,0,1,0,0,2,3,2,0
595,95,2040,46,26,30,3,0,12,49,3,6,3,6,9,9,20,28,1,42,2,0,2,3,2,0
596,62,1372,773,419,590,28,0,166,801,10,204,113,217,214,330,1598,2554,5,13587,754,0,2,1,1,0
597,62,1372,421,273,302,44,34,57,465,17,81,59,107,98,166,583,1098,11,12329,684,0,2,1,1,0
598,1,70,13,10,10,0,0,3,13,1,2,1,2,3,3,2,4,0,2,0,0,2,4,6,1
599,16,823,652,304,544,16,6,88,668,6,89,51,101,95,152,591,998,3,3399,188,0,2,32,28,1
600,157,2724,1338,495,1086,10,64,173,1348,11,122,82,157,133,239,883,1686,7,11934,663,0,2,1,1,1
601,67,1507,1457,730,1242,11,6,188,1468,10,292,166,329,302,495,2424,4078,5,22973,1276,1,2,7,14,1
602,67,1507,74,35,59,1,0,14,75,3,14,7,14,17,21,58,85,1,128,7,0,2,7,14,1
603,67,1507,245,125,200,5,7,34,250,7,30,17,34,37,51,166,265,3,1053,58,0,2,7,14,1
604,47,906,373,158,315,8,0,51,381,5,76,44,79,81,123,486,779,2,2026,112,0,2,94,86,1
605,47,3118,1457,730,1242,11,6,188,1468,10,292,166,329,302,495,2424,4078,5,22973,1276,1,2,9,7,1
606,48,1730,373,158,315,8,0,51,381,5,76,44,79,81,123,486,779,2,2026,112,0,2,94,146,1
607,2,50,127,75,83,2,11,30,129,4,14,7,14,18,21,61,87,2,175,9,0,2,6,2,1
608,2,50,652,304,544,16,6,88,668,6,89,51,101,95,152,591,998,3,3399,188,0,2,6,2,1
609,2,50,2,2,2,0,0,0,2,0,0,0,0,0,0,0,0,0,0,0,0,2,6,2,1
610,2,50,8,5,5,0,0,3,8,0,0,0,0,0,0,0,0,0,0,0,0,2,6,2,1
611,2,50,2,2,2,0,0,0,2,0,0,0,0,0,0,0,0,0,0,0,0,2,6,2,1
612,2,50,14,8,8,0,0,6,14,0,0,0,0,0,0,0,0,0,0,0,0,2,6,2,1
613,2,50,6,4,4,0,0,2,6,0,0,0,0,0,0,0,0,0,0,0,0,2,6,2,1
614,2,50,6,4,4,0,0,2,6,1,2,1,2,3,3,2,4,0,2,0,0,2,6,2,1
615,2,50,6,4,4,0,0,2,6,0,0,0,0,0,0,0,0,0,0,0,0,2,6,2,1
616,2,50,7,5,5,0,0,2,7,0,0,0,0,0,0,0,0,0,0,0,0,2,6,2,1
617,2,50,6,4,4,0,0,2,6,0,0,0,0,0,0,0,0,0,0,0,0,2,6,2,1
618,2,50,10,6,6,0,0,4,10,0,0,0,0,0,0,0,0,0,0,0,0,2,6,2,1
619,2,50,1,1,1,0,0,0,1,0,0,0,0,0,0,0,0,0,0,0,0,2,6,2,1
620,2,50,1,1,1,0,0,0,1,0,0,0,0,0,0,0,0,0,0,0,0,2,6,2,1
621,2,50,14,10,10,0,0,4,14,1,1,1,1,2,2,0,2,0,1,0,0,2,6,2,1
622,2,50,46,26,30,3,0,12,49,3,6,3,6,9,9,20,28,1,42,2,0,2,6,2,1
623,95,2040,127,75,83,2,11,30,129,4,14,7,14,18,21,61,87,2,175,9,0,2,1,1,0
624,95,2040,652,304,544,16,6,88,668,6,89,51,101,95,152,591,998,3,3399,188,0,2,1,1,0
625,95,2040,2,2,2,0,0,0,2,0,0,0,0,0,0,0,0,0,0,0,0,2,1,1,0
626,95,2040,8,5,5,0,0,3,8,0,0,0,0,0,0,0,0,0,0,0,0,2,1,1,0
627,95,2040,2,2,2,0,0,0,2,0,0,0,0,0,0,0,0,0,0,0,0,2,1,1,0
628,95,2040,14,8,8,0,0,6,14,0,0,0,0,0,0,0,0,0,0,0,0,2,1,1,0
629,95,2040,6,4,4,0,0,2,6,0,0,0,0,0,0,0,0,0,0,0,0,2,1,1,0
630,95,2040,6,4,4,0,0,2,6,1,2,1,2,3,3,2,4,0,2,0,0,2,1,1,0
631,95,2040,6,4,4,0,0,2,6,0,0,0,0,0,0,0,0,0,0,0,0,2,1,1,0
632,95,2040,7,5,5,0,0,2,7,0,0,0,0,0,0,0,0,0,0,0,0,2,1,1,0
633,95,2040,6,4,4,0,0,2,6,0,0,0,0,0,0,0,0,0,0,0,0,2,1,1,0
634,95,2040,10,6,6,0,0,4,10,0,0,0,0,0,0,0,0,0,0,0,0,2,1,1,0
635,95,2040,1,1,1,0,0,0,1,0,0,0,0,0,0,0,0,0,0,0,0,2,1,1,0
636,95,2040,1,1,1,0,0,0,1,0,0,0,0,0,0,0,0,0,0,0,0,2,1,1,0
637,95,2040,14,10,10,0,0,4,14,1,1,1,1,2,2,0,2,0,1,0,0,2,1,1,0
638,95,2040,46,26,30,3,0,12,49,3,6,3,6,9,9,20,28,1,42,2,0,2,1,1,0
639,47,906,373,158,315,8,0,51,381,5,76,44,79,81,123,486,779,2,2026,112,0,2,2,2,0
640,48,908,373,158,315,8,0,51,381,5,76,44,79,81,123,486,779,2,2026,112,0,2,1,1,0
641,48,1730,373,158,315,8,0,51,381,5,76,44,79,81,123,486,779,2,2026,112,0,2,3,3,0
642,49,934,373,158,315,8,0,51,381,5,76,44,79,81,123,486,779,2,2026,112,0,2,2,0,0
643,48,1742,373,158,315,8,0,51,381,5,76,44,79,81,123,486,779,2,2026,112,0,2,4,4,1
644,157,2702,1338,495,1086,10,64,173,1348,11,122,82,157,133,239,883,1686,7,11934,663,0,2,10,6,0
645,3,79,1455,414,1257,16,76,112,1471,5,41,23,46,46,69,231,381,2,1069,59,0,2,6,15,0
646,3,79,669,365,481,22,61,110,691,15,103,63,122,118,185,747,1273,8,11311,628,0,2,6,15,0
647,5,262,1455,414,1257,16,76,112,1471,5,41,23,46,46,69,231,381,2,1069,59,0,2,19,14,0
648,41,1405,773,419,590,28,0,166,801,10,204,113,217,214,330,1598,2554,5,13587,754,0,2,10,7,0
649,41,1405,773,419,590,28,0,166,801,10,204,113,217,214,330,1598,2554,5,13587,754,0,2,1,1,0
650,22,535,182,127,129,0,0,53,182,5,39,21,42,44,63,217,343,2,926,51,0,0,102,0,1
651,22,535,1165,710,800,67,119,181,1232,18,243,153,282,261,435,2000,3492,10,36473,2026,1,0,102,0,1
652,84,1873,1392,870,1177,35,17,170,1427,14,494,280,531,508,811,4473,7289,7,54850,3047,2,0,325,0,1
653,62,1415,773,419,590,28,0,166,801,10,204,113,217,214,330,1598,2554,5,13587,754,0,0,287,0,1
654,62,1415,421,273,302,44,34,57,465,17,81,59,107,98,166,583,1098,11,12329,684,0,0,287,0,1
655,13,518,182,127,129,0,0,53,182,5,39,21,42,44,63,217,343,2,926,51,0,0,85,0,1
656,88,3213,1392,870,1177,35,17,170,1427,14,494,280,531,508,811,4473,7289,7,54850,3047,2,0,584,0,1
657,46,1526,773,419,590,28,0,166,801,10,204,113,217,214,330,1598,2554,5,13587,754,0,0,316,0,1
658,1,28,127,75,83,2,11,30,129,4,14,7,14,18,21,61,87,2,175,9,0,2,1,1,1
659,1,28,652,304,544,16,6,88,668,6,89,51,101,95,152,591,998,3,3399,188,0,2,1,1,1
660,1,28,2,2,2,0,0,0,2,0,0,0,0,0,0,0,0,0,0,0,0,2,1,1,1
661,1,28,8,5,5,0,0,3,8,0,0,0,0,0,0,0,0,0,0,0,0,2,1,1,1
662,1,28,2,2,2,0,0,0,2,0,0,0,0,0,0,0,0,0,0,0,0,2,1,1,1
663,1,28,14,8,8,0,0,6,14,0,0,0,0,0,0,0,0,0,0,0,0,2,1,1,1
664,1,28,6,4,4,0,0,2,6,0,0,0,0,0,0,0,0,0,0,0,0,2,1,1,1
665,1,28,6,4,4,0,0,2,6,1,2,1,2,3,3,2,4,0,2,0,0,2,1,1,1
666,1,28,6,4,4,0,0,2,6,0,0,0,0,0,0,0,0,0,0,0,0,2,1,1,1
667,1,28,7,5,5,0,0,2,7,0,0,0,0,0,0,0,0,0,0,0,0,2,1,1,1
668,1,28,6,4,4,0,0,2,6,0,0,0,0,0,0,0,0,0,0,0,0,2,1,1,1
669,1,28,10,6,6,0,0,4,10,0,0,0,0,0,0,0,0,0,0,0,0,2,1,1,1
670,1,28,1,1,1,0,0,0,1,0,0,0,0,0,0,0,0,0,0,0,0,2,1,1,1
671,1,28,1,1,1,0,0,0,1,0,0,0,0,0,0,0,0,0,0,0,0,2,1,1,1
672,1,28,14,10,10,0,0,4,14,1,1,1,1,2,2,0,2,0,1,0,0,2,1,1,1
673,1,28,46,26,30,3,0,12,49,3,6,3,6,9,9,20,28,1,42,2,0,2,1,1,1
674,102,2207,127,75,83,2,11,30,129,4,14,7,14,18,21,61,87,2,175,9,0,0,344,0,1
675,102,2207,652,304,544,16,6,88,668,6,89,51,101,95,152,591,998,3,3399,188,0,0,344,0,1
676,102,2207,2,2,2,0,0,0,2,0,0,0,0,0,0,0,0,0,0,0,0,0,344,0,1
677,102,2207,8,5,5,0,0,3,8,0,0,0,0,0,0,0,0,0,0,0,0,0,344,0,1
678,102,2207,2,2,2,0,0,0,2,0,0,0,0,0,0,0,0,0,0,0,0,0,344,0,1
679,102,2207,14,8,8,0,0,6,14,0,0,0,0,0,0,0,0,0,0,0,0,0,344,0,1
680,102,2207,6,4,4,0,0,2,6,0,0,0,0,0,0,0,0,0,0,0,0,0,344,0,1
681,102,2207,6,4,4,0,0,2,6,1,2,1,2,3,3,2,4,0,2,0,0,0,344,0,1
682,102,2207,6,4,4,0,0,2,6,0,0,0,0,0,0,0,0,0,0,0,0,0,344,0,1
683,102,2207,7,5,5,0,0,2,7,0,0,0,0,0,0,0,0,0,0,0,0,0,344,0,1
684,102,2207,6,4,4,0,0,2,6,0,0,0,0,0,0,0,0,0,0,0,0,0,344,0,1
685,102,2207,10,6,6,0,0,4,10,0,0,0,0,0,0,0,0,0,0,0,0,0,344,0,1
686,102,2207,1,1,1,0,0,0,1,0,0,0,0,0,0,0,0,0,0,0,0,0,344,0,1
687,102,2207,1,1,1,0,0,0,1,0,0,0,0,0,0,0,0,0,0,0,0,0,344,0,1
688,102,2207,14,10,10,0,0,4,14,1,1,1,1,2,2,0,2,0,1,0,0,0,344,0,1
689,102,2207,46,26,30,3,0,12,49,3,6,3,6,9,9,20,28,1,42,2,0,0,344,0,1
690,35,478,282,196,195,3,0,86,285,8,130,71,141,138,212,936,1507,4,6538,363,0,0,120,0,1
691,1,70,13,10,10,0,0,3,13,1,2,1,2,3,3,2,4,0,2,0,0,0,11,0,1
692,7,111,44,19,17,0,16,11,44,3,14,7,14,17,21,58,85,1,128,7,0,0,42,0,1
693,17,841,652,304,544,16,6,88,668,6,89,51,101,95,152,591,998,3,3399,188,0,0,148,0,1
694,2,50,127,75,83,2,11,30,129,4,14,7,14,18,21,61,87,2,175,9,0,2,2,2,1
695,2,50,652,304,544,16,6,88,668,6,89,51,101,95,152,591,998,3,3399,188,0,2,2,2,1
696,2,50,2,2,2,0,0,0,2,0,0,0,0,0,0,0,0,0,0,0,0,2,2,2,1
697,2,50,8,5,5,0,0,3,8,0,0,0,0,0,0,0,0,0,0,0,0,2,2,2,1
698,2,50,2,2,2,0,0,0,2,0,0,0,0,0,0,0,0,0,0,0,0,2,2,2,1
699,2,50,14,8,8,0,0,6,14,0,0,0,0,0,0,0,0,0,0,0,0,2,2,2,1
700,2,50,6,4,4,0,0,2,6,0,0,0,0,0,0,0,0,0,0,0,0,2,2,2,1
701,2,50,6,4,4,0,0,2,6,1,2,1,2,3,3,2,4,0,2,0,0,2,2,2,1
702,2,50,6,4,4,0,0,2,6,0,0,0,0,0,0,0,0,0,0,0,0,2,2,2,1
703,2,50,7,5,5,0,0,2,7,0,0,0,0,0,0,0,0,0,0,0,0,2,2,2,1
704,2,50,6,4,4,0,0,2,6,0,0,0,0,0,0,0,0,0,0,0,0,2,2,2,1
705,2,50,10,6,6,0,0,4,10,0,0,0,0,0,0,0,0,0,0,0,0,2,2,2,1
706,2,50,1,1,1,0,0,0,1,0,0,0,0,0,0,0,0,0,0,0,0,2,2,2,1
707,2,50,1,1,1,0,0,0,1,0,0,0,0,0,0,0,0,0,0,0,0,2,2,2,1
708,2,50,14,10,10,0,0,4,14,1,1,1,1,2,2,0,2,0,1,0,0,2,2,2,1
709,2,50,46,26,30,3,0,12,49,3,6,3,6,9,9,20,28,1,42,2,0,2,2,2,1
710,9,378,15,9,9,0,0,6,15,0,0,0,0,0,0,0,0,0,0,0,0,0,79,0,1
711,5,104,1943,715,1694,26,18,214,1969,12,185,120,237,197,357,1436,2721,7,20915,1161,0,0,25,0,1
712,114,2015,1338,495,1086,10,64,173,1348,11,122,82,157,133,239,883,1686,7,11934,663,0,0,413,0,1
713,6,254,207,111,150,11,0,50,218,5,26,19,36,31,55,133,272,3,943,52,0,0,58,0,1
714,6,254,410,198,237,31,55,97,441,11,63,38,72,74,110,414,683,6,4293,238,0,0,58,0,1
715,58,1278,1457,730,1242,11,6,188,1468,10,292,166,329,302,495,2424,4078,5,22973,1276,1,0,256,0,1
716,58,1278,74,35,59,1,0,14,75,3,14,7,14,17,21,58,85,1,128,7,0,0,256,0,1
717,58,1278,245,125,200,5,7,34,250,7,30,17,34,37,51,166,265,3,1053,58,0,0,256,0,1
718,26,384,477,336,357,30,23,73,507,16,194,134,250,210,384,1538,2962,10,30538,1696,0,0,70,0,1
719,61,1388,1943,715,1694,26,18,214,1969,12,185,120,237,197,357,1436,2721,7,20915,1161,0,0,199,0,1
720,61,1388,1168,838,957,57,25,144,1225,19,348,224,416,367,640,3018,5452,11,61921,3440,1,0,199,0,1
721,13,1034,1943,715,1694,26,18,214,1969,12,185,120,237,197,357,1436,2721,7,20915,1161,0,0,164,0,1
722,33,845,1043,504,840,53,9,147,1096,9,180,112,198,189,310,1377,2344,4,11604,644,0,0,146,0,1
723,33,845,383,288,292,26,6,62,409,11,65,38,67,76,105,429,656,5,3719,206,0,0,146,0,1
724,48,883,373,158,315,8,0,51,381,5,76,44,79,81,123,486,779,2,2026,112,0,0,151,0,1
725,32,1506,1289,550,1043,56,32,155,1345,10,167,93,185,177,278,1266,2075,5,11498,638,0,0,425,0,1
726,4,225,207,111,150,11,0,50,218,5,26,19,36,31,55,133,272,3,943,52,0,0,53,0,1
727,58,3609,1457,730,1242,11,6,188,1468,10,292,166,329,302,495,2424,4078,5,22973,1276,1,0,493,0,1
728,3,185,1455,414,1257,16,76,112,1471,5,41,23,46,46,69,231,381,2,1069,59,0,0,34,0,1
729,31,1367,373,158,315,8,0,51,381,5,76,44,79,81,123,486,779,2,2026,112,0,0,274,0,1
730,1,76,42,7,35,4,0,5,46,1,2,1,2,3,3,2,4,0,2,0,0,0,10,0,1
731,1,76,11,6,10,0,0,1,11,2,4,2,4,6,6,10,15,1,15,0,0,0,10,0,1
732,6,596,42,7,35,4,0,5,46,1,2,1,2,3,3,2,4,0,2,0,0,2,207,3,1
733,6,596,11,6,10,0,0,1,11,2,4,2,4,6,6,10,15,1,15,0,0,2,207,3,1
734,32,1379,373,158,315,8,0,51,381,5,76,44,79,81,123,486,779,2,2026,112,0,2,2,1,1
735,32,1517,1289,550,1043,56,32,155,1345,10,167,93,185,177,278,1266,2075,5,11498,638,0,2,2,1,0
736,21,1028,42,7,35,4,0,5,46,1,2,1,2,3,3,2,4,0,2,0,0,2,106,13,1
737,21,1028,11,6,10,0,0,1,11,2,4,2,4,6,6,10,15,1,15,0,0,2,106,13,1
738,84,1873,1392,870,1177,35,17,170,1427,14,494,280,531,508,811,4473,7289,7,54850,3047,2,2,1,1,0
739,1,485,42,7,35,4,0,5,46,1,2,1,2,3,3,2,4,0,2,0,0,2,45,111,1
740,1,485,11,6,10,0,0,1,11,2,4,2,4,6,6,10,15,1,15,0,0,2,45,111,1
741,33,845,1043,504,840,53,9,147,1096,9,180,112,198,189,310,1377,2344,4,11604,644,0,2,1,1,1
742,33,845,383,288,292,26,6,62,409,11,65,38,67,76,105,429,656,5,3719,206,0,2,1,1,1
743,1,487,42,7,35,4,0,5,46,1,2,1,2,3,3,2,4,0,2,0,0,2,2,1,0
744,1,487,11,6,10,0,0,1,11,2,4,2,4,6,6,10,15,1,15,0,0,2,2,1,0
745,9,213,1450,624,1228,12,26,181,1462,14,306,186,354,320,540,2580,4493,8,36391,2021,1,2,8,1,0
746,25,429,1450,624,1228,12,26,181,1462,14,306,186,354,320,540,2580,4493,8,36391,2021,1,2,8,0,0
747,35,1582,1289,550,1043,56,32,155,1345,10,167,93,185,177,278,1266,2075,5,11498,638,0,2,15,5,0
748,60,1308,1457,730,1242,11,6,188,1468,10,292,166,329,302,495,2424,4078,5,22973,1276,1,2,6,0,0
749,60,1308,74,35,59,1,0,14,75,3,14,7,14,17,21,58,85,1,128,7,0,2,6,0,0
750,60,1308,245,125,200,5,7,34,250,7,30,17,34,37,51,166,265,3,1053,58,0,2,6,0,0
751,59,3677,1457,730,1242,11,6,188,1468,10,292,166,329,302,495,2424,4078,5,22973,1276,1,2,8,0,0
752,68,1461,1457,730,1242,11,6,188,1468,10,292,166,329,302,495,2424,4078,5,22973,1276,1,2,27,0,0
753,68,1461,74,35,59,1,0,14,75,3,14,7,14,17,21,58,85,1,128,7,0,2,27,0,0
754,68,1461,245,125,200,5,7,34,250,7,30,17,34,37,51,166,265,3,1053,58,0,2,27,0,0
755,60,3777,1457,730,1242,11,6,188,1468,10,292,166,329,302,495,2424,4078,5,22973,1276,1,2,16,1,0
756,1,487,42,7,35,4,0,5,46,1,2,1,2,3,3,2,4,0,2,0,0,2,1,1,1
757,1,487,11,6,10,0,0,1,11,2,4,2,4,6,6,10,15,1,15,0,0,2,1,1,1
758,68,1469,1457,730,1242,11,6,188,1468,10,292,166,329,302,495,2424,4078,5,22973,1276,1,2,3,2,0
759,68,1469,74,35,59,1,0,14,75,3,14,7,14,17,21,58,85,1,128,7,0,2,3,2,0
760,68,1469,245,125,200,5,7,34,250,7,30,17,34,37,51,166,265,3,1053,58,0,2,3,2,0
761,60,3773,1457,730,1242,11,6,188,1468,10,292,166,329,302,495,2424,4078,5,22973,1276,1,2,2,2,0
762,116,2055,1338,495,1086,10,64,173,1348,11,122,82,157,133,239,883,1686,7,11934,663,0,2,8,2,1
763,68,1487,1457,730,1242,11,6,188,1468,10,292,166,329,302,495,2424,4078,5,22973,1276,1,2,2,1,1
764,68,1487,74,35,59,1,0,14,75,3,14,7,14,17,21,58,85,1,128,7,0,2,2,1,1
765,68,1487,245,125,200,5,7,34,250,7,30,17,34,37,51,166,265,3,1053,58,0,2,2,1,1
766,60,3776,1457,730,1242,11,6,188,1468,10,292,166,329,302,495,2424,4078,5,22973,1276,1,2,1,1,0
767,142,2436,1338,495,1086,10,64,173,1348,11,122,82,157,133,239,883,1686,7,11934,663,0,2,136,58,1
768,6,254,207,111,150,11,0,50,218,5,26,19,36,31,55,133,272,3,943,52,0,2,1,1,1
769,6,254,410,198,237,31,55,97,441,11,63,38,72,74,110,414,683,6,4293,238,0,2,1,1,1
770,12,1018,1943,715,1694,26,18,214,1969,12,185,120,237,197,357,1436,2721,7,20915,1161,0,2,2,3,1
771,32,832,1043,504,840,53,9,147,1096,9,180,112,198,189,310,1377,2344,4,11604,644,0,2,2,2,1
772,32,832,383,288,292,26,6,62,409,11,65,38,67,76,105,429,656,5,3719,206,0,2,2,2,1
773,35,1582,1289,550,1043,56,32,155,1345,10,167,93,185,177,278,1266,2075,5,11498,638,0,2,2,2,1
774,58,3584,1457,730,1242,11,6,188,1468,10,292,166,329,302,495,2424,4078,5,22973,1276,1,2,4,30,1
775,3,185,1455,414,1257,16,76,112,1471,5,41,23,46,46,69,231,381,2,1069,59,0,2,2,2,1
776,33,1436,373,158,315,8,0,51,381,5,76,44,79,81,123,486,779,2,2026,112,0,2,16,1,1
777,1,28,127,75,83,2,11,30,129,4,14,7,14,18,21,61,87,2,175,9,0,2,2,2,1
778,1,28,652,304,544,16,6,88,668,6,89,51,101,95,152,591,998,3,3399,188,0,2,2,2,1
779,1,28,2,2,2,0,0,0,2,0,0,0,0,0,0,0,0,0,0,0,0,2,2,2,1
780,1,28,8,5,5,0,0,3,8,0,0,0,0,0,0,0,0,0,0,0,0,2,2,2,1
781,1,28,2,2,2,0,0,0,2,0,0,0,0,0,0,0,0,0,0,0,0,2,2,2,1
782,1,28,14,8,8,0,0,6,14,0,0,0,0,0,0,0,0,0,0,0,0,2,2,2,1
783,1,28,6,4,4,0,0,2,6,0,0,0,0,0,0,0,0,0,0,0,0,2,2,2,1
784,1,28,6,4,4,0,0,2,6,1,2,1,2,3,3,2,4,0,2,0,0,2,2,2,1
785,1,28,6,4,4,0,0,2,6,0,0,0,0,0,0,0,0,0,0,0,0,2,2,2,1
786,1,28,7,5,5,0,0,2,7,0,0,0,0,0,0,0,0,0,0,0,0,2,2,2,1
787,1,28,6,4,4,0,0,2,6,0,0,0,0,0,0,0,0,0,0,0,0,2,2,2,1
788,1,28,10,6,6,0,0,4,10,0,0,0,0,0,0,0,0,0,0,0,0,2,2,2,1
789,1,28,1,1,1,0,0,0,1,0,0,0,0,0,0,0,0,0,0,0,0,2,2,2,1
790,1,28,1,1,1,0,0,0,1,0,0,0,0,0,0,0,0,0,0,0,0,2,2,2,1
791,1,28,14,10,10,0,0,4,14,1,1,1,1,2,2,0,2,0,1,0,0,2,2,2,1
792,1,28,46,26,30,3,0,12,49,3,6,3,6,9,9,20,28,1,42,2,0,2,2,2,1
793,88,2029,127,75,83,2,11,30,129,4,14,7,14,18,21,61,87,2,175,9,0,2,20,41,1
794,88,2029,652,304,544,16,6,88,668,6,89,51,101,95,152,591,998,3,3399,188,0,2,20,41,1
795,88,2029,2,2,2,0,0,0,2,0,0,0,0,0,0,0,0,0,0,0,0,2,20,41,1
796,88,2029,8,5,5,0,0,3,8,0,0,0,0,0,0,0,0,0,0,0,0,2,20,41,1
797,88,2029,2,2,2,0,0,0,2,0,0,0,0,0,0,0,0,0,0,0,0,2,20,41,1
798,88,2029,14,8,8,0,0,6,14,0,0,0,0,0,0,0,0,0,0,0,0,2,20,41,1
799,88,2029,6,4,4,0,0,2,6,0,0,0,0,0,0,0,0,0,0,0,0,2,20,41,1
800,88,2029,6,4,4,0,0,2,6,1,2,1,2,3,3,2,4,0,2,0,0,2,20,41,1
801,88,2029,6,4,4,0,0,2,6,0,0,0,0,0,0,0,0,0,0,0,0,2,20,41,1
802,88,2029,7,5,5,0,0,2,7,0,0,0,0,0,0,0,0,0,0,0,0,2,20,41,1
803,88,2029,6,4,4,0,0,2,6,0,0,0,0,0,0,0,0,0,0,0,0,2,20,41,1
804,88,2029,10,6,6,0,0,4,10,0,0,0,0,0,0,0,0,0,0,0,0,2,20,41,1
805,88,2029,1,1,1,0,0,0,1,0,0,0,0,0,0,0,0,0,0,0,0,2,20,41,1
806,88,2029,1,1,1,0,0,0,1,0,0,0,0,0,0,0,0,0,0,0,0,2,20,41,1
807,88,2029,14,10,10,0,0,4,14,1,1,1,1,2,2,0,2,0,1,0,0,2,20,41,1
808,88,2029,46,26,30,3,0,12,49,3,6,3,6,9,9,20,28,1,42,2,0,2,20,41,1
809,2,98,13,10,10,0,0,3,13,1,2,1,2,3,3,2,4,0,2,0,0,2,9,5,1
810,11,596,652,304,544,16,6,88,668,6,89,51,101,95,152,591,998,3,3399,188,0,2,71,104,1
811,2,50,127,75,83,2,11,30,129,4,14,7,14,18,21,61,87,2,175,9,0,2,2,2,1
812,2,50,652,304,544,16,6,88,668,6,89,51,101,95,152,591,998,3,3399,188,0,2,2,2,1
813,2,50,2,2,2,0,0,0,2,0,0,0,0,0,0,0,0,0,0,0,0,2,2,2,1
814,2,50,8,5,5,0,0,3,8,0,0,0,0,0,0,0,0,0,0,0,0,2,2,2,1
815,2,50,2,2,2,0,0,0,2,0,0,0,0,0,0,0,0,0,0,0,0,2,2,2,1
816,2,50,14,8,8,0,0,6,14,0,0,0,0,0,0,0,0,0,0,0,0,2,2,2,1
817,2,50,6,4,4,0,0,2,6,0,0,0,0,0,0,0,0,0,0,0,0,2,2,2,1
818,2,50,6,4,4,0,0,2,6,1,2,1,2,3,3,2,4,0,2,0,0,2,2,2,1
819,2,50,6,4,4,0,0,2,6,0,0,0,0,0,0,0,0,0,0,0,0,2,2,2,1
820,2,50,7,5,5,0,0,2,7,0,0,0,0,0,0,0,0,0,0,0,0,2,2,2,1
821,2,50,6,4,4,0,0,2,6,0,0,0,0,0,0,0,0,0,0,0,0,2,2,2,1
822,2,50,10,6,6,0,0,4,10,0,0,0,0,0,0,0,0,0,0,0,0,2,2,2,1
823,2,50,1,1,1,0,0,0,1,0,0,0,0,0,0,0,0,0,0,0,0,2,2,2,1
824,2,50,1,1,1,0,0,0,1,0,0,0,0,0,0,0,0,0,0,0,0,2,2,2,1
825,2,50,14,10,10,0,0,4,14,1,1,1,1,2,2,0,2,0,1,0,0,2,2,2,1
826,2,50,46,26,30,3,0,12,49,3,6,3,6,9,9,20,28,1,42,2,0,2,2,2,1
827,144,2476,1338,495,1086,10,64,173,1348,11,122,82,157,133,239,883,1686,7,11934,663,0,2,18,14,1
828,1,477,42,7,35,4,0,5,46,1,2,1,2,3,3,2,4,0,2,0,0,2,1,6,0
829,1,477,11,6,10,0,0,1,11,2,4,2,4,6,6,10,15,1,15,0,0,2,1,6,0
830,2,50,127,75,83,2,11,30,129,4,14,7,14,18,21,61,87,2,175,9,0,3,1,1,0
831,2,50,652,304,544,16,6,88,668,6,89,51,101,95,152,591,998,3,3399,188,0,3,1,1,0
832,2,50,2,2,2,0,0,0,2,0,0,0,0,0,0,0,0,0,0,0,0,3,1,1,0
833,2,50,8,5,5,0,0,3,8,0,0,0,0,0,0,0,0,0,0,0,0,3,1,1,0
834,2,50,2,2,2,0,0,0,2,0,0,0,0,0,0,0,0,0,0,0,0,3,1,1,0
835,2,50,14,8,8,0,0,6,14,0,0,0,0,0,0,0,0,0,0,0,0,3,1,1,0
836,2,50,6,4,4,0,0,2,6,0,0,0,0,0,0,0,0,0,0,0,0,3,1,1,0
837,2,50,6,4,4,0,0,2,6,1,2,1,2,3,3,2,4,0,2,0,0,3,1,1,0
838,2,50,6,4,4,0,0,2,6,0,0,0,0,0,0,0,0,0,0,0,0,3,1,1,0
839,2,50,7,5,5,0,0,2,7,0,0,0,0,0,0,0,0,0,0,0,0,3,1,1,0
840,2,50,6,4,4,0,0,2,6,0,0,0,0,0,0,0,0,0,0,0,0,3,1,1,0
841,2,50,10,6,6,0,0,4,10,0,0,0,0,0,0,0,0,0,0,0,0,3,1,1,0
842,2,50,1,1,1,0,0,0,1,0,0,0,0,0,0,0,0,0,0,0,0,3,1,1,0
843,2,50,1,1,1,0,0,0,1,0,0,0,0,0,0,0,0,0,0,0,0,3,1,1,0
844,2,50,14,10,10,0,0,4,14,1,1,1,1,2,2,0,2,0,1,0,0,3,1,1,0
845,2,50,46,26,30,3,0,12,49,3,6,3,6,9,9,20,28,1,42,2,0,3,1,1,0
846,88,3213,1392,870,1177,35,17,170,1427,14,494,280,531,508,811,4473,7289,7,54850,3047,2,2,1,1,0
847,61,1386,1943,715,1694,26,18,214,1969,12,185,120,237,197,357,1436,2721,7,20915,1161,0,2,1,1,1
848,61,1386,1168,838,957,57,25,144,1225,19,348,224,416,367,640,3018,5452,11,61921,3440,1,2,1,1,1
849,57,3573,1457,730,1242,11,6,188,1468,10,292,166,329,302,495,2424,4078,5,22973,1276,1,2,17,11,1
850,33,1460,373,158,315,8,0,51,381,5,76,44,79,81,123,486,779,2,2026,112,0,2,16,7,1
851,19,444,127,75,83,2,11,30,129,4,14,7,14,18,21,61,87,2,175,9,0,0,71,0,1
852,19,444,652,304,544,16,6,88,668,6,89,51,101,95,152,591,998,3,3399,188,0,0,71,0,1
853,19,444,2,2,2,0,0,0,2,0,0,0,0,0,0,0,0,0,0,0,0,0,71,0,1
854,19,444,8,5,5,0,0,3,8,0,0,0,0,0,0,0,0,0,0,0,0,0,71,0,1
855,19,444,2,2,2,0,0,0,2,0,0,0,0,0,0,0,0,0,0,0,0,0,71,0,1
856,19,444,14,8,8,0,0,6,14,0,0,0,0,0,0,0,0,0,0,0,0,0,71,0,1
857,19,444,6,4,4,0,0,2,6,0,0,0,0,0,0,0,0,0,0,0,0,0,71,0,1
858,19,444,6,4,4,0,0,2,6,1,2,1,2,3,3,2,4,0,2,0,0,0,71,0,1
859,19,444,6,4,4,0,0,2,6,0,0,0,0,0,0,0,0,0,0,0,0,0,71,0,1
860,19,444,7,5,5,0,0,2,7,0,0,0,0,0,0,0,0,0,0,0,0,0,71,0,1
861,19,444,6,4,4,0,0,2,6,0,0,0,0,0,0,0,0,0,0,0,0,0,71,0,1
862,19,444,10,6,6,0,0,4,10,0,0,0,0,0,0,0,0,0,0,0,0,0,71,0,1
863,19,444,1,1,1,0,0,0,1,0,0,0,0,0,0,0,0,0,0,0,0,0,71,0,1
864,19,444,1,1,1,0,0,0,1,0,0,0,0,0,0,0,0,0,0,0,0,0,71,0,1
865,19,444,14,10,10,0,0,4,14,1,1,1,1,2,2,0,2,0,1,0,0,0,71,0,1
866,19,444,46,26,30,3,0,12,49,3,6,3,6,9,9,20,28,1,42,2,0,0,71,0,1
867,5,247,652,304,544,16,6,88,668,6,89,51,101,95,152,591,998,3,3399,188,0,0,64,0,1
868,84,1874,1392,870,1177,35,17,170,1427,14,494,280,531,508,811,4473,7289,7,54850,3047,2,2,4,3,1
869,144,2486,1338,495,1086,10,64,173,1348,11,122,82,157,133,239,883,1686,7,11934,663,0,2,2,1,1
870,62,1396,1943,715,1694,26,18,214,1969,12,185,120,237,197,357,1436,2721,7,20915,1161,0,2,1,1,1
871,62,1396,1168,838,957,57,25,144,1225,19,348,224,416,367,640,3018,5452,11,61921,3440,1,2,1,1,1
872,17,1181,1943,715,1694,26,18,214,1969,12,185,120,237,197,357,1436,2721,7,20915,1161,0,2,31,0,1
873,144,2489,1338,495,1086,10,64,173,1348,11,122,82,157,133,239,883,1686,7,11934,663,0,2,1,1,0
874,85,1888,1392,870,1177,35,17,170,1427,14,494,280,531,508,811,4473,7289,7,54850,3047,2,2,9,5,1
875,95,3486,1392,870,1177,35,17,170,1427,14,494,280,531,508,811,4473,7289,7,54850,3047,2,2,59,1,1
876,95,3490,1392,870,1177,35,17,170,1427,14,494,280,531,508,811,4473,7289,7,54850,3047,2,2,1,1,0
877,88,2032,127,75,83,2,11,30,129,4,14,7,14,18,21,61,87,2,175,9,0,2,2,0,0
878,88,2032,652,304,544,16,6,88,668,6,89,51,101,95,152,591,998,3,3399,188,0,2,2,0,0
879,88,2032,2,2,2,0,0,0,2,0,0,0,0,0,0,0,0,0,0,0,0,2,2,0,0
880,88,2032,8,5,5,0,0,3,8,0,0,0,0,0,0,0,0,0,0,0,0,2,2,0,0
881,88,2032,2,2,2,0,0,0,2,0,0,0,0,0,0,0,0,0,0,0,0,2,2,0,0
882,88,2032,14,8,8,0,0,6,14,0,0,0,0,0,0,0,0,0,0,0,0,2,2,0,0
883,88,2032,6,4,4,0,0,2,6,0,0,0,0,0,0,0,0,0,0,0,0,2,2,0,0
884,88,2032,6,4,4,0,0,2,6,1,2,1,2,3,3,2,4,0,2,0,0,2,2,0,0
885,88,2032,6,4,4,0,0,2,6,0,0,0,0,0,0,0,0,0,0,0,0,2,2,0,0
886,88,2032,7,5,5,0,0,2,7,0,0,0,0,0,0,0,0,0,0,0,0,2,2,0,0
887,88,2032,6,4,4,0,0,2,6,0,0,0,0,0,0,0,0,0,0,0,0,2,2,0,0
888,88,2032,10,6,6,0,0,4,10,0,0,0,0,0,0,0,0,0,0,0,0,2,2,0,0
889,88,2032,1,1,1,0,0,0,1,0,0,0,0,0,0,0,0,0,0,0,0,2,2,0,0
890,88,2032,1,1,1,0,0,0,1,0,0,0,0,0,0,0,0,0,0,0,0,2,2,0,0
891,88,2032,14,10,10,0,0,4,14,1,1,1,1,2,2,0,2,0,1,0,0,2,2,0,0
892,88,2032,46,26,30,3,0,12,49,3,6,3,6,9,9,20,28,1,42,2,0,2,2,0,0
893,35,1582,1289,550,1043,56,32,155,1345,10,167,93,185,177,278,1266,2075,5,11498,638,0,2,2,2,0
894,36,1582,1289,550,1043,56,32,155,1345,10,167,93,185,177,278,1266,2075,5,11498,638,0,2,6,5,0
895,1,467,42,7,35,4,0,5,46,1,2,1,2,3,3,2,4,0,2,0,0,2,0,5,0
896,1,467,11,6,10,0,0,1,11,2,4,2,4,6,6,10,15,1,15,0,0,2,0,5,0
897,37,1615,1289,550,1043,56,32,155,1345,10,167,93,185,177,278,1266,2075,5,11498,638,0,2,6,2,0
898,38,1647,1289,550,1043,56,32,155,1345,10,167,93,185,177,278,1266,2075,5,11498,638,0,2,9,6,1
899,96,3511,1392,870,1177,35,17,170,1427,14,494,280,531,508,811,4473,7289,7,54850,3047,2,2,5,2,0
900,18,419,386,256,301,16,9,68,402,4,59,35,69,63,104,355,621,2,1453,80,0,0,74,0,0
901,18,419,264,131,164,11,41,46,275,6,38,22,40,44,62,214,338,3,1068,59,0,0,74,0,0
902,144,2509,1338,495,1086,10,64,173,1348,11,122,82,157,133,239,883,1686,7,11934,663,0,2,10,3,0
903,145,2522,1338,495,1086,10,64,173,1348,11,122,82,157,133,239,883,1686,7,11934,663,0,2,8,1,0
904,64,1428,1943,715,1694,26,18,214,1969,12,185,120,237,197,357,1436,2721,7,20915,1161,0,2,12,6,0
905,64,1428,1168,838,957,57,25,144,1225,19,348,224,416,367,640,3018,5452,11,61921,3440,1,2,12,6,0
906,64,1445,1943,715,1694,26,18,214,1969,12,185,120,237,197,357,1436,2721,7,20915,1161,0,2,5,0,0
907,64,1445,1168,838,957,57,25,144,1225,19,348,224,416,367,640,3018,5452,11,61921,3440,1,2,5,0,0
908,18,1284,1943,715,1694,26,18,214,1969,12,185,120,237,197,357,1436,2721,7,20915,1161,0,2,14,0,0
909,62,1432,1943,715,1694,26,18,214,1969,12,185,120,237,197,357,1436,2721,7,20915,1161,0,2,3,4,0
910,62,1432,1168,838,957,57,25,144,1225,19,348,224,416,367,640,3018,5452,11,61921,3440,1,2,3,4,0
911,20,1426,1943,715,1694,26,18,214,1969,12,185,120,237,197,357,1436,2721,7,20915,1161,0,2,23,0,0
912,63,1445,1943,715,1694,26,18,214,1969,12,185,120,237,197,357,1436,2721,7,20915,1161,0,2,3,2,0
913,63,1445,1168,838,957,57,25,144,1225,19,348,224,416,367,640,3018,5452,11,61921,3440,1,2,3,2,0
914,66,1504,1943,715,1694,26,18,214,1969,12,185,120,237,197,357,1436,2721,7,20915,1161,0,2,9,0,0
915,66,1504,1168,838,957,57,25,144,1225,19,348,224,416,367,640,3018,5452,11,61921,3440,1,2,9,0,0
916,23,1499,1943,715,1694,26,18,214,1969,12,185,120,237,197,357,1436,2721,7,20915,1161,0,2,24,8,0
917,48,907,373,158,315,8,0,51,381,5,76,44,79,81,123,486,779,2,2026,112,0,2,6,3,0
918,15,361,373,158,315,8,0,51,381,5,76,44,79,81,123,486,779,2,2026,112,0,0,58,0,0
919,16,406,373,158,315,8,0,51,381,5,76,44,79,81,123,486,779,2,2026,112,0,2,8,0,0
920,62,1415,773,419,590,28,0,166,801,10,204,113,217,214,330,1598,2554,5,13587,754,0,2,0,2,0
921,62,1415,421,273,302,44,34,57,465,17,81,59,107,98,166,583,1098,11,12329,684,0,2,0,2,0
922,19,432,127,75,83,2,11,30,129,4,14,7,14,18,21,61,87,2,175,9,0,2,1,2,0
923,19,432,652,304,544,16,6,88,668,6,89,51,101,95,152,591,998,3,3399,188,0,2,1,2,0
924,19,432,2,2,2,0,0,0,2,0,0,0,0,0,0,0,0,0,0,0,0,2,1,2,0
925,19,432,8,5,5,0,0,3,8,0,0,0,0,0,0,0,0,0,0,0,0,2,1,2,0
926,19,432,2,2,2,0,0,0,2,0,0,0,0,0,0,0,0,0,0,0,0,2,1,2,0
927,19,432,14,8,8,0,0,6,14,0,0,0,0,0,0,0,0,0,0,0,0,2,1,2,0
928,19,432,6,4,4,0,0,2,6,0,0,0,0,0,0,0,0,0,0,0,0,2,1,2,0
929,19,432,6,4,4,0,0,2,6,1,2,1,2,3,3,2,4,0,2,0,0,2,1,2,0
930,19,432,6,4,4,0,0,2,6,0,0,0,0,0,0,0,0,0,0,0,0,2,1,2,0
931,19,432,7,5,5,0,0,2,7,0,0,0,0,0,0,0,0,0,0,0,0,2,1,2,0
932,19,432,6,4,4,0,0,2,6,0,0,0,0,0,0,0,0,0,0,0,0,2,1,2,0
933,19,432,10,6,6,0,0,4,10,0,0,0,0,0,0,0,0,0,0,0,0,2,1,2,0
934,19,432,1,1,1,0,0,0,1,0,0,0,0,0,0,0,0,0,0,0,0,2,1,2,0
935,19,432,1,1,1,0,0,0,1,0,0,0,0,0,0,0,0,0,0,0,0,2,1,2,0
936,19,432,14,10,10,0,0,4,14,1,1,1,1,2,2,0,2,0,1,0,0,2,1,2,0
937,19,432,46,26,30,3,0,12,49,3,6,3,6,9,9,20,28,1,42,2,0,2,1,2,0
938,5,247,652,304,544,16,6,88,668,6,89,51,101,95,152,591,998,3,3399,188,0,2,2,2,0
939,19,438,127,75,83,2,11,30,129,4,14,7,14,18,21,61,87,2,175,9,0,2,17,1,0
940,19,438,652,304,544,16,6,88,668,6,89,51,101,95,152,591,998,3,3399,188,0,2,17,1,0
941,19,438,2,2,2,0,0,0,2,0,0,0,0,0,0,0,0,0,0,0,0,2,17,1,0
942,19,438,8,5,5,0,0,3,8,0,0,0,0,0,0,0,0,0,0,0,0,2,17,1,0
943,19,438,2,2,2,0,0,0,2,0,0,0,0,0,0,0,0,0,0,0,0,2,17,1,0
944,19,438,14,8,8,0,0,6,14,0,0,0,0,0,0,0,0,0,0,0,0,2,17,1,0
945,19,438,6,4,4,0,0,2,6,0,0,0,0,0,0,0,0,0,0,0,0,2,17,1,0
946,19,438,6,4,4,0,0,2,6,1,2,1,2,3,3,2,4,0,2,0,0,2,17,1,0
947,19,438,6,4,4,0,0,2,6,0,0,0,0,0,0,0,0,0,0,0,0,2,17,1,0
948,19,438,7,5,5,0,0,2,7,0,0,0,0,0,0,0,0,0,0,0,0,2,17,1,0
949,19,438,6,4,4,0,0,2,6,0,0,0,0,0,0,0,0,0,0,0,0,2,17,1,0
950,19,438,10,6,6,0,0,4,10,0,0,0,0,0,0,0,0,0,0,0,0,2,17,1,0
951,19,438,1,1,1,0,0,0,1,0,0,0,0,0,0,0,0,0,0,0,0,2,17,1,0
952,19,438,1,1,1,0,0,0,1,0,0,0,0,0,0,0,0,0,0,0,0,2,17,1,0
953,19,438,14,10,10,0,0,4,14,1,1,1,1,2,2,0,2,0,1,0,0,2,17,1,0
954,19,438,46,26,30,3,0,12,49,3,6,3,6,9,9,20,28,1,42,2,0,2,17,1,0
955,19,438,127,75,83,2,11,30,129,4,14,7,14,18,21,61,87,2,175,9,0,2,10,10,0
956,19,438,652,304,544,16,6,88,668,6,89,51,101,95,152,591,998,3,3399,188,0,2,10,10,0
957,19,438,2,2,2,0,0,0,2,0,0,0,0,0,0,0,0,0,0,0,0,2,10,10,0
958,19,438,8,5,5,0,0,3,8,0,0,0,0,0,0,0,0,0,0,0,0,2,10,10,0
959,19,438,2,2,2,0,0,0,2,0,0,0,0,0,0,0,0,0,0,0,0,2,10,10,0
960,19,438,14,8,8,0,0,6,14,0,0,0,0,0,0,0,0,0,0,0,0,2,10,10,0
961,19,438,6,4,4,0,0,2,6,0,0,0,0,0,0,0,0,0,0,0,0,2,10,10,0
962,19,438,6,4,4,0,0,2,6,1,2,1,2,3,3,2,4,0,2,0,0,2,10,10,0
963,19,438,6,4,4,0,0,2,6,0,0,0,0,0,0,0,0,0,0,0,0,2,10,10,0
964,19,438,7,5,5,0,0,2,7,0,0,0,0,0,0,0,0,0,0,0,0,2,10,10,0
965,19,438,6,4,4,0,0,2,6,0,0,0,0,0,0,0,0,0,0,0,0,2,10,10,0
966,19,438,10,6,6,0,0,4,10,0,0,0,0,0,0,0,0,0,0,0,0,2,10,10,0
967,19,438,1,1,1,0,0,0,1,0,0,0,0,0,0,0,0,0,0,0,0,2,10,10,0
968,19,438,1,1,1,0,0,0,1,0,0,0,0,0,0,0,0,0,0,0,0,2,10,10,0
969,19,438,14,10,10,0,0,4,14,1,1,1,1,2,2,0,2,0,1,0,0,2,10,10,0
970,19,438,46,26,30,3,0,12,49,3,6,3,6,9,9,20,28,1,42,2,0,2,10,10,0
971,6,266,652,304,544,16,6,88,668,6,89,51,101,95,152,591,998,3,3399,188,0,2,4,0,0
972,19,438,127,75,83,2,11,30,129,4,14,7,14,18,21,61,87,2,175,9,0,2,3,3,0
973,19,438,652,304,544,16,6,88,668,6,89,51,101,95,152,591,998,3,3399,188,0,2,3,3,0
974,19,438,2,2,2,0,0,0,2,0,0,0,0,0,0,0,0,0,0,0,0,2,3,3,0
975,19,438,8,5,5,0,0,3,8,0,0,0,0,0,0,0,0,0,0,0,0,2,3,3,0
976,19,438,2,2,2,0,0,0,2,0,0,0,0,0,0,0,0,0,0,0,0,2,3,3,0
977,19,438,14,8,8,0,0,6,14,0,0,0,0,0,0,0,0,0,0,0,0,2,3,3,0
978,19,438,6,4,4,0,0,2,6,0,0,0,0,0,0,0,0,0,0,0,0,2,3,3,0
979,19,438,6,4,4,0,0,2,6,1,2,1,2,3,3,2,4,0,2,0,0,2,3,3,0
980,19,438,6,4,4,0,0,2,6,0,0,0,0,0,0,0,0,0,0,0,0,2,3,3,0
981,19,438,7,5,5,0,0,2,7,0,0,0,0,0,0,0,0,0,0,0,0,2,3,3,0
982,19,438,6,4,4,0,0,2,6,0,0,0,0,0,0,0,0,0,0,0,0,2,3,3,0
983,19,438,10,6,6,0,0,4,10,0,0,0,0,0,0,0,0,0,0,0,0,2,3,3,0
984,19,438,1,1,1,0,0,0,1,0,0,0,0,0,0,0,0,0,0,0,0,2,3,3,0
985,19,438,1,1,1,0,0,0,1,0,0,0,0,0,0,0,0,0,0,0,0,2,3,3,0
986,19,438,14,10,10,0,0,4,14,1,1,1,1,2,2,0,2,0,1,0,0,2,3,3,0
987,19,438,46,26,30,3,0,12,49,3,6,3,6,9,9,20,28,1,42,2,0,2,3,3,0
988,37,1648,1289,550,1043,56,32,155,1345,10,167,93,185,177,278,1266,2075,5,11498,638,0,2,1,4,0
989,87,2025,127,75,83,2,11,30,129,4,14,7,14,18,21,61,87,2,175,9,0,2,1,4,1
990,87,2025,652,304,544,16,6,88,668,6,89,51,101,95,152,591,998,3,3399,188,0,2,1,4,1
991,87,2025,2,2,2,0,0,0,2,0,0,0,0,0,0,0,0,0,0,0,0,2,1,4,1
992,87,2025,8,5,5,0,0,3,8,0,0,0,0,0,0,0,0,0,0,0,0,2,1,4,1
993,87,2025,2,2,2,0,0,0,2,0,0,0,0,0,0,0,0,0,0,0,0,2,1,4,1
994,87,2025,14,8,8,0,0,6,14,0,0,0,0,0,0,0,0,0,0,0,0,2,1,4,1
995,87,2025,6,4,4,0,0,2,6,0,0,0,0,0,0,0,0,0,0,0,0,2,1,4,1
996,87,2025,6,4,4,0,0,2,6,1,2,1,2,3,3,2,4,0,2,0,0,2,1,4,1
997,87,2025,6,4,4,0,0,2,6,0,0,0,0,0,0,0,0,0,0,0,0,2,1,4,1
998,87,2025,7,5,5,0,0,2,7,0,0,0,0,0,0,0,0,0,0,0,0,2,1,4,1
999,87,2025,6,4,4,0,0,2,6,0,0,0,0,0,0,0,0,0,0,0,0,2,1,4,1
1000,87,2025,10,6,6,0,0,4,10,0,0,0,0,0,0,0,0,0,0,0,0,2,1,4,1
1001,87,2025,1,1,1,0,0,0,1,0,0,0,0,0,0,0,0,0,0,0,0,2,1,4,1
1002,87,2025,1,1,1,0,0,0,1,0,0,0,0,0,0,0,0,0,0,0,0,2,1,4,1
1003,87,2025,14,10,10,0,0,4,14,1,1,1,1,2,2,0,2,0,1,0,0,2,1,4,1
1004,87,2025,46,26,30,3,0,12,49,3,6,3,6,9,9,20,28,1,42,2,0,2,1,4,1
1005,1,76,42,7,35,4,0,5,46,1,2,1,2,3,3,2,4,0,2,0,0,2,1,0,1
1006,1,76,11,6,10,0,0,1,11,2,4,2,4,6,6,10,15,1,15,0,0,2,1,0,1
1007,37,1642,1289,550,1043,56,32,155,1345,10,167,93,185,177,278,1266,2075,5,11498,638,0,2,1,1,1
1008,144,2506,1338,495,1086,10,64,173,1348,11,122,82,157,133,239,883,1686,7,11934,663,0,2,0,3,0
1009,14,320,215,129,180,6,0,29,221,8,65,43,72,73,115,415,711,4,3153,175,0,0,54,0,0
1010,14,320,97,69,77,3,3,16,100,6,22,13,23,28,36,113,173,3,542,30,0,0,54,0,0
1011,49,956,373,158,315,8,0,51,381,5,76,44,79,81,123,486,779,2,2026,112,0,2,5,0,0
1012,58,3702,1457,730,1242,11,6,188,1468,10,292,166,329,302,495,2424,4078,5,22973,1276,1,2,21,0,0
1013,15,1127,215,129,180,6,0,29,221,8,65,43,72,73,115,415,711,4,3153,175,0,0,184,0,0
1014,1,473,42,7,35,4,0,5,46,1,2,1,2,3,3,2,4,0,2,0,0,2,5,2,0
1015,1,473,11,6,10,0,0,1,11,2,4,2,4,6,6,10,15,1,15,0,0,2,5,2,0
1016,32,845,1043,504,840,53,9,147,1096,9,180,112,198,189,310,1377,2344,4,11604,644,0,2,6,3,0
1017,32,845,383,288,292,26,6,62,409,11,65,38,67,76,105,429,656,5,3719,206,0,2,6,3,0
1018,37,1642,1289,550,1043,56,32,155,1345,10,167,93,185,177,278,1266,2075,5,11498,638,0,2,3,2,0
1019,86,1899,1392,870,1177,35,17,170,1427,14,494,280,531,508,811,4473,7289,7,54850,3047,2,2,3,1,0
1020,97,3521,1392,870,1177,35,17,170,1427,14,494,280,531,508,811,4473,7289,7,54850,3047,2,2,2,0,0
1021,14,320,215,129,180,6,0,29,221,8,65,43,72,73,115,415,711,4,3153,175,0,2,1,1,0
1022,14,320,97,69,77,3,3,16,100,6,22,13,23,28,36,113,173,3,542,30,0,2,1,1,0
1023,49,951,373,158,315,8,0,51,381,5,76,44,79,81,123,486,779,2,2026,112,0,2,1,1,0
1024,58,3693,1457,730,1242,11,6,188,1468,10,292,166,329,302,495,2424,4078,5,22973,1276,1,2,0,2,0
1025,87,1905,1392,870,1177,35,17,170,1427,14,494,280,531,508,811,4473,7289,7,54850,3047,2,2,4,1,0
1026,16,586,182,127,129,0,0,53,182,5,39,21,42,44,63,217,343,2,926,51,0,2,16,0,0
1027,22,528,182,127,129,0,0,53,182,5,39,21,42,44,63,217,343,2,926,51,0,2,1,2,0
1028,22,528,1165,710,800,67,119,181,1232,18,243,153,282,261,435,2000,3492,10,36473,2026,1,2,1,2,0
1029,20,496,182,127,129,0,0,53,182,5,39,21,42,44,63,217,343,2,926,51,0,2,3,8,1
1030,20,496,1165,710,800,67,119,181,1232,18,243,153,282,261,435,2000,3492,10,36473,2026,1,2,3,8,1
1031,68,1530,773,419,590,28,0,166,801,10,204,113,217,214,330,1598,2554,5,13587,754,0,2,23,1,1
1032,68,1530,421,273,302,44,34,57,465,17,81,59,107,98,166,583,1098,11,12329,684,0,2,23,1,1
1033,97,3521,1392,870,1177,35,17,170,1427,14,494,280,531,508,811,4473,7289,7,54850,3047,2,2,1,1,1
1034,51,1685,773,419,590,28,0,166,801,10,204,113,217,214,330,1598,2554,5,13587,754,0,2,40,0,1
1035,36,1557,373,158,315,8,0,51,381,5,76,44,79,81,123,486,779,2,2026,112,0,2,14,0,1
1036,1,35,127,75,83,2,11,30,129,4,14,7,14,18,21,61,87,2,175,9,0,2,4,6,1
1037,1,35,652,304,544,16,6,88,668,6,89,51,101,95,152,591,998,3,3399,188,0,2,4,6,1
1038,1,35,2,2,2,0,0,0,2,0,0,0,0,0,0,0,0,0,0,0,0,2,4,6,1
1039,1,35,8,5,5,0,0,3,8,0,0,0,0,0,0,0,0,0,0,0,0,2,4,6,1
1040,1,35,2,2,2,0,0,0,2,0,0,0,0,0,0,0,0,0,0,0,0,2,4,6,1
1041,1,35,14,8,8,0,0,6,14,0,0,0,0,0,0,0,0,0,0,0,0,2,4,6,1
1042,1,35,6,4,4,0,0,2,6,0,0,0,0,0,0,0,0,0,0,0,0,2,4,6,1
1043,1,35,6,4,4,0,0,2,6,1,2,1,2,3,3,2,4,0,2,0,0,2,4,6,1
1044,1,35,6,4,4,0,0,2,6,0,0,0,0,0,0,0,0,0,0,0,0,2,4,6,1
1045,1,35,7,5,5,0,0,2,7,0,0,0,0,0,0,0,0,0,0,0,0,2,4,6,1
1046,1,35,6,4,4,0,0,2,6,0,0,0,0,0,0,0,0,0,0,0,0,2,4,6,1
1047,1,35,10,6,6,0,0,4,10,0,0,0,0,0,0,0,0,0,0,0,0,2,4,6,1
1048,1,35,1,1,1,0,0,0,1,0,0,0,0,0,0,0,0,0,0,0,0,2,4,6,1
1049,1,35,1,1,1,0,0,0,1,0,0,0,0,0,0,0,0,0,0,0,0,2,4,6,1
1050,1,35,14,10,10,0,0,4,14,1,1,1,1,2,2,0,2,0,1,0,0,2,4,6,1
1051,1,35,46,26,30,3,0,12,49,3,6,3,6,9,9,20,28,1,42,2,0,2,4,6,1
1052,1,85,127,75,83,2,11,30,129,4,14,7,14,18,21,61,87,2,175,9,0,2,12,35,1
1053,1,85,652,304,544,16,6,88,668,6,89,51,101,95,152,591,998,3,3399,188,0,2,12,35,1
1054,1,85,2,2,2,0,0,0,2,0,0,0,0,0,0,0,0,0,0,0,0,2,12,35,1
1055,1,85,8,5,5,0,0,3,8,0,0,0,0,0,0,0,0,0,0,0,0,2,12,35,1
1056,1,85,2,2,2,0,0,0,2,0,0,0,0,0,0,0,0,0,0,0,0,2,12,35,1
1057,1,85,14,8,8,0,0,6,14,0,0,0,0,0,0,0,0,0,0,0,0,2,12,35,1
1058,1,85,6,4,4,0,0,2,6,0,0,0,0,0,0,0,0,0,0,0,0,2,12,35,1
1059,1,85,6,4,4,0,0,2,6,1,2,1,2,3,3,2,4,0,2,0,0,2,12,35,1
1060,1,85,6,4,4,0,0,2,6,0,0,0,0,0,0,0,0,0,0,0,0,2,12,35,1
1061,1,85,7,5,5,0,0,2,7,0,0,0,0,0,0,0,0,0,0,0,0,2,12,35,1
1062,1,85,6,4,4,0,0,2,6,0,0,0,0,0,0,0,0,0,0,0,0,2,12,35,1
1063,1,85,10,6,6,0,0,4,10,0,0,0,0,0,0,0,0,0,0,0,0,2,12,35,1
1064,1,85,1,1,1,0,0,0,1,0,0,0,0,0,0,0,0,0,0,0,0,2,12,35,1
1065,1,85,1,1,1,0,0,0,1,0,0,0,0,0,0,0,0,0,0,0,0,2,12,35,1
1066,1,85,14,10,10,0,0,4,14,1,1,1,1,2,2,0,2,0,1,0,0,2,12,35,1
1067,1,85,46,26,30,3,0,12,49,3,6,3,6,9,9,20,28,1,42,2,0,2,12,35,1
1068,2,80,13,10,10,0,0,3,13,1,2,1,2,3,3,2,4,0,2,0,0,2,4,5,1
1069,15,369,386,256,301,16,9,68,402,4,59,35,69,63,104,355,621,2,1453,80,0,2,11,16,1
1070,15,369,264,131,164,11,41,46,275,6,38,22,40,44,62,214,338,3,1068,59,0,2,11,16,1
1071,151,2585,1338,495,1086,10,64,173,1348,11,122,82,157,133,239,883,1686,7,11934,663,0,2,88,57,1
1072,57,1285,1457,730,1242,11,6,188,1468,10,292,166,329,302,495,2424,4078,5,22973,1276,1,2,46,80,1
1073,57,1285,74,35,59,1,0,14,75,3,14,7,14,17,21,58,85,1,128,7,0,2,46,80,1
1074,57,1285,245,125,200,5,7,34,250,7,30,17,34,37,51,166,265,3,1053,58,0,2,46,80,1
1075,19,284,477,336,357,30,23,73,507,16,194,134,250,210,384,1538,2962,10,30538,1696,0,2,0,16,1
1076,26,496,334,251,279,10,4,40,344,5,127,74,143,132,217,899,1528,2,4303,239,0,0,92,0,1
1077,3,50,127,75,83,2,11,30,129,4,14,7,14,18,21,61,87,2,175,9,0,0,10,0,1
1078,3,50,652,304,544,16,6,88,668,6,89,51,101,95,152,591,998,3,3399,188,0,0,10,0,1
1079,3,50,2,2,2,0,0,0,2,0,0,0,0,0,0,0,0,0,0,0,0,0,10,0,1
1080,3,50,8,5,5,0,0,3,8,0,0,0,0,0,0,0,0,0,0,0,0,0,10,0,1
1081,3,50,2,2,2,0,0,0,2,0,0,0,0,0,0,0,0,0,0,0,0,0,10,0,1
1082,3,50,14,8,8,0,0,6,14,0,0,0,0,0,0,0,0,0,0,0,0,0,10,0,1
1083,3,50,6,4,4,0,0,2,6,0,0,0,0,0,0,0,0,0,0,0,0,0,10,0,1
1084,3,50,6,4,4,0,0,2,6,1,2,1,2,3,3,2,4,0,2,0,0,0,10,0,1
1085,3,50,6,4,4,0,0,2,6,0,0,0,0,0,0,0,0,0,0,0,0,0,10,0,1
1086,3,50,7,5,5,0,0,2,7,0,0,0,0,0,0,0,0,0,0,0,0,0,10,0,1
1087,3,50,6,4,4,0,0,2,6,0,0,0,0,0,0,0,0,0,0,0,0,0,10,0,1
1088,3,50,10,6,6,0,0,4,10,0,0,0,0,0,0,0,0,0,0,0,0,0,10,0,1
1089,3,50,1,1,1,0,0,0,1,0,0,0,0,0,0,0,0,0,0,0,0,0,10,0,1
1090,3,50,1,1,1,0,0,0,1,0,0,0,0,0,0,0,0,0,0,0,0,0,10,0,1
1091,3,50,14,10,10,0,0,4,14,1,1,1,1,2,2,0,2,0,1,0,0,0,10,0,1
1092,3,50,46,26,30,3,0,12,49,3,6,3,6,9,9,20,28,1,42,2,0,0,10,0,1
1093,25,611,1043,504,840,53,9,147,1096,9,180,112,198,189,310,1377,2344,4,11604,644,0,2,13,42,1
1094,25,611,383,288,292,26,6,62,409,11,65,38,67,76,105,429,656,5,3719,206,0,2,13,42,1
1095,46,833,373,158,315,8,0,51,381,5,76,44,79,81,123,486,779,2,2026,112,0,2,33,44,1
1096,25,1269,1289,550,1043,56,32,155,1345,10,167,93,185,177,278,1266,2075,5,11498,638,0,2,121,181,1
1097,48,3264,1457,730,1242,11,6,188,1468,10,292,166,329,302,495,2424,4078,5,22973,1276,1,2,339,396,1
1098,13,660,334,251,279,10,4,40,344,5,127,74,143,132,217,899,1528,2,4303,239,0,0,90,0,1
1099,23,1008,373,158,315,8,0,51,381,5,76,44,79,81,123,486,779,2,2026,112,0,2,44,128,1
1100,48,3264,1457,730,1242,11,6,188,1468,10,292,166,329,302,495,2424,4078,5,22973,1276,1,2,9,9,0
1101,57,1281,1457,730,1242,11,6,188,1468,10,292,166,329,302,495,2424,4078,5,22973,1276,1,2,4,6,0
1102,57,1281,74,35,59,1,0,14,75,3,14,7,14,17,21,58,85,1,128,7,0,2,4,6,0
1103,57,1281,245,125,200,5,7,34,250,7,30,17,34,37,51,166,265,3,1053,58,0,2,4,6,0
1104,48,3264,1457,730,1242,11,6,188,1468,10,292,166,329,302,495,2424,4078,5,22973,1276,1,2,3,3,0
1105,51,1168,1457,730,1242,11,6,188,1468,10,292,166,329,302,495,2424,4078,5,22973,1276,1,2,12,39,1
1106,51,1168,74,35,59,1,0,14,75,3,14,7,14,17,21,58,85,1,128,7,0,2,12,39,1
1107,51,1168,245,125,200,5,7,34,250,7,30,17,34,37,51,166,265,3,1053,58,0,2,12,39,1
1108,44,2896,1457,730,1242,11,6,188,1468,10,292,166,329,302,495,2424,4078,5,22973,1276,1,2,30,73,1
1109,24,1043,373,158,315,8,0,51,381,5,76,44,79,81,123,486,779,2,2026,112,0,2,5,0,1
1110,98,3601,1392,870,1177,35,17,170,1427,14,494,280,531,508,811,4473,7289,7,54850,3047,2,2,9,0,1
1111,52,1181,1457,730,1242,11,6,188,1468,10,292,166,329,302,495,2424,4078,5,22973,1276,1,2,12,8,1
1112,52,1181,74,35,59,1,0,14,75,3,14,7,14,17,21,58,85,1,128,7,0,2,12,8,1
1113,52,1181,245,125,200,5,7,34,250,7,30,17,34,37,51,166,265,3,1053,58,0,2,12,8,1
1114,44,2900,1457,730,1242,11,6,188,1468,10,292,166,329,302,495,2424,4078,5,22973,1276,1,2,21,9,1
1115,61,1328,1457,730,1242,11,6,188,1468,10,292,166,329,302,495,2424,4078,5,22973,1276,1,2,22,1,0
1116,61,1328,74,35,59,1,0,14,75,3,14,7,14,17,21,58,85,1,128,7,0,2,22,1,0
1117,61,1328,245,125,200,5,7,34,250,7,30,17,34,37,51,166,265,3,1053,58,0,2,22,1,0
1118,46,3133,1457,730,1242,11,6,188,1468,10,292,166,329,302,495,2424,4078,5,22973,1276,1,2,29,0,0
1119,150,2573,1338,495,1086,10,64,173,1348,11,122,82,157,133,239,883,1686,7,11934,663,0,2,0,3,1
1120,58,1297,1457,730,1242,11,6,188,1468,10,292,166,329,302,495,2424,4078,5,22973,1276,1,2,17,28,1
1121,58,1297,74,35,59,1,0,14,75,3,14,7,14,17,21,58,85,1,128,7,0,2,17,28,1
1122,58,1297,245,125,200,5,7,34,250,7,30,17,34,37,51,166,265,3,1053,58,0,2,17,28,1
1123,46,833,373,158,315,8,0,51,381,5,76,44,79,81,123,486,779,2,2026,112,0,2,1,1,1
1124,38,2138,1457,730,1242,11,6,188,1468,10,292,166,329,302,495,2424,4078,5,22973,1276,1,2,0,144,1
1125,140,2408,1338,495,1086,10,64,173,1348,11,122,82,157,133,239,883,1686,7,11934,663,0,2,0,33,1
1126,68,1464,1457,730,1242,11,6,188,1468,10,292,166,329,302,495,2424,4078,5,22973,1276,1,2,36,5,1
1127,68,1464,74,35,59,1,0,14,75,3,14,7,14,17,21,58,85,1,128,7,0,2,36,5,1
1128,68,1464,245,125,200,5,7,34,250,7,30,17,34,37,51,166,265,3,1053,58,0,2,36,5,1
1129,25,615,1043,504,840,53,9,147,1096,9,180,112,198,189,310,1377,2344,4,11604,644,0,2,2,2,1
1130,25,615,383,288,292,26,6,62,409,11,65,38,67,76,105,429,656,5,3719,206,0,2,2,2,1
1131,46,829,373,158,315,8,0,51,381,5,76,44,79,81,123,486,779,2,2026,112,0,2,1,1,1
1132,137,2384,1338,495,1086,10,64,173,1348,11,122,82,157,133,239,883,1686,7,11934,663,0,2,13,21,0
1133,139,2411,1338,495,1086,10,64,173,1348,11,122,82,157,133,239,883,1686,7,11934,663,0,2,5,2,0
1134,25,631,1043,504,840,53,9,147,1096,9,180,112,198,189,310,1377,2344,4,11604,644,0,2,3,1,1
1135,25,631,383,288,292,26,6,62,409,11,65,38,67,76,105,429,656,5,3719,206,0,2,3,1,1
1136,1,445,42,7,35,4,0,5,46,1,2,1,2,3,3,2,4,0,2,0,0,2,1,15,0
1137,1,445,11,6,10,0,0,1,11,2,4,2,4,6,6,10,15,1,15,0,0,2,1,15,0
1138,139,2416,1338,495,1086,10,64,173,1348,11,122,82,157,133,239,883,1686,7,11934,663,0,2,2,0,0
1139,87,1898,1392,870,1177,35,17,170,1427,14,494,280,531,508,811,4473,7289,7,54850,3047,2,2,1,1,1
1140,98,3604,1392,870,1177,35,17,170,1427,14,494,280,531,508,811,4473,7289,7,54850,3047,2,2,1,1,0
1141,1,87,127,75,83,2,11,30,129,4,14,7,14,18,21,61,87,2,175,9,0,2,1,1,1
1142,1,87,652,304,544,16,6,88,668,6,89,51,101,95,152,591,998,3,3399,188,0,2,1,1,1
1143,1,87,2,2,2,0,0,0,2,0,0,0,0,0,0,0,0,0,0,0,0,2,1,1,1
1144,1,87,8,5,5,0,0,3,8,0,0,0,0,0,0,0,0,0,0,0,0,2,1,1,1
1145,1,87,2,2,2,0,0,0,2,0,0,0,0,0,0,0,0,0,0,0,0,2,1,1,1
1146,1,87,14,8,8,0,0,6,14,0,0,0,0,0,0,0,0,0,0,0,0,2,1,1,1
1147,1,87,6,4,4,0,0,2,6,0,0,0,0,0,0,0,0,0,0,0,0,2,1,1,1
1148,1,87,6,4,4,0,0,2,6,1,2,1,2,3,3,2,4,0,2,0,0,2,1,1,1
1149,1,87,6,4,4,0,0,2,6,0,0,0,0,0,0,0,0,0,0,0,0,2,1,1,1
1150,1,87,7,5,5,0,0,2,7,0,0,0,0,0,0,0,0,0,0,0,0,2,1,1,1
1151,1,87,6,4,4,0,0,2,6,0,0,0,0,0,0,0,0,0,0,0,0,2,1,1,1
1152,1,87,10,6,6,0,0,4,10,0,0,0,0,0,0,0,0,0,0,0,0,2,1,1,1
1153,1,87,1,1,1,0,0,0,1,0,0,0,0,0,0,0,0,0,0,0,0,2,1,1,1
1154,1,87,1,1,1,0,0,0,1,0,0,0,0,0,0,0,0,0,0,0,0,2,1,1,1
1155,1,87,14,10,10,0,0,4,14,1,1,1,1,2,2,0,2,0,1,0,0,2,1,1,1
1156,1,87,46,26,30,3,0,12,49,3,6,3,6,9,9,20,28,1,42,2,0,2,1,1,1
1157,1,85,127,75,83,2,11,30,129,4,14,7,14,18,21,61,87,2,175,9,0,2,1,1,0
1158,1,85,652,304,544,16,6,88,668,6,89,51,101,95,152,591,998,3,3399,188,0,2,1,1,0
1159,1,85,2,2,2,0,0,0,2,0,0,0,0,0,0,0,0,0,0,0,0,2,1,1,0
1160,1,85,8,5,5,0,0,3,8,0,0,0,0,0,0,0,0,0,0,0,0,2,1,1,0
1161,1,85,2,2,2,0,0,0,2,0,0,0,0,0,0,0,0,0,0,0,0,2,1,1,0
1162,1,85,14,8,8,0,0,6,14,0,0,0,0,0,0,0,0,0,0,0,0,2,1,1,0
1163,1,85,6,4,4,0,0,2,6,0,0,0,0,0,0,0,0,0,0,0,0,2,1,1,0
1164,1,85,6,4,4,0,0,2,6,1,2,1,2,3,3,2,4,0,2,0,0,2,1,1,0
1165,1,85,6,4,4,0,0,2,6,0,0,0,0,0,0,0,0,0,0,0,0,2,1,1,0
1166,1,85,7,5,5,0,0,2,7,0,0,0,0,0,0,0,0,0,0,0,0,2,1,1,0
1167,1,85,6,4,4,0,0,2,6,0,0,0,0,0,0,0,0,0,0,0,0,2,1,1,0
1168,1,85,10,6,6,0,0,4,10,0,0,0,0,0,0,0,0,0,0,0,0,2,1,1,0
1169,1,85,1,1,1,0,0,0,1,0,0,0,0,0,0,0,0,0,0,0,0,2,1,1,0
1170,1,85,1,1,1,0,0,0,1,0,0,0,0,0,0,0,0,0,0,0,0,2,1,1,0
1171,1,85,14,10,10,0,0,4,14,1,1,1,1,2,2,0,2,0,1,0,0,2,1,1,0
1172,1,85,46,26,30,3,0,12,49,3,6,3,6,9,9,20,28,1,42,2,0,2,1,1,0
1173,27,503,334,251,279,10,4,40,344,5,127,74,143,132,217,899,1528,2,4303,239,0,2,2,1,0
1174,70,1507,1457,730,1242,11,6,188,1468,10,292,166,329,302,495,2424,4078,5,22973,1276,1,2,15,10,1
1175,70,1507,74,35,59,1,0,14,75,3,14,7,14,17,21,58,85,1,128,7,0,2,15,10,1
1176,70,1507,245,125,200,5,7,34,250,7,30,17,34,37,51,166,265,3,1053,58,0,2,15,10,1
1177,44,814,373,158,315,8,0,51,381,5,76,44,79,81,123,486,779,2,2026,112,0,2,3,3,1
1178,25,1266,1289,550,1043,56,32,155,1345,10,167,93,185,177,278,1266,2075,5,11498,638,0,2,8,13,1
1179,38,2103,1457,730,1242,11,6,188,1468,10,292,166,329,302,495,2424,4078,5,22973,1276,1,2,4,7,1
1180,71,1538,1457,730,1242,11,6,188,1468,10,292,166,329,302,495,2424,4078,5,22973,1276,1,2,6,0,1
1181,71,1538,74,35,59,1,0,14,75,3,14,7,14,17,21,58,85,1,128,7,0,2,6,0,1
1182,71,1538,245,125,200,5,7,34,250,7,30,17,34,37,51,166,265,3,1053,58,0,2,6,0,1
1183,26,1318,1289,550,1043,56,32,155,1345,10,167,93,185,177,278,1266,2075,5,11498,638,0,2,25,0,1
1184,39,2134,1457,730,1242,11,6,188,1468,10,292,166,329,302,495,2424,4078,5,22973,1276,1,2,6,0,1
1185,72,1555,1457,730,1242,11,6,188,1468,10,292,166,329,302,495,2424,4078,5,22973,1276,1,2,6,1,1
1186,72,1555,74,35,59,1,0,14,75,3,14,7,14,17,21,58,85,1,128,7,0,2,6,1,1
1187,72,1555,245,125,200,5,7,34,250,7,30,17,34,37,51,166,265,3,1053,58,0,2,6,1,1
1188,27,1359,1289,550,1043,56,32,155,1345,10,167,93,185,177,278,1266,2075,5,11498,638,0,2,13,1,1
1189,45,820,373,158,315,8,0,51,381,5,76,44,79,81,123,486,779,2,2026,112,0,2,2,0,1
1190,24,1006,373,158,315,8,0,51,381,5,76,44,79,81,123,486,779,2,2026,112,0,2,4,11,1
1191,45,825,373,158,315,8,0,51,381,5,76,44,79,81,123,486,779,2,2026,112,0,2,1,0,1
1192,75,1627,1457,730,1242,11,6,188,1468,10,292,166,329,302,495,2424,4078,5,22973,1276,1,2,14,6,1
1193,75,1627,74,35,59,1,0,14,75,3,14,7,14,17,21,58,85,1,128,7,0,2,14,6,1
1194,75,1627,245,125,200,5,7,34,250,7,30,17,34,37,51,166,265,3,1053,58,0,2,14,6,1
1195,28,1417,1289,550,1043,56,32,155,1345,10,167,93,185,177,278,1266,2075,5,11498,638,0,2,11,0,1
1196,39,2134,1457,730,1242,11,6,188,1468,10,292,166,329,302,495,2424,4078,5,22973,1276,1,2,2,1,1
1197,24,1014,373,158,315,8,0,51,381,5,76,44,79,81,123,486,779,2,2026,112,0,2,1,0,1
1198,78,1708,1457,730,1242,11,6,188,1468,10,292,166,329,302,495,2424,4078,5,22973,1276,1,2,15,3,1
1199,78,1708,74,35,59,1,0,14,75,3,14,7,14,17,21,58,85,1,128,7,0,2,15,3,1
1200,78,1708,245,125,200,5,7,34,250,7,30,17,34,37,51,166,265,3,1053,58,0,2,15,3,1
1201,42,2340,1457,730,1242,11,6,188,1468,10,292,166,329,302,495,2424,4078,5,22973,1276,1,2,33,7,1
1202,28,1435,1289,550,1043,56,32,155,1345,10,167,93,185,177,278,1266,2075,5,11498,638,0,2,2,1,1
1203,78,1712,1457,730,1242,11,6,188,1468,10,292,166,329,302,495,2424,4078,5,22973,1276,1,2,1,1,0
1204,78,1712,74,35,59,1,0,14,75,3,14,7,14,17,21,58,85,1,128,7,0,2,1,1,0
1205,78,1712,245,125,200,5,7,34,250,7,30,17,34,37,51,166,265,3,1053,58,0,2,1,1,0
1206,31,1528,1289,550,1043,56,32,155,1345,10,167,93,185,177,278,1266,2075,5,11498,638,0,2,21,3,1
1207,139,2413,1338,495,1086,10,64,173,1348,11,122,82,157,133,239,883,1686,7,11934,663,0,2,13,13,1
1208,25,631,1043,504,840,53,9,147,1096,9,180,112,198,189,310,1377,2344,4,11604,644,0,2,5,5,1
1209,25,631,383,288,292,26,6,62,409,11,65,38,67,76,105,429,656,5,3719,206,0,2,5,5,1
1210,45,825,373,158,315,8,0,51,381,5,76,44,79,81,123,486,779,2,2026,112,0,2,1,1,1
1211,42,2340,1457,730,1242,11,6,188,1468,10,292,166,329,302,495,2424,4078,5,22973,1276,1,2,5,5,1
1212,31,1528,1289,550,1043,56,32,155,1345,10,167,93,185,177,278,1266,2075,5,11498,638,0,2,3,3,1
1213,31,1536,1289,550,1043,56,32,155,1345,10,167,93,185,177,278,1266,2075,5,11498,638,0,2,2,2,1
1214,51,1713,773,419,590,28,0,166,801,10,204,113,217,214,330,1598,2554,5,13587,754,0,2,13,12,0
1215,98,3604,1392,870,1177,35,17,170,1427,14,494,280,531,508,811,4473,7289,7,54850,3047,2,2,1,1,0
1216,140,2422,1338,495,1086,10,64,173,1348,11,122,82,157,133,239,883,1686,7,11934,663,0,2,19,10,1
1217,140,2417,1338,495,1086,10,64,173,1348,11,122,82,157,133,239,883,1686,7,11934,663,0,2,1,1,1
1218,1,90,127,75,83,2,11,30,129,4,14,7,14,18,21,61,87,2,175,9,0,2,2,0,1
1219,1,90,652,304,544,16,6,88,668,6,89,51,101,95,152,591,998,3,3399,188,0,2,2,0,1
1220,1,90,2,2,2,0,0,0,2,0,0,0,0,0,0,0,0,0,0,0,0,2,2,0,1
1221,1,90,8,5,5,0,0,3,8,0,0,0,0,0,0,0,0,0,0,0,0,2,2,0,1
1222,1,90,2,2,2,0,0,0,2,0,0,0,0,0,0,0,0,0,0,0,0,2,2,0,1
1223,1,90,14,8,8,0,0,6,14,0,0,0,0,0,0,0,0,0,0,0,0,2,2,0,1
1224,1,90,6,4,4,0,0,2,6,0,0,0,0,0,0,0,0,0,0,0,0,2,2,0,1
1225,1,90,6,4,4,0,0,2,6,1,2,1,2,3,3,2,4,0,2,0,0,2,2,0,1
1226,1,90,6,4,4,0,0,2,6,0,0,0,0,0,0,0,0,0,0,0,0,2,2,0,1
1227,1,90,7,5,5,0,0,2,7,0,0,0,0,0,0,0,0,0,0,0,0,2,2,0,1
1228,1,90,6,4,4,0,0,2,6,0,0,0,0,0,0,0,0,0,0,0,0,2,2,0,1
1229,1,90,10,6,6,0,0,4,10,0,0,0,0,0,0,0,0,0,0,0,0,2,2,0,1
1230,1,90,1,1,1,0,0,0,1,0,0,0,0,0,0,0,0,0,0,0,0,2,2,0,1
1231,1,90,1,1,1,0,0,0,1,0,0,0,0,0,0,0,0,0,0,0,0,2,2,0,1
1232,1,90,14,10,10,0,0,4,14,1,1,1,1,2,2,0,2,0,1,0,0,2,2,0,1
1233,1,90,46,26,30,3,0,12,49,3,6,3,6,9,9,20,28,1,42,2,0,2,2,0,1
1234,78,1737,1457,730,1242,11,6,188,1468,10,292,166,329,302,495,2424,4078,5,22973,1276,1,2,5,1,1
1235,78,1737,74,35,59,1,0,14,75,3,14,7,14,17,21,58,85,1,128,7,0,2,5,1,1
1236,78,1737,245,125,200,5,7,34,250,7,30,17,34,37,51,166,265,3,1053,58,0,2,5,1,1
1237,45,825,373,158,315,8,0,51,381,5,76,44,79,81,123,486,779,2,2026,112,0,2,2,2,0
1238,13,255,127,75,83,2,11,30,129,4,14,7,14,18,21,61,87,2,175,9,0,2,31,6,1
1239,13,255,652,304,544,16,6,88,668,6,89,51,101,95,152,591,998,3,3399,188,0,2,31,6,1
1240,13,255,2,2,2,0,0,0,2,0,0,0,0,0,0,0,0,0,0,0,0,2,31,6,1
1241,13,255,8,5,5,0,0,3,8,0,0,0,0,0,0,0,0,0,0,0,0,2,31,6,1
1242,13,255,2,2,2,0,0,0,2,0,0,0,0,0,0,0,0,0,0,0,0,2,31,6,1
1243,13,255,14,8,8,0,0,6,14,0,0,0,0,0,0,0,0,0,0,0,0,2,31,6,1
1244,13,255,6,4,4,0,0,2,6,0,0,0,0,0,0,0,0,0,0,0,0,2,31,6,1
1245,13,255,6,4,4,0,0,2,6,1,2,1,2,3,3,2,4,0,2,0,0,2,31,6,1
1246,13,255,6,4,4,0,0,2,6,0,0,0,0,0,0,0,0,0,0,0,0,2,31,6,1
1247,13,255,7,5,5,0,0,2,7,0,0,0,0,0,0,0,0,0,0,0,0,2,31,6,1
1248,13,255,6,4,4,0,0,2,6,0,0,0,0,0,0,0,0,0,0,0,0,2,31,6,1
1249,13,255,10,6,6,0,0,4,10,0,0,0,0,0,0,0,0,0,0,0,0,2,31,6,1
1250,13,255,1,1,1,0,0,0,1,0,0,0,0,0,0,0,0,0,0,0,0,2,31,6,1
1251,13,255,1,1,1,0,0,0,1,0,0,0,0,0,0,0,0,0,0,0,0,2,31,6,1
1252,13,255,14,10,10,0,0,4,14,1,1,1,1,2,2,0,2,0,1,0,0,2,31,6,1
1253,13,255,46,26,30,3,0,12,49,3,6,3,6,9,9,20,28,1,42,2,0,2,31,6,1
1254,13,271,127,75,83,2,11,30,129,4,14,7,14,18,21,61,87,2,175,9,0,2,2,0,1
1255,13,271,652,304,544,16,6,88,668,6,89,51,101,95,152,591,998,3,3399,188,0,2,2,0,1
1256,13,271,2,2,2,0,0,0,2,0,0,0,0,0,0,0,0,0,0,0,0,2,2,0,1
1257,13,271,8,5,5,0,0,3,8,0,0,0,0,0,0,0,0,0,0,0,0,2,2,0,1
1258,13,271,2,2,2,0,0,0,2,0,0,0,0,0,0,0,0,0,0,0,0,2,2,0,1
1259,13,271,14,8,8,0,0,6,14,0,0,0,0,0,0,0,0,0,0,0,0,2,2,0,1
1260,13,271,6,4,4,0,0,2,6,0,0,0,0,0,0,0,0,0,0,0,0,2,2,0,1
1261,13,271,6,4,4,0,0,2,6,1,2,1,2,3,3,2,4,0,2,0,0,2,2,0,1
1262,13,271,6,4,4,0,0,2,6,0,0,0,0,0,0,0,0,0,0,0,0,2,2,0,1
1263,13,271,7,5,5,0,0,2,7,0,0,0,0,0,0,0,0,0,0,0,0,2,2,0,1
1264,13,271,6,4,4,0,0,2,6,0,0,0,0,0,0,0,0,0,0,0,0,2,2,0,1
1265,13,271,10,6,6,0,0,4,10,0,0,0,0,0,0,0,0,0,0,0,0,2,2,0,1
1266,13,271,1,1,1,0,0,0,1,0,0,0,0,0,0,0,0,0,0,0,0,2,2,0,1
1267,13,271,1,1,1,0,0,0,1,0,0,0,0,0,0,0,0,0,0,0,0,2,2,0,1
1268,13,271,14,10,10,0,0,4,14,1,1,1,1,2,2,0,2,0,1,0,0,2,2,0,1
1269,13,271,46,26,30,3,0,12,49,3,6,3,6,9,9,20,28,1,42,2,0,2,2,0,1
1270,31,1539,1289,550,1043,56,32,155,1345,10,167,93,185,177,278,1266,2075,5,11498,638,0,2,7,4,0
1271,45,801,373,158,315,8,0,51,381,5,76,44,79,81,123,486,779,2,2026,112,0,2,1,2,1
1272,42,2324,1457,730,1242,11,6,188,1468,10,292,166,329,302,495,2424,4078,5,22973,1276,1,2,0,3,0
1273,94,1980,1457,730,1242,11,6,188,1468,10,292,166,329,302,495,2424,4078,5,22973,1276,1,2,39,0,1
1274,94,1980,74,35,59,1,0,14,75,3,14,7,14,17,21,58,85,1,128,7,0,2,39,0,1
1275,94,1980,245,125,200,5,7,34,250,7,30,17,34,37,51,166,265,3,1053,58,0,2,39,0,1
1276,31,1539,1289,550,1043,56,32,155,1345,10,167,93,185,177,278,1266,2075,5,11498,638,0,2,10,11,1
1277,42,2324,1457,730,1242,11,6,188,1468,10,292,166,329,302,495,2424,4078,5,22973,1276,1,2,0,2,1
1278,45,796,373,158,315,8,0,51,381,5,76,44,79,81,123,486,779,2,2026,112,0,2,1,1,1
1279,31,1539,1289,550,1043,56,32,155,1345,10,167,93,185,177,278,1266,2075,5,11498,638,0,2,4,4,1
1280,1,449,42,7,35,4,0,5,46,1,2,1,2,3,3,2,4,0,2,0,0,2,20,17,1
1281,1,449,11,6,10,0,0,1,11,2,4,2,4,6,6,10,15,1,15,0,0,2,20,17,1
1282,93,1970,1457,730,1242,11,6,188,1468,10,292,166,329,302,495,2424,4078,5,22973,1276,1,2,4,6,1
1283,93,1970,74,35,59,1,0,14,75,3,14,7,14,17,21,58,85,1,128,7,0,2,4,6,1
1284,93,1970,245,125,200,5,7,34,250,7,30,17,34,37,51,166,265,3,1053,58,0,2,4,6,1
1285,40,756,373,158,315,8,0,51,381,5,76,44,79,81,123,486,779,2,2026,112,0,2,0,12,1
1286,31,1539,1289,550,1043,56,32,155,1345,10,167,93,185,177,278,1266,2075,5,11498,638,0,2,1,1,1
1287,37,2114,1457,730,1242,11,6,188,1468,10,292,166,329,302,495,2424,4078,5,22973,1276,1,2,0,32,1
1288,25,631,1043,504,840,53,9,147,1096,9,180,112,198,189,310,1377,2344,4,11604,644,0,2,1,1,1
1289,25,631,383,288,292,26,6,62,409,11,65,38,67,76,105,429,656,5,3719,206,0,2,1,1,1
1290,93,1972,1457,730,1242,11,6,188,1468,10,292,166,329,302,495,2424,4078,5,22973,1276,1,2,2,2,1
1291,93,1972,74,35,59,1,0,14,75,3,14,7,14,17,21,58,85,1,128,7,0,2,2,2,1
1292,93,1972,245,125,200,5,7,34,250,7,30,17,34,37,51,166,265,3,1053,58,0,2,2,2,1
1293,37,2114,1457,730,1242,11,6,188,1468,10,292,166,329,302,495,2424,4078,5,22973,1276,1,2,4,4,1
1294,92,1962,1457,730,1242,11,6,188,1468,10,292,166,329,302,495,2424,4078,5,22973,1276,1,2,4,7,0
1295,92,1962,74,35,59,1,0,14,75,3,14,7,14,17,21,58,85,1,128,7,0,2,4,7,0
1296,92,1962,245,125,200,5,7,34,250,7,30,17,34,37,51,166,265,3,1053,58,0,2,4,7,0
1297,31,1539,1289,550,1043,56,32,155,1345,10,167,93,185,177,278,1266,2075,5,11498,638,0,2,4,4,0
1298,93,2003,1457,730,1242,11,6,188,1468,10,292,166,329,302,495,2424,4078,5,22973,1276,1,2,12,7,0
1299,93,2003,74,35,59,1,0,14,75,3,14,7,14,17,21,58,85,1,128,7,0,2,12,7,0
1300,93,2003,245,125,200,5,7,34,250,7,30,17,34,37,51,166,265,3,1053,58,0,2,12,7,0
1301,31,1539,1289,550,1043,56,32,155,1345,10,167,93,185,177,278,1266,2075,5,11498,638,0,2,2,2,0
1302,43,2395,1457,730,1242,11,6,188,1468,10,292,166,329,302,495,2424,4078,5,22973,1276,1,2,42,0,0
1303,92,1980,1457,730,1242,11,6,188,1468,10,292,166,329,302,495,2424,4078,5,22973,1276,1,2,10,14,1
1304,92,1980,74,35,59,1,0,14,75,3,14,7,14,17,21,58,85,1,128,7,0,2,10,14,1
1305,92,1980,245,125,200,5,7,34,250,7,30,17,34,37,51,166,265,3,1053,58,0,2,10,14,1
1306,33,1753,1289,550,1043,56,32,155,1345,10,167,93,185,177,278,1266,2075,5,11498,638,0,2,88,39,1
1307,37,2114,1457,730,1242,11,6,188,1468,10,292,166,329,302,495,2424,4078,5,22973,1276,1,2,1,45,1
1308,13,269,127,75,83,2,11,30,129,4,14,7,14,18,21,61,87,2,175,9,0,2,2,3,0
1309,13,269,652,304,544,16,6,88,668,6,89,51,101,95,152,591,998,3,3399,188,0,2,2,3,0
1310,13,269,2,2,2,0,0,0,2,0,0,0,0,0,0,0,0,0,0,0,0,2,2,3,0
1311,13,269,8,5,5,0,0,3,8,0,0,0,0,0,0,0,0,0,0,0,0,2,2,3,0
1312,13,269,2,2,2,0,0,0,2,0,0,0,0,0,0,0,0,0,0,0,0,2,2,3,0
1313,13,269,14,8,8,0,0,6,14,0,0,0,0,0,0,0,0,0,0,0,0,2,2,3,0
1314,13,269,6,4,4,0,0,2,6,0,0,0,0,0,0,0,0,0,0,0,0,2,2,3,0
1315,13,269,6,4,4,0,0,2,6,1,2,1,2,3,3,2,4,0,2,0,0,2,2,3,0
1316,13,269,6,4,4,0,0,2,6,0,0,0,0,0,0,0,0,0,0,0,0,2,2,3,0
1317,13,269,7,5,5,0,0,2,7,0,0,0,0,0,0,0,0,0,0,0,0,2,2,3,0
1318,13,269,6,4,4,0,0,2,6,0,0,0,0,0,0,0,0,0,0,0,0,2,2,3,0
1319,13,269,10,6,6,0,0,4,10,0,0,0,0,0,0,0,0,0,0,0,0,2,2,3,0
1320,13,269,1,1,1,0,0,0,1,0,0,0,0,0,0,0,0,0,0,0,0,2,2,3,0
1321,13,269,1,1,1,0,0,0,1,0,0,0,0,0,0,0,0,0,0,0,0,2,2,3,0
1322,13,269,14,10,10,0,0,4,14,1,1,1,1,2,2,0,2,0,1,0,0,2,2,3,0
1323,13,269,46,26,30,3,0,12,49,3,6,3,6,9,9,20,28,1,42,2,0,2,2,3,0
1324,33,1781,1289,550,1043,56,32,155,1345,10,167,93,185,177,278,1266,2075,5,11498,638,0,2,21,22,0
1325,1,461,42,7,35,4,0,5,46,1,2,1,2,3,3,2,4,0,2,0,0,2,18,12,1
1326,1,461,11,6,10,0,0,1,11,2,4,2,4,6,6,10,15,1,15,0,0,2,18,12,1
1327,1,459,42,7,35,4,0,5,46,1,2,1,2,3,3,2,4,0,2,0,0,2,1,2,0
1328,1,459,11,6,10,0,0,1,11,2,4,2,4,6,6,10,15,1,15,0,0,2,1,2,0
1329,1,459,42,7,35,4,0,5,46,1,2,1,2,3,3,2,4,0,2,0,0,2,1,1,1
1330,1,459,11,6,10,0,0,1,11,2,4,2,4,6,6,10,15,1,15,0,0,2,1,1,1
1331,1,449,42,7,35,4,0,5,46,1,2,1,2,3,3,2,4,0,2,0,0,2,2,7,1
1332,1,449,11,6,10,0,0,1,11,2,4,2,4,6,6,10,15,1,15,0,0,2,2,7,1
1333,1,445,42,7,35,4,0,5,46,1,2,1,2,3,3,2,4,0,2,0,0,2,3,5,0
1334,1,445,11,6,10,0,0,1,11,2,4,2,4,6,6,10,15,1,15,0,0,2,3,5,0
1335,1,445,42,7,35,4,0,5,46,1,2,1,2,3,3,2,4,0,2,0,0,2,4,4,1
1336,1,445,11,6,10,0,0,1,11,2,4,2,4,6,6,10,15,1,15,0,0,2,4,4,1
1337,1,433,42,7,35,4,0,5,46,1,2,1,2,3,3,2,4,0,2,0,0,2,6,12,1
1338,1,433,11,6,10,0,0,1,11,2,4,2,4,6,6,10,15,1,15,0,0,2,6,12,1
1339,96,2109,1457,730,1242,11,6,188,1468,10,292,166,329,302,495,2424,4078,5,22973,1276,1,2,18,1,0
1340,96,2109,74,35,59,1,0,14,75,3,14,7,14,17,21,58,85,1,128,7,0,2,18,1,0
1341,96,2109,245,125,200,5,7,34,250,7,30,17,34,37,51,166,265,3,1053,58,0,2,18,1,0
1342,43,2292,1457,730,1242,11,6,188,1468,10,292,166,329,302,495,2424,4078,5,22973,1276,1,2,28,0,0
1343,33,1810,1289,550,1043,56,32,155,1345,10,167,93,185,177,278,1266,2075,5,11498,638,0,2,8,3,1
1344,3,441,42,7,35,4,0,5,46,1,2,1,2,3,3,2,4,0,2,0,0,2,8,5,1
1345,3,441,11,6,10,0,0,1,11,2,4,2,4,6,6,10,15,1,15,0,0,2,8,5,1
1346,13,269,127,75,83,2,11,30,129,4,14,7,14,18,21,61,87,2,175,9,0,2,2,2,1
1347,13,269,652,304,544,16,6,88,668,6,89,51,101,95,152,591,998,3,3399,188,0,2,2,2,1
1348,13,269,2,2,2,0,0,0,2,0,0,0,0,0,0,0,0,0,0,0,0,2,2,2,1
1349,13,269,8,5,5,0,0,3,8,0,0,0,0,0,0,0,0,0,0,0,0,2,2,2,1
1350,13,269,2,2,2,0,0,0,2,0,0,0,0,0,0,0,0,0,0,0,0,2,2,2,1
1351,13,269,14,8,8,0,0,6,14,0,0,0,0,0,0,0,0,0,0,0,0,2,2,2,1
1352,13,269,6,4,4,0,0,2,6,0,0,0,0,0,0,0,0,0,0,0,0,2,2,2,1
1353,13,269,6,4,4,0,0,2,6,1,2,1,2,3,3,2,4,0,2,0,0,2,2,2,1
1354,13,269,6,4,4,0,0,2,6,0,0,0,0,0,0,0,0,0,0,0,0,2,2,2,1
1355,13,269,7,5,5,0,0,2,7,0,0,0,0,0,0,0,0,0,0,0,0,2,2,2,1
1356,13,269,6,4,4,0,0,2,6,0,0,0,0,0,0,0,0,0,0,0,0,2,2,2,1
1357,13,269,10,6,6,0,0,4,10,0,0,0,0,0,0,0,0,0,0,0,0,2,2,2,1
1358,13,269,1,1,1,0,0,0,1,0,0,0,0,0,0,0,0,0,0,0,0,2,2,2,1
1359,13,269,1,1,1,0,0,0,1,0,0,0,0,0,0,0,0,0,0,0,0,2,2,2,1
1360,13,269,14,10,10,0,0,4,14,1,1,1,1,2,2,0,2,0,1,0,0,2,2,2,1
1361,13,269,46,26,30,3,0,12,49,3,6,3,6,9,9,20,28,1,42,2,0,2,2,2,1
1362,92,1980,1457,730,1242,11,6,188,1468,10,292,166,329,302,495,2424,4078,5,22973,1276,1,2,1,18,0
1363,92,1980,74,35,59,1,0,14,75,3,14,7,14,17,21,58,85,1,128,7,0,2,1,18,0
1364,92,1980,245,125,200,5,7,34,250,7,30,17,34,37,51,166,265,3,1053,58,0,2,1,18,0
1365,37,2114,1457,730,1242,11,6,188,1468,10,292,166,329,302,495,2424,4078,5,22973,1276,1,2,0,28,0
1366,3,399,42,7,35,4,0,5,46,1,2,1,2,3,3,2,4,0,2,0,0,2,2,25,0
1367,3,399,11,6,10,0,0,1,11,2,4,2,4,6,6,10,15,1,15,0,0,2,2,25,0
1368,3,399,42,7,35,4,0,5,46,1,2,1,2,3,3,2,4,0,2,0,0,2,1,1,0
1369,3,399,11,6,10,0,0,1,11,2,4,2,4,6,6,10,15,1,15,0,0,2,1,1,0
1370,27,519,334,251,279,10,4,40,344,5,127,74,143,132,217,899,1528,2,4303,239,0,2,4,2,0
1371,13,660,334,251,279,10,4,40,344,5,127,74,143,132,217,899,1528,2,4303,239,0,2,1,1,0
1372,3,399,42,7,35,4,0,5,46,1,2,1,2,3,3,2,4,0,2,0,0,2,2,2,0
1373,3,399,11,6,10,0,0,1,11,2,4,2,4,6,6,10,15,1,15,0,0,2,2,2,0
1374,13,269,127,75,83,2,11,30,129,4,14,7,14,18,21,61,87,2,175,9,0,2,2,2,1
1375,13,269,652,304,544,16,6,88,668,6,89,51,101,95,152,591,998,3,3399,188,0,2,2,2,1
1376,13,269,2,2,2,0,0,0,2,0,0,0,0,0,0,0,0,0,0,0,0,2,2,2,1
1377,13,269,8,5,5,0,0,3,8,0,0,0,0,0,0,0,0,0,0,0,0,2,2,2,1
1378,13,269,2,2,2,0,0,0,2,0,0,0,0,0,0,0,0,0,0,0,0,2,2,2,1
1379,13,269,14,8,8,0,0,6,14,0,0,0,0,0,0,0,0,0,0,0,0,2,2,2,1
1380,13,269,6,4,4,0,0,2,6,0,0,0,0,0,0,0,0,0,0,0,0,2,2,2,1
1381,13,269,6,4,4,0,0,2,6,1,2,1,2,3,3,2,4,0,2,0,0,2,2,2,1
1382,13,269,6,4,4,0,0,2,6,0,0,0,0,0,0,0,0,0,0,0,0,2,2,2,1
1383,13,269,7,5,5,0,0,2,7,0,0,0,0,0,0,0,0,0,0,0,0,2,2,2,1
1384,13,269,6,4,4,0,0,2,6,0,0,0,0,0,0,0,0,0,0,0,0,2,2,2,1
1385,13,269,10,6,6,0,0,4,10,0,0,0,0,0,0,0,0,0,0,0,0,2,2,2,1
1386,13,269,1,1,1,0,0,0,1,0,0,0,0,0,0,0,0,0,0,0,0,2,2,2,1
1387,13,269,1,1,1,0,0,0,1,0,0,0,0,0,0,0,0,0,0,0,0,2,2,2,1
1388,13,269,14,10,10,0,0,4,14,1,1,1,1,2,2,0,2,0,1,0,0,2,2,2,1
1389,13,269,46,26,30,3,0,12,49,3,6,3,6,9,9,20,28,1,42,2,0,2,2,2,1
1390,3,399,42,7,35,4,0,5,46,1,2,1,2,3,3,2,4,0,2,0,0,2,3,3,0
1391,3,399,11,6,10,0,0,1,11,2,4,2,4,6,6,10,15,1,15,0,0,2,3,3,0
1392,1,383,42,7,35,4,0,5,46,1,2,1,2,3,3,2,4,0,2,0,0,2,7,9,0
1393,1,383,11,6,10,0,0,1,11,2,4,2,4,6,6,10,15,1,15,0,0,2,7,9,0
1394,36,2098,1457,730,1242,11,6,188,1468,10,292,166,329,302,495,2424,4078,5,22973,1276,1,2,3,7,0
1395,13,267,127,75,83,2,11,30,129,4,14,7,14,18,21,61,87,2,175,9,0,2,1,1,1
1396,13,267,652,304,544,16,6,88,668,6,89,51,101,95,152,591,998,3,3399,188,0,2,1,1,1
1397,13,267,2,2,2,0,0,0,2,0,0,0,0,0,0,0,0,0,0,0,0,2,1,1,1
1398,13,267,8,5,5,0,0,3,8,0,0,0,0,0,0,0,0,0,0,0,0,2,1,1,1
1399,13,267,2,2,2,0,0,0,2,0,0,0,0,0,0,0,0,0,0,0,0,2,1,1,1
1400,13,267,14,8,8,0,0,6,14,0,0,0,0,0,0,0,0,0,0,0,0,2,1,1,1
1401,13,267,6,4,4,0,0,2,6,0,0,0,0,0,0,0,0,0,0,0,0,2,1,1,1
1402,13,267,6,4,4,0,0,2,6,1,2,1,2,3,3,2,4,0,2,0,0,2,1,1,1
1403,13,267,6,4,4,0,0,2,6,0,0,0,0,0,0,0,0,0,0,0,0,2,1,1,1
1404,13,267,7,5,5,0,0,2,7,0,0,0,0,0,0,0,0,0,0,0,0,2,1,1,1
1405,13,267,6,4,4,0,0,2,6,0,0,0,0,0,0,0,0,0,0,0,0,2,1,1,1
1406,13,267,10,6,6,0,0,4,10,0,0,0,0,0,0,0,0,0,0,0,0,2,1,1,1
1407,13,267,1,1,1,0,0,0,1,0,0,0,0,0,0,0,0,0,0,0,0,2,1,1,1
1408,13,267,1,1,1,0,0,0,1,0,0,0,0,0,0,0,0,0,0,0,0,2,1,1,1
1409,13,267,14,10,10,0,0,4,14,1,1,1,1,2,2,0,2,0,1,0,0,2,1,1,1
1410,13,267,46,26,30,3,0,12,49,3,6,3,6,9,9,20,28,1,42,2,0,2,1,1,1
1411,1,319,42,7,35,4,0,5,46,1,2,1,2,3,3,2,4,0,2,0,0,2,2,34,0
1412,1,319,11,6,10,0,0,1,11,2,4,2,4,6,6,10,15,1,15,0,0,2,2,34,0
1413,15,369,386,256,301,16,9,68,402,4,59,35,69,63,104,355,621,2,1453,80,0,2,1,1,1
1414,15,369,264,131,164,11,41,46,275,6,38,22,40,44,62,214,338,3,1068,59,0,2,1,1,1
1415,40,756,373,158,315,8,0,51,381,5,76,44,79,81,123,486,779,2,2026,112,0,2,2,2,1
1416,31,322,757,253,292,73,244,162,830,13,61,38,67,74,105,409,651,7,4654,258,0,0,120,0,0
1417,13,272,127,75,83,2,11,30,129,4,14,7,14,18,21,61,87,2,175,9,0,2,1,0,1
1418,13,272,652,304,544,16,6,88,668,6,89,51,101,95,152,591,998,3,3399,188,0,2,1,0,1
1419,13,272,2,2,2,0,0,0,2,0,0,0,0,0,0,0,0,0,0,0,0,2,1,0,1
1420,13,272,8,5,5,0,0,3,8,0,0,0,0,0,0,0,0,0,0,0,0,2,1,0,1
1421,13,272,2,2,2,0,0,0,2,0,0,0,0,0,0,0,0,0,0,0,0,2,1,0,1
1422,13,272,14,8,8,0,0,6,14,0,0,0,0,0,0,0,0,0,0,0,0,2,1,0,1
1423,13,272,6,4,4,0,0,2,6,0,0,0,0,0,0,0,0,0,0,0,0,2,1,0,1
1424,13,272,6,4,4,0,0,2,6,1,2,1,2,3,3,2,4,0,2,0,0,2,1,0,1
1425,13,272,6,4,4,0,0,2,6,0,0,0,0,0,0,0,0,0,0,0,0,2,1,0,1
1426,13,272,7,5,5,0,0,2,7,0,0,0,0,0,0,0,0,0,0,0,0,2,1,0,1
1427,13,272,6,4,4,0,0,2,6,0,0,0,0,0,0,0,0,0,0,0,0,2,1,0,1
1428,13,272,10,6,6,0,0,4,10,0,0,0,0,0,0,0,0,0,0,0,0,2,1,0,1
1429,13,272,1,1,1,0,0,0,1,0,0,0,0,0,0,0,0,0,0,0,0,2,1,0,1
1430,13,272,1,1,1,0,0,0,1,0,0,0,0,0,0,0,0,0,0,0,0,2,1,0,1
1431,13,272,14,10,10,0,0,4,14,1,1,1,1,2,2,0,2,0,1,0,0,2,1,0,1
1432,13,272,46,26,30,3,0,12,49,3,6,3,6,9,9,20,28,1,42,2,0,2,1,0,1
1433,31,320,757,253,292,73,244,162,830,13,61,38,67,74,105,409,651,7,4654,258,0,2,3,3,1
1434,40,750,373,158,315,8,0,51,381,5,76,44,79,81,123,486,779,2,2026,112,0,2,1,1,1
1435,24,1016,373,158,315,8,0,51,381,5,76,44,79,81,123,486,779,2,2026,112,0,2,3,3,1
1436,31,324,757,253,292,73,244,162,830,13,61,38,67,74,105,409,651,7,4654,258,0,2,1,1,1
1437,42,753,373,158,315,8,0,51,381,5,76,44,79,81,123,486,779,2,2026,112,0,2,2,1,1
1438,31,324,757,253,292,73,244,162,830,13,61,38,67,74,105,409,651,7,4654,258,0,2,1,1,1
1439,42,748,373,158,315,8,0,51,381,5,76,44,79,81,123,486,779,2,2026,112,0,2,1,1,1
1440,31,324,757,253,292,73,244,162,830,13,61,38,67,74,105,409,651,7,4654,258,0,2,3,3,1
1441,42,737,373,158,315,8,0,51,381,5,76,44,79,81,123,486,779,2,2026,112,0,2,2,2,1
1442,24,1014,373,158,315,8,0,51,381,5,76,44,79,81,123,486,779,2,2026,112,0,2,2,2,1
1443,31,326,757,253,292,73,244,162,830,13,61,38,67,74,105,409,651,7,4654,258,0,2,2,2,1
1444,23,632,1043,504,840,53,9,147,1096,9,180,112,198,189,310,1377,2344,4,11604,644,0,2,24,23,0
1445,23,632,383,288,292,26,6,62,409,11,65,38,67,76,105,429,656,5,3719,206,0,2,24,23,0
1446,23,1002,373,158,315,8,0,51,381,5,76,44,79,81,123,486,779,2,2026,112,0,2,4,6,0
1447,19,509,1043,504,840,53,9,147,1096,9,180,112,198,189,310,1377,2344,4,11604,644,0,2,39,60,1
1448,19,509,383,288,292,26,6,62,409,11,65,38,67,76,105,429,656,5,3719,206,0,2,39,60,1
1449,138,2386,1338,495,1086,10,64,173,1348,11,122,82,157,133,239,883,1686,7,11934,663,0,2,0,6,0
1450,32,339,757,253,292,73,244,162,830,13,61,38,67,74,105,409,651,7,4654,258,0,2,3,0,0
1451,42,736,373,158,315,8,0,51,381,5,76,44,79,81,123,486,779,2,2026,112,0,2,2,3,0
1452,42,724,373,158,315,8,0,51,381,5,76,44,79,81,123,486,779,2,2026,112,0,2,1,3,0
1453,17,451,1043,504,840,53,9,147,1096,9,180,112,198,189,310,1377,2344,4,11604,644,0,2,0,13,0
1454,17,451,383,288,292,26,6,62,409,11,65,38,67,76,105,429,656,5,3719,206,0,2,0,13,0
1455,19,276,477,336,357,30,23,73,507,16,194,134,250,210,384,1538,2962,10,30538,1696,0,2,0,1,0
1456,42,722,373,158,315,8,0,51,381,5,76,44,79,81,123,486,779,2,2026,112,0,2,1,1,0
1457,33,872,1043,504,840,53,9,147,1096,9,180,112,198,189,310,1377,2344,4,11604,644,0,2,83,6,1
1458,33,872,383,288,292,26,6,62,409,11,65,38,67,76,105,429,656,5,3719,206,0,2,83,6,1
1459,82,1830,1457,730,1242,11,6,188,1468,10,292,166,329,302,495,2424,4078,5,22973,1276,1,2,1,28,1
1460,82,1830,74,35,59,1,0,14,75,3,14,7,14,17,21,58,85,1,128,7,0,2,1,28,1
1461,82,1830,245,125,200,5,7,34,250,7,30,17,34,37,51,166,265,3,1053,58,0,2,1,28,1
1462,33,348,757,253,292,73,244,162,830,13,61,38,67,74,105,409,651,7,4654,258,0,2,3,0,1
1463,53,1236,1043,504,840,53,9,147,1096,9,180,112,198,189,310,1377,2344,4,11604,644,0,2,69,3,1
1464,53,1236,383,288,292,26,6,62,409,11,65,38,67,76,105,429,656,5,3719,206,0,2,69,3,1
1465,34,361,757,253,292,73,244,162,830,13,61,38,67,74,105,409,651,7,4654,258,0,2,4,1,1
1466,55,1341,1043,504,840,53,9,147,1096,9,180,112,198,189,310,1377,2344,4,11604,644,0,2,36,21,1
1467,55,1341,383,288,292,26,6,62,409,11,65,38,67,76,105,429,656,5,3719,206,0,2,36,21,1
1468,6,416,1043,504,840,53,9,147,1096,9,180,112,198,189,310,1377,2344,4,11604,644,0,0,91,0,1
1469,34,361,757,253,292,73,244,162,830,13,61,38,67,74,105,409,651,7,4654,258,0,2,2,2,1
1470,42,722,373,158,315,8,0,51,381,5,76,44,79,81,123,486,779,2,2026,112,0,2,4,4,1
1471,6,416,1043,504,840,53,9,147,1096,9,180,112,198,189,310,1377,2344,4,11604,644,0,2,1,1,1
1472,138,2386,1338,495,1086,10,64,173,1348,11,122,82,157,133,239,883,1686,7,11934,663,0,2,3,18,0
1473,53,1303,1043,504,840,53,9,147,1096,9,180,112,198,189,310,1377,2344,4,11604,644,0,2,0,7,0
1474,53,1303,383,288,292,26,6,62,409,11,65,38,67,76,105,429,656,5,3719,206,0,2,0,7,0
1475,6,416,1043,504,840,53,9,147,1096,9,180,112,198,189,310,1377,2344,4,11604,644,0,2,6,6,0
1476,23,1002,373,158,315,8,0,51,381,5,76,44,79,81,123,486,779,2,2026,112,0,2,3,3,0
1477,35,374,757,253,292,73,244,162,830,13,61,38,67,74,105,409,651,7,4654,258,0,2,3,0,1
1478,53,1303,1043,504,840,53,9,147,1096,9,180,112,198,189,310,1377,2344,4,11604,644,0,2,3,0,1
1479,53,1303,383,288,292,26,6,62,409,11,65,38,67,76,105,429,656,5,3719,206,0,2,3,0,1
1480,23,1002,373,158,315,8,0,51,381,5,76,44,79,81,123,486,779,2,2026,112,0,2,8,8,1
1481,35,374,757,253,292,73,244,162,830,13,61,38,67,74,105,409,651,7,4654,258,0,2,1,1,0
1482,53,1300,1043,504,840,53,9,147,1096,9,180,112,198,189,310,1377,2344,4,11604,644,0,2,2,7,0
1483,53,1300,383,288,292,26,6,62,409,11,65,38,67,76,105,429,656,5,3719,206,0,2,2,7,0
1484,42,722,373,158,315,8,0,51,381,5,76,44,79,81,123,486,779,2,2026,112,0,2,2,2,0
1485,23,1002,373,158,315,8,0,51,381,5,76,44,79,81,123,486,779,2,2026,112,0,2,3,3,0
1486,45,1284,2,2,2,0,0,0,2,0,0,0,0,0,0,0,0,0,0,0,0,0,346,0,0
1487,45,1284,99,48,90,1,3,5,100,0,0,0,0,0,0,0,0,0,0,0,0,0,346,0,0
1488,45,1284,8,5,5,2,0,1,10,0,0,0,0,0,0,0,0,0,0,0,0,0,346,0,0
1489,45,1284,1217,716,841,84,126,174,1301,14,185,118,215,199,333,1446,2542,8,20687,1149,0,0,346,0,0
1490,45,1284,160,89,115,0,13,31,160,7,15,11,17,22,28,78,124,3,495,27,0,0,346,0,0
1491,45,1284,10,10,9,9,0,0,19,0,0,0,0,0,0,0,0,0,0,0,0,0,346,0,0
1492,45,1284,173,84,99,8,29,36,181,5,12,7,13,17,20,54,81,2,221,12,0,0,346,0,0
1493,45,1284,3,1,1,3,0,0,6,0,0,0,0,0,0,0,0,0,0,0,0,0,346,0,0
1494,16,393,2,2,2,0,0,0,2,0,0,0,0,0,0,0,0,0,0,0,0,0,114,0,0
1495,16,393,99,48,90,1,3,5,100,0,0,0,0,0,0,0,0,0,0,0,0,0,114,0,0
1496,16,393,8,5,5,2,0,1,10,0,0,0,0,0,0,0,0,0,0,0,0,0,114,0,0
1497,16,393,1217,716,841,84,126,174,1301,14,185,118,215,199,333,1446,2542,8,20687,1149,0,0,114,0,0
1498,16,393,160,89,115,0,13,31,160,7,15,11,17,22,28,78,124,3,495,27,0,0,114,0,0
1499,16,393,10,10,9,9,0,0,19,0,0,0,0,0,0,0,0,0,0,0,0,0,114,0,0
1500,16,393,173,84,99,8,29,36,181,5,12,7,13,17,20,54,81,2,221,12,0,0,114,0,0
1501,16,393,3,1,1,3,0,0,6,0,0,0,0,0,0,0,0,0,0,0,0,0,114,0,0
1502,88,1951,1457,730,1242,11,6,188,1468,10,292,166,329,302,495,2424,4078,5,22973,1276,1,2,22,0,1
1503,88,1951,74,35,59,1,0,14,75,3,14,7,14,17,21,58,85,1,128,7,0,2,22,0,1
1504,88,1951,245,125,200,5,7,34,250,7,30,17,34,37,51,166,265,3,1053,58,0,2,22,0,1
1505,49,1248,1043,504,840,53,9,147,1096,9,180,112,198,189,310,1377,2344,4,11604,644,0,2,8,27,1
1506,49,1248,383,288,292,26,6,62,409,11,65,38,67,76,105,429,656,5,3719,206,0,2,8,27,1
1507,42,2284,1457,730,1242,11,6,188,1468,10,292,166,329,302,495,2424,4078,5,22973,1276,1,2,32,3,1
1508,44,1071,1043,504,840,53,9,147,1096,9,180,112,198,189,310,1377,2344,4,11604,644,0,2,0,21,0
1509,44,1071,383,288,292,26,6,62,409,11,65,38,67,76,105,429,656,5,3719,206,0,2,0,21,0
1510,6,419,1043,504,840,53,9,147,1096,9,180,112,198,189,310,1377,2344,4,11604,644,0,2,1,0,0
1511,88,1960,1457,730,1242,11,6,188,1468,10,292,166,329,302,495,2424,4078,5,22973,1276,1,2,1,0,1
1512,88,1960,74,35,59,1,0,14,75,3,14,7,14,17,21,58,85,1,128,7,0,2,1,0,1
1513,88,1960,245,125,200,5,7,34,250,7,30,17,34,37,51,166,265,3,1053,58,0,2,1,0,1
1514,36,387,757,253,292,73,244,162,830,13,61,38,67,74,105,409,651,7,4654,258,0,2,4,0,1
1515,16,393,2,2,2,0,0,0,2,0,0,0,0,0,0,0,0,0,0,0,0,2,1,0,0
1516,16,393,99,48,90,1,3,5,100,0,0,0,0,0,0,0,0,0,0,0,0,2,1,0,0
1517,16,393,8,5,5,2,0,1,10,0,0,0,0,0,0,0,0,0,0,0,0,2,1,0,0
1518,16,393,1217,716,841,84,126,174,1301,14,185,118,215,199,333,1446,2542,8,20687,1149,0,2,1,0,0
1519,16,393,160,89,115,0,13,31,160,7,15,11,17,22,28,78,124,3,495,27,0,2,1,0,0
1520,16,393,10,10,9,9,0,0,19,0,0,0,0,0,0,0,0,0,0,0,0,2,1,0,0
1521,16,393,173,84,99,8,29,36,181,5,12,7,13,17,20,54,81,2,221,12,0,2,1,0,0
1522,16,393,3,1,1,3,0,0,6,0,0,0,0,0,0,0,0,0,0,0,0,2,1,0,0
1523,138,2382,1338,495,1086,10,64,173,1348,11,122,82,157,133,239,883,1686,7,11934,663,0,2,3,4,0
1524,37,416,757,253,292,73,244,162,830,13,61,38,67,74,105,409,651,7,4654,258,0,2,10,1,0
1525,44,1069,1043,504,840,53,9,147,1096,9,180,112,198,189,310,1377,2344,4,11604,644,0,2,2,3,0
1526,44,1069,383,288,292,26,6,62,409,11,65,38,67,76,105,429,656,5,3719,206,0,2,2,3,0
1527,13,274,127,75,83,2,11,30,129,4,14,7,14,18,21,61,87,2,175,9,0,2,2,1,1
1528,13,274,652,304,544,16,6,88,668,6,89,51,101,95,152,591,998,3,3399,188,0,2,2,1,1
1529,13,274,2,2,2,0,0,0,2,0,0,0,0,0,0,0,0,0,0,0,0,2,2,1,1
1530,13,274,8,5,5,0,0,3,8,0,0,0,0,0,0,0,0,0,0,0,0,2,2,1,1
1531,13,274,2,2,2,0,0,0,2,0,0,0,0,0,0,0,0,0,0,0,0,2,2,1,1
1532,13,274,14,8,8,0,0,6,14,0,0,0,0,0,0,0,0,0,0,0,0,2,2,1,1
1533,13,274,6,4,4,0,0,2,6,0,0,0,0,0,0,0,0,0,0,0,0,2,2,1,1
1534,13,274,6,4,4,0,0,2,6,1,2,1,2,3,3,2,4,0,2,0,0,2,2,1,1
1535,13,274,6,4,4,0,0,2,6,0,0,0,0,0,0,0,0,0,0,0,0,2,2,1,1
1536,13,274,7,5,5,0,0,2,7,0,0,0,0,0,0,0,0,0,0,0,0,2,2,1,1
1537,13,274,6,4,4,0,0,2,6,0,0,0,0,0,0,0,0,0,0,0,0,2,2,1,1
1538,13,274,10,6,6,0,0,4,10,0,0,0,0,0,0,0,0,0,0,0,0,2,2,1,1
1539,13,274,1,1,1,0,0,0,1,0,0,0,0,0,0,0,0,0,0,0,0,2,2,1,1
1540,13,274,1,1,1,0,0,0,1,0,0,0,0,0,0,0,0,0,0,0,0,2,2,1,1
1541,13,274,14,10,10,0,0,4,14,1,1,1,1,2,2,0,2,0,1,0,0,2,2,1,1
1542,13,274,46,26,30,3,0,12,49,3,6,3,6,9,9,20,28,1,42,2,0,2,2,1,1
1543,37,418,757,253,292,73,244,162,830,13,61,38,67,74,105,409,651,7,4654,258,0,2,1,1,1
1544,37,416,757,253,292,73,244,162,830,13,61,38,67,74,105,409,651,7,4654,258,0,2,1,1,0
1545,33,376,757,253,292,73,244,162,830,13,61,38,67,74,105,409,651,7,4654,258,0,2,0,12,1
1546,34,385,757,253,292,73,244,162,830,13,61,38,67,74,105,409,651,7,4654,258,0,2,31,26,1
1547,44,1069,1043,504,840,53,9,147,1096,9,180,112,198,189,310,1377,2344,4,11604,644,0,2,1,0,1
1548,44,1069,383,288,292,26,6,62,409,11,65,38,67,76,105,429,656,5,3719,206,0,2,1,0,1
1549,42,733,373,158,315,8,0,51,381,5,76,44,79,81,123,486,779,2,2026,112,0,2,5,6,1
1550,6,419,1043,504,840,53,9,147,1096,9,180,112,198,189,310,1377,2344,4,11604,644,0,2,6,6,1
1551,23,1002,373,158,315,8,0,51,381,5,76,44,79,81,123,486,779,2,2026,112,0,2,3,3,1
1552,33,376,757,253,292,73,244,162,830,13,61,38,67,74,105,409,651,7,4654,258,0,2,7,13,0
1553,42,734,373,158,315,8,0,51,381,5,76,44,79,81,123,486,779,2,2026,112,0,2,5,4,0
1554,33,376,757,253,292,73,244,162,830,13,61,38,67,74,105,409,651,7,4654,258,0,2,8,9,1
1555,42,736,373,158,315,8,0,51,381,5,76,44,79,81,123,486,779,2,2026,112,0,2,1,1,1
1556,88,1958,1457,730,1242,11,6,188,1468,10,292,166,329,302,495,2424,4078,5,22973,1276,1,2,1,1,1
1557,88,1958,74,35,59,1,0,14,75,3,14,7,14,17,21,58,85,1,128,7,0,2,1,1,1
1558,88,1958,245,125,200,5,7,34,250,7,30,17,34,37,51,166,265,3,1053,58,0,2,1,1,1
1559,31,347,757,253,292,73,244,162,830,13,61,38,67,74,105,409,651,7,4654,258,0,2,3,13,1
1560,15,369,386,256,301,16,9,68,402,4,59,35,69,63,104,355,621,2,1453,80,0,2,1,1,0
1561,15,369,264,131,164,11,41,46,275,6,38,22,40,44,62,214,338,3,1068,59,0,2,1,1,0
1562,88,1960,1457,730,1242,11,6,188,1468,10,292,166,329,302,495,2424,4078,5,22973,1276,1,2,1,1,0
1563,88,1960,74,35,59,1,0,14,75,3,14,7,14,17,21,58,85,1,128,7,0,2,1,1,0
1564,88,1960,245,125,200,5,7,34,250,7,30,17,34,37,51,166,265,3,1053,58,0,2,1,1,0
1565,31,347,757,253,292,73,244,162,830,13,61,38,67,74,105,409,651,7,4654,258,0,2,2,1,0
1566,31,347,757,253,292,73,244,162,830,13,61,38,67,74,105,409,651,7,4654,258,0,2,32,25,0
1567,15,369,386,256,301,16,9,68,402,4,59,35,69,63,104,355,621,2,1453,80,0,2,4,4,1
1568,15,369,264,131,164,11,41,46,275,6,38,22,40,44,62,214,338,3,1068,59,0,2,4,4,1
1569,138,2382,1338,495,1086,10,64,173,1348,11,122,82,157,133,239,883,1686,7,11934,663,0,2,1,1,1
1570,88,1953,1457,730,1242,11,6,188,1468,10,292,166,329,302,495,2424,4078,5,22973,1276,1,2,11,12,1
1571,88,1953,74,35,59,1,0,14,75,3,14,7,14,17,21,58,85,1,128,7,0,2,11,12,1
1572,88,1953,245,125,200,5,7,34,250,7,30,17,34,37,51,166,265,3,1053,58,0,2,11,12,1
1573,42,736,373,158,315,8,0,51,381,5,76,44,79,81,123,486,779,2,2026,112,0,2,5,5,1
1574,42,2286,1457,730,1242,11,6,188,1468,10,292,166,329,302,495,2424,4078,5,22973,1276,1,2,1,1,1
1575,42,905,384,251,317,7,8,52,391,11,70,44,84,81,128,467,811,6,5355,297,0,3,8,2,0
1576,33,1623,384,251,317,7,8,52,391,11,70,44,84,81,128,467,811,6,5355,297,0,3,3,3,0
1577,42,906,384,251,317,7,8,52,391,11,70,44,84,81,128,467,811,6,5355,297,0,2,9,9,1
1578,31,347,757,253,292,73,244,162,830,13,61,38,67,74,105,409,651,7,4654,258,0,2,27,15,1
1579,42,924,384,251,317,7,8,52,391,11,70,44,84,81,128,467,811,6,5355,297,0,2,5,1,1
1580,33,1629,384,251,317,7,8,52,391,11,70,44,84,81,128,467,811,6,5355,297,0,2,49,49,1
1581,88,1953,1457,730,1242,11,6,188,1468,10,292,166,329,302,495,2424,4078,5,22973,1276,1,2,3,1,1
1582,88,1953,74,35,59,1,0,14,75,3,14,7,14,17,21,58,85,1,128,7,0,2,3,1,1
1583,88,1953,245,125,200,5,7,34,250,7,30,17,34,37,51,166,265,3,1053,58,0,2,3,1,1
1584,42,2286,1457,730,1242,11,6,188,1468,10,292,166,329,302,495,2424,4078,5,22973,1276,1,2,1,1,1
1585,138,2380,1338,495,1086,10,64,173,1348,11,122,82,157,133,239,883,1686,7,11934,663,0,2,1,2,1
1586,31,352,757,253,292,73,244,162,830,13,61,38,67,74,105,409,651,7,4654,258,0,2,1,0,1
1587,42,944,384,251,317,7,8,52,391,11,70,44,84,81,128,467,811,6,5355,297,0,2,8,8,1
1588,30,1516,384,251,317,7,8,52,391,11,70,44,84,81,128,467,811,6,5355,297,0,2,1,18,1
1589,138,2382,1338,495,1086,10,64,173,1348,11,122,82,157,133,239,883,1686,7,11934,663,0,2,3,4,0
1590,88,1947,1457,730,1242,11,6,188,1468,10,292,166,329,302,495,2424,4078,5,22973,1276,1,2,1,2,0
1591,88,1947,74,35,59,1,0,14,75,3,14,7,14,17,21,58,85,1,128,7,0,2,1,2,0
1592,88,1947,245,125,200,5,7,34,250,7,30,17,34,37,51,166,265,3,1053,58,0,2,1,2,0
1593,138,2382,1338,495,1086,10,64,173,1348,11,122,82,157,133,239,883,1686,7,11934,663,0,2,3,3,0
1594,88,1947,1457,730,1242,11,6,188,1468,10,292,166,329,302,495,2424,4078,5,22973,1276,1,2,1,1,0
1595,88,1947,74,35,59,1,0,14,75,3,14,7,14,17,21,58,85,1,128,7,0,2,1,1,0
1596,88,1947,245,125,200,5,7,34,250,7,30,17,34,37,51,166,265,3,1053,58,0,2,1,1,0
1597,20,481,2,2,2,0,0,0,2,0,0,0,0,0,0,0,0,0,0,0,0,2,131,40,1
1598,20,481,99,48,90,1,3,5,100,0,0,0,0,0,0,0,0,0,0,0,0,2,131,40,1
1599,20,481,8,5,5,2,0,1,10,0,0,0,0,0,0,0,0,0,0,0,0,2,131,40,1
1600,20,481,1217,716,841,84,126,174,1301,14,185,118,215,199,333,1446,2542,8,20687,1149,0,2,131,40,1
1601,20,481,160,89,115,0,13,31,160,7,15,11,17,22,28,78,124,3,495,27,0,2,131,40,1
1602,20,481,10,10,9,9,0,0,19,0,0,0,0,0,0,0,0,0,0,0,0,2,131,40,1
1603,20,481,173,84,99,8,29,36,181,5,12,7,13,17,20,54,81,2,221,12,0,2,131,40,1
1604,20,481,3,1,1,3,0,0,6,0,0,0,0,0,0,0,0,0,0,0,0,2,131,40,1
1605,45,1292,2,2,2,0,0,0,2,0,0,0,0,0,0,0,0,0,0,0,0,2,4,2,0
1606,45,1292,99,48,90,1,3,5,100,0,0,0,0,0,0,0,0,0,0,0,0,2,4,2,0
1607,45,1292,8,5,5,2,0,1,10,0,0,0,0,0,0,0,0,0,0,0,0,2,4,2,0
1608,45,1292,1217,716,841,84,126,174,1301,14,185,118,215,199,333,1446,2542,8,20687,1149,0,2,4,2,0
1609,45,1292,160,89,115,0,13,31,160,7,15,11,17,22,28,78,124,3,495,27,0,2,4,2,0
1610,45,1292,10,10,9,9,0,0,19,0,0,0,0,0,0,0,0,0,0,0,0,2,4,2,0
1611,45,1292,173,84,99,8,29,36,181,5,12,7,13,17,20,54,81,2,221,12,0,2,4,2,0
1612,45,1292,3,1,1,3,0,0,6,0,0,0,0,0,0,0,0,0,0,0,0,2,4,2,0
1613,1,312,42,7,35,4,0,5,46,1,2,1,2,3,3,2,4,0,2,0,0,2,12,14,1
1614,1,312,11,6,10,0,0,1,11,2,4,2,4,6,6,10,15,1,15,0,0,2,12,14,1
1615,27,522,334,251,279,10,4,40,344,5,127,74,143,132,217,899,1528,2,4303,239,0,2,2,2,0
1616,14,695,334,251,279,10,4,40,344,5,127,74,143,132,217,899,1528,2,4303,239,0,2,9,1,0
1617,2,32,127,75,83,2,11,30,129,4,14,7,14,18,21,61,87,2,175,9,0,0,10,0,1
1618,2,32,652,304,544,16,6,88,668,6,89,51,101,95,152,591,998,3,3399,188,0,0,10,0,1
1619,2,32,2,2,2,0,0,0,2,0,0,0,0,0,0,0,0,0,0,0,0,0,10,0,1
1620,2,32,8,5,5,0,0,3,8,0,0,0,0,0,0,0,0,0,0,0,0,0,10,0,1
1621,2,32,2,2,2,0,0,0,2,0,0,0,0,0,0,0,0,0,0,0,0,0,10,0,1
1622,2,32,14,8,8,0,0,6,14,0,0,0,0,0,0,0,0,0,0,0,0,0,10,0,1
1623,2,32,6,4,4,0,0,2,6,0,0,0,0,0,0,0,0,0,0,0,0,0,10,0,1
1624,2,32,6,4,4,0,0,2,6,1,2,1,2,3,3,2,4,0,2,0,0,0,10,0,1
1625,2,32,6,4,4,0,0,2,6,0,0,0,0,0,0,0,0,0,0,0,0,0,10,0,1
1626,2,32,7,5,5,0,0,2,7,0,0,0,0,0,0,0,0,0,0,0,0,0,10,0,1
1627,2,32,6,4,4,0,0,2,6,0,0,0,0,0,0,0,0,0,0,0,0,0,10,0,1
1628,2,32,10,6,6,0,0,4,10,0,0,0,0,0,0,0,0,0,0,0,0,0,10,0,1
1629,2,32,1,1,1,0,0,0,1,0,0,0,0,0,0,0,0,0,0,0,0,0,10,0,1
1630,2,32,1,1,1,0,0,0,1,0,0,0,0,0,0,0,0,0,0,0,0,0,10,0,1
1631,2,32,14,10,10,0,0,4,14,1,1,1,1,2,2,0,2,0,1,0,0,0,10,0,1
1632,2,32,46,26,30,3,0,12,49,3,6,3,6,9,9,20,28,1,42,2,0,0,10,0,1
1633,42,953,384,251,317,7,8,52,391,11,70,44,84,81,128,467,811,6,5355,297,0,2,2,2,1
1634,13,274,127,75,83,2,11,30,129,4,14,7,14,18,21,61,87,2,175,9,0,2,4,4,1
1635,13,274,652,304,544,16,6,88,668,6,89,51,101,95,152,591,998,3,3399,188,0,2,4,4,1
1636,13,274,2,2,2,0,0,0,2,0,0,0,0,0,0,0,0,0,0,0,0,2,4,4,1
1637,13,274,8,5,5,0,0,3,8,0,0,0,0,0,0,0,0,0,0,0,0,2,4,4,1
1638,13,274,2,2,2,0,0,0,2,0,0,0,0,0,0,0,0,0,0,0,0,2,4,4,1
1639,13,274,14,8,8,0,0,6,14,0,0,0,0,0,0,0,0,0,0,0,0,2,4,4,1
1640,13,274,6,4,4,0,0,2,6,0,0,0,0,0,0,0,0,0,0,0,0,2,4,4,1
1641,13,274,6,4,4,0,0,2,6,1,2,1,2,3,3,2,4,0,2,0,0,2,4,4,1
1642,13,274,6,4,4,0,0,2,6,0,0,0,0,0,0,0,0,0,0,0,0,2,4,4,1
1643,13,274,7,5,5,0,0,2,7,0,0,0,0,0,0,0,0,0,0,0,0,2,4,4,1
1644,13,274,6,4,4,0,0,2,6,0,0,0,0,0,0,0,0,0,0,0,0,2,4,4,1
1645,13,274,10,6,6,0,0,4,10,0,0,0,0,0,0,0,0,0,0,0,0,2,4,4,1
1646,13,274,1,1,1,0,0,0,1,0,0,0,0,0,0,0,0,0,0,0,0,2,4,4,1
1647,13,274,1,1,1,0,0,0,1,0,0,0,0,0,0,0,0,0,0,0,0,2,4,4,1
1648,13,274,14,10,10,0,0,4,14,1,1,1,1,2,2,0,2,0,1,0,0,2,4,4,1
1649,13,274,46,26,30,3,0,12,49,3,6,3,6,9,9,20,28,1,42,2,0,2,4,4,1
1650,42,955,384,251,317,7,8,52,391,11,70,44,84,81,128,467,811,6,5355,297,0,2,1,0,1
1651,2,32,127,75,83,2,11,30,129,4,14,7,14,18,21,61,87,2,175,9,0,0,10,0,0
1652,2,32,652,304,544,16,6,88,668,6,89,51,101,95,152,591,998,3,3399,188,0,0,10,0,0
1653,2,32,2,2,2,0,0,0,2,0,0,0,0,0,0,0,0,0,0,0,0,0,10,0,0
1654,2,32,8,5,5,0,0,3,8,0,0,0,0,0,0,0,0,0,0,0,0,0,10,0,0
1655,2,32,2,2,2,0,0,0,2,0,0,0,0,0,0,0,0,0,0,0,0,0,10,0,0
1656,2,32,14,8,8,0,0,6,14,0,0,0,0,0,0,0,0,0,0,0,0,0,10,0,0
1657,2,32,6,4,4,0,0,2,6,0,0,0,0,0,0,0,0,0,0,0,0,0,10,0,0
1658,2,32,6,4,4,0,0,2,6,1,2,1,2,3,3,2,4,0,2,0,0,0,10,0,0
1659,2,32,6,4,4,0,0,2,6,0,0,0,0,0,0,0,0,0,0,0,0,0,10,0,0
1660,2,32,7,5,5,0,0,2,7,0,0,0,0,0,0,0,0,0,0,0,0,0,10,0,0
1661,2,32,6,4,4,0,0,2,6,0,0,0,0,0,0,0,0,0,0,0,0,0,10,0,0
1662,2,32,10,6,6,0,0,4,10,0,0,0,0,0,0,0,0,0,0,0,0,0,10,0,0
1663,2,32,1,1,1,0,0,0,1,0,0,0,0,0,0,0,0,0,0,0,0,0,10,0,0
1664,2,32,1,1,1,0,0,0,1,0,0,0,0,0,0,0,0,0,0,0,0,0,10,0,0
1665,2,32,14,10,10,0,0,4,14,1,1,1,1,2,2,0,2,0,1,0,0,0,10,0,0
1666,2,32,46,26,30,3,0,12,49,3,6,3,6,9,9,20,28,1,42,2,0,0,10,0,0
1667,13,274,127,75,83,2,11,30,129,4,14,7,14,18,21,61,87,2,175,9,0,2,4,4,0
1668,13,274,652,304,544,16,6,88,668,6,89,51,101,95,152,591,998,3,3399,188,0,2,4,4,0
1669,13,274,2,2,2,0,0,0,2,0,0,0,0,0,0,0,0,0,0,0,0,2,4,4,0
1670,13,274,8,5,5,0,0,3,8,0,0,0,0,0,0,0,0,0,0,0,0,2,4,4,0
1671,13,274,2,2,2,0,0,0,2,0,0,0,0,0,0,0,0,0,0,0,0,2,4,4,0
1672,13,274,14,8,8,0,0,6,14,0,0,0,0,0,0,0,0,0,0,0,0,2,4,4,0
1673,13,274,6,4,4,0,0,2,6,0,0,0,0,0,0,0,0,0,0,0,0,2,4,4,0
1674,13,274,6,4,4,0,0,2,6,1,2,1,2,3,3,2,4,0,2,0,0,2,4,4,0
1675,13,274,6,4,4,0,0,2,6,0,0,0,0,0,0,0,0,0,0,0,0,2,4,4,0
1676,13,274,7,5,5,0,0,2,7,0,0,0,0,0,0,0,0,0,0,0,0,2,4,4,0
1677,13,274,6,4,4,0,0,2,6,0,0,0,0,0,0,0,0,0,0,0,0,2,4,4,0
1678,13,274,10,6,6,0,0,4,10,0,0,0,0,0,0,0,0,0,0,0,0,2,4,4,0
1679,13,274,1,1,1,0,0,0,1,0,0,0,0,0,0,0,0,0,0,0,0,2,4,4,0
1680,13,274,1,1,1,0,0,0,1,0,0,0,0,0,0,0,0,0,0,0,0,2,4,4,0
1681,13,274,14,10,10,0,0,4,14,1,1,1,1,2,2,0,2,0,1,0,0,2,4,4,0
1682,13,274,46,26,30,3,0,12,49,3,6,3,6,9,9,20,28,1,42,2,0,2,4,4,0
1683,42,955,384,251,317,7,8,52,391,11,70,44,84,81,128,467,811,6,5355,297,0,2,3,2,0
1684,1,312,42,7,35,4,0,5,46,1,2,1,2,3,3,2,4,0,2,0,0,2,1,1,0
1685,1,312,11,6,10,0,0,1,11,2,4,2,4,6,6,10,15,1,15,0,0,2,1,1,0
1686,1,312,42,7,35,4,0,5,46,1,2,1,2,3,3,2,4,0,2,0,0,2,1,1,1
1687,1,312,11,6,10,0,0,1,11,2,4,2,4,6,6,10,15,1,15,0,0,2,1,1,1
1688,30,339,757,253,292,73,244,162,830,13,61,38,67,74,105,409,651,7,4654,258,0,2,0,3,0
1689,30,339,757,253,292,73,244,162,830,13,61,38,67,74,105,409,651,7,4654,258,0,2,0,3,0
1690,44,1063,1043,504,840,53,9,147,1096,9,180,112,198,189,310,1377,2344,4,11604,644,0,2,0,2,0
1691,44,1063,383,288,292,26,6,62,409,11,65,38,67,76,105,429,656,5,3719,206,0,2,0,2,0
1692,30,344,757,253,292,73,244,162,830,13,61,38,67,74,105,409,651,7,4654,258,0,2,1,0,0
1693,18,462,2,2,2,0,0,0,2,0,0,0,0,0,0,0,0,0,0,0,0,2,7,12,0
1694,18,462,99,48,90,1,3,5,100,0,0,0,0,0,0,0,0,0,0,0,0,2,7,12,0
1695,18,462,8,5,5,2,0,1,10,0,0,0,0,0,0,0,0,0,0,0,0,2,7,12,0
1696,18,462,1217,716,841,84,126,174,1301,14,185,118,215,199,333,1446,2542,8,20687,1149,0,2,7,12,0
1697,18,462,160,89,115,0,13,31,160,7,15,11,17,22,28,78,124,3,495,27,0,2,7,12,0
1698,18,462,10,10,9,9,0,0,19,0,0,0,0,0,0,0,0,0,0,0,0,2,7,12,0
1699,18,462,173,84,99,8,29,36,181,5,12,7,13,17,20,54,81,2,221,12,0,2,7,12,0
1700,18,462,3,1,1,3,0,0,6,0,0,0,0,0,0,0,0,0,0,0,0,2,7,12,0
1701,88,1955,1457,730,1242,11,6,188,1468,10,292,166,329,302,495,2424,4078,5,22973,1276,1,2,1,0,1
1702,88,1955,74,35,59,1,0,14,75,3,14,7,14,17,21,58,85,1,128,7,0,2,1,0,1
1703,88,1955,245,125,200,5,7,34,250,7,30,17,34,37,51,166,265,3,1053,58,0,2,1,0,1
1704,45,990,384,251,317,7,8,52,391,11,70,44,84,81,128,467,811,6,5355,297,0,2,5,0,1
1705,34,1864,1289,550,1043,56,32,155,1345,10,167,93,185,177,278,1266,2075,5,11498,638,0,2,17,0,1
1706,31,1539,384,251,317,7,8,52,391,11,70,44,84,81,128,467,811,6,5355,297,0,2,6,0,1
1707,7,97,127,75,83,2,11,30,129,4,14,7,14,18,21,61,87,2,175,9,0,0,22,0,1
1708,7,97,652,304,544,16,6,88,668,6,89,51,101,95,152,591,998,3,3399,188,0,0,22,0,1
1709,7,97,2,2,2,0,0,0,2,0,0,0,0,0,0,0,0,0,0,0,0,0,22,0,1
1710,7,97,8,5,5,0,0,3,8,0,0,0,0,0,0,0,0,0,0,0,0,0,22,0,1
1711,7,97,2,2,2,0,0,0,2,0,0,0,0,0,0,0,0,0,0,0,0,0,22,0,1
1712,7,97,14,8,8,0,0,6,14,0,0,0,0,0,0,0,0,0,0,0,0,0,22,0,1
1713,7,97,6,4,4,0,0,2,6,0,0,0,0,0,0,0,0,0,0,0,0,0,22,0,1
1714,7,97,6,4,4,0,0,2,6,1,2,1,2,3,3,2,4,0,2,0,0,0,22,0,1
1715,7,97,6,4,4,0,0,2,6,0,0,0,0,0,0,0,0,0,0,0,0,0,22,0,1
1716,7,97,7,5,5,0,0,2,7,0,0,0,0,0,0,0,0,0,0,0,0,0,22,0,1
1717,7,97,6,4,4,0,0,2,6,0,0,0,0,0,0,0,0,0,0,0,0,0,22,0,1
1718,7,97,10,6,6,0,0,4,10,0,0,0,0,0,0,0,0,0,0,0,0,0,22,0,1
1719,7,97,1,1,1,0,0,0,1,0,0,0,0,0,0,0,0,0,0,0,0,0,22,0,1
1720,7,97,1,1,1,0,0,0,1,0,0,0,0,0,0,0,0,0,0,0,0,0,22,0,1
1721,7,97,14,10,10,0,0,4,14,1,1,1,1,2,2,0,2,0,1,0,0,0,22,0,1
1722,7,97,46,26,30,3,0,12,49,3,6,3,6,9,9,20,28,1,42,2,0,0,22,0,1
1723,138,2407,1338,495,1086,10,64,173,1348,11,122,82,157,133,239,883,1686,7,11934,663,0,2,10,11,1
1724,123,2176,1338,495,1086,10,64,173,1348,11,122,82,157,133,239,883,1686,7,11934,663,0,2,6,42,1
1725,45,1069,1043,504,840,53,9,147,1096,9,180,112,198,189,310,1377,2344,4,11604,644,0,2,2,1,0
1726,45,1069,383,288,292,26,6,62,409,11,65,38,67,76,105,429,656,5,3719,206,0,2,2,1,0
1727,13,269,127,75,83,2,11,30,129,4,14,7,14,18,21,61,87,2,175,9,0,2,0,1,0
1728,13,269,652,304,544,16,6,88,668,6,89,51,101,95,152,591,998,3,3399,188,0,2,0,1,0
1729,13,269,2,2,2,0,0,0,2,0,0,0,0,0,0,0,0,0,0,0,0,2,0,1,0
1730,13,269,8,5,5,0,0,3,8,0,0,0,0,0,0,0,0,0,0,0,0,2,0,1,0
1731,13,269,2,2,2,0,0,0,2,0,0,0,0,0,0,0,0,0,0,0,0,2,0,1,0
1732,13,269,14,8,8,0,0,6,14,0,0,0,0,0,0,0,0,0,0,0,0,2,0,1,0
1733,13,269,6,4,4,0,0,2,6,0,0,0,0,0,0,0,0,0,0,0,0,2,0,1,0
1734,13,269,6,4,4,0,0,2,6,1,2,1,2,3,3,2,4,0,2,0,0,2,0,1,0
1735,13,269,6,4,4,0,0,2,6,0,0,0,0,0,0,0,0,0,0,0,0,2,0,1,0
1736,13,269,7,5,5,0,0,2,7,0,0,0,0,0,0,0,0,0,0,0,0,2,0,1,0
1737,13,269,6,4,4,0,0,2,6,0,0,0,0,0,0,0,0,0,0,0,0,2,0,1,0
1738,13,269,10,6,6,0,0,4,10,0,0,0,0,0,0,0,0,0,0,0,0,2,0,1,0
1739,13,269,1,1,1,0,0,0,1,0,0,0,0,0,0,0,0,0,0,0,0,2,0,1,0
1740,13,269,1,1,1,0,0,0,1,0,0,0,0,0,0,0,0,0,0,0,0,2,0,1,0
1741,13,269,14,10,10,0,0,4,14,1,1,1,1,2,2,0,2,0,1,0,0,2,0,1,0
1742,13,269,46,26,30,3,0,12,49,3,6,3,6,9,9,20,28,1,42,2,0,2,0,1,0
1743,30,1650,1289,550,1043,56,32,155,1345,10,167,93,185,177,278,1266,2075,5,11498,638,0,2,2,23,1
1744,124,2190,1338,495,1086,10,64,173,1348,11,122,82,157,133,239,883,1686,7,11934,663,0,2,2,0,1
1745,124,2190,1338,495,1086,10,64,173,1348,11,122,82,157,133,239,883,1686,7,11934,663,0,2,3,3,1
1746,88,1955,1457,730,1242,11,6,188,1468,10,292,166,329,302,495,2424,4078,5,22973,1276,1,2,2,2,1
1747,88,1955,74,35,59,1,0,14,75,3,14,7,14,17,21,58,85,1,128,7,0,2,2,2,1
1748,88,1955,245,125,200,5,7,34,250,7,30,17,34,37,51,166,265,3,1053,58,0,2,2,2,1
1749,45,990,384,251,317,7,8,52,391,11,70,44,84,81,128,467,811,6,5355,297,0,2,7,7,1
1750,45,1069,1043,504,840,53,9,147,1096,9,180,112,198,189,310,1377,2344,4,11604,644,0,2,1,1,1
1751,45,1069,383,288,292,26,6,62,409,11,65,38,67,76,105,429,656,5,3719,206,0,2,1,1,1
1752,42,736,373,158,315,8,0,51,381,5,76,44,79,81,123,486,779,2,2026,112,0,2,6,6,1
1753,31,1539,384,251,317,7,8,52,391,11,70,44,84,81,128,467,811,6,5355,297,0,2,1,1,1
1754,31,1517,384,251,317,7,8,52,391,11,70,44,84,81,128,467,811,6,5355,297,0,2,0,2,1
1755,30,344,757,253,292,73,244,162,830,13,61,38,67,74,105,409,651,7,4654,258,0,2,2,2,0
1756,31,353,757,253,292,73,244,162,830,13,61,38,67,74,105,409,651,7,4654,258,0,2,3,1,1
1757,31,353,757,253,292,73,244,162,830,13,61,38,67,74,105,409,651,7,4654,258,0,2,1,1,1
1758,75,1630,773,419,590,28,0,166,801,10,204,113,217,214,330,1598,2554,5,13587,754,0,2,20,0,1
1759,75,1630,421,273,302,44,34,57,465,17,81,59,107,98,166,583,1098,11,12329,684,0,2,20,0,1
1760,53,1808,773,419,590,28,0,166,801,10,204,113,217,214,330,1598,2554,5,13587,754,0,2,20,0,1
1761,54,1831,773,419,590,28,0,166,801,10,204,113,217,214,330,1598,2554,5,13587,754,0,2,6,2,1
1762,45,1069,1043,504,840,53,9,147,1096,9,180,112,198,189,310,1377,2344,4,11604,644,0,2,1,1,0
1763,45,1069,383,288,292,26,6,62,409,11,65,38,67,76,105,429,656,5,3719,206,0,2,1,1,0
1764,32,362,757,253,292,73,244,162,830,13,61,38,67,74,105,409,651,7,4654,258,0,2,5,0,0
1765,54,1827,773,419,590,28,0,166,801,10,204,113,217,214,330,1598,2554,5,13587,754,0,2,1,1,0
1766,124,2190,1338,495,1086,10,64,173,1348,11,122,82,157,133,239,883,1686,7,11934,663,0,2,1,1,1
1767,32,367,757,253,292,73,244,162,830,13,61,38,67,74,105,409,651,7,4654,258,0,2,6,5,1
1768,75,1630,773,419,590,28,0,166,801,10,204,113,217,214,330,1598,2554,5,13587,754,0,2,20,0,0
1769,75,1630,421,273,302,44,34,57,465,17,81,59,107,98,166,583,1098,11,12329,684,0,2,20,0,0
1770,54,1827,773,419,590,28,0,166,801,10,204,113,217,214,330,1598,2554,5,13587,754,0,2,24,0,0
1771,124,2190,1338,495,1086,10,64,173,1348,11,122,82,157,133,239,883,1686,7,11934,663,0,2,1,1,0
1772,32,367,757,253,292,73,244,162,830,13,61,38,67,74,105,409,651,7,4654,258,0,2,6,0,0
1773,45,1069,1043,504,840,53,9,147,1096,9,180,112,198,189,310,1377,2344,4,11604,644,0,2,1,1,0
1774,45,1069,383,288,292,26,6,62,409,11,65,38,67,76,105,429,656,5,3719,206,0,2,1,1,0
1775,32,367,757,253,292,73,244,162,830,13,61,38,67,74,105,409,651,7,4654,258,0,2,1,1,1
1776,7,97,127,75,83,2,11,30,129,4,14,7,14,18,21,61,87,2,175,9,0,3,2,2,1
1777,7,97,652,304,544,16,6,88,668,6,89,51,101,95,152,591,998,3,3399,188,0,3,2,2,1
1778,7,97,2,2,2,0,0,0,2,0,0,0,0,0,0,0,0,0,0,0,0,3,2,2,1
1779,7,97,8,5,5,0,0,3,8,0,0,0,0,0,0,0,0,0,0,0,0,3,2,2,1
1780,7,97,2,2,2,0,0,0,2,0,0,0,0,0,0,0,0,0,0,0,0,3,2,2,1
1781,7,97,14,8,8,0,0,6,14,0,0,0,0,0,0,0,0,0,0,0,0,3,2,2,1
1782,7,97,6,4,4,0,0,2,6,0,0,0,0,0,0,0,0,0,0,0,0,3,2,2,1
1783,7,97,6,4,4,0,0,2,6,1,2,1,2,3,3,2,4,0,2,0,0,3,2,2,1
1784,7,97,6,4,4,0,0,2,6,0,0,0,0,0,0,0,0,0,0,0,0,3,2,2,1
1785,7,97,7,5,5,0,0,2,7,0,0,0,0,0,0,0,0,0,0,0,0,3,2,2,1
1786,7,97,6,4,4,0,0,2,6,0,0,0,0,0,0,0,0,0,0,0,0,3,2,2,1
1787,7,97,10,6,6,0,0,4,10,0,0,0,0,0,0,0,0,0,0,0,0,3,2,2,1
1788,7,97,1,1,1,0,0,0,1,0,0,0,0,0,0,0,0,0,0,0,0,3,2,2,1
1789,7,97,1,1,1,0,0,0,1,0,0,0,0,0,0,0,0,0,0,0,0,3,2,2,1
1790,7,97,14,10,10,0,0,4,14,1,1,1,1,2,2,0,2,0,1,0,0,3,2,2,1
1791,7,97,46,26,30,3,0,12,49,3,6,3,6,9,9,20,28,1,42,2,0,3,2,2,1
1792,3,48,127,75,83,2,11,30,129,4,14,7,14,18,21,61,87,2,175,9,0,2,3,1,1
1793,3,48,652,304,544,16,6,88,668,6,89,51,101,95,152,591,998,3,3399,188,0,2,3,1,1
1794,3,48,2,2,2,0,0,0,2,0,0,0,0,0,0,0,0,0,0,0,0,2,3,1,1
1795,3,48,8,5,5,0,0,3,8,0,0,0,0,0,0,0,0,0,0,0,0,2,3,1,1
1796,3,48,2,2,2,0,0,0,2,0,0,0,0,0,0,0,0,0,0,0,0,2,3,1,1
1797,3,48,14,8,8,0,0,6,14,0,0,0,0,0,0,0,0,0,0,0,0,2,3,1,1
1798,3,48,6,4,4,0,0,2,6,0,0,0,0,0,0,0,0,0,0,0,0,2,3,1,1
1799,3,48,6,4,4,0,0,2,6,1,2,1,2,3,3,2,4,0,2,0,0,2,3,1,1
1800,3,48,6,4,4,0,0,2,6,0,0,0,0,0,0,0,0,0,0,0,0,2,3,1,1
1801,3,48,7,5,5,0,0,2,7,0,0,0,0,0,0,0,0,0,0,0,0,2,3,1,1
1802,3,48,6,4,4,0,0,2,6,0,0,0,0,0,0,0,0,0,0,0,0,2,3,1,1
1803,3,48,10,6,6,0,0,4,10,0,0,0,0,0,0,0,0,0,0,0,0,2,3,1,1
1804,3,48,1,1,1,0,0,0,1,0,0,0,0,0,0,0,0,0,0,0,0,2,3,1,1
1805,3,48,1,1,1,0,0,0,1,0,0,0,0,0,0,0,0,0,0,0,0,2,3,1,1
1806,3,48,14,10,10,0,0,4,14,1,1,1,1,2,2,0,2,0,1,0,0,2,3,1,1
1807,3,48,46,26,30,3,0,12,49,3,6,3,6,9,9,20,28,1,42,2,0,2,3,1,1
1808,6,113,127,75,83,2,11,30,129,4,14,7,14,18,21,61,87,2,175,9,0,0,25,0,1
1809,6,113,652,304,544,16,6,88,668,6,89,51,101,95,152,591,998,3,3399,188,0,0,25,0,1
1810,6,113,2,2,2,0,0,0,2,0,0,0,0,0,0,0,0,0,0,0,0,0,25,0,1
1811,6,113,8,5,5,0,0,3,8,0,0,0,0,0,0,0,0,0,0,0,0,0,25,0,1
1812,6,113,2,2,2,0,0,0,2,0,0,0,0,0,0,0,0,0,0,0,0,0,25,0,1
1813,6,113,14,8,8,0,0,6,14,0,0,0,0,0,0,0,0,0,0,0,0,0,25,0,1
1814,6,113,6,4,4,0,0,2,6,0,0,0,0,0,0,0,0,0,0,0,0,0,25,0,1
1815,6,113,6,4,4,0,0,2,6,1,2,1,2,3,3,2,4,0,2,0,0,0,25,0,1
1816,6,113,6,4,4,0,0,2,6,0,0,0,0,0,0,0,0,0,0,0,0,0,25,0,1
1817,6,113,7,5,5,0,0,2,7,0,0,0,0,0,0,0,0,0,0,0,0,0,25,0,1
1818,6,113,6,4,4,0,0,2,6,0,0,0,0,0,0,0,0,0,0,0,0,0,25,0,1
1819,6,113,10,6,6,0,0,4,10,0,0,0,0,0,0,0,0,0,0,0,0,0,25,0,1
1820,6,113,1,1,1,0,0,0,1,0,0,0,0,0,0,0,0,0,0,0,0,0,25,0,1
1821,6,113,1,1,1,0,0,0,1,0,0,0,0,0,0,0,0,0,0,0,0,0,25,0,1
1822,6,113,14,10,10,0,0,4,14,1,1,1,1,2,2,0,2,0,1,0,0,0,25,0,1
1823,6,113,46,26,30,3,0,12,49,3,6,3,6,9,9,20,28,1,42,2,0,0,25,0,1
1824,2,32,127,75,83,2,11,30,129,4,14,7,14,18,21,61,87,2,175,9,0,2,1,3,1
1825,2,32,652,304,544,16,6,88,668,6,89,51,101,95,152,591,998,3,3399,188,0,2,1,3,1
1826,2,32,2,2,2,0,0,0,2,0,0,0,0,0,0,0,0,0,0,0,0,2,1,3,1
1827,2,32,8,5,5,0,0,3,8,0,0,0,0,0,0,0,0,0,0,0,0,2,1,3,1
1828,2,32,2,2,2,0,0,0,2,0,0,0,0,0,0,0,0,0,0,0,0,2,1,3,1
1829,2,32,14,8,8,0,0,6,14,0,0,0,0,0,0,0,0,0,0,0,0,2,1,3,1
1830,2,32,6,4,4,0,0,2,6,0,0,0,0,0,0,0,0,0,0,0,0,2,1,3,1
1831,2,32,6,4,4,0,0,2,6,1,2,1,2,3,3,2,4,0,2,0,0,2,1,3,1
1832,2,32,6,4,4,0,0,2,6,0,0,0,0,0,0,0,0,0,0,0,0,2,1,3,1
1833,2,32,7,5,5,0,0,2,7,0,0,0,0,0,0,0,0,0,0,0,0,2,1,3,1
1834,2,32,6,4,4,0,0,2,6,0,0,0,0,0,0,0,0,0,0,0,0,2,1,3,1
1835,2,32,10,6,6,0,0,4,10,0,0,0,0,0,0,0,0,0,0,0,0,2,1,3,1
1836,2,32,1,1,1,0,0,0,1,0,0,0,0,0,0,0,0,0,0,0,0,2,1,3,1
1837,2,32,1,1,1,0,0,0,1,0,0,0,0,0,0,0,0,0,0,0,0,2,1,3,1
1838,2,32,14,10,10,0,0,4,14,1,1,1,1,2,2,0,2,0,1,0,0,2,1,3,1
1839,2,32,46,26,30,3,0,12,49,3,6,3,6,9,9,20,28,1,42,2,0,2,1,3,1
1840,49,1165,1043,504,840,53,9,147,1096,9,180,112,198,189,310,1377,2344,4,11604,644,0,2,19,3,1
1841,49,1165,383,288,292,26,6,62,409,11,65,38,67,76,105,429,656,5,3719,206,0,2,19,3,1
1842,7,469,1043,504,840,53,9,147,1096,9,180,112,198,189,310,1377,2344,4,11604,644,0,2,10,0,1
1843,13,257,127,75,83,2,11,30,129,4,14,7,14,18,21,61,87,2,175,9,0,2,15,17,1
1844,13,257,652,304,544,16,6,88,668,6,89,51,101,95,152,591,998,3,3399,188,0,2,15,17,1
1845,13,257,2,2,2,0,0,0,2,0,0,0,0,0,0,0,0,0,0,0,0,2,15,17,1
1846,13,257,8,5,5,0,0,3,8,0,0,0,0,0,0,0,0,0,0,0,0,2,15,17,1
1847,13,257,2,2,2,0,0,0,2,0,0,0,0,0,0,0,0,0,0,0,0,2,15,17,1
1848,13,257,14,8,8,0,0,6,14,0,0,0,0,0,0,0,0,0,0,0,0,2,15,17,1
1849,13,257,6,4,4,0,0,2,6,0,0,0,0,0,0,0,0,0,0,0,0,2,15,17,1
1850,13,257,6,4,4,0,0,2,6,1,2,1,2,3,3,2,4,0,2,0,0,2,15,17,1
1851,13,257,6,4,4,0,0,2,6,0,0,0,0,0,0,0,0,0,0,0,0,2,15,17,1
1852,13,257,7,5,5,0,0,2,7,0,0,0,0,0,0,0,0,0,0,0,0,2,15,17,1
1853,13,257,6,4,4,0,0,2,6,0,0,0,0,0,0,0,0,0,0,0,0,2,15,17,1
1854,13,257,10,6,6,0,0,4,10,0,0,0,0,0,0,0,0,0,0,0,0,2,15,17,1
1855,13,257,1,1,1,0,0,0,1,0,0,0,0,0,0,0,0,0,0,0,0,2,15,17,1
1856,13,257,1,1,1,0,0,0,1,0,0,0,0,0,0,0,0,0,0,0,0,2,15,17,1
1857,13,257,14,10,10,0,0,4,14,1,1,1,1,2,2,0,2,0,1,0,0,2,15,17,1
1858,13,257,46,26,30,3,0,12,49,3,6,3,6,9,9,20,28,1,42,2,0,2,15,17,1
1859,5,100,127,75,83,2,11,30,129,4,14,7,14,18,21,61,87,2,175,9,0,2,19,5,1
1860,5,100,652,304,544,16,6,88,668,6,89,51,101,95,152,591,998,3,3399,188,0,2,19,5,1
1861,5,100,2,2,2,0,0,0,2,0,0,0,0,0,0,0,0,0,0,0,0,2,19,5,1
1862,5,100,8,5,5,0,0,3,8,0,0,0,0,0,0,0,0,0,0,0,0,2,19,5,1
1863,5,100,2,2,2,0,0,0,2,0,0,0,0,0,0,0,0,0,0,0,0,2,19,5,1
1864,5,100,14,8,8,0,0,6,14,0,0,0,0,0,0,0,0,0,0,0,0,2,19,5,1
1865,5,100,6,4,4,0,0,2,6,0,0,0,0,0,0,0,0,0,0,0,0,2,19,5,1
1866,5,100,6,4,4,0,0,2,6,1,2,1,2,3,3,2,4,0,2,0,0,2,19,5,1
1867,5,100,6,4,4,0,0,2,6,0,0,0,0,0,0,0,0,0,0,0,0,2,19,5,1
1868,5,100,7,5,5,0,0,2,7,0,0,0,0,0,0,0,0,0,0,0,0,2,19,5,1
1869,5,100,6,4,4,0,0,2,6,0,0,0,0,0,0,0,0,0,0,0,0,2,19,5,1
1870,5,100,10,6,6,0,0,4,10,0,0,0,0,0,0,0,0,0,0,0,0,2,19,5,1
1871,5,100,1,1,1,0,0,0,1,0,0,0,0,0,0,0,0,0,0,0,0,2,19,5,1
1872,5,100,1,1,1,0,0,0,1,0,0,0,0,0,0,0,0,0,0,0,0,2,19,5,1
1873,5,100,14,10,10,0,0,4,14,1,1,1,1,2,2,0,2,0,1,0,0,2,19,5,1
1874,5,100,46,26,30,3,0,12,49,3,6,3,6,9,9,20,28,1,42,2,0,2,19,5,1
1875,49,1034,384,251,317,7,8,52,391,11,70,44,84,81,128,467,811,6,5355,297,0,2,29,24,1
1876,30,1650,1289,550,1043,56,32,155,1345,10,167,93,185,177,278,1266,2075,5,11498,638,0,2,4,6,1
1877,25,1340,384,251,317,7,8,52,391,11,70,44,84,81,128,467,811,6,5355,297,0,2,21,50,1
1878,127,2219,1338,495,1086,10,64,173,1348,11,122,82,157,133,239,883,1686,7,11934,663,0,2,6,0,0
1879,124,2168,1338,495,1086,10,64,173,1348,11,122,82,157,133,239,883,1686,7,11934,663,0,2,0,10,1
1880,124,2168,1338,495,1086,10,64,173,1348,11,122,82,157,133,239,883,1686,7,11934,663,0,2,6,10,0
1881,50,1088,384,251,317,7,8,52,391,11,70,44,84,81,128,467,811,6,5355,297,0,2,18,10,1
1882,26,1428,384,251,317,7,8,52,391,11,70,44,84,81,128,467,811,6,5355,297,0,2,15,2,1
1883,7,469,1043,504,840,53,9,147,1096,9,180,112,198,189,310,1377,2344,4,11604,644,0,2,12,12,1
1884,23,1002,373,158,315,8,0,51,381,5,76,44,79,81,123,486,779,2,2026,112,0,2,6,6,1
1885,32,372,757,253,292,73,244,162,830,13,61,38,67,74,105,409,651,7,4654,258,0,2,1,0,0
1886,49,1061,384,251,317,7,8,52,391,11,70,44,84,81,128,467,811,6,5355,297,0,2,1,4,0
1887,22,1316,384,251,317,7,8,52,391,11,70,44,84,81,128,467,811,6,5355,297,0,2,0,20,0
1888,5,108,127,75,83,2,11,30,129,4,14,7,14,18,21,61,87,2,175,9,0,2,1,0,1
1889,5,108,652,304,544,16,6,88,668,6,89,51,101,95,152,591,998,3,3399,188,0,2,1,0,1
1890,5,108,2,2,2,0,0,0,2,0,0,0,0,0,0,0,0,0,0,0,0,2,1,0,1
1891,5,108,8,5,5,0,0,3,8,0,0,0,0,0,0,0,0,0,0,0,0,2,1,0,1
1892,5,108,2,2,2,0,0,0,2,0,0,0,0,0,0,0,0,0,0,0,0,2,1,0,1
1893,5,108,14,8,8,0,0,6,14,0,0,0,0,0,0,0,0,0,0,0,0,2,1,0,1
1894,5,108,6,4,4,0,0,2,6,0,0,0,0,0,0,0,0,0,0,0,0,2,1,0,1
1895,5,108,6,4,4,0,0,2,6,1,2,1,2,3,3,2,4,0,2,0,0,2,1,0,1
1896,5,108,6,4,4,0,0,2,6,0,0,0,0,0,0,0,0,0,0,0,0,2,1,0,1
1897,5,108,7,5,5,0,0,2,7,0,0,0,0,0,0,0,0,0,0,0,0,2,1,0,1
1898,5,108,6,4,4,0,0,2,6,0,0,0,0,0,0,0,0,0,0,0,0,2,1,0,1
1899,5,108,10,6,6,0,0,4,10,0,0,0,0,0,0,0,0,0,0,0,0,2,1,0,1
1900,5,108,1,1,1,0,0,0,1,0,0,0,0,0,0,0,0,0,0,0,0,2,1,0,1
1901,5,108,1,1,1,0,0,0,1,0,0,0,0,0,0,0,0,0,0,0,0,2,1,0,1
1902,5,108,14,10,10,0,0,4,14,1,1,1,1,2,2,0,2,0,1,0,0,2,1,0,1
1903,5,108,46,26,30,3,0,12,49,3,6,3,6,9,9,20,28,1,42,2,0,2,1,0,1
1904,14,695,334,251,279,10,4,40,344,5,127,74,143,132,217,899,1528,2,4303,239,0,2,2,2,1
1905,42,2286,1457,730,1242,11,6,188,1468,10,292,166,329,302,495,2424,4078,5,22973,1276,1,2,2,2,1
1906,22,1316,384,251,317,7,8,52,391,11,70,44,84,81,128,467,811,6,5355,297,0,2,3,3,1
1907,23,1002,373,158,315,8,0,51,381,5,76,44,79,81,123,486,779,2,2026,112,0,2,29,29,1
1908,3,67,127,75,83,2,11,30,129,4,14,7,14,18,21,61,87,2,175,9,0,2,6,12,1
1909,3,67,652,304,544,16,6,88,668,6,89,51,101,95,152,591,998,3,3399,188,0,2,6,12,1
1910,3,67,2,2,2,0,0,0,2,0,0,0,0,0,0,0,0,0,0,0,0,2,6,12,1
1911,3,67,8,5,5,0,0,3,8,0,0,0,0,0,0,0,0,0,0,0,0,2,6,12,1
1912,3,67,2,2,2,0,0,0,2,0,0,0,0,0,0,0,0,0,0,0,0,2,6,12,1
1913,3,67,14,8,8,0,0,6,14,0,0,0,0,0,0,0,0,0,0,0,0,2,6,12,1
1914,3,67,6,4,4,0,0,2,6,0,0,0,0,0,0,0,0,0,0,0,0,2,6,12,1
1915,3,67,6,4,4,0,0,2,6,1,2,1,2,3,3,2,4,0,2,0,0,2,6,12,1
1916,3,67,6,4,4,0,0,2,6,0,0,0,0,0,0,0,0,0,0,0,0,2,6,12,1
1917,3,67,7,5,5,0,0,2,7,0,0,0,0,0,0,0,0,0,0,0,0,2,6,12,1
1918,3,67,6,4,4,0,0,2,6,0,0,0,0,0,0,0,0,0,0,0,0,2,6,12,1
1919,3,67,10,6,6,0,0,4,10,0,0,0,0,0,0,0,0,0,0,0,0,2,6,12,1
1920,3,67,1,1,1,0,0,0,1,0,0,0,0,0,0,0,0,0,0,0,0,2,6,12,1
1921,3,67,1,1,1,0,0,0,1,0,0,0,0,0,0,0,0,0,0,0,0,2,6,12,1
1922,3,67,14,10,10,0,0,4,14,1,1,1,1,2,2,0,2,0,1,0,0,2,6,12,1
1923,3,67,46,26,30,3,0,12,49,3,6,3,6,9,9,20,28,1,42,2,0,2,6,12,1
1924,2,27,127,75,83,2,11,30,129,4,14,7,14,18,21,61,87,2,175,9,0,2,2,3,1
1925,2,27,652,304,544,16,6,88,668,6,89,51,101,95,152,591,998,3,3399,188,0,2,2,3,1
1926,2,27,2,2,2,0,0,0,2,0,0,0,0,0,0,0,0,0,0,0,0,2,2,3,1
1927,2,27,8,5,5,0,0,3,8,0,0,0,0,0,0,0,0,0,0,0,0,2,2,3,1
1928,2,27,2,2,2,0,0,0,2,0,0,0,0,0,0,0,0,0,0,0,0,2,2,3,1
1929,2,27,14,8,8,0,0,6,14,0,0,0,0,0,0,0,0,0,0,0,0,2,2,3,1
1930,2,27,6,4,4,0,0,2,6,0,0,0,0,0,0,0,0,0,0,0,0,2,2,3,1
1931,2,27,6,4,4,0,0,2,6,1,2,1,2,3,3,2,4,0,2,0,0,2,2,3,1
1932,2,27,6,4,4,0,0,2,6,0,0,0,0,0,0,0,0,0,0,0,0,2,2,3,1
1933,2,27,7,5,5,0,0,2,7,0,0,0,0,0,0,0,0,0,0,0,0,2,2,3,1
1934,2,27,6,4,4,0,0,2,6,0,0,0,0,0,0,0,0,0,0,0,0,2,2,3,1
1935,2,27,10,6,6,0,0,4,10,0,0,0,0,0,0,0,0,0,0,0,0,2,2,3,1
1936,2,27,1,1,1,0,0,0,1,0,0,0,0,0,0,0,0,0,0,0,0,2,2,3,1
1937,2,27,1,1,1,0,0,0,1,0,0,0,0,0,0,0,0,0,0,0,0,2,2,3,1
1938,2,27,14,10,10,0,0,4,14,1,1,1,1,2,2,0,2,0,1,0,0,2,2,3,1
1939,2,27,46,26,30,3,0,12,49,3,6,3,6,9,9,20,28,1,42,2,0,2,2,3,1
1940,6,106,127,75,83,2,11,30,129,4,14,7,14,18,21,61,87,2,175,9,0,2,5,6,1
1941,6,106,652,304,544,16,6,88,668,6,89,51,101,95,152,591,998,3,3399,188,0,2,5,6,1
1942,6,106,2,2,2,0,0,0,2,0,0,0,0,0,0,0,0,0,0,0,0,2,5,6,1
1943,6,106,8,5,5,0,0,3,8,0,0,0,0,0,0,0,0,0,0,0,0,2,5,6,1
1944,6,106,2,2,2,0,0,0,2,0,0,0,0,0,0,0,0,0,0,0,0,2,5,6,1
1945,6,106,14,8,8,0,0,6,14,0,0,0,0,0,0,0,0,0,0,0,0,2,5,6,1
1946,6,106,6,4,4,0,0,2,6,0,0,0,0,0,0,0,0,0,0,0,0,2,5,6,1
1947,6,106,6,4,4,0,0,2,6,1,2,1,2,3,3,2,4,0,2,0,0,2,5,6,1
1948,6,106,6,4,4,0,0,2,6,0,0,0,0,0,0,0,0,0,0,0,0,2,5,6,1
1949,6,106,7,5,5,0,0,2,7,0,0,0,0,0,0,0,0,0,0,0,0,2,5,6,1
1950,6,106,6,4,4,0,0,2,6,0,0,0,0,0,0,0,0,0,0,0,0,2,5,6,1
1951,6,106,10,6,6,0,0,4,10,0,0,0,0,0,0,0,0,0,0,0,0,2,5,6,1
1952,6,106,1,1,1,0,0,0,1,0,0,0,0,0,0,0,0,0,0,0,0,2,5,6,1
1953,6,106,1,1,1,0,0,0,1,0,0,0,0,0,0,0,0,0,0,0,0,2,5,6,1
1954,6,106,14,10,10,0,0,4,14,1,1,1,1,2,2,0,2,0,1,0,0,2,5,6,1
1955,6,106,46,26,30,3,0,12,49,3,6,3,6,9,9,20,28,1,42,2,0,2,5,6,1
1956,2,80,13,10,10,0,0,3,13,1,2,1,2,3,3,2,4,0,2,0,0,2,3,3,1
1957,51,1169,1043,504,840,53,9,147,1096,9,180,112,198,189,310,1377,2344,4,11604,644,0,2,17,10,1
1958,51,1169,383,288,292,26,6,62,409,11,65,38,67,76,105,429,656,5,3719,206,0,2,17,10,1
1959,8,544,1043,504,840,53,9,147,1096,9,180,112,198,189,310,1377,2344,4,11604,644,0,2,17,1,1
1960,1,306,42,7,35,4,0,5,46,1,2,1,2,3,3,2,4,0,2,0,0,2,3,4,0
1961,1,306,11,6,10,0,0,1,11,2,4,2,4,6,6,10,15,1,15,0,0,2,3,4,0
1962,51,1158,1043,504,840,53,9,147,1096,9,180,112,198,189,310,1377,2344,4,11604,644,0,2,5,5,0
1963,51,1158,383,288,292,26,6,62,409,11,65,38,67,76,105,429,656,5,3719,206,0,2,5,5,0
1964,32,372,757,253,292,73,244,162,830,13,61,38,67,74,105,409,651,7,4654,258,0,2,2,1,1
1965,48,1080,1043,504,840,53,9,147,1096,9,180,112,198,189,310,1377,2344,4,11604,644,0,2,26,42,1
1966,48,1080,383,288,292,26,6,62,409,11,65,38,67,76,105,429,656,5,3719,206,0,2,26,42,1
1967,26,913,1043,504,840,53,9,147,1096,9,180,112,198,189,310,1377,2344,4,11604,644,0,2,244,73,1
1968,23,1002,373,158,315,8,0,51,381,5,76,44,79,81,123,486,779,2,2026,112,0,2,3,3,1
1969,51,1155,1043,504,840,53,9,147,1096,9,180,112,198,189,310,1377,2344,4,11604,644,0,2,27,21,1
1970,51,1155,383,288,292,26,6,62,409,11,65,38,67,76,105,429,656,5,3719,206,0,2,27,21,1
1971,30,350,757,253,292,73,244,162,830,13,61,38,67,74,105,409,651,7,4654,258,0,2,7,13,1
1972,49,1053,384,251,317,7,8,52,391,11,70,44,84,81,128,467,811,6,5355,297,0,2,2,2,1
1973,49,1106,1043,504,840,53,9,147,1096,9,180,112,198,189,310,1377,2344,4,11604,644,0,2,5,10,1
1974,49,1106,383,288,292,26,6,62,409,11,65,38,67,76,105,429,656,5,3719,206,0,2,5,10,1
1975,38,676,373,158,315,8,0,51,381,5,76,44,79,81,123,486,779,2,2026,112,0,2,1,10,1
1976,28,1589,1289,550,1043,56,32,155,1345,10,167,93,185,177,278,1266,2075,5,11498,638,0,2,0,15,1
1977,24,833,1043,504,840,53,9,147,1096,9,180,112,198,189,310,1377,2344,4,11604,644,0,2,0,20,1
1978,21,888,373,158,315,8,0,51,381,5,76,44,79,81,123,486,779,2,2026,112,0,2,0,16,1
1979,30,354,757,253,292,73,244,162,830,13,61,38,67,74,105,409,651,7,4654,258,0,2,3,5,1
1980,38,683,373,158,315,8,0,51,381,5,76,44,79,81,123,486,779,2,2026,112,0,2,3,2,1
1981,45,1291,2,2,2,0,0,0,2,0,0,0,0,0,0,0,0,0,0,0,0,2,0,19,1
1982,45,1291,99,48,90,1,3,5,100,0,0,0,0,0,0,0,0,0,0,0,0,2,0,19,1
1983,45,1291,8,5,5,2,0,1,10,0,0,0,0,0,0,0,0,0,0,0,0,2,0,19,1
1984,45,1291,1217,716,841,84,126,174,1301,14,185,118,215,199,333,1446,2542,8,20687,1149,0,2,0,19,1
1985,45,1291,160,89,115,0,13,31,160,7,15,11,17,22,28,78,124,3,495,27,0,2,0,19,1
1986,45,1291,10,10,9,9,0,0,19,0,0,0,0,0,0,0,0,0,0,0,0,2,0,19,1
1987,45,1291,173,84,99,8,29,36,181,5,12,7,13,17,20,54,81,2,221,12,0,2,0,19,1
1988,45,1291,3,1,1,3,0,0,6,0,0,0,0,0,0,0,0,0,0,0,0,2,0,19,1
1989,18,449,2,2,2,0,0,0,2,0,0,0,0,0,0,0,0,0,0,0,0,2,1,4,1
1990,18,449,99,48,90,1,3,5,100,0,0,0,0,0,0,0,0,0,0,0,0,2,1,4,1
1991,18,449,8,5,5,2,0,1,10,0,0,0,0,0,0,0,0,0,0,0,0,2,1,4,1
1992,18,449,1217,716,841,84,126,174,1301,14,185,118,215,199,333,1446,2542,8,20687,1149,0,2,1,4,1
1993,18,449,160,89,115,0,13,31,160,7,15,11,17,22,28,78,124,3,495,27,0,2,1,4,1
1994,18,449,10,10,9,9,0,0,19,0,0,0,0,0,0,0,0,0,0,0,0,2,1,4,1
1995,18,449,173,84,99,8,29,36,181,5,12,7,13,17,20,54,81,2,221,12,0,2,1,4,1
1996,18,449,3,1,1,3,0,0,6,0,0,0,0,0,0,0,0,0,0,0,0,2,1,4,1
1997,5,106,127,75,83,2,11,30,129,4,14,7,14,18,21,61,87,2,175,9,0,2,1,1,1
1998,5,106,652,304,544,16,6,88,668,6,89,51,101,95,152,591,998,3,3399,188,0,2,1,1,1
1999,5,106,2,2,2,0,0,0,2,0,0,0,0,0,0,0,0,0,0,0,0,2,1,1,1
2000,5,106,8,5,5,0,0,3,8,0,0,0,0,0,0,0,0,0,0,0,0,2,1,1,1
2001,5,106,2,2,2,0,0,0,2,0,0,0,0,0,0,0,0,0,0,0,0,2,1,1,1
2002,5,106,14,8,8,0,0,6,14,0,0,0,0,0,0,0,0,0,0,0,0,2,1,1,1
2003,5,106,6,4,4,0,0,2,6,0,0,0,0,0,0,0,0,0,0,0,0,2,1,1,1
2004,5,106,6,4,4,0,0,2,6,1,2,1,2,3,3,2,4,0,2,0,0,2,1,1,1
2005,5,106,6,4,4,0,0,2,6,0,0,0,0,0,0,0,0,0,0,0,0,2,1,1,1
2006,5,106,7,5,5,0,0,2,7,0,0,0,0,0,0,0,0,0,0,0,0,2,1,1,1
2007,5,106,6,4,4,0,0,2,6,0,0,0,0,0,0,0,0,0,0,0,0,2,1,1,1
2008,5,106,10,6,6,0,0,4,10,0,0,0,0,0,0,0,0,0,0,0,0,2,1,1,1
2009,5,106,1,1,1,0,0,0,1,0,0,0,0,0,0,0,0,0,0,0,0,2,1,1,1
2010,5,106,1,1,1,0,0,0,1,0,0,0,0,0,0,0,0,0,0,0,0,2,1,1,1
2011,5,106,14,10,10,0,0,4,14,1,1,1,1,2,2,0,2,0,1,0,0,2,1,1,1
2012,5,106,46,26,30,3,0,12,49,3,6,3,6,9,9,20,28,1,42,2,0,2,1,1,1
2013,70,1433,384,251,317,7,8,52,391,11,70,44,84,81,128,467,811,6,5355,297,0,2,70,0,1
2014,29,1470,384,251,317,7,8,52,391,11,70,44,84,81,128,467,811,6,5355,297,0,2,28,2,1
2015,18,449,2,2,2,0,0,0,2,0,0,0,0,0,0,0,0,0,0,0,0,2,3,3,0
2016,18,449,99,48,90,1,3,5,100,0,0,0,0,0,0,0,0,0,0,0,0,2,3,3,0
2017,18,449,8,5,5,2,0,1,10,0,0,0,0,0,0,0,0,0,0,0,0,2,3,3,0
2018,18,449,1217,716,841,84,126,174,1301,14,185,118,215,199,333,1446,2542,8,20687,1149,0,2,3,3,0
2019,18,449,160,89,115,0,13,31,160,7,15,11,17,22,28,78,124,3,495,27,0,2,3,3,0
2020,18,449,10,10,9,9,0,0,19,0,0,0,0,0,0,0,0,0,0,0,0,2,3,3,0
2021,18,449,173,84,99,8,29,36,181,5,12,7,13,17,20,54,81,2,221,12,0,2,3,3,0
2022,18,449,3,1,1,3,0,0,6,0,0,0,0,0,0,0,0,0,0,0,0,2,3,3,0
2023,19,456,2,2,2,0,0,0,2,0,0,0,0,0,0,0,0,0,0,0,0,2,1,0,0
2024,19,456,99,48,90,1,3,5,100,0,0,0,0,0,0,0,0,0,0,0,0,2,1,0,0
2025,19,456,8,5,5,2,0,1,10,0,0,0,0,0,0,0,0,0,0,0,0,2,1,0,0
2026,19,456,1217,716,841,84,126,174,1301,14,185,118,215,199,333,1446,2542,8,20687,1149,0,2,1,0,0
2027,19,456,160,89,115,0,13,31,160,7,15,11,17,22,28,78,124,3,495,27,0,2,1,0,0
2028,19,456,10,10,9,9,0,0,19,0,0,0,0,0,0,0,0,0,0,0,0,2,1,0,0
2029,19,456,173,84,99,8,29,36,181,5,12,7,13,17,20,54,81,2,221,12,0,2,1,0,0
2030,19,456,3,1,1,3,0,0,6,0,0,0,0,0,0,0,0,0,0,0,0,2,1,0,0
2031,16,369,2,2,2,0,0,0,2,0,0,0,0,0,0,0,0,0,0,0,0,2,29,48,0
2032,16,369,99,48,90,1,3,5,100,0,0,0,0,0,0,0,0,0,0,0,0,2,29,48,0
2033,16,369,8,5,5,2,0,1,10,0,0,0,0,0,0,0,0,0,0,0,0,2,29,48,0
2034,16,369,1217,716,841,84,126,174,1301,14,185,118,215,199,333,1446,2542,8,20687,1149,0,2,29,48,0
2035,16,369,160,89,115,0,13,31,160,7,15,11,17,22,28,78,124,3,495,27,0,2,29,48,0
2036,16,369,10,10,9,9,0,0,19,0,0,0,0,0,0,0,0,0,0,0,0,2,29,48,0
2037,16,369,173,84,99,8,29,36,181,5,12,7,13,17,20,54,81,2,221,12,0,2,29,48,0
2038,16,369,3,1,1,3,0,0,6,0,0,0,0,0,0,0,0,0,0,0,0,2,29,48,0
2039,19,404,2,2,2,0,0,0,2,0,0,0,0,0,0,0,0,0,0,0,0,2,12,1,0
2040,19,404,99,48,90,1,3,5,100,0,0,0,0,0,0,0,0,0,0,0,0,2,12,1,0
2041,19,404,8,5,5,2,0,1,10,0,0,0,0,0,0,0,0,0,0,0,0,2,12,1,0
2042,19,404,1217,716,841,84,126,174,1301,14,185,118,215,199,333,1446,2542,8,20687,1149,0,2,12,1,0
2043,19,404,160,89,115,0,13,31,160,7,15,11,17,22,28,78,124,3,495,27,0,2,12,1,0
2044,19,404,10,10,9,9,0,0,19,0,0,0,0,0,0,0,0,0,0,0,0,2,12,1,0
2045,19,404,173,84,99,8,29,36,181,5,12,7,13,17,20,54,81,2,221,12,0,2,12,1,0
2046,19,404,3,1,1,3,0,0,6,0,0,0,0,0,0,0,0,0,0,0,0,2,12,1,0
2047,88,1938,1457,730,1242,11,6,188,1468,10,292,166,329,302,495,2424,4078,5,22973,1276,1,2,0,2,1
2048,88,1938,74,35,59,1,0,14,75,3,14,7,14,17,21,58,85,1,128,7,0,2,0,2,1
2049,88,1938,245,125,200,5,7,34,250,7,30,17,34,37,51,166,265,3,1053,58,0,2,0,2,1
2050,34,391,757,253,292,73,244,162,830,13,61,38,67,74,105,409,651,7,4654,258,0,2,19,6,1
2051,68,1398,384,251,317,7,8,52,391,11,70,44,84,81,128,467,811,6,5355,297,0,2,0,5,1
2052,38,680,373,158,315,8,0,51,381,5,76,44,79,81,123,486,779,2,2026,112,0,2,4,6,1
2053,21,888,373,158,315,8,0,51,381,5,76,44,79,81,123,486,779,2,2026,112,0,2,1,1,1
2054,34,387,757,253,292,73,244,162,830,13,61,38,67,74,105,409,651,7,4654,258,0,2,8,9,1
2055,34,316,647,139,84,35,284,233,682,0,0,0,0,0,0,0,0,0,0,0,0,0,153,0,1
2056,68,1394,384,251,317,7,8,52,391,11,70,44,84,81,128,467,811,6,5355,297,0,2,3,3,1
2057,66,1372,384,251,317,7,8,52,391,11,70,44,84,81,128,467,811,6,5355,297,0,2,2,6,0
2058,28,1427,384,251,317,7,8,52,391,11,70,44,84,81,128,467,811,6,5355,297,0,2,0,9,0
2059,123,2153,1338,495,1086,10,64,173,1348,11,122,82,157,133,239,883,1686,7,11934,663,0,2,4,8,1
2060,88,1939,1457,730,1242,11,6,188,1468,10,292,166,329,302,495,2424,4078,5,22973,1276,1,2,2,1,1
2061,88,1939,74,35,59,1,0,14,75,3,14,7,14,17,21,58,85,1,128,7,0,2,2,1,1
2062,88,1939,245,125,200,5,7,34,250,7,30,17,34,37,51,166,265,3,1053,58,0,2,2,1,1
2063,5,107,127,75,83,2,11,30,129,4,14,7,14,18,21,61,87,2,175,9,0,2,1,1,1
2064,5,107,652,304,544,16,6,88,668,6,89,51,101,95,152,591,998,3,3399,188,0,2,1,1,1
2065,5,107,2,2,2,0,0,0,2,0,0,0,0,0,0,0,0,0,0,0,0,2,1,1,1
2066,5,107,8,5,5,0,0,3,8,0,0,0,0,0,0,0,0,0,0,0,0,2,1,1,1
2067,5,107,2,2,2,0,0,0,2,0,0,0,0,0,0,0,0,0,0,0,0,2,1,1,1
2068,5,107,14,8,8,0,0,6,14,0,0,0,0,0,0,0,0,0,0,0,0,2,1,1,1
2069,5,107,6,4,4,0,0,2,6,0,0,0,0,0,0,0,0,0,0,0,0,2,1,1,1
2070,5,107,6,4,4,0,0,2,6,1,2,1,2,3,3,2,4,0,2,0,0,2,1,1,1
2071,5,107,6,4,4,0,0,2,6,0,0,0,0,0,0,0,0,0,0,0,0,2,1,1,1
2072,5,107,7,5,5,0,0,2,7,0,0,0,0,0,0,0,0,0,0,0,0,2,1,1,1
2073,5,107,6,4,4,0,0,2,6,0,0,0,0,0,0,0,0,0,0,0,0,2,1,1,1
2074,5,107,10,6,6,0,0,4,10,0,0,0,0,0,0,0,0,0,0,0,0,2,1,1,1
2075,5,107,1,1,1,0,0,0,1,0,0,0,0,0,0,0,0,0,0,0,0,2,1,1,1
2076,5,107,1,1,1,0,0,0,1,0,0,0,0,0,0,0,0,0,0,0,0,2,1,1,1
2077,5,107,14,10,10,0,0,4,14,1,1,1,1,2,2,0,2,0,1,0,0,2,1,1,1
2078,5,107,46,26,30,3,0,12,49,3,6,3,6,9,9,20,28,1,42,2,0,2,1,1,1
2079,18,389,2,2,2,0,0,0,2,0,0,0,0,0,0,0,0,0,0,0,0,2,2,3,1
2080,18,389,99,48,90,1,3,5,100,0,0,0,0,0,0,0,0,0,0,0,0,2,2,3,1
2081,18,389,8,5,5,2,0,1,10,0,0,0,0,0,0,0,0,0,0,0,0,2,2,3,1
2082,18,389,1217,716,841,84,126,174,1301,14,185,118,215,199,333,1446,2542,8,20687,1149,0,2,2,3,1
2083,18,389,160,89,115,0,13,31,160,7,15,11,17,22,28,78,124,3,495,27,0,2,2,3,1
2084,18,389,10,10,9,9,0,0,19,0,0,0,0,0,0,0,0,0,0,0,0,2,2,3,1
2085,18,389,173,84,99,8,29,36,181,5,12,7,13,17,20,54,81,2,221,12,0,2,2,3,1
2086,18,389,3,1,1,3,0,0,6,0,0,0,0,0,0,0,0,0,0,0,0,2,2,3,1
2087,123,2143,1338,495,1086,10,64,173,1348,11,122,82,157,133,239,883,1686,7,11934,663,0,2,3,3,1
2088,34,312,647,139,84,35,284,233,682,0,0,0,0,0,0,0,0,0,0,0,0,2,23,18,1
2089,124,2163,1338,495,1086,10,64,173,1348,11,122,82,157,133,239,883,1686,7,11934,663,0,2,10,5,1
2090,33,298,647,139,84,35,284,233,682,0,0,0,0,0,0,0,0,0,0,0,0,2,6,14,1
2091,1,319,42,7,35,4,0,5,46,1,2,1,2,3,3,2,4,0,2,0,0,2,18,16,1
2092,1,319,11,6,10,0,0,1,11,2,4,2,4,6,6,10,15,1,15,0,0,2,18,16,1
2093,34,305,647,139,84,35,284,233,682,0,0,0,0,0,0,0,0,0,0,0,0,2,4,0,1
2094,71,1431,384,251,317,7,8,52,391,11,70,44,84,81,128,467,811,6,5355,297,0,2,12,0,1
2095,42,2275,1457,730,1242,11,6,188,1468,10,292,166,329,302,495,2424,4078,5,22973,1276,1,2,2,1,1
2096,29,1463,384,251,317,7,8,52,391,11,70,44,84,81,128,467,811,6,5355,297,0,2,17,1,1
2097,72,1433,384,251,317,7,8,52,391,11,70,44,84,81,128,467,811,6,5355,297,0,2,2,1,0
2098,1,319,42,7,35,4,0,5,46,1,2,1,2,3,3,2,4,0,2,0,0,2,1,1,0
2099,1,319,11,6,10,0,0,1,11,2,4,2,4,6,6,10,15,1,15,0,0,2,1,1,0
2100,1,319,42,7,35,4,0,5,46,1,2,1,2,3,3,2,4,0,2,0,0,2,11,5,1
2101,1,319,11,6,10,0,0,1,11,2,4,2,4,6,6,10,15,1,15,0,0,2,11,5,1
2102,1,136,42,7,35,4,0,5,46,1,2,1,2,3,3,2,4,0,2,0,0,2,7,97,0
2103,1,136,11,6,10,0,0,1,11,2,4,2,4,6,6,10,15,1,15,0,0,2,7,97,0
2104,124,2163,1338,495,1086,10,64,173,1348,11,122,82,157,133,239,883,1686,7,11934,663,0,2,1,1,0
2105,1,220,42,7,35,4,0,5,46,1,2,1,2,3,3,2,4,0,2,0,0,2,51,9,1
2106,1,220,11,6,10,0,0,1,11,2,4,2,4,6,6,10,15,1,15,0,0,2,51,9,1
2107,1,311,42,7,35,4,0,5,46,1,2,1,2,3,3,2,4,0,2,0,0,2,49,8,1
2108,1,311,11,6,10,0,0,1,11,2,4,2,4,6,6,10,15,1,15,0,0,2,49,8,1
2109,1,311,42,7,35,4,0,5,46,1,2,1,2,3,3,2,4,0,2,0,0,2,3,4,0
2110,1,311,11,6,10,0,0,1,11,2,4,2,4,6,6,10,15,1,15,0,0,2,3,4,0
2111,1,311,42,7,35,4,0,5,46,1,2,1,2,3,3,2,4,0,2,0,0,2,1,1,0
2112,1,311,11,6,10,0,0,1,11,2,4,2,4,6,6,10,15,1,15,0,0,2,1,1,0
2113,124,2163,1338,495,1086,10,64,173,1348,11,122,82,157,133,239,883,1686,7,11934,663,0,2,1,1,1
2114,1,311,42,7,35,4,0,5,46,1,2,1,2,3,3,2,4,0,2,0,0,2,6,14,1
2115,1,311,11,6,10,0,0,1,11,2,4,2,4,6,6,10,15,1,15,0,0,2,6,14,1
2116,1,313,42,7,35,4,0,5,46,1,2,1,2,3,3,2,4,0,2,0,0,2,4,4,1
2117,1,313,11,6,10,0,0,1,11,2,4,2,4,6,6,10,15,1,15,0,0,2,4,4,1
2118,1,311,42,7,35,4,0,5,46,1,2,1,2,3,3,2,4,0,2,0,0,2,1,1,0
2119,1,311,11,6,10,0,0,1,11,2,4,2,4,6,6,10,15,1,15,0,0,2,1,1,0
2120,1,313,42,7,35,4,0,5,46,1,2,1,2,3,3,2,4,0,2,0,0,2,2,5,1
2121,1,313,11,6,10,0,0,1,11,2,4,2,4,6,6,10,15,1,15,0,0,2,2,5,1
2122,29,1465,384,251,317,7,8,52,391,11,70,44,84,81,128,467,811,6,5355,297,0,2,1,1,1
2123,34,305,647,139,84,35,284,233,682,0,0,0,0,0,0,0,0,0,0,0,0,2,1,1,0
2124,34,305,647,139,84,35,284,233,682,0,0,0,0,0,0,0,0,0,0,0,0,2,1,1,0
2125,29,1465,384,251,317,7,8,52,391,11,70,44,84,81,128,467,811,6,5355,297,0,2,1,1,0
2126,1,306,42,7,35,4,0,5,46,1,2,1,2,3,3,2,4,0,2,0,0,2,1,3,1
2127,1,306,11,6,10,0,0,1,11,2,4,2,4,6,6,10,15,1,15,0,0,2,1,3,1
2128,1,306,42,7,35,4,0,5,46,1,2,1,2,3,3,2,4,0,2,0,0,2,2,6,0
2129,1,306,11,6,10,0,0,1,11,2,4,2,4,6,6,10,15,1,15,0,0,2,2,6,0
2130,28,1379,384,251,317,7,8,52,391,11,70,44,84,81,128,467,811,6,5355,297,0,2,0,24,1
2131,1,306,42,7,35,4,0,5,46,1,2,1,2,3,3,2,4,0,2,0,0,2,4,4,1
2132,1,306,11,6,10,0,0,1,11,2,4,2,4,6,6,10,15,1,15,0,0,2,4,4,1
2133,2,80,13,10,10,0,0,3,13,1,2,1,2,3,3,2,4,0,2,0,0,3,1,1,1
2134,75,1676,384,251,317,7,8,52,391,11,70,44,84,81,128,467,811,6,5355,297,0,2,48,4,1
2135,29,1440,384,251,317,7,8,52,391,11,70,44,84,81,128,467,811,6,5355,297,0,2,16,1,1
2136,2,80,13,10,10,0,0,3,13,1,2,1,2,3,3,2,4,0,2,0,0,3,1,1,0
2137,75,1676,384,251,317,7,8,52,391,11,70,44,84,81,128,467,811,6,5355,297,0,2,48,4,0
2138,29,1440,384,251,317,7,8,52,391,11,70,44,84,81,128,467,811,6,5355,297,0,2,16,25,0
2139,1,306,42,7,35,4,0,5,46,1,2,1,2,3,3,2,4,0,2,0,0,2,2,3,0
2140,1,306,11,6,10,0,0,1,11,2,4,2,4,6,6,10,15,1,15,0,0,2,2,3,0
2141,34,305,647,139,84,35,284,233,682,0,0,0,0,0,0,0,0,0,0,0,0,2,55,53,1
2142,2,311,42,7,35,4,0,5,46,1,2,1,2,3,3,2,4,0,2,0,0,2,2,1,0
2143,2,311,11,6,10,0,0,1,11,2,4,2,4,6,6,10,15,1,15,0,0,2,2,1,0
2144,34,305,647,139,84,35,284,233,682,0,0,0,0,0,0,0,0,0,0,0,0,2,55,53,0
2145,2,311,42,7,35,4,0,5,46,1,2,1,2,3,3,2,4,0,2,0,0,2,2,1,0
2146,2,311,11,6,10,0,0,1,11,2,4,2,4,6,6,10,15,1,15,0,0,2,2,1,0
2147,34,304,647,139,84,35,284,233,682,0,0,0,0,0,0,0,0,0,0,0,0,2,3,3,1
2148,75,1673,384,251,317,7,8,52,391,11,70,44,84,81,128,467,811,6,5355,297,0,2,2,2,1
2149,29,1440,384,251,317,7,8,52,391,11,70,44,84,81,128,467,811,6,5355,297,0,2,1,1,1
2150,35,307,647,139,84,35,284,233,682,0,0,0,0,0,0,0,0,0,0,0,0,2,6,3,1
2151,36,671,373,158,315,8,0,51,381,5,76,44,79,81,123,486,779,2,2026,112,0,2,5,5,1
2152,35,307,647,139,84,35,284,233,682,0,0,0,0,0,0,0,0,0,0,0,0,2,1,2,1
2153,35,307,647,139,84,35,284,233,682,0,0,0,0,0,0,0,0,0,0,0,0,2,10,8,0
2154,75,1673,384,251,317,7,8,52,391,11,70,44,84,81,128,467,811,6,5355,297,0,2,2,2,0
2155,36,671,373,158,315,8,0,51,381,5,76,44,79,81,123,486,779,2,2026,112,0,2,5,5,0
2156,29,1440,384,251,317,7,8,52,391,11,70,44,84,81,128,467,811,6,5355,297,0,2,1,1,0
2157,36,671,373,158,315,8,0,51,381,5,76,44,79,81,123,486,779,2,2026,112,0,2,1,1,1
2158,36,671,373,158,315,8,0,51,381,5,76,44,79,81,123,486,779,2,2026,112,0,2,1,1,0
2159,2,311,42,7,35,4,0,5,46,1,2,1,2,3,3,2,4,0,2,0,0,2,1,1,0
2160,2,311,11,6,10,0,0,1,11,2,4,2,4,6,6,10,15,1,15,0,0,2,1,1,0
2161,122,2141,1338,495,1086,10,64,173,1348,11,122,82,157,133,239,883,1686,7,11934,663,0,2,6,8,1
2162,77,1723,1457,730,1242,11,6,188,1468,10,292,166,329,302,495,2424,4078,5,22973,1276,1,2,0,37,1
2163,77,1723,74,35,59,1,0,14,75,3,14,7,14,17,21,58,85,1,128,7,0,2,0,37,1
2164,77,1723,245,125,200,5,7,34,250,7,30,17,34,37,51,166,265,3,1053,58,0,2,0,37,1
2165,27,1540,1289,550,1043,56,32,155,1345,10,167,93,185,177,278,1266,2075,5,11498,638,0,2,0,22,1
2166,34,1908,1457,730,1242,11,6,188,1468,10,292,166,329,302,495,2424,4078,5,22973,1276,1,2,0,55,1
2167,124,2153,1338,495,1086,10,64,173,1348,11,122,82,157,133,239,883,1686,7,11934,663,0,2,5,1,0
2168,17,320,127,75,83,2,11,30,129,4,14,7,14,18,21,61,87,2,175,9,0,2,10,0,1
2169,17,320,652,304,544,16,6,88,668,6,89,51,101,95,152,591,998,3,3399,188,0,2,10,0,1
2170,17,320,2,2,2,0,0,0,2,0,0,0,0,0,0,0,0,0,0,0,0,2,10,0,1
2171,17,320,8,5,5,0,0,3,8,0,0,0,0,0,0,0,0,0,0,0,0,2,10,0,1
2172,17,320,2,2,2,0,0,0,2,0,0,0,0,0,0,0,0,0,0,0,0,2,10,0,1
2173,17,320,14,8,8,0,0,6,14,0,0,0,0,0,0,0,0,0,0,0,0,2,10,0,1
2174,17,320,6,4,4,0,0,2,6,0,0,0,0,0,0,0,0,0,0,0,0,2,10,0,1
2175,17,320,6,4,4,0,0,2,6,1,2,1,2,3,3,2,4,0,2,0,0,2,10,0,1
2176,17,320,6,4,4,0,0,2,6,0,0,0,0,0,0,0,0,0,0,0,0,2,10,0,1
2177,17,320,7,5,5,0,0,2,7,0,0,0,0,0,0,0,0,0,0,0,0,2,10,0,1
2178,17,320,6,4,4,0,0,2,6,0,0,0,0,0,0,0,0,0,0,0,0,2,10,0,1
2179,17,320,10,6,6,0,0,4,10,0,0,0,0,0,0,0,0,0,0,0,0,2,10,0,1
2180,17,320,1,1,1,0,0,0,1,0,0,0,0,0,0,0,0,0,0,0,0,2,10,0,1
2181,17,320,1,1,1,0,0,0,1,0,0,0,0,0,0,0,0,0,0,0,0,2,10,0,1
2182,17,320,14,10,10,0,0,4,14,1,1,1,1,2,2,0,2,0,1,0,0,2,10,0,1
2183,17,320,46,26,30,3,0,12,49,3,6,3,6,9,9,20,28,1,42,2,0,2,10,0,1
2184,14,692,334,251,279,10,4,40,344,5,127,74,143,132,217,899,1528,2,4303,239,0,2,1,3,1
2185,37,326,647,139,84,35,284,233,682,0,0,0,0,0,0,0,0,0,0,0,0,2,8,0,1
2186,17,320,127,75,83,2,11,30,129,4,14,7,14,18,21,61,87,2,175,9,0,2,10,0,0
2187,17,320,652,304,544,16,6,88,668,6,89,51,101,95,152,591,998,3,3399,188,0,2,10,0,0
2188,17,320,2,2,2,0,0,0,2,0,0,0,0,0,0,0,0,0,0,0,0,2,10,0,0
2189,17,320,8,5,5,0,0,3,8,0,0,0,0,0,0,0,0,0,0,0,0,2,10,0,0
2190,17,320,2,2,2,0,0,0,2,0,0,0,0,0,0,0,0,0,0,0,0,2,10,0,0
2191,17,320,14,8,8,0,0,6,14,0,0,0,0,0,0,0,0,0,0,0,0,2,10,0,0
2192,17,320,6,4,4,0,0,2,6,0,0,0,0,0,0,0,0,0,0,0,0,2,10,0,0
2193,17,320,6,4,4,0,0,2,6,1,2,1,2,3,3,2,4,0,2,0,0,2,10,0,0
2194,17,320,6,4,4,0,0,2,6,0,0,0,0,0,0,0,0,0,0,0,0,2,10,0,0
2195,17,320,7,5,5,0,0,2,7,0,0,0,0,0,0,0,0,0,0,0,0,2,10,0,0
2196,17,320,6,4,4,0,0,2,6,0,0,0,0,0,0,0,0,0,0,0,0,2,10,0,0
2197,17,320,10,6,6,0,0,4,10,0,0,0,0,0,0,0,0,0,0,0,0,2,10,0,0
2198,17,320,1,1,1,0,0,0,1,0,0,0,0,0,0,0,0,0,0,0,0,2,10,0,0
2199,17,320,1,1,1,0,0,0,1,0,0,0,0,0,0,0,0,0,0,0,0,2,10,0,0
2200,17,320,14,10,10,0,0,4,14,1,1,1,1,2,2,0,2,0,1,0,0,2,10,0,0
2201,17,320,46,26,30,3,0,12,49,3,6,3,6,9,9,20,28,1,42,2,0,2,10,0,0
2202,124,2153,1338,495,1086,10,64,173,1348,11,122,82,157,133,239,883,1686,7,11934,663,0,2,11,9,0
2203,77,1723,1457,730,1242,11,6,188,1468,10,292,166,329,302,495,2424,4078,5,22973,1276,1,2,0,37,0
2204,77,1723,74,35,59,1,0,14,75,3,14,7,14,17,21,58,85,1,128,7,0,2,0,37,0
2205,77,1723,245,125,200,5,7,34,250,7,30,17,34,37,51,166,265,3,1053,58,0,2,0,37,0
2206,37,326,647,139,84,35,284,233,682,0,0,0,0,0,0,0,0,0,0,0,0,2,8,0,0
2207,27,1540,1289,550,1043,56,32,155,1345,10,167,93,185,177,278,1266,2075,5,11498,638,0,2,0,22,0
2208,34,1908,1457,730,1242,11,6,188,1468,10,292,166,329,302,495,2424,4078,5,22973,1276,1,2,0,55,0
2209,14,692,334,251,279,10,4,40,344,5,127,74,143,132,217,899,1528,2,4303,239,0,2,1,3,0
2210,2,311,42,7,35,4,0,5,46,1,2,1,2,3,3,2,4,0,2,0,0,2,1,1,0
2211,2,311,11,6,10,0,0,1,11,2,4,2,4,6,6,10,15,1,15,0,0,2,1,1,0
2212,25,1394,1289,550,1043,56,32,155,1345,10,167,93,185,177,278,1266,2075,5,11498,638,0,0,422,0,1
2213,16,927,1289,550,1043,56,32,155,1345,10,167,93,185,177,278,1266,2075,5,11498,638,0,2,0,203,1
2214,90,1970,1392,870,1177,35,17,170,1427,14,494,280,531,508,811,4473,7289,7,54850,3047,2,2,17,6,1
2215,100,3732,1392,870,1177,35,17,170,1427,14,494,280,531,508,811,4473,7289,7,54850,3047,2,2,21,0,1
2216,2,311,42,7,35,4,0,5,46,1,2,1,2,3,3,2,4,0,2,0,0,2,1,1,1
2217,2,311,11,6,10,0,0,1,11,2,4,2,4,6,6,10,15,1,15,0,0,2,1,1,1
2218,101,3760,1392,870,1177,35,17,170,1427,14,494,280,531,508,811,4473,7289,7,54850,3047,2,2,3,1,0
2219,9,518,1289,550,1043,56,32,155,1345,10,167,93,185,177,278,1266,2075,5,11498,638,0,2,0,274,1
2220,37,326,647,139,84,35,284,233,682,0,0,0,0,0,0,0,0,0,0,0,0,2,2,2,1
2221,36,671,373,158,315,8,0,51,381,5,76,44,79,81,123,486,779,2,2026,112,0,2,3,3,1
2222,5,261,1289,550,1043,56,32,155,1345,10,167,93,185,177,278,1266,2075,5,11498,638,0,2,0,184,1
2223,2,311,42,7,35,4,0,5,46,1,2,1,2,3,3,2,4,0,2,0,0,2,1,1,1
2224,2,311,11,6,10,0,0,1,11,2,4,2,4,6,6,10,15,1,15,0,0,2,1,1,1
2225,2,311,42,7,35,4,0,5,46,1,2,1,2,3,3,2,4,0,2,0,0,2,1,1,0
2226,2,311,11,6,10,0,0,1,11,2,4,2,4,6,6,10,15,1,15,0,0,2,1,1,0
2227,90,1970,1392,870,1177,35,17,170,1427,14,494,280,531,508,811,4473,7289,7,54850,3047,2,2,17,6,0
2228,101,3760,1392,870,1177,35,17,170,1427,14,494,280,531,508,811,4473,7289,7,54850,3047,2,2,23,0,0
2229,9,518,1289,550,1043,56,32,155,1345,10,167,93,185,177,278,1266,2075,5,11498,638,0,0,148,0,0
2230,37,326,647,139,84,35,284,233,682,0,0,0,0,0,0,0,0,0,0,0,0,2,2,2,0
2231,36,671,373,158,315,8,0,51,381,5,76,44,79,81,123,486,779,2,2026,112,0,2,3,3,0
2232,5,261,1289,550,1043,56,32,155,1345,10,167,93,185,177,278,1266,2075,5,11498,638,0,2,0,387,0
2233,2,311,42,7,35,4,0,5,46,1,2,1,2,3,3,2,4,0,2,0,0,2,2,2,0
2234,2,311,11,6,10,0,0,1,11,2,4,2,4,6,6,10,15,1,15,0,0,2,2,2,0
2235,127,2226,1338,495,1086,10,64,173,1348,11,122,82,157,133,239,883,1686,7,11934,663,0,2,10,0,1
2236,2,311,42,7,35,4,0,5,46,1,2,1,2,3,3,2,4,0,2,0,0,2,1,1,1
2237,2,311,11,6,10,0,0,1,11,2,4,2,4,6,6,10,15,1,15,0,0,2,1,1,1
2238,37,326,647,139,84,35,284,233,682,0,0,0,0,0,0,0,0,0,0,0,0,2,3,3,1
2239,127,2230,1338,495,1086,10,64,173,1348,11,122,82,157,133,239,883,1686,7,11934,663,0,2,2,5,1
2240,6,319,1289,550,1043,56,32,155,1345,10,167,93,185,177,278,1266,2075,5,11498,638,0,2,9,0,1
2241,127,2230,1338,495,1086,10,64,173,1348,11,122,82,157,133,239,883,1686,7,11934,663,0,2,12,5,0
2242,37,326,647,139,84,35,284,233,682,0,0,0,0,0,0,0,0,0,0,0,0,2,3,3,0
2243,6,319,1289,550,1043,56,32,155,1345,10,167,93,185,177,278,1266,2075,5,11498,638,0,2,9,0,0
2244,2,311,42,7,35,4,0,5,46,1,2,1,2,3,3,2,4,0,2,0,0,2,1,1,0
2245,2,311,11,6,10,0,0,1,11,2,4,2,4,6,6,10,15,1,15,0,0,2,1,1,0
2246,89,1961,1392,870,1177,35,17,170,1427,14,494,280,531,508,811,4473,7289,7,54850,3047,2,2,1,2,1
2247,101,3788,1392,870,1177,35,17,170,1427,14,494,280,531,508,811,4473,7289,7,54850,3047,2,2,5,1,1
2248,54,1827,773,419,590,28,0,166,801,10,204,113,217,214,330,1598,2554,5,13587,754,0,2,2,2,1
2249,75,1669,384,251,317,7,8,52,391,11,70,44,84,81,128,467,811,6,5355,297,0,2,0,3,1
2250,30,1475,384,251,317,7,8,52,391,11,70,44,84,81,128,467,811,6,5355,297,0,2,10,1,1
2251,75,1674,384,251,317,7,8,52,391,11,70,44,84,81,128,467,811,6,5355,297,0,2,12,9,1
2252,29,1457,384,251,317,7,8,52,391,11,70,44,84,81,128,467,811,6,5355,297,0,2,0,4,1
2253,131,2252,1338,495,1086,10,64,173,1348,11,122,82,157,133,239,883,1686,7,11934,663,0,2,6,1,1
2254,5,107,127,75,83,2,11,30,129,4,14,7,14,18,21,61,87,2,175,9,0,2,8,3,1
2255,5,107,652,304,544,16,6,88,668,6,89,51,101,95,152,591,998,3,3399,188,0,2,8,3,1
2256,5,107,2,2,2,0,0,0,2,0,0,0,0,0,0,0,0,0,0,0,0,2,8,3,1
2257,5,107,8,5,5,0,0,3,8,0,0,0,0,0,0,0,0,0,0,0,0,2,8,3,1
2258,5,107,2,2,2,0,0,0,2,0,0,0,0,0,0,0,0,0,0,0,0,2,8,3,1
2259,5,107,14,8,8,0,0,6,14,0,0,0,0,0,0,0,0,0,0,0,0,2,8,3,1
2260,5,107,6,4,4,0,0,2,6,0,0,0,0,0,0,0,0,0,0,0,0,2,8,3,1
2261,5,107,6,4,4,0,0,2,6,1,2,1,2,3,3,2,4,0,2,0,0,2,8,3,1
2262,5,107,6,4,4,0,0,2,6,0,0,0,0,0,0,0,0,0,0,0,0,2,8,3,1
2263,5,107,7,5,5,0,0,2,7,0,0,0,0,0,0,0,0,0,0,0,0,2,8,3,1
2264,5,107,6,4,4,0,0,2,6,0,0,0,0,0,0,0,0,0,0,0,0,2,8,3,1
2265,5,107,10,6,6,0,0,4,10,0,0,0,0,0,0,0,0,0,0,0,0,2,8,3,1
2266,5,107,1,1,1,0,0,0,1,0,0,0,0,0,0,0,0,0,0,0,0,2,8,3,1
2267,5,107,1,1,1,0,0,0,1,0,0,0,0,0,0,0,0,0,0,0,0,2,8,3,1
2268,5,107,14,10,10,0,0,4,14,1,1,1,1,2,2,0,2,0,1,0,0,2,8,3,1
2269,5,107,46,26,30,3,0,12,49,3,6,3,6,9,9,20,28,1,42,2,0,2,8,3,1
2270,75,1669,384,251,317,7,8,52,391,11,70,44,84,81,128,467,811,6,5355,297,0,2,8,7,1
2271,29,1457,384,251,317,7,8,52,391,11,70,44,84,81,128,467,811,6,5355,297,0,2,2,2,1
2272,7,384,1289,550,1043,56,32,155,1345,10,167,93,185,177,278,1266,2075,5,11498,638,0,2,8,0,1
2273,89,1961,1392,870,1177,35,17,170,1427,14,494,280,531,508,811,4473,7289,7,54850,3047,2,2,1,2,0
2274,101,3788,1392,870,1177,35,17,170,1427,14,494,280,531,508,811,4473,7289,7,54850,3047,2,2,5,1,0
2275,54,1827,773,419,590,28,0,166,801,10,204,113,217,214,330,1598,2554,5,13587,754,0,2,2,2,0
2276,131,2252,1338,495,1086,10,64,173,1348,11,122,82,157,133,239,883,1686,7,11934,663,0,2,6,1,0
2277,5,107,127,75,83,2,11,30,129,4,14,7,14,18,21,61,87,2,175,9,0,2,8,3,0
2278,5,107,652,304,544,16,6,88,668,6,89,51,101,95,152,591,998,3,3399,188,0,2,8,3,0
2279,5,107,2,2,2,0,0,0,2,0,0,0,0,0,0,0,0,0,0,0,0,2,8,3,0
2280,5,107,8,5,5,0,0,3,8,0,0,0,0,0,0,0,0,0,0,0,0,2,8,3,0
2281,5,107,2,2,2,0,0,0,2,0,0,0,0,0,0,0,0,0,0,0,0,2,8,3,0
2282,5,107,14,8,8,0,0,6,14,0,0,0,0,0,0,0,0,0,0,0,0,2,8,3,0
2283,5,107,6,4,4,0,0,2,6,0,0,0,0,0,0,0,0,0,0,0,0,2,8,3,0
2284,5,107,6,4,4,0,0,2,6,1,2,1,2,3,3,2,4,0,2,0,0,2,8,3,0
2285,5,107,6,4,4,0,0,2,6,0,0,0,0,0,0,0,0,0,0,0,0,2,8,3,0
2286,5,107,7,5,5,0,0,2,7,0,0,0,0,0,0,0,0,0,0,0,0,2,8,3,0
2287,5,107,6,4,4,0,0,2,6,0,0,0,0,0,0,0,0,0,0,0,0,2,8,3,0
2288,5,107,10,6,6,0,0,4,10,0,0,0,0,0,0,0,0,0,0,0,0,2,8,3,0
2289,5,107,1,1,1,0,0,0,1,0,0,0,0,0,0,0,0,0,0,0,0,2,8,3,0
2290,5,107,1,1,1,0,0,0,1,0,0,0,0,0,0,0,0,0,0,0,0,2,8,3,0
2291,5,107,14,10,10,0,0,4,14,1,1,1,1,2,2,0,2,0,1,0,0,2,8,3,0
2292,5,107,46,26,30,3,0,12,49,3,6,3,6,9,9,20,28,1,42,2,0,2,8,3,0
2293,75,1669,384,251,317,7,8,52,391,11,70,44,84,81,128,467,811,6,5355,297,0,2,20,19,0
2294,7,384,1289,550,1043,56,32,155,1345,10,167,93,185,177,278,1266,2075,5,11498,638,0,2,8,0,0
2295,29,1457,384,251,317,7,8,52,391,11,70,44,84,81,128,467,811,6,5355,297,0,2,12,7,0
2296,7,379,1289,550,1043,56,32,155,1345,10,167,93,185,177,278,1266,2075,5,11498,638,0,2,1,3,0
2297,2,311,42,7,35,4,0,5,46,1,2,1,2,3,3,2,4,0,2,0,0,2,1,1,0
2298,2,311,11,6,10,0,0,1,11,2,4,2,4,6,6,10,15,1,15,0,0,2,1,1,0
2299,36,504,282,196,195,3,0,86,285,8,130,71,141,138,212,936,1507,4,6538,363,0,2,7,5,1
2300,2,311,42,7,35,4,0,5,46,1,2,1,2,3,3,2,4,0,2,0,0,2,1,1,1
2301,2,311,11,6,10,0,0,1,11,2,4,2,4,6,6,10,15,1,15,0,0,2,1,1,1
2302,2,80,13,10,10,0,0,3,13,1,2,1,2,3,3,2,4,0,2,0,0,2,1,1,1
2303,77,1723,1457,730,1242,11,6,188,1468,10,292,166,329,302,495,2424,4078,5,22973,1276,1,2,1,1,1
2304,77,1723,74,35,59,1,0,14,75,3,14,7,14,17,21,58,85,1,128,7,0,2,1,1,1
2305,77,1723,245,125,200,5,7,34,250,7,30,17,34,37,51,166,265,3,1053,58,0,2,1,1,1
2306,9,518,1289,550,1043,56,32,155,1345,10,167,93,185,177,278,1266,2075,5,11498,638,0,2,1,1,1
2307,74,1661,384,251,317,7,8,52,391,11,70,44,84,81,128,467,811,6,5355,297,0,2,1,2,1
2308,6,314,1289,550,1043,56,32,155,1345,10,167,93,185,177,278,1266,2075,5,11498,638,0,2,0,8,1
2309,34,1908,1457,730,1242,11,6,188,1468,10,292,166,329,302,495,2424,4078,5,22973,1276,1,2,1,1,1
2310,2,307,42,7,35,4,0,5,46,1,2,1,2,3,3,2,4,0,2,0,0,2,0,2,1
2311,2,307,11,6,10,0,0,1,11,2,4,2,4,6,6,10,15,1,15,0,0,2,0,2,1
2312,36,504,282,196,195,3,0,86,285,8,130,71,141,138,212,936,1507,4,6538,363,0,2,7,5,0
2313,2,80,13,10,10,0,0,3,13,1,2,1,2,3,3,2,4,0,2,0,0,2,1,1,0
2314,77,1723,1457,730,1242,11,6,188,1468,10,292,166,329,302,495,2424,4078,5,22973,1276,1,2,1,1,0
2315,77,1723,74,35,59,1,0,14,75,3,14,7,14,17,21,58,85,1,128,7,0,2,1,1,0
2316,77,1723,245,125,200,5,7,34,250,7,30,17,34,37,51,166,265,3,1053,58,0,2,1,1,0
2317,9,518,1289,550,1043,56,32,155,1345,10,167,93,185,177,278,1266,2075,5,11498,638,0,2,1,1,0
2318,74,1661,384,251,317,7,8,52,391,11,70,44,84,81,128,467,811,6,5355,297,0,2,1,2,0
2319,6,314,1289,550,1043,56,32,155,1345,10,167,93,185,177,278,1266,2075,5,11498,638,0,2,0,10,0
2320,34,1908,1457,730,1242,11,6,188,1468,10,292,166,329,302,495,2424,4078,5,22973,1276,1,2,1,1,0
2321,2,307,42,7,35,4,0,5,46,1,2,1,2,3,3,2,4,0,2,0,0,2,0,2,0
2322,2,307,11,6,10,0,0,1,11,2,4,2,4,6,6,10,15,1,15,0,0,2,0,2,0
2323,17,322,127,75,83,2,11,30,129,4,14,7,14,18,21,61,87,2,175,9,0,2,1,1,1
2324,17,322,652,304,544,16,6,88,668,6,89,51,101,95,152,591,998,3,3399,188,0,2,1,1,1
2325,17,322,2,2,2,0,0,0,2,0,0,0,0,0,0,0,0,0,0,0,0,2,1,1,1
2326,17,322,8,5,5,0,0,3,8,0,0,0,0,0,0,0,0,0,0,0,0,2,1,1,1
2327,17,322,2,2,2,0,0,0,2,0,0,0,0,0,0,0,0,0,0,0,0,2,1,1,1
2328,17,322,14,8,8,0,0,6,14,0,0,0,0,0,0,0,0,0,0,0,0,2,1,1,1
2329,17,322,6,4,4,0,0,2,6,0,0,0,0,0,0,0,0,0,0,0,0,2,1,1,1
2330,17,322,6,4,4,0,0,2,6,1,2,1,2,3,3,2,4,0,2,0,0,2,1,1,1
2331,17,322,6,4,4,0,0,2,6,0,0,0,0,0,0,0,0,0,0,0,0,2,1,1,1
2332,17,322,7,5,5,0,0,2,7,0,0,0,0,0,0,0,0,0,0,0,0,2,1,1,1
2333,17,322,6,4,4,0,0,2,6,0,0,0,0,0,0,0,0,0,0,0,0,2,1,1,1
2334,17,322,10,6,6,0,0,4,10,0,0,0,0,0,0,0,0,0,0,0,0,2,1,1,1
2335,17,322,1,1,1,0,0,0,1,0,0,0,0,0,0,0,0,0,0,0,0,2,1,1,1
2336,17,322,1,1,1,0,0,0,1,0,0,0,0,0,0,0,0,0,0,0,0,2,1,1,1
2337,17,322,14,10,10,0,0,4,14,1,1,1,1,2,2,0,2,0,1,0,0,2,1,1,1
2338,17,322,46,26,30,3,0,12,49,3,6,3,6,9,9,20,28,1,42,2,0,2,1,1,1
2339,2,307,42,7,35,4,0,5,46,1,2,1,2,3,3,2,4,0,2,0,0,2,2,2,1
2340,2,307,11,6,10,0,0,1,11,2,4,2,4,6,6,10,15,1,15,0,0,2,2,2,1
2341,2,307,42,7,35,4,0,5,46,1,2,1,2,3,3,2,4,0,2,0,0,2,1,2,1
2342,2,307,11,6,10,0,0,1,11,2,4,2,4,6,6,10,15,1,15,0,0,2,1,2,1
2343,57,1511,1513,682,1277,25,13,200,1538,11,199,116,219,210,335,1557,2584,6,15641,868,0,3,96,4,1
2344,57,1511,819,519,539,24,98,155,843,15,96,57,106,111,163,690,1107,8,9171,509,0,3,96,4,1
2345,38,1736,1513,682,1277,25,13,200,1538,11,199,116,219,210,335,1557,2584,6,15641,868,0,3,101,3,1
2346,74,1659,384,251,317,7,8,52,391,11,70,44,84,81,128,467,811,6,5355,297,0,2,1,1,1
2347,43,844,215,129,180,6,0,29,221,8,65,43,72,73,115,415,711,4,3153,175,0,0,183,0,1
2348,43,844,97,69,77,3,3,16,100,6,22,13,23,28,36,113,173,3,542,30,0,0,183,0,1
2349,12,379,15,9,9,0,0,6,15,0,0,0,0,0,0,0,0,0,0,0,0,0,80,0,1
2350,12,380,15,9,9,0,0,6,15,0,0,0,0,0,0,0,0,0,0,0,0,2,3,0,1
2351,2,299,42,7,35,4,0,5,46,1,2,1,2,3,3,2,4,0,2,0,0,2,7,10,1
2352,2,299,11,6,10,0,0,1,11,2,4,2,4,6,6,10,15,1,15,0,0,2,7,10,1
2353,176,3856,182,127,129,0,0,53,182,5,39,21,42,44,63,217,343,2,926,51,0,2,634,1,1
2354,176,3856,1165,710,800,67,119,181,1232,18,243,153,282,261,435,2000,3492,10,36473,2026,1,2,634,1,1
2355,75,1638,773,419,590,28,0,166,801,10,204,113,217,214,330,1598,2554,5,13587,754,0,2,2,1,1
2356,75,1638,421,273,302,44,34,57,465,17,81,59,107,98,166,583,1098,11,12329,684,0,2,2,1,1
2357,31,977,182,127,129,0,0,53,182,5,39,21,42,44,63,217,343,2,926,51,0,2,68,1,1
2358,101,3788,1392,870,1177,35,17,170,1427,14,494,280,531,508,811,4473,7289,7,54850,3047,2,2,1,1,1
2359,2,307,42,7,35,4,0,5,46,1,2,1,2,3,3,2,4,0,2,0,0,2,1,1,1
2360,2,307,11,6,10,0,0,1,11,2,4,2,4,6,6,10,15,1,15,0,0,2,1,1,1
2361,2,307,42,7,35,4,0,5,46,1,2,1,2,3,3,2,4,0,2,0,0,2,1,1,1
2362,2,307,11,6,10,0,0,1,11,2,4,2,4,6,6,10,15,1,15,0,0,2,1,1,1
2363,2,297,42,7,35,4,0,5,46,1,2,1,2,3,3,2,4,0,2,0,0,2,3,4,0
2364,2,297,11,6,10,0,0,1,11,2,4,2,4,6,6,10,15,1,15,0,0,2,3,4,0
2365,2,307,42,7,35,4,0,5,46,1,2,1,2,3,3,2,4,0,2,0,0,2,1,1,0
2366,2,307,11,6,10,0,0,1,11,2,4,2,4,6,6,10,15,1,15,0,0,2,1,1,0
2367,125,3182,1450,624,1228,12,26,181,1462,14,306,186,354,320,540,2580,4493,8,36391,2021,1,3,127,13,1
2368,182,3987,182,127,129,0,0,53,182,5,39,21,42,44,63,217,343,2,926,51,0,2,28,5,1
2369,182,3987,1165,710,800,67,119,181,1232,18,243,153,282,261,435,2000,3492,10,36473,2026,1,2,28,5,1
2370,37,828,1450,624,1228,12,26,181,1462,14,306,186,354,320,540,2580,4493,8,36391,2021,1,0,173,0,1
2371,33,1067,182,127,129,0,0,53,182,5,39,21,42,44,63,217,343,2,926,51,0,2,15,2,1
2372,101,3788,1392,870,1177,35,17,170,1427,14,494,280,531,508,811,4473,7289,7,54850,3047,2,2,2,2,1
2373,36,799,1450,624,1228,12,26,181,1462,14,306,186,354,320,540,2580,4493,8,36391,2021,1,2,0,10,1
2374,1,73,42,7,35,4,0,5,46,1,2,1,2,3,3,2,4,0,2,0,0,2,1,1,1
2375,1,73,11,6,10,0,0,1,11,2,4,2,4,6,6,10,15,1,15,0,0,2,1,1,1
2376,77,1723,1457,730,1242,11,6,188,1468,10,292,166,329,302,495,2424,4078,5,22973,1276,1,2,1,1,1
2377,77,1723,74,35,59,1,0,14,75,3,14,7,14,17,21,58,85,1,128,7,0,2,1,1,1
2378,77,1723,245,125,200,5,7,34,250,7,30,17,34,37,51,166,265,3,1053,58,0,2,1,1,1
2379,27,510,334,251,279,10,4,40,344,5,127,74,143,132,217,899,1528,2,4303,239,0,2,3,3,1
2380,14,690,334,251,279,10,4,40,344,5,127,74,143,132,217,899,1528,2,4303,239,0,2,2,2,1
2381,20,854,373,158,315,8,0,51,381,5,76,44,79,81,123,486,779,2,2026,112,0,2,1,11,0
2382,182,3979,182,127,129,0,0,53,182,5,39,21,42,44,63,217,343,2,926,51,0,2,2,2,1
2383,182,3979,1165,710,800,67,119,181,1232,18,243,153,282,261,435,2000,3492,10,36473,2026,1,2,2,2,1
2384,185,4091,182,127,129,0,0,53,182,5,39,21,42,44,63,217,343,2,926,51,0,2,34,21,1
2385,185,4091,1165,710,800,67,119,181,1232,18,243,153,282,261,435,2000,3492,10,36473,2026,1,2,34,21,1
2386,73,1622,773,419,590,28,0,166,801,10,204,113,217,214,330,1598,2554,5,13587,754,0,2,12,13,1
2387,73,1622,421,273,302,44,34,57,465,17,81,59,107,98,166,583,1098,11,12329,684,0,2,12,13,1
2388,37,841,1450,624,1228,12,26,181,1462,14,306,186,354,320,540,2580,4493,8,36391,2021,1,2,19,9,1
2389,34,1106,182,127,129,0,0,53,182,5,39,21,42,44,63,217,343,2,926,51,0,2,15,8,1
2390,101,3798,1392,870,1177,35,17,170,1427,14,494,280,531,508,811,4473,7289,7,54850,3047,2,2,10,16,1
2391,54,1866,773,419,590,28,0,166,801,10,204,113,217,214,330,1598,2554,5,13587,754,0,2,15,13,1
2392,57,1522,1513,682,1277,25,13,200,1538,11,199,116,219,210,335,1557,2584,6,15641,868,0,2,5,4,1
2393,57,1522,819,519,539,24,98,155,843,15,96,57,106,111,163,690,1107,8,9171,509,0,2,5,4,1
2394,131,2259,1338,495,1086,10,64,173,1348,11,122,82,157,133,239,883,1686,7,11934,663,0,2,3,2,1
2395,80,1742,1457,730,1242,11,6,188,1468,10,292,166,329,302,495,2424,4078,5,22973,1276,1,2,4,2,1
2396,80,1742,74,35,59,1,0,14,75,3,14,7,14,17,21,58,85,1,128,7,0,2,4,2,1
2397,80,1742,245,125,200,5,7,34,250,7,30,17,34,37,51,166,265,3,1053,58,0,2,4,2,1
2398,74,1711,384,251,317,7,8,52,391,11,70,44,84,81,128,467,811,6,5355,297,0,2,12,9,1
2399,185,4091,182,127,129,0,0,53,182,5,39,21,42,44,63,217,343,2,926,51,0,2,2,2,0
2400,185,4091,1165,710,800,67,119,181,1232,18,243,153,282,261,435,2000,3492,10,36473,2026,1,2,2,2,0
2401,73,1676,773,419,590,28,0,166,801,10,204,113,217,214,330,1598,2554,5,13587,754,0,2,13,0,0
2402,73,1676,421,273,302,44,34,57,465,17,81,59,107,98,166,583,1098,11,12329,684,0,2,13,0,0
2403,56,1928,773,419,590,28,0,166,801,10,204,113,217,214,330,1598,2554,5,13587,754,0,2,9,0,0
2404,127,3221,1450,624,1228,12,26,181,1462,14,306,186,354,320,540,2580,4493,8,36391,2021,1,2,45,33,1
2405,2,293,42,7,35,4,0,5,46,1,2,1,2,3,3,2,4,0,2,0,0,2,1,3,0
2406,2,293,11,6,10,0,0,1,11,2,4,2,4,6,6,10,15,1,15,0,0,2,1,3,0
2407,15,423,1450,624,1228,12,26,181,1462,14,306,186,354,320,540,2580,4493,8,36391,2021,1,0,76,0,1
2408,185,4091,182,127,129,0,0,53,182,5,39,21,42,44,63,217,343,2,926,51,0,2,4,4,1
2409,185,4091,1165,710,800,67,119,181,1232,18,243,153,282,261,435,2000,3492,10,36473,2026,1,2,4,4,1
2410,37,841,1450,624,1228,12,26,181,1462,14,306,186,354,320,540,2580,4493,8,36391,2021,1,2,1,1,1
2411,39,869,1450,624,1228,12,26,181,1462,14,306,186,354,320,540,2580,4493,8,36391,2021,1,2,11,3,1
2412,43,937,1450,624,1228,12,26,181,1462,14,306,186,354,320,540,2580,4493,8,36391,2021,1,2,16,0,0
2413,43,937,1450,624,1228,12,26,181,1462,14,306,186,354,320,540,2580,4493,8,36391,2021,1,2,16,0,0
2414,58,1569,1513,682,1277,25,13,200,1538,11,199,116,219,210,335,1557,2584,6,15641,868,0,2,21,15,1
2415,58,1569,819,519,539,24,98,155,843,15,96,57,106,111,163,690,1107,8,9171,509,0,2,21,15,1
2416,47,1955,1513,682,1277,25,13,200,1538,11,199,116,219,210,335,1557,2584,6,15641,868,0,2,122,93,1
2417,101,3809,1392,870,1177,35,17,170,1427,14,494,280,531,508,811,4473,7289,7,54850,3047,2,2,10,7,1
2418,15,439,1450,624,1228,12,26,181,1462,14,306,186,354,320,540,2580,4493,8,36391,2021,1,2,3,0,0
2419,102,3827,1392,870,1177,35,17,170,1427,14,494,280,531,508,811,4473,7289,7,54850,3047,2,2,9,5,0
2420,73,1676,773,419,590,28,0,166,801,10,204,113,217,214,330,1598,2554,5,13587,754,0,2,1,1,1
2421,73,1676,421,273,302,44,34,57,465,17,81,59,107,98,166,583,1098,11,12329,684,0,2,1,1,1
2422,6,256,207,111,150,11,0,50,218,5,26,19,36,31,55,133,272,3,943,52,0,2,1,1,1
2423,6,256,410,198,237,31,55,97,441,11,63,38,72,74,110,414,683,6,4293,238,0,2,1,1,1
2424,19,282,477,336,357,30,23,73,507,16,194,134,250,210,384,1538,2962,10,30538,1696,0,2,1,1,1
2425,4,227,207,111,150,11,0,50,218,5,26,19,36,31,55,133,272,3,943,52,0,2,1,1,1
2426,34,1912,1457,730,1242,11,6,188,1468,10,292,166,329,302,495,2424,4078,5,22973,1276,1,2,2,2,1
2427,29,1459,384,251,317,7,8,52,391,11,70,44,84,81,128,467,811,6,5355,297,0,2,1,1,1
2428,20,856,373,158,315,8,0,51,381,5,76,44,79,81,123,486,779,2,2026,112,0,2,1,1,1
2429,12,284,1523,757,1297,19,12,193,1542,12,193,117,230,205,347,1508,2664,7,19053,1058,0,2,1,1,1
2430,12,284,701,378,504,33,58,109,734,13,110,68,126,123,194,794,1346,7,10027,557,0,2,1,1,1
2431,9,518,1289,550,1043,56,32,155,1345,10,167,93,185,177,278,1266,2075,5,11498,638,0,2,9,9,1
2432,29,1459,384,251,317,7,8,52,391,11,70,44,84,81,128,467,811,6,5355,297,0,2,4,4,1
2433,15,432,1450,624,1228,12,26,181,1462,14,306,186,354,320,540,2580,4493,8,36391,2021,1,2,1,5,0
2434,6,282,207,111,150,11,0,50,218,5,26,19,36,31,55,133,272,3,943,52,0,2,6,1,1
2435,6,282,410,198,237,31,55,97,441,11,63,38,72,74,110,414,683,6,4293,238,0,2,6,1,1
2436,11,497,127,75,83,2,11,30,129,4,14,7,14,18,21,61,87,2,175,9,0,0,71,0,1
2437,11,497,652,304,544,16,6,88,668,6,89,51,101,95,152,591,998,3,3399,188,0,0,71,0,1
2438,11,497,2,2,2,0,0,0,2,0,0,0,0,0,0,0,0,0,0,0,0,0,71,0,1
2439,11,497,8,5,5,0,0,3,8,0,0,0,0,0,0,0,0,0,0,0,0,0,71,0,1
2440,11,497,2,2,2,0,0,0,2,0,0,0,0,0,0,0,0,0,0,0,0,0,71,0,1
2441,11,497,14,8,8,0,0,6,14,0,0,0,0,0,0,0,0,0,0,0,0,0,71,0,1
2442,11,497,6,4,4,0,0,2,6,0,0,0,0,0,0,0,0,0,0,0,0,0,71,0,1
2443,11,497,6,4,4,0,0,2,6,1,2,1,2,3,3,2,4,0,2,0,0,0,71,0,1
2444,11,497,6,4,4,0,0,2,6,0,0,0,0,0,0,0,0,0,0,0,0,0,71,0,1
2445,11,497,7,5,5,0,0,2,7,0,0,0,0,0,0,0,0,0,0,0,0,0,71,0,1
2446,11,497,6,4,4,0,0,2,6,0,0,0,0,0,0,0,0,0,0,0,0,0,71,0,1
2447,11,497,10,6,6,0,0,4,10,0,0,0,0,0,0,0,0,0,0,0,0,0,71,0,1
2448,11,497,1,1,1,0,0,0,1,0,0,0,0,0,0,0,0,0,0,0,0,0,71,0,1
2449,11,497,1,1,1,0,0,0,1,0,0,0,0,0,0,0,0,0,0,0,0,0,71,0,1
2450,11,497,14,10,10,0,0,4,14,1,1,1,1,2,2,0,2,0,1,0,0,0,71,0,1
2451,11,497,46,26,30,3,0,12,49,3,6,3,6,9,9,20,28,1,42,2,0,0,71,0,1
2452,36,512,282,196,195,3,0,86,285,8,130,71,141,138,212,936,1507,4,6538,363,0,2,2,2,0
2453,65,1702,1513,682,1277,25,13,200,1538,11,199,116,219,210,335,1557,2584,6,15641,868,0,2,28,4,1
2454,65,1702,819,519,539,24,98,155,843,15,96,57,106,111,163,690,1107,8,9171,509,0,2,28,4,1
2455,43,852,215,129,180,6,0,29,221,8,65,43,72,73,115,415,711,4,3153,175,0,2,18,17,1
2456,43,852,97,69,77,3,3,16,100,6,22,13,23,28,36,113,173,3,542,30,0,2,18,17,1
2457,133,2262,1338,495,1086,10,64,173,1348,11,122,82,157,133,239,883,1686,7,11934,663,0,2,1,1,1
2458,6,261,207,111,150,11,0,50,218,5,26,19,36,31,55,133,272,3,943,52,0,2,1,6,1
2459,6,261,410,198,237,31,55,97,441,11,63,38,72,74,110,414,683,6,4293,238,0,2,1,6,1
2460,73,1676,773,419,590,28,0,166,801,10,204,113,217,214,330,1598,2554,5,13587,754,0,2,1,1,0
2461,73,1676,421,273,302,44,34,57,465,17,81,59,107,98,166,583,1098,11,12329,684,0,2,1,1,0
2462,185,4092,182,127,129,0,0,53,182,5,39,21,42,44,63,217,343,2,926,51,0,2,1,4,1
2463,185,4092,1165,710,800,67,119,181,1232,18,243,153,282,261,435,2000,3492,10,36473,2026,1,2,1,4,1
2464,102,3828,1392,870,1177,35,17,170,1427,14,494,280,531,508,811,4473,7289,7,54850,3047,2,2,1,4,1
2465,9,526,1289,550,1043,56,32,155,1345,10,167,93,185,177,278,1266,2075,5,11498,638,0,2,15,11,1
2466,73,1670,773,419,590,28,0,166,801,10,204,113,217,214,330,1598,2554,5,13587,754,0,2,2,3,1
2467,73,1670,421,273,302,44,34,57,465,17,81,59,107,98,166,583,1098,11,12329,684,0,2,2,3,1
2468,11,515,127,75,83,2,11,30,129,4,14,7,14,18,21,61,87,2,175,9,0,2,7,5,1
2469,11,515,652,304,544,16,6,88,668,6,89,51,101,95,152,591,998,3,3399,188,0,2,7,5,1
2470,11,515,2,2,2,0,0,0,2,0,0,0,0,0,0,0,0,0,0,0,0,2,7,5,1
2471,11,515,8,5,5,0,0,3,8,0,0,0,0,0,0,0,0,0,0,0,0,2,7,5,1
2472,11,515,2,2,2,0,0,0,2,0,0,0,0,0,0,0,0,0,0,0,0,2,7,5,1
2473,11,515,14,8,8,0,0,6,14,0,0,0,0,0,0,0,0,0,0,0,0,2,7,5,1
2474,11,515,6,4,4,0,0,2,6,0,0,0,0,0,0,0,0,0,0,0,0,2,7,5,1
2475,11,515,6,4,4,0,0,2,6,1,2,1,2,3,3,2,4,0,2,0,0,2,7,5,1
2476,11,515,6,4,4,0,0,2,6,0,0,0,0,0,0,0,0,0,0,0,0,2,7,5,1
2477,11,515,7,5,5,0,0,2,7,0,0,0,0,0,0,0,0,0,0,0,0,2,7,5,1
2478,11,515,6,4,4,0,0,2,6,0,0,0,0,0,0,0,0,0,0,0,0,2,7,5,1
2479,11,515,10,6,6,0,0,4,10,0,0,0,0,0,0,0,0,0,0,0,0,2,7,5,1
2480,11,515,1,1,1,0,0,0,1,0,0,0,0,0,0,0,0,0,0,0,0,2,7,5,1
2481,11,515,1,1,1,0,0,0,1,0,0,0,0,0,0,0,0,0,0,0,0,2,7,5,1
2482,11,515,14,10,10,0,0,4,14,1,1,1,1,2,2,0,2,0,1,0,0,2,7,5,1
2483,11,515,46,26,30,3,0,12,49,3,6,3,6,9,9,20,28,1,42,2,0,2,7,5,1
2484,74,1693,773,419,590,28,0,166,801,10,204,113,217,214,330,1598,2554,5,13587,754,0,2,9,1,0
2485,74,1693,421,273,302,44,34,57,465,17,81,59,107,98,166,583,1098,11,12329,684,0,2,9,1,0
2486,17,326,127,75,83,2,11,30,129,4,14,7,14,18,21,61,87,2,175,9,0,3,1,1,1
2487,17,326,652,304,544,16,6,88,668,6,89,51,101,95,152,591,998,3,3399,188,0,3,1,1,1
2488,17,326,2,2,2,0,0,0,2,0,0,0,0,0,0,0,0,0,0,0,0,3,1,1,1
2489,17,326,8,5,5,0,0,3,8,0,0,0,0,0,0,0,0,0,0,0,0,3,1,1,1
2490,17,326,2,2,2,0,0,0,2,0,0,0,0,0,0,0,0,0,0,0,0,3,1,1,1
2491,17,326,14,8,8,0,0,6,14,0,0,0,0,0,0,0,0,0,0,0,0,3,1,1,1
2492,17,326,6,4,4,0,0,2,6,0,0,0,0,0,0,0,0,0,0,0,0,3,1,1,1
2493,17,326,6,4,4,0,0,2,6,1,2,1,2,3,3,2,4,0,2,0,0,3,1,1,1
2494,17,326,6,4,4,0,0,2,6,0,0,0,0,0,0,0,0,0,0,0,0,3,1,1,1
2495,17,326,7,5,5,0,0,2,7,0,0,0,0,0,0,0,0,0,0,0,0,3,1,1,1
2496,17,326,6,4,4,0,0,2,6,0,0,0,0,0,0,0,0,0,0,0,0,3,1,1,1
2497,17,326,10,6,6,0,0,4,10,0,0,0,0,0,0,0,0,0,0,0,0,3,1,1,1
2498,17,326,1,1,1,0,0,0,1,0,0,0,0,0,0,0,0,0,0,0,0,3,1,1,1
2499,17,326,1,1,1,0,0,0,1,0,0,0,0,0,0,0,0,0,0,0,0,3,1,1,1
2500,17,326,14,10,10,0,0,4,14,1,1,1,1,2,2,0,2,0,1,0,0,3,1,1,1
2501,17,326,46,26,30,3,0,12,49,3,6,3,6,9,9,20,28,1,42,2,0,3,1,1,1
2502,7,111,44,19,17,0,16,11,44,3,14,7,14,17,21,58,85,1,128,7,0,2,1,1,1
2503,2,29,127,75,83,2,11,30,129,4,14,7,14,18,21,61,87,2,175,9,0,2,1,1,1
2504,2,29,652,304,544,16,6,88,668,6,89,51,101,95,152,591,998,3,3399,188,0,2,1,1,1
2505,2,29,2,2,2,0,0,0,2,0,0,0,0,0,0,0,0,0,0,0,0,2,1,1,1
2506,2,29,8,5,5,0,0,3,8,0,0,0,0,0,0,0,0,0,0,0,0,2,1,1,1
2507,2,29,2,2,2,0,0,0,2,0,0,0,0,0,0,0,0,0,0,0,0,2,1,1,1
2508,2,29,14,8,8,0,0,6,14,0,0,0,0,0,0,0,0,0,0,0,0,2,1,1,1
2509,2,29,6,4,4,0,0,2,6,0,0,0,0,0,0,0,0,0,0,0,0,2,1,1,1
2510,2,29,6,4,4,0,0,2,6,1,2,1,2,3,3,2,4,0,2,0,0,2,1,1,1
2511,2,29,6,4,4,0,0,2,6,0,0,0,0,0,0,0,0,0,0,0,0,2,1,1,1
2512,2,29,7,5,5,0,0,2,7,0,0,0,0,0,0,0,0,0,0,0,0,2,1,1,1
2513,2,29,6,4,4,0,0,2,6,0,0,0,0,0,0,0,0,0,0,0,0,2,1,1,1
2514,2,29,10,6,6,0,0,4,10,0,0,0,0,0,0,0,0,0,0,0,0,2,1,1,1
2515,2,29,1,1,1,0,0,0,1,0,0,0,0,0,0,0,0,0,0,0,0,2,1,1,1
2516,2,29,1,1,1,0,0,0,1,0,0,0,0,0,0,0,0,0,0,0,0,2,1,1,1
2517,2,29,14,10,10,0,0,4,14,1,1,1,1,2,2,0,2,0,1,0,0,2,1,1,1
2518,2,29,46,26,30,3,0,12,49,3,6,3,6,9,9,20,28,1,42,2,0,2,1,1,1
2519,6,108,127,75,83,2,11,30,129,4,14,7,14,18,21,61,87,2,175,9,0,2,1,1,1
2520,6,108,652,304,544,16,6,88,668,6,89,51,101,95,152,591,998,3,3399,188,0,2,1,1,1
2521,6,108,2,2,2,0,0,0,2,0,0,0,0,0,0,0,0,0,0,0,0,2,1,1,1
2522,6,108,8,5,5,0,0,3,8,0,0,0,0,0,0,0,0,0,0,0,0,2,1,1,1
2523,6,108,2,2,2,0,0,0,2,0,0,0,0,0,0,0,0,0,0,0,0,2,1,1,1
2524,6,108,14,8,8,0,0,6,14,0,0,0,0,0,0,0,0,0,0,0,0,2,1,1,1
2525,6,108,6,4,4,0,0,2,6,0,0,0,0,0,0,0,0,0,0,0,0,2,1,1,1
2526,6,108,6,4,4,0,0,2,6,1,2,1,2,3,3,2,4,0,2,0,0,2,1,1,1
2527,6,108,6,4,4,0,0,2,6,0,0,0,0,0,0,0,0,0,0,0,0,2,1,1,1
2528,6,108,7,5,5,0,0,2,7,0,0,0,0,0,0,0,0,0,0,0,0,2,1,1,1
2529,6,108,6,4,4,0,0,2,6,0,0,0,0,0,0,0,0,0,0,0,0,2,1,1,1
2530,6,108,10,6,6,0,0,4,10,0,0,0,0,0,0,0,0,0,0,0,0,2,1,1,1
2531,6,108,1,1,1,0,0,0,1,0,0,0,0,0,0,0,0,0,0,0,0,2,1,1,1
2532,6,108,1,1,1,0,0,0,1,0,0,0,0,0,0,0,0,0,0,0,0,2,1,1,1
2533,6,108,14,10,10,0,0,4,14,1,1,1,1,2,2,0,2,0,1,0,0,2,1,1,1
2534,6,108,46,26,30,3,0,12,49,3,6,3,6,9,9,20,28,1,42,2,0,2,1,1,1
2535,7,169,127,75,83,2,11,30,129,4,14,7,14,18,21,61,87,2,175,9,0,3,10,4,1
2536,7,169,652,304,544,16,6,88,668,6,89,51,101,95,152,591,998,3,3399,188,0,3,10,4,1
2537,7,169,2,2,2,0,0,0,2,0,0,0,0,0,0,0,0,0,0,0,0,3,10,4,1
2538,7,169,8,5,5,0,0,3,8,0,0,0,0,0,0,0,0,0,0,0,0,3,10,4,1
2539,7,169,2,2,2,0,0,0,2,0,0,0,0,0,0,0,0,0,0,0,0,3,10,4,1
2540,7,169,14,8,8,0,0,6,14,0,0,0,0,0,0,0,0,0,0,0,0,3,10,4,1
2541,7,169,6,4,4,0,0,2,6,0,0,0,0,0,0,0,0,0,0,0,0,3,10,4,1
2542,7,169,6,4,4,0,0,2,6,1,2,1,2,3,3,2,4,0,2,0,0,3,10,4,1
2543,7,169,6,4,4,0,0,2,6,0,0,0,0,0,0,0,0,0,0,0,0,3,10,4,1
2544,7,169,7,5,5,0,0,2,7,0,0,0,0,0,0,0,0,0,0,0,0,3,10,4,1
2545,7,169,6,4,4,0,0,2,6,0,0,0,0,0,0,0,0,0,0,0,0,3,10,4,1
2546,7,169,10,6,6,0,0,4,10,0,0,0,0,0,0,0,0,0,0,0,0,3,10,4,1
2547,7,169,1,1,1,0,0,0,1,0,0,0,0,0,0,0,0,0,0,0,0,3,10,4,1
2548,7,169,1,1,1,0,0,0,1,0,0,0,0,0,0,0,0,0,0,0,0,3,10,4,1
2549,7,169,14,10,10,0,0,4,14,1,1,1,1,2,2,0,2,0,1,0,0,3,10,4,1
2550,7,169,46,26,30,3,0,12,49,3,6,3,6,9,9,20,28,1,42,2,0,3,10,4,1
2551,1,71,42,7,35,4,0,5,46,1,2,1,2,3,3,2,4,0,2,0,0,0,11,0,1
2552,1,71,11,6,10,0,0,1,11,2,4,2,4,6,6,10,15,1,15,0,0,0,11,0,1
2553,2,223,42,7,35,4,0,5,46,1,2,1,2,3,3,2,4,0,2,0,0,2,5,39,1
2554,2,223,11,6,10,0,0,1,11,2,4,2,4,6,6,10,15,1,15,0,0,2,5,39,1
2555,186,4149,182,127,129,0,0,53,182,5,39,21,42,44,63,217,343,2,926,51,0,2,12,10,0
2556,186,4149,1165,710,800,67,119,181,1232,18,243,153,282,261,435,2000,3492,10,36473,2026,1,2,12,10,0
2557,34,1110,182,127,129,0,0,53,182,5,39,21,42,44,63,217,343,2,926,51,0,2,1,1,0
2558,11,269,127,75,83,2,11,30,129,4,14,7,14,18,21,61,87,2,175,9,0,0,46,0,0
2559,11,269,652,304,544,16,6,88,668,6,89,51,101,95,152,591,998,3,3399,188,0,0,46,0,0
2560,11,269,2,2,2,0,0,0,2,0,0,0,0,0,0,0,0,0,0,0,0,0,46,0,0
2561,11,269,8,5,5,0,0,3,8,0,0,0,0,0,0,0,0,0,0,0,0,0,46,0,0
2562,11,269,2,2,2,0,0,0,2,0,0,0,0,0,0,0,0,0,0,0,0,0,46,0,0
2563,11,269,14,8,8,0,0,6,14,0,0,0,0,0,0,0,0,0,0,0,0,0,46,0,0
2564,11,269,6,4,4,0,0,2,6,0,0,0,0,0,0,0,0,0,0,0,0,0,46,0,0
2565,11,269,6,4,4,0,0,2,6,1,2,1,2,3,3,2,4,0,2,0,0,0,46,0,0
2566,11,269,6,4,4,0,0,2,6,0,0,0,0,0,0,0,0,0,0,0,0,0,46,0,0
2567,11,269,7,5,5,0,0,2,7,0,0,0,0,0,0,0,0,0,0,0,0,0,46,0,0
2568,11,269,6,4,4,0,0,2,6,0,0,0,0,0,0,0,0,0,0,0,0,0,46,0,0
2569,11,269,10,6,6,0,0,4,10,0,0,0,0,0,0,0,0,0,0,0,0,0,46,0,0
2570,11,269,1,1,1,0,0,0,1,0,0,0,0,0,0,0,0,0,0,0,0,0,46,0,0
2571,11,269,1,1,1,0,0,0,1,0,0,0,0,0,0,0,0,0,0,0,0,0,46,0,0
2572,11,269,14,10,10,0,0,4,14,1,1,1,1,2,2,0,2,0,1,0,0,0,46,0,0
2573,11,269,46,26,30,3,0,12,49,3,6,3,6,9,9,20,28,1,42,2,0,0,46,0,0
2574,40,353,647,139,84,35,284,233,682,0,0,0,0,0,0,0,0,0,0,0,0,2,9,0,0
2575,11,269,127,75,83,2,11,30,129,4,14,7,14,18,21,61,87,2,175,9,0,2,1,1,1
2576,11,269,652,304,544,16,6,88,668,6,89,51,101,95,152,591,998,3,3399,188,0,2,1,1,1
2577,11,269,2,2,2,0,0,0,2,0,0,0,0,0,0,0,0,0,0,0,0,2,1,1,1
2578,11,269,8,5,5,0,0,3,8,0,0,0,0,0,0,0,0,0,0,0,0,2,1,1,1
2579,11,269,2,2,2,0,0,0,2,0,0,0,0,0,0,0,0,0,0,0,0,2,1,1,1
2580,11,269,14,8,8,0,0,6,14,0,0,0,0,0,0,0,0,0,0,0,0,2,1,1,1
2581,11,269,6,4,4,0,0,2,6,0,0,0,0,0,0,0,0,0,0,0,0,2,1,1,1
2582,11,269,6,4,4,0,0,2,6,1,2,1,2,3,3,2,4,0,2,0,0,2,1,1,1
2583,11,269,6,4,4,0,0,2,6,0,0,0,0,0,0,0,0,0,0,0,0,2,1,1,1
2584,11,269,7,5,5,0,0,2,7,0,0,0,0,0,0,0,0,0,0,0,0,2,1,1,1
2585,11,269,6,4,4,0,0,2,6,0,0,0,0,0,0,0,0,0,0,0,0,2,1,1,1
2586,11,269,10,6,6,0,0,4,10,0,0,0,0,0,0,0,0,0,0,0,0,2,1,1,1
2587,11,269,1,1,1,0,0,0,1,0,0,0,0,0,0,0,0,0,0,0,0,2,1,1,1
2588,11,269,1,1,1,0,0,0,1,0,0,0,0,0,0,0,0,0,0,0,0,2,1,1,1
2589,11,269,14,10,10,0,0,4,14,1,1,1,1,2,2,0,2,0,1,0,0,2,1,1,1
2590,11,269,46,26,30,3,0,12,49,3,6,3,6,9,9,20,28,1,42,2,0,2,1,1,1
2591,11,269,127,75,83,2,11,30,129,4,14,7,14,18,21,61,87,2,175,9,0,2,1,1,1
2592,11,269,652,304,544,16,6,88,668,6,89,51,101,95,152,591,998,3,3399,188,0,2,1,1,1
2593,11,269,2,2,2,0,0,0,2,0,0,0,0,0,0,0,0,0,0,0,0,2,1,1,1
2594,11,269,8,5,5,0,0,3,8,0,0,0,0,0,0,0,0,0,0,0,0,2,1,1,1
2595,11,269,2,2,2,0,0,0,2,0,0,0,0,0,0,0,0,0,0,0,0,2,1,1,1
2596,11,269,14,8,8,0,0,6,14,0,0,0,0,0,0,0,0,0,0,0,0,2,1,1,1
2597,11,269,6,4,4,0,0,2,6,0,0,0,0,0,0,0,0,0,0,0,0,2,1,1,1
2598,11,269,6,4,4,0,0,2,6,1,2,1,2,3,3,2,4,0,2,0,0,2,1,1,1
2599,11,269,6,4,4,0,0,2,6,0,0,0,0,0,0,0,0,0,0,0,0,2,1,1,1
2600,11,269,7,5,5,0,0,2,7,0,0,0,0,0,0,0,0,0,0,0,0,2,1,1,1
2601,11,269,6,4,4,0,0,2,6,0,0,0,0,0,0,0,0,0,0,0,0,2,1,1,1
2602,11,269,10,6,6,0,0,4,10,0,0,0,0,0,0,0,0,0,0,0,0,2,1,1,1
2603,11,269,1,1,1,0,0,0,1,0,0,0,0,0,0,0,0,0,0,0,0,2,1,1,1
2604,11,269,1,1,1,0,0,0,1,0,0,0,0,0,0,0,0,0,0,0,0,2,1,1,1
2605,11,269,14,10,10,0,0,4,14,1,1,1,1,2,2,0,2,0,1,0,0,2,1,1,1
2606,11,269,46,26,30,3,0,12,49,3,6,3,6,9,9,20,28,1,42,2,0,2,1,1,1
2607,3,58,127,75,83,2,11,30,129,4,14,7,14,18,21,61,87,2,175,9,0,0,7,0,1
2608,3,58,652,304,544,16,6,88,668,6,89,51,101,95,152,591,998,3,3399,188,0,0,7,0,1
2609,3,58,2,2,2,0,0,0,2,0,0,0,0,0,0,0,0,0,0,0,0,0,7,0,1
2610,3,58,8,5,5,0,0,3,8,0,0,0,0,0,0,0,0,0,0,0,0,0,7,0,1
2611,3,58,2,2,2,0,0,0,2,0,0,0,0,0,0,0,0,0,0,0,0,0,7,0,1
2612,3,58,14,8,8,0,0,6,14,0,0,0,0,0,0,0,0,0,0,0,0,0,7,0,1
2613,3,58,6,4,4,0,0,2,6,0,0,0,0,0,0,0,0,0,0,0,0,0,7,0,1
2614,3,58,6,4,4,0,0,2,6,1,2,1,2,3,3,2,4,0,2,0,0,0,7,0,1
2615,3,58,6,4,4,0,0,2,6,0,0,0,0,0,0,0,0,0,0,0,0,0,7,0,1
2616,3,58,7,5,5,0,0,2,7,0,0,0,0,0,0,0,0,0,0,0,0,0,7,0,1
2617,3,58,6,4,4,0,0,2,6,0,0,0,0,0,0,0,0,0,0,0,0,0,7,0,1
2618,3,58,10,6,6,0,0,4,10,0,0,0,0,0,0,0,0,0,0,0,0,0,7,0,1
2619,3,58,1,1,1,0,0,0,1,0,0,0,0,0,0,0,0,0,0,0,0,0,7,0,1
2620,3,58,1,1,1,0,0,0,1,0,0,0,0,0,0,0,0,0,0,0,0,0,7,0,1
2621,3,58,14,10,10,0,0,4,14,1,1,1,1,2,2,0,2,0,1,0,0,0,7,0,1
2622,3,58,46,26,30,3,0,12,49,3,6,3,6,9,9,20,28,1,42,2,0,0,7,0,1
2623,1,9,2,2,2,0,0,0,2,0,0,0,0,0,0,0,0,0,0,0,0,0,5,0,1
2624,3,65,127,75,83,2,11,30,129,4,14,7,14,18,21,61,87,2,175,9,0,0,15,0,1
2625,3,65,652,304,544,16,6,88,668,6,89,51,101,95,152,591,998,3,3399,188,0,0,15,0,1
2626,3,65,2,2,2,0,0,0,2,0,0,0,0,0,0,0,0,0,0,0,0,0,15,0,1
2627,3,65,8,5,5,0,0,3,8,0,0,0,0,0,0,0,0,0,0,0,0,0,15,0,1
2628,3,65,2,2,2,0,0,0,2,0,0,0,0,0,0,0,0,0,0,0,0,0,15,0,1
2629,3,65,14,8,8,0,0,6,14,0,0,0,0,0,0,0,0,0,0,0,0,0,15,0,1
2630,3,65,6,4,4,0,0,2,6,0,0,0,0,0,0,0,0,0,0,0,0,0,15,0,1
2631,3,65,6,4,4,0,0,2,6,1,2,1,2,3,3,2,4,0,2,0,0,0,15,0,1
2632,3,65,6,4,4,0,0,2,6,0,0,0,0,0,0,0,0,0,0,0,0,0,15,0,1
2633,3,65,7,5,5,0,0,2,7,0,0,0,0,0,0,0,0,0,0,0,0,0,15,0,1
2634,3,65,6,4,4,0,0,2,6,0,0,0,0,0,0,0,0,0,0,0,0,0,15,0,1
2635,3,65,10,6,6,0,0,4,10,0,0,0,0,0,0,0,0,0,0,0,0,0,15,0,1
2636,3,65,1,1,1,0,0,0,1,0,0,0,0,0,0,0,0,0,0,0,0,0,15,0,1
2637,3,65,1,1,1,0,0,0,1,0,0,0,0,0,0,0,0,0,0,0,0,0,15,0,1
2638,3,65,14,10,10,0,0,4,14,1,1,1,1,2,2,0,2,0,1,0,0,0,15,0,1
2639,3,65,46,26,30,3,0,12,49,3,6,3,6,9,9,20,28,1,42,2,0,0,15,0,1
2640,56,1928,773,419,590,28,0,166,801,10,204,113,217,214,330,1598,2554,5,13587,754,0,2,5,5,1
2641,12,380,15,9,9,0,0,6,15,0,0,0,0,0,0,0,0,0,0,0,0,2,1,1,0
2642,12,380,15,9,9,0,0,6,15,0,0,0,0,0,0,0,0,0,0,0,0,2,1,1,0
2643,19,349,127,75,83,2,11,30,129,4,14,7,14,18,21,61,87,2,175,9,0,2,6,3,1
2644,19,349,652,304,544,16,6,88,668,6,89,51,101,95,152,591,998,3,3399,188,0,2,6,3,1
2645,19,349,2,2,2,0,0,0,2,0,0,0,0,0,0,0,0,0,0,0,0,2,6,3,1
2646,19,349,8,5,5,0,0,3,8,0,0,0,0,0,0,0,0,0,0,0,0,2,6,3,1
2647,19,349,2,2,2,0,0,0,2,0,0,0,0,0,0,0,0,0,0,0,0,2,6,3,1
2648,19,349,14,8,8,0,0,6,14,0,0,0,0,0,0,0,0,0,0,0,0,2,6,3,1
2649,19,349,6,4,4,0,0,2,6,0,0,0,0,0,0,0,0,0,0,0,0,2,6,3,1
2650,19,349,6,4,4,0,0,2,6,1,2,1,2,3,3,2,4,0,2,0,0,2,6,3,1
2651,19,349,6,4,4,0,0,2,6,0,0,0,0,0,0,0,0,0,0,0,0,2,6,3,1
2652,19,349,7,5,5,0,0,2,7,0,0,0,0,0,0,0,0,0,0,0,0,2,6,3,1
2653,19,349,6,4,4,0,0,2,6,0,0,0,0,0,0,0,0,0,0,0,0,2,6,3,1
2654,19,349,10,6,6,0,0,4,10,0,0,0,0,0,0,0,0,0,0,0,0,2,6,3,1
2655,19,349,1,1,1,0,0,0,1,0,0,0,0,0,0,0,0,0,0,0,0,2,6,3,1
2656,19,349,1,1,1,0,0,0,1,0,0,0,0,0,0,0,0,0,0,0,0,2,6,3,1
2657,19,349,14,10,10,0,0,4,14,1,1,1,1,2,2,0,2,0,1,0,0,2,6,3,1
2658,19,349,46,26,30,3,0,12,49,3,6,3,6,9,9,20,28,1,42,2,0,2,6,3,1
2659,6,106,127,75,83,2,11,30,129,4,14,7,14,18,21,61,87,2,175,9,0,2,1,1,1
2660,6,106,652,304,544,16,6,88,668,6,89,51,101,95,152,591,998,3,3399,188,0,2,1,1,1
2661,6,106,2,2,2,0,0,0,2,0,0,0,0,0,0,0,0,0,0,0,0,2,1,1,1
2662,6,106,8,5,5,0,0,3,8,0,0,0,0,0,0,0,0,0,0,0,0,2,1,1,1
2663,6,106,2,2,2,0,0,0,2,0,0,0,0,0,0,0,0,0,0,0,0,2,1,1,1
2664,6,106,14,8,8,0,0,6,14,0,0,0,0,0,0,0,0,0,0,0,0,2,1,1,1
2665,6,106,6,4,4,0,0,2,6,0,0,0,0,0,0,0,0,0,0,0,0,2,1,1,1
2666,6,106,6,4,4,0,0,2,6,1,2,1,2,3,3,2,4,0,2,0,0,2,1,1,1
2667,6,106,6,4,4,0,0,2,6,0,0,0,0,0,0,0,0,0,0,0,0,2,1,1,1
2668,6,106,7,5,5,0,0,2,7,0,0,0,0,0,0,0,0,0,0,0,0,2,1,1,1
2669,6,106,6,4,4,0,0,2,6,0,0,0,0,0,0,0,0,0,0,0,0,2,1,1,1
2670,6,106,10,6,6,0,0,4,10,0,0,0,0,0,0,0,0,0,0,0,0,2,1,1,1
2671,6,106,1,1,1,0,0,0,1,0,0,0,0,0,0,0,0,0,0,0,0,2,1,1,1
2672,6,106,1,1,1,0,0,0,1,0,0,0,0,0,0,0,0,0,0,0,0,2,1,1,1
2673,6,106,14,10,10,0,0,4,14,1,1,1,1,2,2,0,2,0,1,0,0,2,1,1,1
2674,6,106,46,26,30,3,0,12,49,3,6,3,6,9,9,20,28,1,42,2,0,2,1,1,1
2675,80,1742,1457,730,1242,11,6,188,1468,10,292,166,329,302,495,2424,4078,5,22973,1276,1,2,2,1,1
2676,80,1742,74,35,59,1,0,14,75,3,14,7,14,17,21,58,85,1,128,7,0,2,2,1,1
2677,80,1742,245,125,200,5,7,34,250,7,30,17,34,37,51,166,265,3,1053,58,0,2,2,1,1
2678,2,219,42,7,35,4,0,5,46,1,2,1,2,3,3,2,4,0,2,0,0,2,4,8,1
2679,2,219,11,6,10,0,0,1,11,2,4,2,4,6,6,10,15,1,15,0,0,2,4,8,1
2680,28,538,334,251,279,10,4,40,344,5,127,74,143,132,217,899,1528,2,4303,239,0,2,5,0,1
2681,34,1920,1457,730,1242,11,6,188,1468,10,292,166,329,302,495,2424,4078,5,22973,1276,1,2,1,0,1
2682,16,752,334,251,279,10,4,40,344,5,127,74,143,132,217,899,1528,2,4303,239,0,2,15,0,1
2683,2,219,42,7,35,4,0,5,46,1,2,1,2,3,3,2,4,0,2,0,0,2,4,4,1
2684,2,219,11,6,10,0,0,1,11,2,4,2,4,6,6,10,15,1,15,0,0,2,4,4,1
2685,15,428,1450,624,1228,12,26,181,1462,14,306,186,354,320,540,2580,4493,8,36391,2021,1,3,2,2,1
2686,186,4143,182,127,129,0,0,53,182,5,39,21,42,44,63,217,343,2,926,51,0,3,3,3,1
2687,186,4143,1165,710,800,67,119,181,1232,18,243,153,282,261,435,2000,3492,10,36473,2026,1,3,3,3,1
2688,133,2264,1338,495,1086,10,64,173,1348,11,122,82,157,133,239,883,1686,7,11934,663,0,3,1,1,1
2689,79,1733,1457,730,1242,11,6,188,1468,10,292,166,329,302,495,2424,4078,5,22973,1276,1,3,11,13,1
2690,79,1733,74,35,59,1,0,14,75,3,14,7,14,17,21,58,85,1,128,7,0,3,11,13,1
2691,79,1733,245,125,200,5,7,34,250,7,30,17,34,37,51,166,265,3,1053,58,0,3,11,13,1
2692,74,1701,384,251,317,7,8,52,391,11,70,44,84,81,128,467,811,6,5355,297,0,3,6,6,1
2693,36,669,373,158,315,8,0,51,381,5,76,44,79,81,123,486,779,2,2026,112,0,3,1,1,1
2694,2,221,42,7,35,4,0,5,46,1,2,1,2,3,3,2,4,0,2,0,0,2,27,32,1
2695,2,221,11,6,10,0,0,1,11,2,4,2,4,6,6,10,15,1,15,0,0,2,27,32,1
2696,43,935,1450,624,1228,12,26,181,1462,14,306,186,354,320,540,2580,4493,8,36391,2021,1,2,1,1,1
2697,34,1106,182,127,129,0,0,53,182,5,39,21,42,44,63,217,343,2,926,51,0,2,2,2,1
2698,102,3828,1392,870,1177,35,17,170,1427,14,494,280,531,508,811,4473,7289,7,54850,3047,2,2,3,3,1
2699,56,1918,773,419,590,28,0,166,801,10,204,113,217,214,330,1598,2554,5,13587,754,0,2,5,5,1
2700,47,1953,1513,682,1277,25,13,200,1538,11,199,116,219,210,335,1557,2584,6,15641,868,0,2,1,1,1
2701,11,513,127,75,83,2,11,30,129,4,14,7,14,18,21,61,87,2,175,9,0,2,1,1,1
2702,11,513,652,304,544,16,6,88,668,6,89,51,101,95,152,591,998,3,3399,188,0,2,1,1,1
2703,11,513,2,2,2,0,0,0,2,0,0,0,0,0,0,0,0,0,0,0,0,2,1,1,1
2704,11,513,8,5,5,0,0,3,8,0,0,0,0,0,0,0,0,0,0,0,0,2,1,1,1
2705,11,513,2,2,2,0,0,0,2,0,0,0,0,0,0,0,0,0,0,0,0,2,1,1,1
2706,11,513,14,8,8,0,0,6,14,0,0,0,0,0,0,0,0,0,0,0,0,2,1,1,1
2707,11,513,6,4,4,0,0,2,6,0,0,0,0,0,0,0,0,0,0,0,0,2,1,1,1
2708,11,513,6,4,4,0,0,2,6,1,2,1,2,3,3,2,4,0,2,0,0,2,1,1,1
2709,11,513,6,4,4,0,0,2,6,0,0,0,0,0,0,0,0,0,0,0,0,2,1,1,1
2710,11,513,7,5,5,0,0,2,7,0,0,0,0,0,0,0,0,0,0,0,0,2,1,1,1
2711,11,513,6,4,4,0,0,2,6,0,0,0,0,0,0,0,0,0,0,0,0,2,1,1,1
2712,11,513,10,6,6,0,0,4,10,0,0,0,0,0,0,0,0,0,0,0,0,2,1,1,1
2713,11,513,1,1,1,0,0,0,1,0,0,0,0,0,0,0,0,0,0,0,0,2,1,1,1
2714,11,513,1,1,1,0,0,0,1,0,0,0,0,0,0,0,0,0,0,0,0,2,1,1,1
2715,11,513,14,10,10,0,0,4,14,1,1,1,1,2,2,0,2,0,1,0,0,2,1,1,1
2716,11,513,46,26,30,3,0,12,49,3,6,3,6,9,9,20,28,1,42,2,0,2,1,1,1
2717,7,169,127,75,83,2,11,30,129,4,14,7,14,18,21,61,87,2,175,9,0,2,2,2,1
2718,7,169,652,304,544,16,6,88,668,6,89,51,101,95,152,591,998,3,3399,188,0,2,2,2,1
2719,7,169,2,2,2,0,0,0,2,0,0,0,0,0,0,0,0,0,0,0,0,2,2,2,1
2720,7,169,8,5,5,0,0,3,8,0,0,0,0,0,0,0,0,0,0,0,0,2,2,2,1
2721,7,169,2,2,2,0,0,0,2,0,0,0,0,0,0,0,0,0,0,0,0,2,2,2,1
2722,7,169,14,8,8,0,0,6,14,0,0,0,0,0,0,0,0,0,0,0,0,2,2,2,1
2723,7,169,6,4,4,0,0,2,6,0,0,0,0,0,0,0,0,0,0,0,0,2,2,2,1
2724,7,169,6,4,4,0,0,2,6,1,2,1,2,3,3,2,4,0,2,0,0,2,2,2,1
2725,7,169,6,4,4,0,0,2,6,0,0,0,0,0,0,0,0,0,0,0,0,2,2,2,1
2726,7,169,7,5,5,0,0,2,7,0,0,0,0,0,0,0,0,0,0,0,0,2,2,2,1
2727,7,169,6,4,4,0,0,2,6,0,0,0,0,0,0,0,0,0,0,0,0,2,2,2,1
2728,7,169,10,6,6,0,0,4,10,0,0,0,0,0,0,0,0,0,0,0,0,2,2,2,1
2729,7,169,1,1,1,0,0,0,1,0,0,0,0,0,0,0,0,0,0,0,0,2,2,2,1
2730,7,169,1,1,1,0,0,0,1,0,0,0,0,0,0,0,0,0,0,0,0,2,2,2,1
2731,7,169,14,10,10,0,0,4,14,1,1,1,1,2,2,0,2,0,1,0,0,2,2,2,1
2732,7,169,46,26,30,3,0,12,49,3,6,3,6,9,9,20,28,1,42,2,0,2,2,2,1
2733,4,223,207,111,150,11,0,50,218,5,26,19,36,31,55,133,272,3,943,52,0,2,2,2,1
2734,34,1914,1457,730,1242,11,6,188,1468,10,292,166,329,302,495,2424,4078,5,22973,1276,1,2,3,3,1
2735,16,750,334,251,279,10,4,40,344,5,127,74,143,132,217,899,1528,2,4303,239,0,2,1,1,1
2736,29,1453,384,251,317,7,8,52,391,11,70,44,84,81,128,467,811,6,5355,297,0,2,3,3,1
2737,2,223,42,7,35,4,0,5,46,1,2,1,2,3,3,2,4,0,2,0,0,2,3,5,1
2738,2,223,11,6,10,0,0,1,11,2,4,2,4,6,6,10,15,1,15,0,0,2,3,5,1
2739,16,759,334,251,279,10,4,40,344,5,127,74,143,132,217,899,1528,2,4303,239,0,2,12,10,1
2740,42,923,1450,624,1228,12,26,181,1462,14,306,186,354,320,540,2580,4493,8,36391,2021,1,2,1,5,1
2741,55,1910,773,419,590,28,0,166,801,10,204,113,217,214,330,1598,2554,5,13587,754,0,2,1,3,1
2742,78,1734,384,251,317,7,8,52,391,11,70,44,84,81,128,467,811,6,5355,297,0,2,17,10,1
2743,30,1536,384,251,317,7,8,52,391,11,70,44,84,81,128,467,811,6,5355,297,0,2,11,1,1
2744,28,548,334,251,279,10,4,40,344,5,127,74,143,132,217,899,1528,2,4303,239,0,2,12,10,1
2745,19,349,127,75,83,2,11,30,129,4,14,7,14,18,21,61,87,2,175,9,0,2,1,1,1
2746,19,349,652,304,544,16,6,88,668,6,89,51,101,95,152,591,998,3,3399,188,0,2,1,1,1
2747,19,349,2,2,2,0,0,0,2,0,0,0,0,0,0,0,0,0,0,0,0,2,1,1,1
2748,19,349,8,5,5,0,0,3,8,0,0,0,0,0,0,0,0,0,0,0,0,2,1,1,1
2749,19,349,2,2,2,0,0,0,2,0,0,0,0,0,0,0,0,0,0,0,0,2,1,1,1
2750,19,349,14,8,8,0,0,6,14,0,0,0,0,0,0,0,0,0,0,0,0,2,1,1,1
2751,19,349,6,4,4,0,0,2,6,0,0,0,0,0,0,0,0,0,0,0,0,2,1,1,1
2752,19,349,6,4,4,0,0,2,6,1,2,1,2,3,3,2,4,0,2,0,0,2,1,1,1
2753,19,349,6,4,4,0,0,2,6,0,0,0,0,0,0,0,0,0,0,0,0,2,1,1,1
2754,19,349,7,5,5,0,0,2,7,0,0,0,0,0,0,0,0,0,0,0,0,2,1,1,1
2755,19,349,6,4,4,0,0,2,6,0,0,0,0,0,0,0,0,0,0,0,0,2,1,1,1
2756,19,349,10,6,6,0,0,4,10,0,0,0,0,0,0,0,0,0,0,0,0,2,1,1,1
2757,19,349,1,1,1,0,0,0,1,0,0,0,0,0,0,0,0,0,0,0,0,2,1,1,1
2758,19,349,1,1,1,0,0,0,1,0,0,0,0,0,0,0,0,0,0,0,0,2,1,1,1
2759,19,349,14,10,10,0,0,4,14,1,1,1,1,2,2,0,2,0,1,0,0,2,1,1,1
2760,19,349,46,26,30,3,0,12,49,3,6,3,6,9,9,20,28,1,42,2,0,2,1,1,1
2761,19,842,334,251,279,10,4,40,344,5,127,74,143,132,217,899,1528,2,4303,239,0,2,15,3,1
2762,19,349,127,75,83,2,11,30,129,4,14,7,14,18,21,61,87,2,175,9,0,2,2,2,1
2763,19,349,652,304,544,16,6,88,668,6,89,51,101,95,152,591,998,3,3399,188,0,2,2,2,1
2764,19,349,2,2,2,0,0,0,2,0,0,0,0,0,0,0,0,0,0,0,0,2,2,2,1
2765,19,349,8,5,5,0,0,3,8,0,0,0,0,0,0,0,0,0,0,0,0,2,2,2,1
2766,19,349,2,2,2,0,0,0,2,0,0,0,0,0,0,0,0,0,0,0,0,2,2,2,1
2767,19,349,14,8,8,0,0,6,14,0,0,0,0,0,0,0,0,0,0,0,0,2,2,2,1
2768,19,349,6,4,4,0,0,2,6,0,0,0,0,0,0,0,0,0,0,0,0,2,2,2,1
2769,19,349,6,4,4,0,0,2,6,1,2,1,2,3,3,2,4,0,2,0,0,2,2,2,1
2770,19,349,6,4,4,0,0,2,6,0,0,0,0,0,0,0,0,0,0,0,0,2,2,2,1
2771,19,349,7,5,5,0,0,2,7,0,0,0,0,0,0,0,0,0,0,0,0,2,2,2,1
2772,19,349,6,4,4,0,0,2,6,0,0,0,0,0,0,0,0,0,0,0,0,2,2,2,1
2773,19,349,10,6,6,0,0,4,10,0,0,0,0,0,0,0,0,0,0,0,0,2,2,2,1
2774,19,349,1,1,1,0,0,0,1,0,0,0,0,0,0,0,0,0,0,0,0,2,2,2,1
2775,19,349,1,1,1,0,0,0,1,0,0,0,0,0,0,0,0,0,0,0,0,2,2,2,1
2776,19,349,14,10,10,0,0,4,14,1,1,1,1,2,2,0,2,0,1,0,0,2,2,2,1
2777,19,349,46,26,30,3,0,12,49,3,6,3,6,9,9,20,28,1,42,2,0,2,2,2,1
2778,19,349,127,75,83,2,11,30,129,4,14,7,14,18,21,61,87,2,175,9,0,2,2,2,1
2779,19,349,652,304,544,16,6,88,668,6,89,51,101,95,152,591,998,3,3399,188,0,2,2,2,1
2780,19,349,2,2,2,0,0,0,2,0,0,0,0,0,0,0,0,0,0,0,0,2,2,2,1
2781,19,349,8,5,5,0,0,3,8,0,0,0,0,0,0,0,0,0,0,0,0,2,2,2,1
2782,19,349,2,2,2,0,0,0,2,0,0,0,0,0,0,0,0,0,0,0,0,2,2,2,1
2783,19,349,14,8,8,0,0,6,14,0,0,0,0,0,0,0,0,0,0,0,0,2,2,2,1
2784,19,349,6,4,4,0,0,2,6,0,0,0,0,0,0,0,0,0,0,0,0,2,2,2,1
2785,19,349,6,4,4,0,0,2,6,1,2,1,2,3,3,2,4,0,2,0,0,2,2,2,1
2786,19,349,6,4,4,0,0,2,6,0,0,0,0,0,0,0,0,0,0,0,0,2,2,2,1
2787,19,349,7,5,5,0,0,2,7,0,0,0,0,0,0,0,0,0,0,0,0,2,2,2,1
2788,19,349,6,4,4,0,0,2,6,0,0,0,0,0,0,0,0,0,0,0,0,2,2,2,1
2789,19,349,10,6,6,0,0,4,10,0,0,0,0,0,0,0,0,0,0,0,0,2,2,2,1
2790,19,349,1,1,1,0,0,0,1,0,0,0,0,0,0,0,0,0,0,0,0,2,2,2,1
2791,19,349,1,1,1,0,0,0,1,0,0,0,0,0,0,0,0,0,0,0,0,2,2,2,1
2792,19,349,14,10,10,0,0,4,14,1,1,1,1,2,2,0,2,0,1,0,0,2,2,2,1
2793,19,349,46,26,30,3,0,12,49,3,6,3,6,9,9,20,28,1,42,2,0,2,2,2,1
2794,3,65,127,75,83,2,11,30,129,4,14,7,14,18,21,61,87,2,175,9,0,2,1,1,0
2795,3,65,652,304,544,16,6,88,668,6,89,51,101,95,152,591,998,3,3399,188,0,2,1,1,0
2796,3,65,2,2,2,0,0,0,2,0,0,0,0,0,0,0,0,0,0,0,0,2,1,1,0
2797,3,65,8,5,5,0,0,3,8,0,0,0,0,0,0,0,0,0,0,0,0,2,1,1,0
2798,3,65,2,2,2,0,0,0,2,0,0,0,0,0,0,0,0,0,0,0,0,2,1,1,0
2799,3,65,14,8,8,0,0,6,14,0,0,0,0,0,0,0,0,0,0,0,0,2,1,1,0
2800,3,65,6,4,4,0,0,2,6,0,0,0,0,0,0,0,0,0,0,0,0,2,1,1,0
2801,3,65,6,4,4,0,0,2,6,1,2,1,2,3,3,2,4,0,2,0,0,2,1,1,0
2802,3,65,6,4,4,0,0,2,6,0,0,0,0,0,0,0,0,0,0,0,0,2,1,1,0
2803,3,65,7,5,5,0,0,2,7,0,0,0,0,0,0,0,0,0,0,0,0,2,1,1,0
2804,3,65,6,4,4,0,0,2,6,0,0,0,0,0,0,0,0,0,0,0,0,2,1,1,0
2805,3,65,10,6,6,0,0,4,10,0,0,0,0,0,0,0,0,0,0,0,0,2,1,1,0
2806,3,65,1,1,1,0,0,0,1,0,0,0,0,0,0,0,0,0,0,0,0,2,1,1,0
2807,3,65,1,1,1,0,0,0,1,0,0,0,0,0,0,0,0,0,0,0,0,2,1,1,0
2808,3,65,14,10,10,0,0,4,14,1,1,1,1,2,2,0,2,0,1,0,0,2,1,1,0
2809,3,65,46,26,30,3,0,12,49,3,6,3,6,9,9,20,28,1,42,2,0,2,1,1,0
2810,34,1914,1457,730,1242,11,6,188,1468,10,292,166,329,302,495,2424,4078,5,22973,1276,1,2,1,1,0
2811,133,2248,1338,495,1086,10,64,173,1348,11,122,82,157,133,239,883,1686,7,11934,663,0,2,1,2,1
2812,78,1725,1457,730,1242,11,6,188,1468,10,292,166,329,302,495,2424,4078,5,22973,1276,1,2,2,2,1
2813,78,1725,74,35,59,1,0,14,75,3,14,7,14,17,21,58,85,1,128,7,0,2,2,2,1
2814,78,1725,245,125,200,5,7,34,250,7,30,17,34,37,51,166,265,3,1053,58,0,2,2,2,1
2815,102,3815,1392,870,1177,35,17,170,1427,14,494,280,531,508,811,4473,7289,7,54850,3047,2,2,1,1,1
2816,7,160,127,75,83,2,11,30,129,4,14,7,14,18,21,61,87,2,175,9,0,2,1,1,1
2817,7,160,652,304,544,16,6,88,668,6,89,51,101,95,152,591,998,3,3399,188,0,2,1,1,1
2818,7,160,2,2,2,0,0,0,2,0,0,0,0,0,0,0,0,0,0,0,0,2,1,1,1
2819,7,160,8,5,5,0,0,3,8,0,0,0,0,0,0,0,0,0,0,0,0,2,1,1,1
2820,7,160,2,2,2,0,0,0,2,0,0,0,0,0,0,0,0,0,0,0,0,2,1,1,1
2821,7,160,14,8,8,0,0,6,14,0,0,0,0,0,0,0,0,0,0,0,0,2,1,1,1
2822,7,160,6,4,4,0,0,2,6,0,0,0,0,0,0,0,0,0,0,0,0,2,1,1,1
2823,7,160,6,4,4,0,0,2,6,1,2,1,2,3,3,2,4,0,2,0,0,2,1,1,1
2824,7,160,6,4,4,0,0,2,6,0,0,0,0,0,0,0,0,0,0,0,0,2,1,1,1
2825,7,160,7,5,5,0,0,2,7,0,0,0,0,0,0,0,0,0,0,0,0,2,1,1,1
2826,7,160,6,4,4,0,0,2,6,0,0,0,0,0,0,0,0,0,0,0,0,2,1,1,1
2827,7,160,10,6,6,0,0,4,10,0,0,0,0,0,0,0,0,0,0,0,0,2,1,1,1
2828,7,160,1,1,1,0,0,0,1,0,0,0,0,0,0,0,0,0,0,0,0,2,1,1,1
2829,7,160,1,1,1,0,0,0,1,0,0,0,0,0,0,0,0,0,0,0,0,2,1,1,1
2830,7,160,14,10,10,0,0,4,14,1,1,1,1,2,2,0,2,0,1,0,0,2,1,1,1
2831,7,160,46,26,30,3,0,12,49,3,6,3,6,9,9,20,28,1,42,2,0,2,1,1,1
2832,15,439,1450,624,1228,12,26,181,1462,14,306,186,354,320,540,2580,4493,8,36391,2021,1,2,1,1,1
2833,187,4157,182,127,129,0,0,53,182,5,39,21,42,44,63,217,343,2,926,51,0,2,3,0,1
2834,187,4157,1165,710,800,67,119,181,1232,18,243,153,282,261,435,2000,3492,10,36473,2026,1,2,3,0,1
2835,42,935,1450,624,1228,12,26,181,1462,14,306,186,354,320,540,2580,4493,8,36391,2021,1,2,2,0,1
2836,34,1126,182,127,129,0,0,53,182,5,39,21,42,44,63,217,343,2,926,51,0,2,6,0,1
2837,102,3816,1392,870,1177,35,17,170,1427,14,494,280,531,508,811,4473,7289,7,54850,3047,2,2,1,1,1
2838,42,923,1450,624,1228,12,26,181,1462,14,306,186,354,320,540,2580,4493,8,36391,2021,1,2,1,1,0
2839,42,923,1450,624,1228,12,26,181,1462,14,306,186,354,320,540,2580,4493,8,36391,2021,1,2,1,1,0
2840,2,206,42,7,35,4,0,5,46,1,2,1,2,3,3,2,4,0,2,0,0,2,8,13,1
2841,2,206,11,6,10,0,0,1,11,2,4,2,4,6,6,10,15,1,15,0,0,2,8,13,1
2842,2,180,42,7,35,4,0,5,46,1,2,1,2,3,3,2,4,0,2,0,0,2,7,22,1
2843,2,180,11,6,10,0,0,1,11,2,4,2,4,6,6,10,15,1,15,0,0,2,7,22,1
2844,19,385,127,75,83,2,11,30,129,4,14,7,14,18,21,61,87,2,175,9,0,2,10,1,0
2845,19,385,652,304,544,16,6,88,668,6,89,51,101,95,152,591,998,3,3399,188,0,2,10,1,0
2846,19,385,2,2,2,0,0,0,2,0,0,0,0,0,0,0,0,0,0,0,0,2,10,1,0
2847,19,385,8,5,5,0,0,3,8,0,0,0,0,0,0,0,0,0,0,0,0,2,10,1,0
2848,19,385,2,2,2,0,0,0,2,0,0,0,0,0,0,0,0,0,0,0,0,2,10,1,0
2849,19,385,14,8,8,0,0,6,14,0,0,0,0,0,0,0,0,0,0,0,0,2,10,1,0
2850,19,385,6,4,4,0,0,2,6,0,0,0,0,0,0,0,0,0,0,0,0,2,10,1,0
2851,19,385,6,4,4,0,0,2,6,1,2,1,2,3,3,2,4,0,2,0,0,2,10,1,0
2852,19,385,6,4,4,0,0,2,6,0,0,0,0,0,0,0,0,0,0,0,0,2,10,1,0
2853,19,385,7,5,5,0,0,2,7,0,0,0,0,0,0,0,0,0,0,0,0,2,10,1,0
2854,19,385,6,4,4,0,0,2,6,0,0,0,0,0,0,0,0,0,0,0,0,2,10,1,0
2855,19,385,10,6,6,0,0,4,10,0,0,0,0,0,0,0,0,0,0,0,0,2,10,1,0
2856,19,385,1,1,1,0,0,0,1,0,0,0,0,0,0,0,0,0,0,0,0,2,10,1,0
2857,19,385,1,1,1,0,0,0,1,0,0,0,0,0,0,0,0,0,0,0,0,2,10,1,0
2858,19,385,14,10,10,0,0,4,14,1,1,1,1,2,2,0,2,0,1,0,0,2,10,1,0
2859,19,385,46,26,30,3,0,12,49,3,6,3,6,9,9,20,28,1,42,2,0,2,10,1,0
2860,79,1735,1457,730,1242,11,6,188,1468,10,292,166,329,302,495,2424,4078,5,22973,1276,1,2,2,2,1
2861,79,1735,74,35,59,1,0,14,75,3,14,7,14,17,21,58,85,1,128,7,0,2,2,2,1
2862,79,1735,245,125,200,5,7,34,250,7,30,17,34,37,51,166,265,3,1053,58,0,2,2,2,1
2863,15,443,1450,624,1228,12,26,181,1462,14,306,186,354,320,540,2580,4493,8,36391,2021,1,3,2,2,1
2864,187,4163,182,127,129,0,0,53,182,5,39,21,42,44,63,217,343,2,926,51,0,3,3,3,1
2865,187,4163,1165,710,800,67,119,181,1232,18,243,153,282,261,435,2000,3492,10,36473,2026,1,3,3,3,1
2866,133,2248,1338,495,1086,10,64,173,1348,11,122,82,157,133,239,883,1686,7,11934,663,0,3,1,1,1
2867,79,1724,1457,730,1242,11,6,188,1468,10,292,166,329,302,495,2424,4078,5,22973,1276,1,3,4,5,1
2868,79,1724,74,35,59,1,0,14,75,3,14,7,14,17,21,58,85,1,128,7,0,3,4,5,1
2869,79,1724,245,125,200,5,7,34,250,7,30,17,34,37,51,166,265,3,1053,58,0,3,4,5,1
2870,78,1724,384,251,317,7,8,52,391,11,70,44,84,81,128,467,811,6,5355,297,0,3,7,6,1
2871,36,671,373,158,315,8,0,51,381,5,76,44,79,81,123,486,779,2,2026,112,0,3,1,1,1
2872,2,180,42,7,35,4,0,5,46,1,2,1,2,3,3,2,4,0,2,0,0,2,13,12,1
2873,2,180,11,6,10,0,0,1,11,2,4,2,4,6,6,10,15,1,15,0,0,2,13,12,1
2874,42,923,1450,624,1228,12,26,181,1462,14,306,186,354,320,540,2580,4493,8,36391,2021,1,2,1,1,1
2875,34,1130,182,127,129,0,0,53,182,5,39,21,42,44,63,217,343,2,926,51,0,2,2,2,1
2876,102,3818,1392,870,1177,35,17,170,1427,14,494,280,531,508,811,4473,7289,7,54850,3047,2,2,1,1,1
2877,55,1920,773,419,590,28,0,166,801,10,204,113,217,214,330,1598,2554,5,13587,754,0,2,5,5,1
2878,47,1955,1513,682,1277,25,13,200,1538,11,199,116,219,210,335,1557,2584,6,15641,868,0,2,1,1,1
2879,11,515,127,75,83,2,11,30,129,4,14,7,14,18,21,61,87,2,175,9,0,2,1,1,1
2880,11,515,652,304,544,16,6,88,668,6,89,51,101,95,152,591,998,3,3399,188,0,2,1,1,1
2881,11,515,2,2,2,0,0,0,2,0,0,0,0,0,0,0,0,0,0,0,0,2,1,1,1
2882,11,515,8,5,5,0,0,3,8,0,0,0,0,0,0,0,0,0,0,0,0,2,1,1,1
2883,11,515,2,2,2,0,0,0,2,0,0,0,0,0,0,0,0,0,0,0,0,2,1,1,1
2884,11,515,14,8,8,0,0,6,14,0,0,0,0,0,0,0,0,0,0,0,0,2,1,1,1
2885,11,515,6,4,4,0,0,2,6,0,0,0,0,0,0,0,0,0,0,0,0,2,1,1,1
2886,11,515,6,4,4,0,0,2,6,1,2,1,2,3,3,2,4,0,2,0,0,2,1,1,1
2887,11,515,6,4,4,0,0,2,6,0,0,0,0,0,0,0,0,0,0,0,0,2,1,1,1
2888,11,515,7,5,5,0,0,2,7,0,0,0,0,0,0,0,0,0,0,0,0,2,1,1,1
2889,11,515,6,4,4,0,0,2,6,0,0,0,0,0,0,0,0,0,0,0,0,2,1,1,1
2890,11,515,10,6,6,0,0,4,10,0,0,0,0,0,0,0,0,0,0,0,0,2,1,1,1
2891,11,515,1,1,1,0,0,0,1,0,0,0,0,0,0,0,0,0,0,0,0,2,1,1,1
2892,11,515,1,1,1,0,0,0,1,0,0,0,0,0,0,0,0,0,0,0,0,2,1,1,1
2893,11,515,14,10,10,0,0,4,14,1,1,1,1,2,2,0,2,0,1,0,0,2,1,1,1
2894,11,515,46,26,30,3,0,12,49,3,6,3,6,9,9,20,28,1,42,2,0,2,1,1,1
2895,7,172,127,75,83,2,11,30,129,4,14,7,14,18,21,61,87,2,175,9,0,3,3,2,1
2896,7,172,652,304,544,16,6,88,668,6,89,51,101,95,152,591,998,3,3399,188,0,3,3,2,1
2897,7,172,2,2,2,0,0,0,2,0,0,0,0,0,0,0,0,0,0,0,0,3,3,2,1
2898,7,172,8,5,5,0,0,3,8,0,0,0,0,0,0,0,0,0,0,0,0,3,3,2,1
2899,7,172,2,2,2,0,0,0,2,0,0,0,0,0,0,0,0,0,0,0,0,3,3,2,1
2900,7,172,14,8,8,0,0,6,14,0,0,0,0,0,0,0,0,0,0,0,0,3,3,2,1
2901,7,172,6,4,4,0,0,2,6,0,0,0,0,0,0,0,0,0,0,0,0,3,3,2,1
2902,7,172,6,4,4,0,0,2,6,1,2,1,2,3,3,2,4,0,2,0,0,3,3,2,1
2903,7,172,6,4,4,0,0,2,6,0,0,0,0,0,0,0,0,0,0,0,0,3,3,2,1
2904,7,172,7,5,5,0,0,2,7,0,0,0,0,0,0,0,0,0,0,0,0,3,3,2,1
2905,7,172,6,4,4,0,0,2,6,0,0,0,0,0,0,0,0,0,0,0,0,3,3,2,1
2906,7,172,10,6,6,0,0,4,10,0,0,0,0,0,0,0,0,0,0,0,0,3,3,2,1
2907,7,172,1,1,1,0,0,0,1,0,0,0,0,0,0,0,0,0,0,0,0,3,3,2,1
2908,7,172,1,1,1,0,0,0,1,0,0,0,0,0,0,0,0,0,0,0,0,3,3,2,1
2909,7,172,14,10,10,0,0,4,14,1,1,1,1,2,2,0,2,0,1,0,0,3,3,2,1
2910,7,172,46,26,30,3,0,12,49,3,6,3,6,9,9,20,28,1,42,2,0,3,3,2,1
2911,4,227,207,111,150,11,0,50,218,5,26,19,36,31,55,133,272,3,943,52,0,2,2,2,1
2912,34,1920,1457,730,1242,11,6,188,1468,10,292,166,329,302,495,2424,4078,5,22973,1276,1,2,3,3,1
2913,19,844,334,251,279,10,4,40,344,5,127,74,143,132,217,899,1528,2,4303,239,0,2,1,1,1
2914,30,1542,384,251,317,7,8,52,391,11,70,44,84,81,128,467,811,6,5355,297,0,2,3,3,1
2915,28,551,334,251,279,10,4,40,344,5,127,74,143,132,217,899,1528,2,4303,239,0,2,1,0,1
2916,2,178,42,7,35,4,0,5,46,1,2,1,2,3,3,2,4,0,2,0,0,2,2,3,1
2917,2,178,11,6,10,0,0,1,11,2,4,2,4,6,6,10,15,1,15,0,0,2,2,3,1
2918,2,178,42,7,35,4,0,5,46,1,2,1,2,3,3,2,4,0,2,0,0,2,1,1,0
2919,2,178,11,6,10,0,0,1,11,2,4,2,4,6,6,10,15,1,15,0,0,2,1,1,0
2920,9,523,1289,550,1043,56,32,155,1345,10,167,93,185,177,278,1266,2075,5,11498,638,0,2,3,3,0
2921,79,1731,1457,730,1242,11,6,188,1468,10,292,166,329,302,495,2424,4078,5,22973,1276,1,2,1,0,1
2922,79,1731,74,35,59,1,0,14,75,3,14,7,14,17,21,58,85,1,128,7,0,2,1,0,1
2923,79,1731,245,125,200,5,7,34,250,7,30,17,34,37,51,166,265,3,1053,58,0,2,1,0,1
2924,81,1771,384,251,317,7,8,52,391,11,70,44,84,81,128,467,811,6,5355,297,0,2,8,0,1
2925,33,1635,384,251,317,7,8,52,391,11,70,44,84,81,128,467,811,6,5355,297,0,2,18,0,1
2926,82,1777,384,251,317,7,8,52,391,11,70,44,84,81,128,467,811,6,5355,297,0,2,4,1,0
2927,34,1678,384,251,317,7,8,52,391,11,70,44,84,81,128,467,811,6,5355,297,0,2,7,0,0
2928,44,869,215,129,180,6,0,29,221,8,65,43,72,73,115,415,711,4,3153,175,0,2,2,0,0
2929,44,869,97,69,77,3,3,16,100,6,22,13,23,28,36,113,173,3,542,30,0,2,2,0,0
2930,4,84,127,75,83,2,11,30,129,4,14,7,14,18,21,61,87,2,175,9,0,2,3,0,1
2931,4,84,652,304,544,16,6,88,668,6,89,51,101,95,152,591,998,3,3399,188,0,2,3,0,1
2932,4,84,2,2,2,0,0,0,2,0,0,0,0,0,0,0,0,0,0,0,0,2,3,0,1
2933,4,84,8,5,5,0,0,3,8,0,0,0,0,0,0,0,0,0,0,0,0,2,3,0,1
2934,4,84,2,2,2,0,0,0,2,0,0,0,0,0,0,0,0,0,0,0,0,2,3,0,1
2935,4,84,14,8,8,0,0,6,14,0,0,0,0,0,0,0,0,0,0,0,0,2,3,0,1
2936,4,84,6,4,4,0,0,2,6,0,0,0,0,0,0,0,0,0,0,0,0,2,3,0,1
2937,4,84,6,4,4,0,0,2,6,1,2,1,2,3,3,2,4,0,2,0,0,2,3,0,1
2938,4,84,6,4,4,0,0,2,6,0,0,0,0,0,0,0,0,0,0,0,0,2,3,0,1
2939,4,84,7,5,5,0,0,2,7,0,0,0,0,0,0,0,0,0,0,0,0,2,3,0,1
2940,4,84,6,4,4,0,0,2,6,0,0,0,0,0,0,0,0,0,0,0,0,2,3,0,1
2941,4,84,10,6,6,0,0,4,10,0,0,0,0,0,0,0,0,0,0,0,0,2,3,0,1
2942,4,84,1,1,1,0,0,0,1,0,0,0,0,0,0,0,0,0,0,0,0,2,3,0,1
2943,4,84,1,1,1,0,0,0,1,0,0,0,0,0,0,0,0,0,0,0,0,2,3,0,1
2944,4,84,14,10,10,0,0,4,14,1,1,1,1,2,2,0,2,0,1,0,0,2,3,0,1
2945,4,84,46,26,30,3,0,12,49,3,6,3,6,9,9,20,28,1,42,2,0,2,3,0,1
2946,45,961,1450,624,1228,12,26,181,1462,14,306,186,354,320,540,2580,4493,8,36391,2021,1,2,8,0,0
2947,19,392,127,75,83,2,11,30,129,4,14,7,14,18,21,61,87,2,175,9,0,2,2,0,0
2948,19,392,652,304,544,16,6,88,668,6,89,51,101,95,152,591,998,3,3399,188,0,2,2,0,0
2949,19,392,2,2,2,0,0,0,2,0,0,0,0,0,0,0,0,0,0,0,0,2,2,0,0
2950,19,392,8,5,5,0,0,3,8,0,0,0,0,0,0,0,0,0,0,0,0,2,2,0,0
2951,19,392,2,2,2,0,0,0,2,0,0,0,0,0,0,0,0,0,0,0,0,2,2,0,0
2952,19,392,14,8,8,0,0,6,14,0,0,0,0,0,0,0,0,0,0,0,0,2,2,0,0
2953,19,392,6,4,4,0,0,2,6,0,0,0,0,0,0,0,0,0,0,0,0,2,2,0,0
2954,19,392,6,4,4,0,0,2,6,1,2,1,2,3,3,2,4,0,2,0,0,2,2,0,0
2955,19,392,6,4,4,0,0,2,6,0,0,0,0,0,0,0,0,0,0,0,0,2,2,0,0
2956,19,392,7,5,5,0,0,2,7,0,0,0,0,0,0,0,0,0,0,0,0,2,2,0,0
2957,19,392,6,4,4,0,0,2,6,0,0,0,0,0,0,0,0,0,0,0,0,2,2,0,0
2958,19,392,10,6,6,0,0,4,10,0,0,0,0,0,0,0,0,0,0,0,0,2,2,0,0
2959,19,392,1,1,1,0,0,0,1,0,0,0,0,0,0,0,0,0,0,0,0,2,2,0,0
2960,19,392,1,1,1,0,0,0,1,0,0,0,0,0,0,0,0,0,0,0,0,2,2,0,0
2961,19,392,14,10,10,0,0,4,14,1,1,1,1,2,2,0,2,0,1,0,0,2,2,0,0
2962,19,392,46,26,30,3,0,12,49,3,6,3,6,9,9,20,28,1,42,2,0,2,2,0,0
2963,40,353,647,139,84,35,284,233,682,0,0,0,0,0,0,0,0,0,0,0,0,2,3,3,0
2964,8,346,42,7,35,4,0,5,46,1,2,1,2,3,3,2,4,0,2,0,0,2,27,9,1
2965,8,346,11,6,10,0,0,1,11,2,4,2,4,6,6,10,15,1,15,0,0,2,27,9,1
2966,8,346,42,7,35,4,0,5,46,1,2,1,2,3,3,2,4,0,2,0,0,2,1,1,0
2967,8,346,11,6,10,0,0,1,11,2,4,2,4,6,6,10,15,1,15,0,0,2,1,1,0
2968,9,523,1289,550,1043,56,32,155,1345,10,167,93,185,177,278,1266,2075,5,11498,638,0,2,3,3,0
2969,135,2281,1338,495,1086,10,64,173,1348,11,122,82,157,133,239,883,1686,7,11934,663,0,2,6,2,0
2970,11,531,127,75,83,2,11,30,129,4,14,7,14,18,21,61,87,2,175,9,0,2,10,7,0
2971,11,531,652,304,544,16,6,88,668,6,89,51,101,95,152,591,998,3,3399,188,0,2,10,7,0
2972,11,531,2,2,2,0,0,0,2,0,0,0,0,0,0,0,0,0,0,0,0,2,10,7,0
2973,11,531,8,5,5,0,0,3,8,0,0,0,0,0,0,0,0,0,0,0,0,2,10,7,0
2974,11,531,2,2,2,0,0,0,2,0,0,0,0,0,0,0,0,0,0,0,0,2,10,7,0
2975,11,531,14,8,8,0,0,6,14,0,0,0,0,0,0,0,0,0,0,0,0,2,10,7,0
2976,11,531,6,4,4,0,0,2,6,0,0,0,0,0,0,0,0,0,0,0,0,2,10,7,0
2977,11,531,6,4,4,0,0,2,6,1,2,1,2,3,3,2,4,0,2,0,0,2,10,7,0
2978,11,531,6,4,4,0,0,2,6,0,0,0,0,0,0,0,0,0,0,0,0,2,10,7,0
2979,11,531,7,5,5,0,0,2,7,0,0,0,0,0,0,0,0,0,0,0,0,2,10,7,0
2980,11,531,6,4,4,0,0,2,6,0,0,0,0,0,0,0,0,0,0,0,0,2,10,7,0
2981,11,531,10,6,6,0,0,4,10,0,0,0,0,0,0,0,0,0,0,0,0,2,10,7,0
2982,11,531,1,1,1,0,0,0,1,0,0,0,0,0,0,0,0,0,0,0,0,2,10,7,0
2983,11,531,1,1,1,0,0,0,1,0,0,0,0,0,0,0,0,0,0,0,0,2,10,7,0
2984,11,531,14,10,10,0,0,4,14,1,1,1,1,2,2,0,2,0,1,0,0,2,10,7,0
2985,11,531,46,26,30,3,0,12,49,3,6,3,6,9,9,20,28,1,42,2,0,2,10,7,0
2986,135,2281,1338,495,1086,10,64,173,1348,11,122,82,157,133,239,883,1686,7,11934,663,0,2,1,1,0
2987,81,1777,1457,730,1242,11,6,188,1468,10,292,166,329,302,495,2424,4078,5,22973,1276,1,2,8,1,0
2988,81,1777,74,35,59,1,0,14,75,3,14,7,14,17,21,58,85,1,128,7,0,2,8,1,0
2989,81,1777,245,125,200,5,7,34,250,7,30,17,34,37,51,166,265,3,1053,58,0,2,8,1,0
2990,80,1795,384,251,317,7,8,52,391,11,70,44,84,81,128,467,811,6,5355,297,0,2,12,11,0
2991,7,170,127,75,83,2,11,30,129,4,14,7,14,18,21,61,87,2,175,9,0,2,1,1,0
2992,7,170,652,304,544,16,6,88,668,6,89,51,101,95,152,591,998,3,3399,188,0,2,1,1,0
2993,7,170,2,2,2,0,0,0,2,0,0,0,0,0,0,0,0,0,0,0,0,2,1,1,0
2994,7,170,8,5,5,0,0,3,8,0,0,0,0,0,0,0,0,0,0,0,0,2,1,1,0
2995,7,170,2,2,2,0,0,0,2,0,0,0,0,0,0,0,0,0,0,0,0,2,1,1,0
2996,7,170,14,8,8,0,0,6,14,0,0,0,0,0,0,0,0,0,0,0,0,2,1,1,0
2997,7,170,6,4,4,0,0,2,6,0,0,0,0,0,0,0,0,0,0,0,0,2,1,1,0
2998,7,170,6,4,4,0,0,2,6,1,2,1,2,3,3,2,4,0,2,0,0,2,1,1,0
2999,7,170,6,4,4,0,0,2,6,0,0,0,0,0,0,0,0,0,0,0,0,2,1,1,0
3000,7,170,7,5,5,0,0,2,7,0,0,0,0,0,0,0,0,0,0,0,0,2,1,1,0
3001,7,170,6,4,4,0,0,2,6,0,0,0,0,0,0,0,0,0,0,0,0,2,1,1,0
3002,7,170,10,6,6,0,0,4,10,0,0,0,0,0,0,0,0,0,0,0,0,2,1,1,0
3003,7,170,1,1,1,0,0,0,1,0,0,0,0,0,0,0,0,0,0,0,0,2,1,1,0
3004,7,170,1,1,1,0,0,0,1,0,0,0,0,0,0,0,0,0,0,0,0,2,1,1,0
3005,7,170,14,10,10,0,0,4,14,1,1,1,1,2,2,0,2,0,1,0,0,2,1,1,0
3006,7,170,46,26,30,3,0,12,49,3,6,3,6,9,9,20,28,1,42,2,0,2,1,1,0
3007,34,1680,384,251,317,7,8,52,391,11,70,44,84,81,128,467,811,6,5355,297,0,2,6,3,0
3008,60,1259,384,251,317,7,8,52,391,11,70,44,84,81,128,467,811,6,5355,297,0,2,1,101,1
3009,40,355,647,139,84,35,284,233,682,0,0,0,0,0,0,0,0,0,0,0,0,2,1,1,1
3010,31,1596,384,251,317,7,8,52,391,11,70,44,84,81,128,467,811,6,5355,297,0,2,3,15,1
3011,81,1754,1457,730,1242,11,6,188,1468,10,292,166,329,302,495,2424,4078,5,22973,1276,1,2,2,3,1
3012,81,1754,74,35,59,1,0,14,75,3,14,7,14,17,21,58,85,1,128,7,0,2,2,3,1
3013,81,1754,245,125,200,5,7,34,250,7,30,17,34,37,51,166,265,3,1053,58,0,2,2,3,1
3014,93,1908,384,251,317,7,8,52,391,11,70,44,84,81,128,467,811,6,5355,297,0,2,127,16,1
3015,33,1899,1457,730,1242,11,6,188,1468,10,292,166,329,302,495,2424,4078,5,22973,1276,1,2,0,3,1
3016,61,2672,384,251,317,7,8,52,391,11,70,44,84,81,128,467,811,6,5355,297,0,2,183,0,1
3017,80,1713,1457,730,1242,11,6,188,1468,10,292,166,329,302,495,2424,4078,5,22973,1276,1,2,11,24,1
3018,80,1713,74,35,59,1,0,14,75,3,14,7,14,17,21,58,85,1,128,7,0,2,11,24,1
3019,80,1713,245,125,200,5,7,34,250,7,30,17,34,37,51,166,265,3,1053,58,0,2,11,24,1
3020,81,1725,1457,730,1242,11,6,188,1468,10,292,166,329,302,495,2424,4078,5,22973,1276,1,2,14,6,1
3021,81,1725,74,35,59,1,0,14,75,3,14,7,14,17,21,58,85,1,128,7,0,2,14,6,1
3022,81,1725,245,125,200,5,7,34,250,7,30,17,34,37,51,166,265,3,1053,58,0,2,14,6,1
3023,93,1911,384,251,317,7,8,52,391,11,70,44,84,81,128,467,811,6,5355,297,0,2,1,2,1
3024,8,391,1289,550,1043,56,32,155,1345,10,167,93,185,177,278,1266,2075,5,11498,638,0,2,16,1,1
3025,61,2672,384,251,317,7,8,52,391,11,70,44,84,81,128,467,811,6,5355,297,0,2,1,0,1
3026,17,360,127,75,83,2,11,30,129,4,14,7,14,18,21,61,87,2,175,9,0,2,4,8,1
3027,17,360,652,304,544,16,6,88,668,6,89,51,101,95,152,591,998,3,3399,188,0,2,4,8,1
3028,17,360,2,2,2,0,0,0,2,0,0,0,0,0,0,0,0,0,0,0,0,2,4,8,1
3029,17,360,8,5,5,0,0,3,8,0,0,0,0,0,0,0,0,0,0,0,0,2,4,8,1
3030,17,360,2,2,2,0,0,0,2,0,0,0,0,0,0,0,0,0,0,0,0,2,4,8,1
3031,17,360,14,8,8,0,0,6,14,0,0,0,0,0,0,0,0,0,0,0,0,2,4,8,1
3032,17,360,6,4,4,0,0,2,6,0,0,0,0,0,0,0,0,0,0,0,0,2,4,8,1
3033,17,360,6,4,4,0,0,2,6,1,2,1,2,3,3,2,4,0,2,0,0,2,4,8,1
3034,17,360,6,4,4,0,0,2,6,0,0,0,0,0,0,0,0,0,0,0,0,2,4,8,1
3035,17,360,7,5,5,0,0,2,7,0,0,0,0,0,0,0,0,0,0,0,0,2,4,8,1
3036,17,360,6,4,4,0,0,2,6,0,0,0,0,0,0,0,0,0,0,0,0,2,4,8,1
3037,17,360,10,6,6,0,0,4,10,0,0,0,0,0,0,0,0,0,0,0,0,2,4,8,1
3038,17,360,1,1,1,0,0,0,1,0,0,0,0,0,0,0,0,0,0,0,0,2,4,8,1
3039,17,360,1,1,1,0,0,0,1,0,0,0,0,0,0,0,0,0,0,0,0,2,4,8,1
3040,17,360,14,10,10,0,0,4,14,1,1,1,1,2,2,0,2,0,1,0,0,2,4,8,1
3041,17,360,46,26,30,3,0,12,49,3,6,3,6,9,9,20,28,1,42,2,0,2,4,8,1
3042,79,1661,1457,730,1242,11,6,188,1468,10,292,166,329,302,495,2424,4078,5,22973,1276,1,2,0,13,1
3043,79,1661,74,35,59,1,0,14,75,3,14,7,14,17,21,58,85,1,128,7,0,2,0,13,1
3044,79,1661,245,125,200,5,7,34,250,7,30,17,34,37,51,166,265,3,1053,58,0,2,0,13,1
3045,33,1845,1457,730,1242,11,6,188,1468,10,292,166,329,302,495,2424,4078,5,22973,1276,1,2,29,31,1
3046,61,2664,384,251,317,7,8,52,391,11,70,44,84,81,128,467,811,6,5355,297,0,2,0,1,1
3047,20,851,373,158,315,8,0,51,381,5,76,44,79,81,123,486,779,2,2026,112,0,2,2,2,1
3048,32,1814,1457,730,1242,11,6,188,1468,10,292,166,329,302,495,2424,4078,5,22973,1276,1,2,0,14,0
3049,11,552,127,75,83,2,11,30,129,4,14,7,14,18,21,61,87,2,175,9,0,2,4,2,1
3050,11,552,652,304,544,16,6,88,668,6,89,51,101,95,152,591,998,3,3399,188,0,2,4,2,1
3051,11,552,2,2,2,0,0,0,2,0,0,0,0,0,0,0,0,0,0,0,0,2,4,2,1
3052,11,552,8,5,5,0,0,3,8,0,0,0,0,0,0,0,0,0,0,0,0,2,4,2,1
3053,11,552,2,2,2,0,0,0,2,0,0,0,0,0,0,0,0,0,0,0,0,2,4,2,1
3054,11,552,14,8,8,0,0,6,14,0,0,0,0,0,0,0,0,0,0,0,0,2,4,2,1
3055,11,552,6,4,4,0,0,2,6,0,0,0,0,0,0,0,0,0,0,0,0,2,4,2,1
3056,11,552,6,4,4,0,0,2,6,1,2,1,2,3,3,2,4,0,2,0,0,2,4,2,1
3057,11,552,6,4,4,0,0,2,6,0,0,0,0,0,0,0,0,0,0,0,0,2,4,2,1
3058,11,552,7,5,5,0,0,2,7,0,0,0,0,0,0,0,0,0,0,0,0,2,4,2,1
3059,11,552,6,4,4,0,0,2,6,0,0,0,0,0,0,0,0,0,0,0,0,2,4,2,1
3060,11,552,10,6,6,0,0,4,10,0,0,0,0,0,0,0,0,0,0,0,0,2,4,2,1
3061,11,552,1,1,1,0,0,0,1,0,0,0,0,0,0,0,0,0,0,0,0,2,4,2,1
3062,11,552,1,1,1,0,0,0,1,0,0,0,0,0,0,0,0,0,0,0,0,2,4,2,1
3063,11,552,14,10,10,0,0,4,14,1,1,1,1,2,2,0,2,0,1,0,0,2,4,2,1
3064,11,552,46,26,30,3,0,12,49,3,6,3,6,9,9,20,28,1,42,2,0,2,4,2,1
3065,79,1661,1457,730,1242,11,6,188,1468,10,292,166,329,302,495,2424,4078,5,22973,1276,1,2,1,0,1
3066,79,1661,74,35,59,1,0,14,75,3,14,7,14,17,21,58,85,1,128,7,0,2,1,0,1
3067,79,1661,245,125,200,5,7,34,250,7,30,17,34,37,51,166,265,3,1053,58,0,2,1,0,1
3068,95,3781,1392,870,1177,35,17,170,1427,14,494,280,531,508,811,4473,7289,7,54850,3047,2,2,48,58,1
3069,55,1911,773,419,590,28,0,166,801,10,204,113,217,214,330,1598,2554,5,13587,754,0,2,1,2,1
3070,8,388,1289,550,1043,56,32,155,1345,10,167,93,185,177,278,1266,2075,5,11498,638,0,2,3,3,1
3071,32,1815,1457,730,1242,11,6,188,1468,10,292,166,329,302,495,2424,4078,5,22973,1276,1,2,2,2,1
3072,139,2371,1338,495,1086,10,64,173,1348,11,122,82,157,133,239,883,1686,7,11934,663,0,2,15,3,1
3073,82,1712,1457,730,1242,11,6,188,1468,10,292,166,329,302,495,2424,4078,5,22973,1276,1,2,7,0,1
3074,82,1712,74,35,59,1,0,14,75,3,14,7,14,17,21,58,85,1,128,7,0,2,7,0,1
3075,82,1712,245,125,200,5,7,34,250,7,30,17,34,37,51,166,265,3,1053,58,0,2,7,0,1
3076,90,1868,384,251,317,7,8,52,391,11,70,44,84,81,128,467,811,6,5355,297,0,2,14,18,1
3077,57,2496,384,251,317,7,8,52,391,11,70,44,84,81,128,467,811,6,5355,297,0,2,0,26,1
3078,140,2381,1338,495,1086,10,64,173,1348,11,122,82,157,133,239,883,1686,7,11934,663,0,2,4,1,1
3079,82,1712,1457,730,1242,11,6,188,1468,10,292,166,329,302,495,2424,4078,5,22973,1276,1,2,1,1,1
3080,82,1712,74,35,59,1,0,14,75,3,14,7,14,17,21,58,85,1,128,7,0,2,1,1,1
3081,82,1712,245,125,200,5,7,34,250,7,30,17,34,37,51,166,265,3,1053,58,0,2,1,1,1
3082,11,574,127,75,83,2,11,30,129,4,14,7,14,18,21,61,87,2,175,9,0,2,2,0,0
3083,11,574,652,304,544,16,6,88,668,6,89,51,101,95,152,591,998,3,3399,188,0,2,2,0,0
3084,11,574,2,2,2,0,0,0,2,0,0,0,0,0,0,0,0,0,0,0,0,2,2,0,0
3085,11,574,8,5,5,0,0,3,8,0,0,0,0,0,0,0,0,0,0,0,0,2,2,0,0
3086,11,574,2,2,2,0,0,0,2,0,0,0,0,0,0,0,0,0,0,0,0,2,2,0,0
3087,11,574,14,8,8,0,0,6,14,0,0,0,0,0,0,0,0,0,0,0,0,2,2,0,0
3088,11,574,6,4,4,0,0,2,6,0,0,0,0,0,0,0,0,0,0,0,0,2,2,0,0
3089,11,574,6,4,4,0,0,2,6,1,2,1,2,3,3,2,4,0,2,0,0,2,2,0,0
3090,11,574,6,4,4,0,0,2,6,0,0,0,0,0,0,0,0,0,0,0,0,2,2,0,0
3091,11,574,7,5,5,0,0,2,7,0,0,0,0,0,0,0,0,0,0,0,0,2,2,0,0
3092,11,574,6,4,4,0,0,2,6,0,0,0,0,0,0,0,0,0,0,0,0,2,2,0,0
3093,11,574,10,6,6,0,0,4,10,0,0,0,0,0,0,0,0,0,0,0,0,2,2,0,0
3094,11,574,1,1,1,0,0,0,1,0,0,0,0,0,0,0,0,0,0,0,0,2,2,0,0
3095,11,574,1,1,1,0,0,0,1,0,0,0,0,0,0,0,0,0,0,0,0,2,2,0,0
3096,11,574,14,10,10,0,0,4,14,1,1,1,1,2,2,0,2,0,1,0,0,2,2,0,0
3097,11,574,46,26,30,3,0,12,49,3,6,3,6,9,9,20,28,1,42,2,0,2,2,0,0
3098,139,2371,1338,495,1086,10,64,173,1348,11,122,82,157,133,239,883,1686,7,11934,663,0,2,1,4,1
3099,82,1712,1457,730,1242,11,6,188,1468,10,292,166,329,302,495,2424,4078,5,22973,1276,1,2,1,1,0
3100,82,1712,74,35,59,1,0,14,75,3,14,7,14,17,21,58,85,1,128,7,0,2,1,1,0
3101,82,1712,245,125,200,5,7,34,250,7,30,17,34,37,51,166,265,3,1053,58,0,2,1,1,0
3102,8,420,1289,550,1043,56,32,155,1345,10,167,93,185,177,278,1266,2075,5,11498,638,0,2,0,33,0
3103,31,1779,1457,730,1242,11,6,188,1468,10,292,166,329,302,495,2424,4078,5,22973,1276,1,2,0,17,0
3104,140,2380,1338,495,1086,10,64,173,1348,11,122,82,157,133,239,883,1686,7,11934,663,0,2,4,4,1
3105,82,1749,1457,730,1242,11,6,188,1468,10,292,166,329,302,495,2424,4078,5,22973,1276,1,2,8,4,1
3106,82,1749,74,35,59,1,0,14,75,3,14,7,14,17,21,58,85,1,128,7,0,2,8,4,1
3107,82,1749,245,125,200,5,7,34,250,7,30,17,34,37,51,166,265,3,1053,58,0,2,8,4,1
3108,40,360,647,139,84,35,284,233,682,0,0,0,0,0,0,0,0,0,0,0,0,2,1,0,1
3109,31,606,127,75,83,2,11,30,129,4,14,7,14,18,21,61,87,2,175,9,0,2,44,0,1
3110,31,606,652,304,544,16,6,88,668,6,89,51,101,95,152,591,998,3,3399,188,0,2,44,0,1
3111,31,606,2,2,2,0,0,0,2,0,0,0,0,0,0,0,0,0,0,0,0,2,44,0,1
3112,31,606,8,5,5,0,0,3,8,0,0,0,0,0,0,0,0,0,0,0,0,2,44,0,1
3113,31,606,2,2,2,0,0,0,2,0,0,0,0,0,0,0,0,0,0,0,0,2,44,0,1
3114,31,606,14,8,8,0,0,6,14,0,0,0,0,0,0,0,0,0,0,0,0,2,44,0,1
3115,31,606,6,4,4,0,0,2,6,0,0,0,0,0,0,0,0,0,0,0,0,2,44,0,1
3116,31,606,6,4,4,0,0,2,6,1,2,1,2,3,3,2,4,0,2,0,0,2,44,0,1
3117,31,606,6,4,4,0,0,2,6,0,0,0,0,0,0,0,0,0,0,0,0,2,44,0,1
3118,31,606,7,5,5,0,0,2,7,0,0,0,0,0,0,0,0,0,0,0,0,2,44,0,1
3119,31,606,6,4,4,0,0,2,6,0,0,0,0,0,0,0,0,0,0,0,0,2,44,0,1
3120,31,606,10,6,6,0,0,4,10,0,0,0,0,0,0,0,0,0,0,0,0,2,44,0,1
3121,31,606,1,1,1,0,0,0,1,0,0,0,0,0,0,0,0,0,0,0,0,2,44,0,1
3122,31,606,1,1,1,0,0,0,1,0,0,0,0,0,0,0,0,0,0,0,0,2,44,0,1
3123,31,606,14,10,10,0,0,4,14,1,1,1,1,2,2,0,2,0,1,0,0,2,44,0,1
3124,31,606,46,26,30,3,0,12,49,3,6,3,6,9,9,20,28,1,42,2,0,2,44,0,1
3125,30,602,127,75,83,2,11,30,129,4,14,7,14,18,21,61,87,2,175,9,0,2,10,12,0
3126,30,602,652,304,544,16,6,88,668,6,89,51,101,95,152,591,998,3,3399,188,0,2,10,12,0
3127,30,602,2,2,2,0,0,0,2,0,0,0,0,0,0,0,0,0,0,0,0,2,10,12,0
3128,30,602,8,5,5,0,0,3,8,0,0,0,0,0,0,0,0,0,0,0,0,2,10,12,0
3129,30,602,2,2,2,0,0,0,2,0,0,0,0,0,0,0,0,0,0,0,0,2,10,12,0
3130,30,602,14,8,8,0,0,6,14,0,0,0,0,0,0,0,0,0,0,0,0,2,10,12,0
3131,30,602,6,4,4,0,0,2,6,0,0,0,0,0,0,0,0,0,0,0,0,2,10,12,0
3132,30,602,6,4,4,0,0,2,6,1,2,1,2,3,3,2,4,0,2,0,0,2,10,12,0
3133,30,602,6,4,4,0,0,2,6,0,0,0,0,0,0,0,0,0,0,0,0,2,10,12,0
3134,30,602,7,5,5,0,0,2,7,0,0,0,0,0,0,0,0,0,0,0,0,2,10,12,0
3135,30,602,6,4,4,0,0,2,6,0,0,0,0,0,0,0,0,0,0,0,0,2,10,12,0
3136,30,602,10,6,6,0,0,4,10,0,0,0,0,0,0,0,0,0,0,0,0,2,10,12,0
3137,30,602,1,1,1,0,0,0,1,0,0,0,0,0,0,0,0,0,0,0,0,2,10,12,0
3138,30,602,1,1,1,0,0,0,1,0,0,0,0,0,0,0,0,0,0,0,0,2,10,12,0
3139,30,602,14,10,10,0,0,4,14,1,1,1,1,2,2,0,2,0,1,0,0,2,10,12,0
3140,30,602,46,26,30,3,0,12,49,3,6,3,6,9,9,20,28,1,42,2,0,2,10,12,0
3141,83,1755,1457,730,1242,11,6,188,1468,10,292,166,329,302,495,2424,4078,5,22973,1276,1,2,4,1,1
3142,83,1755,74,35,59,1,0,14,75,3,14,7,14,17,21,58,85,1,128,7,0,2,4,1,1
3143,83,1755,245,125,200,5,7,34,250,7,30,17,34,37,51,166,265,3,1053,58,0,2,4,1,1
3144,187,4173,182,127,129,0,0,53,182,5,39,21,42,44,63,217,343,2,926,51,0,2,2,1,1
3145,187,4173,1165,710,800,67,119,181,1232,18,243,153,282,261,435,2000,3492,10,36473,2026,1,2,2,1,1
3146,90,1868,384,251,317,7,8,52,391,11,70,44,84,81,128,467,811,6,5355,297,0,2,1,1,1
3147,90,1869,384,251,317,7,8,52,391,11,70,44,84,81,128,467,811,6,5355,297,0,2,2,1,1
3148,140,2370,1338,495,1086,10,64,173,1348,11,122,82,157,133,239,883,1686,7,11934,663,0,2,6,18,0
3149,83,1755,1457,730,1242,11,6,188,1468,10,292,166,329,302,495,2424,4078,5,22973,1276,1,2,2,2,1
3150,83,1755,74,35,59,1,0,14,75,3,14,7,14,17,21,58,85,1,128,7,0,2,2,2,1
3151,83,1755,245,125,200,5,7,34,250,7,30,17,34,37,51,166,265,3,1053,58,0,2,2,2,1
3152,90,1873,384,251,317,7,8,52,391,11,70,44,84,81,128,467,811,6,5355,297,0,2,3,2,1
3153,34,1885,1457,730,1242,11,6,188,1468,10,292,166,329,302,495,2424,4078,5,22973,1276,1,2,21,0,1
3154,57,2508,384,251,317,7,8,52,391,11,70,44,84,81,128,467,811,6,5355,297,0,2,2,0,1
3155,83,1769,1457,730,1242,11,6,188,1468,10,292,166,329,302,495,2424,4078,5,22973,1276,1,2,1,0,0
3156,83,1769,74,35,59,1,0,14,75,3,14,7,14,17,21,58,85,1,128,7,0,2,1,0,0
3157,83,1769,245,125,200,5,7,34,250,7,30,17,34,37,51,166,265,3,1053,58,0,2,1,0,0
3158,32,621,334,251,279,10,4,40,344,5,127,74,143,132,217,899,1528,2,4303,239,0,2,14,5,0
3159,92,1901,384,251,317,7,8,52,391,11,70,44,84,81,128,467,811,6,5355,297,0,2,11,10,0
3160,18,815,334,251,279,10,4,40,344,5,127,74,143,132,217,899,1528,2,4303,239,0,2,2,8,0
3161,57,2515,384,251,317,7,8,52,391,11,70,44,84,81,128,467,811,6,5355,297,0,2,7,8,0
3162,92,1901,384,251,317,7,8,52,391,11,70,44,84,81,128,467,811,6,5355,297,0,2,1,1,1
3163,139,2342,1338,495,1086,10,64,173,1348,11,122,82,157,133,239,883,1686,7,11934,663,0,2,72,101,1
3164,79,1704,1457,730,1242,11,6,188,1468,10,292,166,329,302,495,2424,4078,5,22973,1276,1,2,4,11,1
3165,79,1704,74,35,59,1,0,14,75,3,14,7,14,17,21,58,85,1,128,7,0,2,4,11,1
3166,79,1704,245,125,200,5,7,34,250,7,30,17,34,37,51,166,265,3,1053,58,0,2,4,11,1
3167,34,1906,1457,730,1242,11,6,188,1468,10,292,166,329,302,495,2424,4078,5,22973,1276,1,2,4,3,1
3168,92,1901,384,251,317,7,8,52,391,11,70,44,84,81,128,467,811,6,5355,297,0,2,1,1,0
3169,8,346,42,7,35,4,0,5,46,1,2,1,2,3,3,2,4,0,2,0,0,2,2,2,0
3170,8,346,11,6,10,0,0,1,11,2,4,2,4,6,6,10,15,1,15,0,0,2,2,2,0
3171,11,544,127,75,83,2,11,30,129,4,14,7,14,18,21,61,87,2,175,9,0,2,2,2,1
3172,11,544,652,304,544,16,6,88,668,6,89,51,101,95,152,591,998,3,3399,188,0,2,2,2,1
3173,11,544,2,2,2,0,0,0,2,0,0,0,0,0,0,0,0,0,0,0,0,2,2,2,1
3174,11,544,8,5,5,0,0,3,8,0,0,0,0,0,0,0,0,0,0,0,0,2,2,2,1
3175,11,544,2,2,2,0,0,0,2,0,0,0,0,0,0,0,0,0,0,0,0,2,2,2,1
3176,11,544,14,8,8,0,0,6,14,0,0,0,0,0,0,0,0,0,0,0,0,2,2,2,1
3177,11,544,6,4,4,0,0,2,6,0,0,0,0,0,0,0,0,0,0,0,0,2,2,2,1
3178,11,544,6,4,4,0,0,2,6,1,2,1,2,3,3,2,4,0,2,0,0,2,2,2,1
3179,11,544,6,4,4,0,0,2,6,0,0,0,0,0,0,0,0,0,0,0,0,2,2,2,1
3180,11,544,7,5,5,0,0,2,7,0,0,0,0,0,0,0,0,0,0,0,0,2,2,2,1
3181,11,544,6,4,4,0,0,2,6,0,0,0,0,0,0,0,0,0,0,0,0,2,2,2,1
3182,11,544,10,6,6,0,0,4,10,0,0,0,0,0,0,0,0,0,0,0,0,2,2,2,1
3183,11,544,1,1,1,0,0,0,1,0,0,0,0,0,0,0,0,0,0,0,0,2,2,2,1
3184,11,544,1,1,1,0,0,0,1,0,0,0,0,0,0,0,0,0,0,0,0,2,2,2,1
3185,11,544,14,10,10,0,0,4,14,1,1,1,1,2,2,0,2,0,1,0,0,2,2,2,1
3186,11,544,46,26,30,3,0,12,49,3,6,3,6,9,9,20,28,1,42,2,0,2,2,2,1
3187,8,348,42,7,35,4,0,5,46,1,2,1,2,3,3,2,4,0,2,0,0,2,13,12,1
3188,8,348,11,6,10,0,0,1,11,2,4,2,4,6,6,10,15,1,15,0,0,2,13,12,1
3189,8,386,1289,550,1043,56,32,155,1345,10,167,93,185,177,278,1266,2075,5,11498,638,0,2,1,1,1
3190,8,376,1289,550,1043,56,32,155,1345,10,167,93,185,177,278,1266,2075,5,11498,638,0,2,2,2,1
3191,135,2241,1338,495,1086,10,64,173,1348,11,122,82,157,133,239,883,1686,7,11934,663,0,2,7,17,1
3192,85,1902,1457,730,1242,11,6,188,1468,10,292,166,329,302,495,2424,4078,5,22973,1276,1,2,34,11,1
3193,85,1902,74,35,59,1,0,14,75,3,14,7,14,17,21,58,85,1,128,7,0,2,34,11,1
3194,85,1902,245,125,200,5,7,34,250,7,30,17,34,37,51,166,265,3,1053,58,0,2,34,11,1
3195,33,626,373,158,315,8,0,51,381,5,76,44,79,81,123,486,779,2,2026,112,0,2,1,8,1
3196,34,1943,1457,730,1242,11,6,188,1468,10,292,166,329,302,495,2424,4078,5,22973,1276,1,2,16,14,1
3197,8,347,42,7,35,4,0,5,46,1,2,1,2,3,3,2,4,0,2,0,0,2,1,2,1
3198,8,347,11,6,10,0,0,1,11,2,4,2,4,6,6,10,15,1,15,0,0,2,1,2,1
3199,85,1902,1457,730,1242,11,6,188,1468,10,292,166,329,302,495,2424,4078,5,22973,1276,1,2,2,2,1
3200,85,1902,74,35,59,1,0,14,75,3,14,7,14,17,21,58,85,1,128,7,0,2,2,2,1
3201,85,1902,245,125,200,5,7,34,250,7,30,17,34,37,51,166,265,3,1053,58,0,2,2,2,1
3202,135,2241,1338,495,1086,10,64,173,1348,11,122,82,157,133,239,883,1686,7,11934,663,0,2,1,1,1
3203,81,1873,1457,730,1242,11,6,188,1468,10,292,166,329,302,495,2424,4078,5,22973,1276,1,2,7,11,1
3204,81,1873,74,35,59,1,0,14,75,3,14,7,14,17,21,58,85,1,128,7,0,2,7,11,1
3205,81,1873,245,125,200,5,7,34,250,7,30,17,34,37,51,166,265,3,1053,58,0,2,7,11,1
3206,95,3781,1392,870,1177,35,17,170,1427,14,494,280,531,508,811,4473,7289,7,54850,3047,2,2,1,1,1
3207,33,628,373,158,315,8,0,51,381,5,76,44,79,81,123,486,779,2,2026,112,0,2,1,4,1
3208,81,1888,1457,730,1242,11,6,188,1468,10,292,166,329,302,495,2424,4078,5,22973,1276,1,2,3,2,0
3209,81,1888,74,35,59,1,0,14,75,3,14,7,14,17,21,58,85,1,128,7,0,2,3,2,0
3210,81,1888,245,125,200,5,7,34,250,7,30,17,34,37,51,166,265,3,1053,58,0,2,3,2,0
3211,41,367,647,139,84,35,284,233,682,0,0,0,0,0,0,0,0,0,0,0,0,2,3,0,1
3212,20,429,127,75,83,2,11,30,129,4,14,7,14,18,21,61,87,2,175,9,0,2,5,38,1
3213,20,429,652,304,544,16,6,88,668,6,89,51,101,95,152,591,998,3,3399,188,0,2,5,38,1
3214,20,429,2,2,2,0,0,0,2,0,0,0,0,0,0,0,0,0,0,0,0,2,5,38,1
3215,20,429,8,5,5,0,0,3,8,0,0,0,0,0,0,0,0,0,0,0,0,2,5,38,1
3216,20,429,2,2,2,0,0,0,2,0,0,0,0,0,0,0,0,0,0,0,0,2,5,38,1
3217,20,429,14,8,8,0,0,6,14,0,0,0,0,0,0,0,0,0,0,0,0,2,5,38,1
3218,20,429,6,4,4,0,0,2,6,0,0,0,0,0,0,0,0,0,0,0,0,2,5,38,1
3219,20,429,6,4,4,0,0,2,6,1,2,1,2,3,3,2,4,0,2,0,0,2,5,38,1
3220,20,429,6,4,4,0,0,2,6,0,0,0,0,0,0,0,0,0,0,0,0,2,5,38,1
3221,20,429,7,5,5,0,0,2,7,0,0,0,0,0,0,0,0,0,0,0,0,2,5,38,1
3222,20,429,6,4,4,0,0,2,6,0,0,0,0,0,0,0,0,0,0,0,0,2,5,38,1
3223,20,429,10,6,6,0,0,4,10,0,0,0,0,0,0,0,0,0,0,0,0,2,5,38,1
3224,20,429,1,1,1,0,0,0,1,0,0,0,0,0,0,0,0,0,0,0,0,2,5,38,1
3225,20,429,1,1,1,0,0,0,1,0,0,0,0,0,0,0,0,0,0,0,0,2,5,38,1
3226,20,429,14,10,10,0,0,4,14,1,1,1,1,2,2,0,2,0,1,0,0,2,5,38,1
3227,20,429,46,26,30,3,0,12,49,3,6,3,6,9,9,20,28,1,42,2,0,2,5,38,1
3228,70,1681,1457,730,1242,11,6,188,1468,10,292,166,329,302,495,2424,4078,5,22973,1276,1,2,4,38,1
3229,70,1681,74,35,59,1,0,14,75,3,14,7,14,17,21,58,85,1,128,7,0,2,4,38,1
3230,70,1681,245,125,200,5,7,34,250,7,30,17,34,37,51,166,265,3,1053,58,0,2,4,38,1
3231,96,1953,384,251,317,7,8,52,391,11,70,44,84,81,128,467,811,6,5355,297,0,2,12,0,1
3232,8,343,42,7,35,4,0,5,46,1,2,1,2,3,3,2,4,0,2,0,0,2,0,2,1
3233,8,343,11,6,10,0,0,1,11,2,4,2,4,6,6,10,15,1,15,0,0,2,0,2,1
3234,32,1840,1457,730,1242,11,6,188,1468,10,292,166,329,302,495,2424,4078,5,22973,1276,1,2,0,15,1
3235,15,439,1450,624,1228,12,26,181,1462,14,306,186,354,320,540,2580,4493,8,36391,2021,1,3,2,2,1
3236,187,4167,182,127,129,0,0,53,182,5,39,21,42,44,63,217,343,2,926,51,0,3,3,3,1
3237,187,4167,1165,710,800,67,119,181,1232,18,243,153,282,261,435,2000,3492,10,36473,2026,1,3,3,3,1
3238,70,1671,1457,730,1242,11,6,188,1468,10,292,166,329,302,495,2424,4078,5,22973,1276,1,3,5,5,1
3239,70,1671,74,35,59,1,0,14,75,3,14,7,14,17,21,58,85,1,128,7,0,3,5,5,1
3240,70,1671,245,125,200,5,7,34,250,7,30,17,34,37,51,166,265,3,1053,58,0,3,5,5,1
3241,96,1951,384,251,317,7,8,52,391,11,70,44,84,81,128,467,811,6,5355,297,0,3,3,3,1
3242,33,626,373,158,315,8,0,51,381,5,76,44,79,81,123,486,779,2,2026,112,0,3,1,1,1
3243,8,341,42,7,35,4,0,5,46,1,2,1,2,3,3,2,4,0,2,0,0,2,9,10,1
3244,8,341,11,6,10,0,0,1,11,2,4,2,4,6,6,10,15,1,15,0,0,2,9,10,1
3245,45,961,1450,624,1228,12,26,181,1462,14,306,186,354,320,540,2580,4493,8,36391,2021,1,2,1,1,1
3246,34,1126,182,127,129,0,0,53,182,5,39,21,42,44,63,217,343,2,926,51,0,2,2,2,1
3247,95,3779,1392,870,1177,35,17,170,1427,14,494,280,531,508,811,4473,7289,7,54850,3047,2,2,1,1,1
3248,55,1901,773,419,590,28,0,166,801,10,204,113,217,214,330,1598,2554,5,13587,754,0,2,5,5,1
3249,47,1953,1513,682,1277,25,13,200,1538,11,199,116,219,210,335,1557,2584,6,15641,868,0,2,1,1,1
3250,11,542,127,75,83,2,11,30,129,4,14,7,14,18,21,61,87,2,175,9,0,2,1,1,1
3251,11,542,652,304,544,16,6,88,668,6,89,51,101,95,152,591,998,3,3399,188,0,2,1,1,1
3252,11,542,2,2,2,0,0,0,2,0,0,0,0,0,0,0,0,0,0,0,0,2,1,1,1
3253,11,542,8,5,5,0,0,3,8,0,0,0,0,0,0,0,0,0,0,0,0,2,1,1,1
3254,11,542,2,2,2,0,0,0,2,0,0,0,0,0,0,0,0,0,0,0,0,2,1,1,1
3255,11,542,14,8,8,0,0,6,14,0,0,0,0,0,0,0,0,0,0,0,0,2,1,1,1
3256,11,542,6,4,4,0,0,2,6,0,0,0,0,0,0,0,0,0,0,0,0,2,1,1,1
3257,11,542,6,4,4,0,0,2,6,1,2,1,2,3,3,2,4,0,2,0,0,2,1,1,1
3258,11,542,6,4,4,0,0,2,6,0,0,0,0,0,0,0,0,0,0,0,0,2,1,1,1
3259,11,542,7,5,5,0,0,2,7,0,0,0,0,0,0,0,0,0,0,0,0,2,1,1,1
3260,11,542,6,4,4,0,0,2,6,0,0,0,0,0,0,0,0,0,0,0,0,2,1,1,1
3261,11,542,10,6,6,0,0,4,10,0,0,0,0,0,0,0,0,0,0,0,0,2,1,1,1
3262,11,542,1,1,1,0,0,0,1,0,0,0,0,0,0,0,0,0,0,0,0,2,1,1,1
3263,11,542,1,1,1,0,0,0,1,0,0,0,0,0,0,0,0,0,0,0,0,2,1,1,1
3264,11,542,14,10,10,0,0,4,14,1,1,1,1,2,2,0,2,0,1,0,0,2,1,1,1
3265,11,542,46,26,30,3,0,12,49,3,6,3,6,9,9,20,28,1,42,2,0,2,1,1,1
3266,7,168,127,75,83,2,11,30,129,4,14,7,14,18,21,61,87,2,175,9,0,2,3,3,1
3267,7,168,652,304,544,16,6,88,668,6,89,51,101,95,152,591,998,3,3399,188,0,2,3,3,1
3268,7,168,2,2,2,0,0,0,2,0,0,0,0,0,0,0,0,0,0,0,0,2,3,3,1
3269,7,168,8,5,5,0,0,3,8,0,0,0,0,0,0,0,0,0,0,0,0,2,3,3,1
3270,7,168,2,2,2,0,0,0,2,0,0,0,0,0,0,0,0,0,0,0,0,2,3,3,1
3271,7,168,14,8,8,0,0,6,14,0,0,0,0,0,0,0,0,0,0,0,0,2,3,3,1
3272,7,168,6,4,4,0,0,2,6,0,0,0,0,0,0,0,0,0,0,0,0,2,3,3,1
3273,7,168,6,4,4,0,0,2,6,1,2,1,2,3,3,2,4,0,2,0,0,2,3,3,1
3274,7,168,6,4,4,0,0,2,6,0,0,0,0,0,0,0,0,0,0,0,0,2,3,3,1
3275,7,168,7,5,5,0,0,2,7,0,0,0,0,0,0,0,0,0,0,0,0,2,3,3,1
3276,7,168,6,4,4,0,0,2,6,0,0,0,0,0,0,0,0,0,0,0,0,2,3,3,1
3277,7,168,10,6,6,0,0,4,10,0,0,0,0,0,0,0,0,0,0,0,0,2,3,3,1
3278,7,168,1,1,1,0,0,0,1,0,0,0,0,0,0,0,0,0,0,0,0,2,3,3,1
3279,7,168,1,1,1,0,0,0,1,0,0,0,0,0,0,0,0,0,0,0,0,2,3,3,1
3280,7,168,14,10,10,0,0,4,14,1,1,1,1,2,2,0,2,0,1,0,0,2,3,3,1
3281,7,168,46,26,30,3,0,12,49,3,6,3,6,9,9,20,28,1,42,2,0,2,3,3,1
3282,4,223,207,111,150,11,0,50,218,5,26,19,36,31,55,133,272,3,943,52,0,2,2,2,1
3283,32,1832,1457,730,1242,11,6,188,1468,10,292,166,329,302,495,2424,4078,5,22973,1276,1,2,4,4,1
3284,18,813,334,251,279,10,4,40,344,5,127,74,143,132,217,899,1528,2,4303,239,0,2,1,1,1
3285,57,2507,384,251,317,7,8,52,391,11,70,44,84,81,128,467,811,6,5355,297,0,2,4,4,1
3286,8,376,1289,550,1043,56,32,155,1345,10,167,93,185,177,278,1266,2075,5,11498,638,0,2,2,2,1
3287,57,2507,384,251,317,7,8,52,391,11,70,44,84,81,128,467,811,6,5355,297,0,2,2,2,1
3288,2,80,13,10,10,0,0,3,13,1,2,1,2,3,3,2,4,0,2,0,0,2,1,1,1
3289,96,1951,384,251,317,7,8,52,391,11,70,44,84,81,128,467,811,6,5355,297,0,2,1,1,1
3290,2,81,13,10,10,0,0,3,13,1,2,1,2,3,3,2,4,0,2,0,0,2,1,1,0
3291,136,2272,1338,495,1086,10,64,173,1348,11,122,82,157,133,239,883,1686,7,11934,663,0,2,26,25,1
3292,72,1693,1457,730,1242,11,6,188,1468,10,292,166,329,302,495,2424,4078,5,22973,1276,1,2,14,14,1
3293,72,1693,74,35,59,1,0,14,75,3,14,7,14,17,21,58,85,1,128,7,0,2,14,14,1
3294,72,1693,245,125,200,5,7,34,250,7,30,17,34,37,51,166,265,3,1053,58,0,2,14,14,1
3295,34,635,373,158,315,8,0,51,381,5,76,44,79,81,123,486,779,2,2026,112,0,2,2,0,1
3296,44,2711,1457,730,1242,11,6,188,1468,10,292,166,329,302,495,2424,4078,5,22973,1276,1,2,129,0,1
3297,19,818,373,158,315,8,0,51,381,5,76,44,79,81,123,486,779,2,2026,112,0,2,0,5,1
3298,187,4166,182,127,129,0,0,53,182,5,39,21,42,44,63,217,343,2,926,51,0,2,2,2,0
3299,187,4166,1165,710,800,67,119,181,1232,18,243,153,282,261,435,2000,3492,10,36473,2026,1,2,2,2,0
3300,97,3803,1392,870,1177,35,17,170,1427,14,494,280,531,508,811,4473,7289,7,54850,3047,2,2,4,2,0
3301,8,341,42,7,35,4,0,5,46,1,2,1,2,3,3,2,4,0,2,0,0,2,1,1,1
3302,8,341,11,6,10,0,0,1,11,2,4,2,4,6,6,10,15,1,15,0,0,2,1,1,1
3303,187,4169,182,127,129,0,0,53,182,5,39,21,42,44,63,217,343,2,926,51,0,2,5,5,0
3304,187,4169,1165,710,800,67,119,181,1232,18,243,153,282,261,435,2000,3492,10,36473,2026,1,2,5,5,0
3305,98,3979,1392,870,1177,35,17,170,1427,14,494,280,531,508,811,4473,7289,7,54850,3047,2,2,26,0,0
3306,1,83,13,10,10,0,0,3,13,1,2,1,2,3,3,2,4,0,2,0,0,2,8,7,0
3307,8,341,42,7,35,4,0,5,46,1,2,1,2,3,3,2,4,0,2,0,0,2,1,1,1
3308,8,341,11,6,10,0,0,1,11,2,4,2,4,6,6,10,15,1,15,0,0,2,1,1,1
3309,2,29,127,75,83,2,11,30,129,4,14,7,14,18,21,61,87,2,175,9,0,2,4,0,0
3310,2,29,652,304,544,16,6,88,668,6,89,51,101,95,152,591,998,3,3399,188,0,2,4,0,0
3311,2,29,2,2,2,0,0,0,2,0,0,0,0,0,0,0,0,0,0,0,0,2,4,0,0
3312,2,29,8,5,5,0,0,3,8,0,0,0,0,0,0,0,0,0,0,0,0,2,4,0,0
3313,2,29,2,2,2,0,0,0,2,0,0,0,0,0,0,0,0,0,0,0,0,2,4,0,0
3314,2,29,14,8,8,0,0,6,14,0,0,0,0,0,0,0,0,0,0,0,0,2,4,0,0
3315,2,29,6,4,4,0,0,2,6,0,0,0,0,0,0,0,0,0,0,0,0,2,4,0,0
3316,2,29,6,4,4,0,0,2,6,1,2,1,2,3,3,2,4,0,2,0,0,2,4,0,0
3317,2,29,6,4,4,0,0,2,6,0,0,0,0,0,0,0,0,0,0,0,0,2,4,0,0
3318,2,29,7,5,5,0,0,2,7,0,0,0,0,0,0,0,0,0,0,0,0,2,4,0,0
3319,2,29,6,4,4,0,0,2,6,0,0,0,0,0,0,0,0,0,0,0,0,2,4,0,0
3320,2,29,10,6,6,0,0,4,10,0,0,0,0,0,0,0,0,0,0,0,0,2,4,0,0
3321,2,29,1,1,1,0,0,0,1,0,0,0,0,0,0,0,0,0,0,0,0,2,4,0,0
3322,2,29,1,1,1,0,0,0,1,0,0,0,0,0,0,0,0,0,0,0,0,2,4,0,0
3323,2,29,14,10,10,0,0,4,14,1,1,1,1,2,2,0,2,0,1,0,0,2,4,0,0
3324,2,29,46,26,30,3,0,12,49,3,6,3,6,9,9,20,28,1,42,2,0,2,4,0,0
3325,8,341,42,7,35,4,0,5,46,1,2,1,2,3,3,2,4,0,2,0,0,2,1,1,0
3326,8,341,11,6,10,0,0,1,11,2,4,2,4,6,6,10,15,1,15,0,0,2,1,1,0
3327,2,35,127,75,83,2,11,30,129,4,14,7,14,18,21,61,87,2,175,9,0,2,1,2,0
3328,2,35,652,304,544,16,6,88,668,6,89,51,101,95,152,591,998,3,3399,188,0,2,1,2,0
3329,2,35,2,2,2,0,0,0,2,0,0,0,0,0,0,0,0,0,0,0,0,2,1,2,0
3330,2,35,8,5,5,0,0,3,8,0,0,0,0,0,0,0,0,0,0,0,0,2,1,2,0
3331,2,35,2,2,2,0,0,0,2,0,0,0,0,0,0,0,0,0,0,0,0,2,1,2,0
3332,2,35,14,8,8,0,0,6,14,0,0,0,0,0,0,0,0,0,0,0,0,2,1,2,0
3333,2,35,6,4,4,0,0,2,6,0,0,0,0,0,0,0,0,0,0,0,0,2,1,2,0
3334,2,35,6,4,4,0,0,2,6,1,2,1,2,3,3,2,4,0,2,0,0,2,1,2,0
3335,2,35,6,4,4,0,0,2,6,0,0,0,0,0,0,0,0,0,0,0,0,2,1,2,0
3336,2,35,7,5,5,0,0,2,7,0,0,0,0,0,0,0,0,0,0,0,0,2,1,2,0
3337,2,35,6,4,4,0,0,2,6,0,0,0,0,0,0,0,0,0,0,0,0,2,1,2,0
3338,2,35,10,6,6,0,0,4,10,0,0,0,0,0,0,0,0,0,0,0,0,2,1,2,0
3339,2,35,1,1,1,0,0,0,1,0,0,0,0,0,0,0,0,0,0,0,0,2,1,2,0
3340,2,35,1,1,1,0,0,0,1,0,0,0,0,0,0,0,0,0,0,0,0,2,1,2,0
3341,2,35,14,10,10,0,0,4,14,1,1,1,1,2,2,0,2,0,1,0,0,2,1,2,0
3342,2,35,46,26,30,3,0,12,49,3,6,3,6,9,9,20,28,1,42,2,0,2,1,2,0
3343,8,376,1289,550,1043,56,32,155,1345,10,167,93,185,177,278,1266,2075,5,11498,638,0,2,1,1,1
3344,8,376,1289,550,1043,56,32,155,1345,10,167,93,185,177,278,1266,2075,5,11498,638,0,2,1,1,0
3345,35,315,647,139,84,35,284,233,682,0,0,0,0,0,0,0,0,0,0,0,0,2,3,25,1
3346,100,2023,384,251,317,7,8,52,391,11,70,44,84,81,128,467,811,6,5355,297,0,2,16,3,1
3347,8,341,42,7,35,4,0,5,46,1,2,1,2,3,3,2,4,0,2,0,0,2,1,1,1
3348,8,341,11,6,10,0,0,1,11,2,4,2,4,6,6,10,15,1,15,0,0,2,1,1,1
3349,7,336,42,7,35,4,0,5,46,1,2,1,2,3,3,2,4,0,2,0,0,2,1,2,0
3350,7,336,11,6,10,0,0,1,11,2,4,2,4,6,6,10,15,1,15,0,0,2,1,2,0
3351,47,1977,1513,682,1277,25,13,200,1538,11,199,116,219,210,335,1557,2584,6,15641,868,0,2,9,0,0
3352,98,3995,1392,870,1177,35,17,170,1427,14,494,280,531,508,811,4473,7289,7,54850,3047,2,2,5,1,0
3353,55,1929,773,419,590,28,0,166,801,10,204,113,217,214,330,1598,2554,5,13587,754,0,2,10,0,0
3354,187,4174,182,127,129,0,0,53,182,5,39,21,42,44,63,217,343,2,926,51,0,2,2,1,0
3355,187,4174,1165,710,800,67,119,181,1232,18,243,153,282,261,435,2000,3492,10,36473,2026,1,2,2,1,0
3356,47,1957,1513,682,1277,25,13,200,1538,11,199,116,219,210,335,1557,2584,6,15641,868,0,2,1,1,1
3357,187,4174,182,127,129,0,0,53,182,5,39,21,42,44,63,217,343,2,926,51,0,2,2,1,0
3358,187,4174,1165,710,800,67,119,181,1232,18,243,153,282,261,435,2000,3492,10,36473,2026,1,2,2,1,0
3359,98,3995,1392,870,1177,35,17,170,1427,14,494,280,531,508,811,4473,7289,7,54850,3047,2,2,5,1,0
3360,55,1929,773,419,590,28,0,166,801,10,204,113,217,214,330,1598,2554,5,13587,754,0,2,10,0,0
3361,47,1981,1513,682,1277,25,13,200,1538,11,199,116,219,210,335,1557,2584,6,15641,868,0,2,9,0,0
3362,35,663,373,158,315,8,0,51,381,5,76,44,79,81,123,486,779,2,2026,112,0,2,14,10,1
3363,188,4195,182,127,129,0,0,53,182,5,39,21,42,44,63,217,343,2,926,51,0,2,4,1,1
3364,188,4195,1165,710,800,67,119,181,1232,18,243,153,282,261,435,2000,3492,10,36473,2026,1,2,4,1,1
3365,36,1177,182,127,129,0,0,53,182,5,39,21,42,44,63,217,343,2,926,51,0,2,7,0,1
3366,190,4250,182,127,129,0,0,53,182,5,39,21,42,44,63,217,343,2,926,51,0,2,12,2,1
3367,190,4250,1165,710,800,67,119,181,1232,18,243,153,282,261,435,2000,3492,10,36473,2026,1,2,12,2,1
3368,37,1193,182,127,129,0,0,53,182,5,39,21,42,44,63,217,343,2,926,51,0,2,2,0,1
3369,44,2719,1457,730,1242,11,6,188,1468,10,292,166,329,302,495,2424,4078,5,22973,1276,1,2,1,0,1
3370,72,1691,1457,730,1242,11,6,188,1468,10,292,166,329,302,495,2424,4078,5,22973,1276,1,2,1,1,1
3371,72,1691,74,35,59,1,0,14,75,3,14,7,14,17,21,58,85,1,128,7,0,2,1,1,1
3372,72,1691,245,125,200,5,7,34,250,7,30,17,34,37,51,166,265,3,1053,58,0,2,1,1,1
3373,135,2260,1338,495,1086,10,64,173,1348,11,122,82,157,133,239,883,1686,7,11934,663,0,2,4,6,0
3374,100,2021,384,251,317,7,8,52,391,11,70,44,84,81,128,467,811,6,5355,297,0,2,1,2,1
3375,35,660,373,158,315,8,0,51,381,5,76,44,79,81,123,486,779,2,2026,112,0,2,12,6,1
3376,44,2723,1457,730,1242,11,6,188,1468,10,292,166,329,302,495,2424,4078,5,22973,1276,1,2,4,3,1
3377,100,2021,384,251,317,7,8,52,391,11,70,44,84,81,128,467,811,6,5355,297,0,2,1,1,1
3378,44,2723,1457,730,1242,11,6,188,1468,10,292,166,329,302,495,2424,4078,5,22973,1276,1,2,2,2,1
3379,65,1718,1513,682,1277,25,13,200,1538,11,199,116,219,210,335,1557,2584,6,15641,868,0,2,2,0,1
3380,65,1718,819,519,539,24,98,155,843,15,96,57,106,111,163,690,1107,8,9171,509,0,2,2,0,1
3381,193,4289,182,127,129,0,0,53,182,5,39,21,42,44,63,217,343,2,926,51,0,2,17,8,1
3382,193,4289,1165,710,800,67,119,181,1232,18,243,153,282,261,435,2000,3492,10,36473,2026,1,2,17,8,1
3383,40,1273,182,127,129,0,0,53,182,5,39,21,42,44,63,217,343,2,926,51,0,2,17,1,1
3384,8,369,1289,550,1043,56,32,155,1345,10,167,93,185,177,278,1266,2075,5,11498,638,0,2,5,5,1
3385,18,812,334,251,279,10,4,40,344,5,127,74,143,132,217,899,1528,2,4303,239,0,2,1,1,1
3386,57,2505,384,251,317,7,8,52,391,11,70,44,84,81,128,467,811,6,5355,297,0,2,1,1,1
3387,15,451,1450,624,1228,12,26,181,1462,14,306,186,354,320,540,2580,4493,8,36391,2021,1,2,9,7,0
3388,193,4285,182,127,129,0,0,53,182,5,39,21,42,44,63,217,343,2,926,51,0,2,1,2,0
3389,193,4285,1165,710,800,67,119,181,1232,18,243,153,282,261,435,2000,3492,10,36473,2026,1,2,1,2,0
3390,46,981,1450,624,1228,12,26,181,1462,14,306,186,354,320,540,2580,4493,8,36391,2021,1,2,4,2,0
3391,47,1972,1513,682,1277,25,13,200,1538,11,199,116,219,210,335,1557,2584,6,15641,868,0,2,1,2,0
3392,184,4050,182,127,129,0,0,53,182,5,39,21,42,44,63,217,343,2,926,51,0,2,3,45,1
3393,184,4050,1165,710,800,67,119,181,1232,18,243,153,282,261,435,2000,3492,10,36473,2026,1,2,3,45,1
3394,9,265,149,95,105,2,0,41,151,8,54,28,55,62,83,334,494,4,2013,111,0,0,55,0,1
3395,9,265,82,56,54,0,13,15,82,4,13,8,16,17,24,56,98,2,241,13,0,0,55,0,1
3396,31,1044,182,127,129,0,0,53,182,5,39,21,42,44,63,217,343,2,926,51,0,2,0,38,1
3397,21,588,149,95,105,2,0,41,151,8,54,28,55,62,83,334,494,4,2013,111,0,0,99,0,1
3398,9,270,149,95,105,2,0,41,151,8,54,28,55,62,83,334,494,4,2013,111,0,2,1,0,0
3399,9,270,82,56,54,0,13,15,82,4,13,8,16,17,24,56,98,2,241,13,0,2,1,0,0
3400,36,329,647,139,84,35,284,233,682,0,0,0,0,0,0,0,0,0,0,0,0,2,7,0,0
3401,127,2187,1338,495,1086,10,64,173,1348,11,122,82,157,133,239,883,1686,7,11934,663,0,2,3,16,0
3402,37,343,647,139,84,35,284,233,682,0,0,0,0,0,0,0,0,0,0,0,0,2,8,0,0
3403,66,1725,1513,682,1277,25,13,200,1538,11,199,116,219,210,335,1557,2584,6,15641,868,0,2,2,0,0
3404,66,1725,819,519,539,24,98,155,843,15,96,57,106,111,163,690,1107,8,9171,509,0,2,2,0,0
3405,47,1977,1513,682,1277,25,13,200,1538,11,199,116,219,210,335,1557,2584,6,15641,868,0,2,1,0,0
3406,7,336,42,7,35,4,0,5,46,1,2,1,2,3,3,2,4,0,2,0,0,2,1,1,1
3407,7,336,11,6,10,0,0,1,11,2,4,2,4,6,6,10,15,1,15,0,0,2,1,1,1
3408,37,343,647,139,84,35,284,233,682,0,0,0,0,0,0,0,0,0,0,0,0,2,2,2,0
3409,127,2187,1338,495,1086,10,64,173,1348,11,122,82,157,133,239,883,1686,7,11934,663,0,2,1,1,0
3410,37,343,647,139,84,35,284,233,682,0,0,0,0,0,0,0,0,0,0,0,0,2,6,6,1
3411,102,2071,384,251,317,7,8,52,391,11,70,44,84,81,128,467,811,6,5355,297,0,2,16,8,1
3412,61,2680,384,251,317,7,8,52,391,11,70,44,84,81,128,467,811,6,5355,297,0,2,59,6,1
3413,7,338,42,7,35,4,0,5,46,1,2,1,2,3,3,2,4,0,2,0,0,2,2,1,1
3414,7,338,11,6,10,0,0,1,11,2,4,2,4,6,6,10,15,1,15,0,0,2,2,1,1
3415,7,338,42,7,35,4,0,5,46,1,2,1,2,3,3,2,4,0,2,0,0,2,1,1,1
3416,7,338,11,6,10,0,0,1,11,2,4,2,4,6,6,10,15,1,15,0,0,2,1,1,1
3417,9,414,1289,550,1043,56,32,155,1345,10,167,93,185,177,278,1266,2075,5,11498,638,0,2,16,0,1
3418,170,3700,182,127,129,0,0,53,182,5,39,21,42,44,63,217,343,2,926,51,0,2,6,56,1
3419,170,3700,1165,710,800,67,119,181,1232,18,243,153,282,261,435,2000,3492,10,36473,2026,1,2,6,56,1
3420,72,1616,773,419,590,28,0,166,801,10,204,113,217,214,330,1598,2554,5,13587,754,0,2,20,40,1
3421,72,1616,421,273,302,44,34,57,465,17,81,59,107,98,166,583,1098,11,12329,684,0,2,20,40,1
3422,20,590,182,127,129,0,0,53,182,5,39,21,42,44,63,217,343,2,926,51,0,2,0,75,1
3423,98,3993,1392,870,1177,35,17,170,1427,14,494,280,531,508,811,4473,7289,7,54850,3047,2,2,0,1,1
3424,55,1917,773,419,590,28,0,166,801,10,204,113,217,214,330,1598,2554,5,13587,754,0,2,3,11,1
3425,7,338,42,7,35,4,0,5,46,1,2,1,2,3,3,2,4,0,2,0,0,2,1,1,0
3426,7,338,11,6,10,0,0,1,11,2,4,2,4,6,6,10,15,1,15,0,0,2,1,1,0
3427,170,3700,182,127,129,0,0,53,182,5,39,21,42,44,63,217,343,2,926,51,0,2,6,56,0
3428,170,3700,1165,710,800,67,119,181,1232,18,243,153,282,261,435,2000,3492,10,36473,2026,1,2,6,56,0
3429,72,1616,773,419,590,28,0,166,801,10,204,113,217,214,330,1598,2554,5,13587,754,0,2,20,40,0
3430,72,1616,421,273,302,44,34,57,465,17,81,59,107,98,166,583,1098,11,12329,684,0,2,20,40,0
3431,7,338,42,7,35,4,0,5,46,1,2,1,2,3,3,2,4,0,2,0,0,2,1,1,0
3432,7,338,11,6,10,0,0,1,11,2,4,2,4,6,6,10,15,1,15,0,0,2,1,1,0
3433,9,414,1289,550,1043,56,32,155,1345,10,167,93,185,177,278,1266,2075,5,11498,638,0,2,16,0,0
3434,20,590,182,127,129,0,0,53,182,5,39,21,42,44,63,217,343,2,926,51,0,2,0,75,0
3435,98,3993,1392,870,1177,35,17,170,1427,14,494,280,531,508,811,4473,7289,7,54850,3047,2,2,0,1,0
3436,55,1917,773,419,590,28,0,166,801,10,204,113,217,214,330,1598,2554,5,13587,754,0,2,3,11,0
3437,54,1911,773,419,590,28,0,166,801,10,204,113,217,214,330,1598,2554,5,13587,754,0,2,1,2,1
3438,12,564,1289,550,1043,56,32,155,1345,10,167,93,185,177,278,1266,2075,5,11498,638,0,2,42,0,1
3439,54,1884,773,419,590,28,0,166,801,10,204,113,217,214,330,1598,2554,5,13587,754,0,2,2,5,0
3440,72,1661,773,419,590,28,0,166,801,10,204,113,217,214,330,1598,2554,5,13587,754,0,2,9,1,0
3441,72,1661,421,273,302,44,34,57,465,17,81,59,107,98,166,583,1098,11,12329,684,0,2,9,1,0
3442,87,1695,1513,682,1277,25,13,200,1538,11,199,116,219,210,335,1557,2584,6,15641,868,0,2,103,103,1
3443,87,1695,819,519,539,24,98,155,843,15,96,57,106,111,163,690,1107,8,9171,509,0,2,103,103,1
3444,51,2204,1513,682,1277,25,13,200,1538,11,199,116,219,210,335,1557,2584,6,15641,868,0,2,43,3,1
3445,89,1783,1513,682,1277,25,13,200,1538,11,199,116,219,210,335,1557,2584,6,15641,868,0,2,29,25,0
3446,89,1783,819,519,539,24,98,155,843,15,96,57,106,111,163,690,1107,8,9171,509,0,2,29,25,0
3447,66,2628,1513,682,1277,25,13,200,1538,11,199,116,219,210,335,1557,2584,6,15641,868,0,2,81,8,0
3448,92,1793,1513,682,1277,25,13,200,1538,11,199,116,219,210,335,1557,2584,6,15641,868,0,2,16,6,0
3449,92,1793,819,519,539,24,98,155,843,15,96,57,106,111,163,690,1107,8,9171,509,0,2,16,6,0
3450,67,2673,1513,682,1277,25,13,200,1538,11,199,116,219,210,335,1557,2584,6,15641,868,0,2,22,0,0
3451,91,1781,1513,682,1277,25,13,200,1538,11,199,116,219,210,335,1557,2584,6,15641,868,0,2,26,35,0
3452,91,1781,819,519,539,24,98,155,843,15,96,57,106,111,163,690,1107,8,9171,509,0,2,26,35,0
3453,67,2671,1513,682,1277,25,13,200,1538,11,199,116,219,210,335,1557,2584,6,15641,868,0,2,1,2,0
3454,68,2725,1513,682,1277,25,13,200,1538,11,199,116,219,210,335,1557,2584,6,15641,868,0,2,11,1,0
3455,95,1800,1513,682,1277,25,13,200,1538,11,199,116,219,210,335,1557,2584,6,15641,868,0,2,18,20,0
3456,95,1800,819,519,539,24,98,155,843,15,96,57,106,111,163,690,1107,8,9171,509,0,2,18,20,0
3457,67,2671,1513,682,1277,25,13,200,1538,11,199,116,219,210,335,1557,2584,6,15641,868,0,2,1,11,0
3458,95,1806,1513,682,1277,25,13,200,1538,11,199,116,219,210,335,1557,2584,6,15641,868,0,2,1,0,0
3459,95,1806,819,519,539,24,98,155,843,15,96,57,106,111,163,690,1107,8,9171,509,0,2,1,0,0
3460,105,2122,384,251,317,7,8,52,391,11,70,44,84,81,128,467,811,6,5355,297,0,2,7,0,1
3461,62,2713,384,251,317,7,8,52,391,11,70,44,84,81,128,467,811,6,5355,297,0,2,26,0,1
3462,102,2071,384,251,317,7,8,52,391,11,70,44,84,81,128,467,811,6,5355,297,0,2,0,7,1
3463,61,2680,384,251,317,7,8,52,391,11,70,44,84,81,128,467,811,6,5355,297,0,2,0,26,1
3464,75,1691,773,419,590,28,0,166,801,10,204,113,217,214,330,1598,2554,5,13587,754,0,2,5,1,1
3465,75,1691,421,273,302,44,34,57,465,17,81,59,107,98,166,583,1098,11,12329,684,0,2,5,1,1
3466,57,1972,773,419,590,28,0,166,801,10,204,113,217,214,330,1598,2554,5,13587,754,0,2,14,0,1
3467,175,3745,182,127,129,0,0,53,182,5,39,21,42,44,63,217,343,2,926,51,0,2,30,18,1
3468,175,3745,1165,710,800,67,119,181,1232,18,243,153,282,261,435,2000,3492,10,36473,2026,1,2,30,18,1
3469,128,2196,1338,495,1086,10,64,173,1348,11,122,82,157,133,239,883,1686,7,11934,663,0,2,6,5,1
3470,98,3995,1392,870,1177,35,17,170,1427,14,494,280,531,508,811,4473,7289,7,54850,3047,2,2,10,10,1
3471,7,338,42,7,35,4,0,5,46,1,2,1,2,3,3,2,4,0,2,0,0,2,1,1,1
3472,7,338,11,6,10,0,0,1,11,2,4,2,4,6,6,10,15,1,15,0,0,2,1,1,1
3473,4,68,38,23,23,0,0,15,38,0,0,0,0,0,0,0,0,0,0,0,0,0,16,0,0
3474,29,591,127,75,83,2,11,30,129,4,14,7,14,18,21,61,87,2,175,9,0,2,22,1,0
3475,29,591,652,304,544,16,6,88,668,6,89,51,101,95,152,591,998,3,3399,188,0,2,22,1,0
3476,29,591,2,2,2,0,0,0,2,0,0,0,0,0,0,0,0,0,0,0,0,2,22,1,0
3477,29,591,8,5,5,0,0,3,8,0,0,0,0,0,0,0,0,0,0,0,0,2,22,1,0
3478,29,591,2,2,2,0,0,0,2,0,0,0,0,0,0,0,0,0,0,0,0,2,22,1,0
3479,29,591,14,8,8,0,0,6,14,0,0,0,0,0,0,0,0,0,0,0,0,2,22,1,0
3480,29,591,6,4,4,0,0,2,6,0,0,0,0,0,0,0,0,0,0,0,0,2,22,1,0
3481,29,591,6,4,4,0,0,2,6,1,2,1,2,3,3,2,4,0,2,0,0,2,22,1,0
3482,29,591,6,4,4,0,0,2,6,0,0,0,0,0,0,0,0,0,0,0,0,2,22,1,0
3483,29,591,7,5,5,0,0,2,7,0,0,0,0,0,0,0,0,0,0,0,0,2,22,1,0
3484,29,591,6,4,4,0,0,2,6,0,0,0,0,0,0,0,0,0,0,0,0,2,22,1,0
3485,29,591,10,6,6,0,0,4,10,0,0,0,0,0,0,0,0,0,0,0,0,2,22,1,0
3486,29,591,1,1,1,0,0,0,1,0,0,0,0,0,0,0,0,0,0,0,0,2,22,1,0
3487,29,591,1,1,1,0,0,0,1,0,0,0,0,0,0,0,0,0,0,0,0,2,22,1,0
3488,29,591,14,10,10,0,0,4,14,1,1,1,1,2,2,0,2,0,1,0,0,2,22,1,0
3489,29,591,46,26,30,3,0,12,49,3,6,3,6,9,9,20,28,1,42,2,0,2,22,1,0
3490,29,591,127,75,83,2,11,30,129,4,14,7,14,18,21,61,87,2,175,9,0,2,22,1,0
3491,29,591,652,304,544,16,6,88,668,6,89,51,101,95,152,591,998,3,3399,188,0,2,22,1,0
3492,29,591,2,2,2,0,0,0,2,0,0,0,0,0,0,0,0,0,0,0,0,2,22,1,0
3493,29,591,8,5,5,0,0,3,8,0,0,0,0,0,0,0,0,0,0,0,0,2,22,1,0
3494,29,591,2,2,2,0,0,0,2,0,0,0,0,0,0,0,0,0,0,0,0,2,22,1,0
3495,29,591,14,8,8,0,0,6,14,0,0,0,0,0,0,0,0,0,0,0,0,2,22,1,0
3496,29,591,6,4,4,0,0,2,6,0,0,0,0,0,0,0,0,0,0,0,0,2,22,1,0
3497,29,591,6,4,4,0,0,2,6,1,2,1,2,3,3,2,4,0,2,0,0,2,22,1,0
3498,29,591,6,4,4,0,0,2,6,0,0,0,0,0,0,0,0,0,0,0,0,2,22,1,0
3499,29,591,7,5,5,0,0,2,7,0,0,0,0,0,0,0,0,0,0,0,0,2,22,1,0
3500,29,591,6,4,4,0,0,2,6,0,0,0,0,0,0,0,0,0,0,0,0,2,22,1,0
3501,29,591,10,6,6,0,0,4,10,0,0,0,0,0,0,0,0,0,0,0,0,2,22,1,0
3502,29,591,1,1,1,0,0,0,1,0,0,0,0,0,0,0,0,0,0,0,0,2,22,1,0
3503,29,591,1,1,1,0,0,0,1,0,0,0,0,0,0,0,0,0,0,0,0,2,22,1,0
3504,29,591,14,10,10,0,0,4,14,1,1,1,1,2,2,0,2,0,1,0,0,2,22,1,0
3505,29,591,46,26,30,3,0,12,49,3,6,3,6,9,9,20,28,1,42,2,0,2,22,1,0
3506,36,699,373,158,315,8,0,51,381,5,76,44,79,81,123,486,779,2,2026,112,0,2,13,7,1
3507,20,857,373,158,315,8,0,51,381,5,76,44,79,81,123,486,779,2,2026,112,0,2,10,0,1
3508,36,702,373,158,315,8,0,51,381,5,76,44,79,81,123,486,779,2,2026,112,0,2,1,0,1
3509,7,338,42,7,35,4,0,5,46,1,2,1,2,3,3,2,4,0,2,0,0,2,1,1,1
3510,7,338,11,6,10,0,0,1,11,2,4,2,4,6,6,10,15,1,15,0,0,2,1,1,1
3511,12,386,15,9,9,0,0,6,15,0,0,0,0,0,0,0,0,0,0,0,0,2,2,2,0
3512,75,1712,773,419,590,28,0,166,801,10,204,113,217,214,330,1598,2554,5,13587,754,0,2,5,2,0
3513,75,1712,421,273,302,44,34,57,465,17,81,59,107,98,166,583,1098,11,12329,684,0,2,5,2,0
3514,59,2040,773,419,590,28,0,166,801,10,204,113,217,214,330,1598,2554,5,13587,754,0,2,19,3,0
3515,128,2201,1338,495,1086,10,64,173,1348,11,122,82,157,133,239,883,1686,7,11934,663,0,2,2,1,1
3516,48,1010,1450,624,1228,12,26,181,1462,14,306,186,354,320,540,2580,4493,8,36391,2021,1,2,7,0,1
3517,50,1037,1450,624,1228,12,26,181,1462,14,306,186,354,320,540,2580,4493,8,36391,2021,1,2,7,0,1
3518,102,2071,384,251,317,7,8,52,391,11,70,44,84,81,128,467,811,6,5355,297,0,2,2,2,1
3519,50,1037,1450,624,1228,12,26,181,1462,14,306,186,354,320,540,2580,4493,8,36391,2021,1,2,1,1,0
3520,7,338,42,7,35,4,0,5,46,1,2,1,2,3,3,2,4,0,2,0,0,2,3,3,0
3521,7,338,11,6,10,0,0,1,11,2,4,2,4,6,6,10,15,1,15,0,0,2,3,3,0
3522,130,2241,1338,495,1086,10,64,173,1348,11,122,82,157,133,239,883,1686,7,11934,663,0,2,11,4,1
3523,20,856,373,158,315,8,0,51,381,5,76,44,79,81,123,486,779,2,2026,112,0,2,1,1,1
3524,59,2043,773,419,590,28,0,166,801,10,204,113,217,214,330,1598,2554,5,13587,754,0,2,1,1,1
3525,7,338,42,7,35,4,0,5,46,1,2,1,2,3,3,2,4,0,2,0,0,2,1,1,1
3526,7,338,11,6,10,0,0,1,11,2,4,2,4,6,6,10,15,1,15,0,0,2,1,1,1
3527,7,338,42,7,35,4,0,5,46,1,2,1,2,3,3,2,4,0,2,0,0,2,1,1,1
3528,7,338,11,6,10,0,0,1,11,2,4,2,4,6,6,10,15,1,15,0,0,2,1,1,1
3529,29,591,127,75,83,2,11,30,129,4,14,7,14,18,21,61,87,2,175,9,0,2,5,5,1
3530,29,591,652,304,544,16,6,88,668,6,89,51,101,95,152,591,998,3,3399,188,0,2,5,5,1
3531,29,591,2,2,2,0,0,0,2,0,0,0,0,0,0,0,0,0,0,0,0,2,5,5,1
3532,29,591,8,5,5,0,0,3,8,0,0,0,0,0,0,0,0,0,0,0,0,2,5,5,1
3533,29,591,2,2,2,0,0,0,2,0,0,0,0,0,0,0,0,0,0,0,0,2,5,5,1
3534,29,591,14,8,8,0,0,6,14,0,0,0,0,0,0,0,0,0,0,0,0,2,5,5,1
3535,29,591,6,4,4,0,0,2,6,0,0,0,0,0,0,0,0,0,0,0,0,2,5,5,1
3536,29,591,6,4,4,0,0,2,6,1,2,1,2,3,3,2,4,0,2,0,0,2,5,5,1
3537,29,591,6,4,4,0,0,2,6,0,0,0,0,0,0,0,0,0,0,0,0,2,5,5,1
3538,29,591,7,5,5,0,0,2,7,0,0,0,0,0,0,0,0,0,0,0,0,2,5,5,1
3539,29,591,6,4,4,0,0,2,6,0,0,0,0,0,0,0,0,0,0,0,0,2,5,5,1
3540,29,591,10,6,6,0,0,4,10,0,0,0,0,0,0,0,0,0,0,0,0,2,5,5,1
3541,29,591,1,1,1,0,0,0,1,0,0,0,0,0,0,0,0,0,0,0,0,2,5,5,1
3542,29,591,1,1,1,0,0,0,1,0,0,0,0,0,0,0,0,0,0,0,0,2,5,5,1
3543,29,591,14,10,10,0,0,4,14,1,1,1,1,2,2,0,2,0,1,0,0,2,5,5,1
3544,29,591,46,26,30,3,0,12,49,3,6,3,6,9,9,20,28,1,42,2,0,2,5,5,1
3545,18,389,2,2,2,0,0,0,2,0,0,0,0,0,0,0,0,0,0,0,0,2,12,12,1
3546,18,389,99,48,90,1,3,5,100,0,0,0,0,0,0,0,0,0,0,0,0,2,12,12,1
3547,18,389,8,5,5,2,0,1,10,0,0,0,0,0,0,0,0,0,0,0,0,2,12,12,1
3548,18,389,1217,716,841,84,126,174,1301,14,185,118,215,199,333,1446,2542,8,20687,1149,0,2,12,12,1
3549,18,389,160,89,115,0,13,31,160,7,15,11,17,22,28,78,124,3,495,27,0,2,12,12,1
3550,18,389,10,10,9,9,0,0,19,0,0,0,0,0,0,0,0,0,0,0,0,2,12,12,1
3551,18,389,173,84,99,8,29,36,181,5,12,7,13,17,20,54,81,2,221,12,0,2,12,12,1
3552,18,389,3,1,1,3,0,0,6,0,0,0,0,0,0,0,0,0,0,0,0,2,12,12,1
3553,36,512,282,196,195,3,0,86,285,8,130,71,141,138,212,936,1507,4,6538,363,0,2,3,3,1
3554,1,9,2,2,2,0,0,0,2,0,0,0,0,0,0,0,0,0,0,0,0,2,1,1,1
3555,1,83,13,10,10,0,0,3,13,1,2,1,2,3,3,2,4,0,2,0,0,2,1,1,1
3556,3,67,127,75,83,2,11,30,129,4,14,7,14,18,21,61,87,2,175,9,0,2,2,2,1
3557,3,67,652,304,544,16,6,88,668,6,89,51,101,95,152,591,998,3,3399,188,0,2,2,2,1
3558,3,67,2,2,2,0,0,0,2,0,0,0,0,0,0,0,0,0,0,0,0,2,2,2,1
3559,3,67,8,5,5,0,0,3,8,0,0,0,0,0,0,0,0,0,0,0,0,2,2,2,1
3560,3,67,2,2,2,0,0,0,2,0,0,0,0,0,0,0,0,0,0,0,0,2,2,2,1
3561,3,67,14,8,8,0,0,6,14,0,0,0,0,0,0,0,0,0,0,0,0,2,2,2,1
3562,3,67,6,4,4,0,0,2,6,0,0,0,0,0,0,0,0,0,0,0,0,2,2,2,1
3563,3,67,6,4,4,0,0,2,6,1,2,1,2,3,3,2,4,0,2,0,0,2,2,2,1
3564,3,67,6,4,4,0,0,2,6,0,0,0,0,0,0,0,0,0,0,0,0,2,2,2,1
3565,3,67,7,5,5,0,0,2,7,0,0,0,0,0,0,0,0,0,0,0,0,2,2,2,1
3566,3,67,6,4,4,0,0,2,6,0,0,0,0,0,0,0,0,0,0,0,0,2,2,2,1
3567,3,67,10,6,6,0,0,4,10,0,0,0,0,0,0,0,0,0,0,0,0,2,2,2,1
3568,3,67,1,1,1,0,0,0,1,0,0,0,0,0,0,0,0,0,0,0,0,2,2,2,1
3569,3,67,1,1,1,0,0,0,1,0,0,0,0,0,0,0,0,0,0,0,0,2,2,2,1
3570,3,67,14,10,10,0,0,4,14,1,1,1,1,2,2,0,2,0,1,0,0,2,2,2,1
3571,3,67,46,26,30,3,0,12,49,3,6,3,6,9,9,20,28,1,42,2,0,2,2,2,1
3572,6,106,127,75,83,2,11,30,129,4,14,7,14,18,21,61,87,2,175,9,0,2,3,3,1
3573,6,106,652,304,544,16,6,88,668,6,89,51,101,95,152,591,998,3,3399,188,0,2,3,3,1
3574,6,106,2,2,2,0,0,0,2,0,0,0,0,0,0,0,0,0,0,0,0,2,3,3,1
3575,6,106,8,5,5,0,0,3,8,0,0,0,0,0,0,0,0,0,0,0,0,2,3,3,1
3576,6,106,2,2,2,0,0,0,2,0,0,0,0,0,0,0,0,0,0,0,0,2,3,3,1
3577,6,106,14,8,8,0,0,6,14,0,0,0,0,0,0,0,0,0,0,0,0,2,3,3,1
3578,6,106,6,4,4,0,0,2,6,0,0,0,0,0,0,0,0,0,0,0,0,2,3,3,1
3579,6,106,6,4,4,0,0,2,6,1,2,1,2,3,3,2,4,0,2,0,0,2,3,3,1
3580,6,106,6,4,4,0,0,2,6,0,0,0,0,0,0,0,0,0,0,0,0,2,3,3,1
3581,6,106,7,5,5,0,0,2,7,0,0,0,0,0,0,0,0,0,0,0,0,2,3,3,1
3582,6,106,6,4,4,0,0,2,6,0,0,0,0,0,0,0,0,0,0,0,0,2,3,3,1
3583,6,106,10,6,6,0,0,4,10,0,0,0,0,0,0,0,0,0,0,0,0,2,3,3,1
3584,6,106,1,1,1,0,0,0,1,0,0,0,0,0,0,0,0,0,0,0,0,2,3,3,1
3585,6,106,1,1,1,0,0,0,1,0,0,0,0,0,0,0,0,0,0,0,0,2,3,3,1
3586,6,106,14,10,10,0,0,4,14,1,1,1,1,2,2,0,2,0,1,0,0,2,3,3,1
3587,6,106,46,26,30,3,0,12,49,3,6,3,6,9,9,20,28,1,42,2,0,2,3,3,1
3588,3,65,127,75,83,2,11,30,129,4,14,7,14,18,21,61,87,2,175,9,0,2,8,8,1
3589,3,65,652,304,544,16,6,88,668,6,89,51,101,95,152,591,998,3,3399,188,0,2,8,8,1
3590,3,65,2,2,2,0,0,0,2,0,0,0,0,0,0,0,0,0,0,0,0,2,8,8,1
3591,3,65,8,5,5,0,0,3,8,0,0,0,0,0,0,0,0,0,0,0,0,2,8,8,1
3592,3,65,2,2,2,0,0,0,2,0,0,0,0,0,0,0,0,0,0,0,0,2,8,8,1
3593,3,65,14,8,8,0,0,6,14,0,0,0,0,0,0,0,0,0,0,0,0,2,8,8,1
3594,3,65,6,4,4,0,0,2,6,0,0,0,0,0,0,0,0,0,0,0,0,2,8,8,1
3595,3,65,6,4,4,0,0,2,6,1,2,1,2,3,3,2,4,0,2,0,0,2,8,8,1
3596,3,65,6,4,4,0,0,2,6,0,0,0,0,0,0,0,0,0,0,0,0,2,8,8,1
3597,3,65,7,5,5,0,0,2,7,0,0,0,0,0,0,0,0,0,0,0,0,2,8,8,1
3598,3,65,6,4,4,0,0,2,6,0,0,0,0,0,0,0,0,0,0,0,0,2,8,8,1
3599,3,65,10,6,6,0,0,4,10,0,0,0,0,0,0,0,0,0,0,0,0,2,8,8,1
3600,3,65,1,1,1,0,0,0,1,0,0,0,0,0,0,0,0,0,0,0,0,2,8,8,1
3601,3,65,1,1,1,0,0,0,1,0,0,0,0,0,0,0,0,0,0,0,0,2,8,8,1
3602,3,65,14,10,10,0,0,4,14,1,1,1,1,2,2,0,2,0,1,0,0,2,8,8,1
3603,3,65,46,26,30,3,0,12,49,3,6,3,6,9,9,20,28,1,42,2,0,2,8,8,1
3604,15,451,1450,624,1228,12,26,181,1462,14,306,186,354,320,540,2580,4493,8,36391,2021,1,2,1,1,1
3605,175,3745,182,127,129,0,0,53,182,5,39,21,42,44,63,217,343,2,926,51,0,2,100,100,1
3606,175,3745,1165,710,800,67,119,181,1232,18,243,153,282,261,435,2000,3492,10,36473,2026,1,2,100,100,1
3607,75,1712,773,419,590,28,0,166,801,10,204,113,217,214,330,1598,2554,5,13587,754,0,2,31,31,1
3608,75,1712,421,273,302,44,34,57,465,17,81,59,107,98,166,583,1098,11,12329,684,0,2,31,31,1
3609,12,386,15,9,9,0,0,6,15,0,0,0,0,0,0,0,0,0,0,0,0,2,14,14,1
3610,95,1806,1513,682,1277,25,13,200,1538,11,199,116,219,210,335,1557,2584,6,15641,868,0,2,61,61,1
3611,95,1806,819,519,539,24,98,155,843,15,96,57,106,111,163,690,1107,8,9171,509,0,2,61,61,1
3612,9,270,149,95,105,2,0,41,151,8,54,28,55,62,83,334,494,4,2013,111,0,2,6,6,1
3613,9,270,82,56,54,0,13,15,82,4,13,8,16,17,24,56,98,2,241,13,0,2,6,6,1
3614,44,869,215,129,180,6,0,29,221,8,65,43,72,73,115,415,711,4,3153,175,0,2,47,47,1
3615,44,869,97,69,77,3,3,16,100,6,22,13,23,28,36,113,173,3,542,30,0,2,47,47,1
3616,37,343,647,139,84,35,284,233,682,0,0,0,0,0,0,0,0,0,0,0,0,2,21,21,1
3617,130,2241,1338,495,1086,10,64,173,1348,11,122,82,157,133,239,883,1686,7,11934,663,0,2,68,68,1
3618,72,1691,1457,730,1242,11,6,188,1468,10,292,166,329,302,495,2424,4078,5,22973,1276,1,2,48,48,1
3619,72,1691,74,35,59,1,0,14,75,3,14,7,14,17,21,58,85,1,128,7,0,2,48,48,1
3620,72,1691,245,125,200,5,7,34,250,7,30,17,34,37,51,166,265,3,1053,58,0,2,48,48,1
3621,32,621,334,251,279,10,4,40,344,5,127,74,143,132,217,899,1528,2,4303,239,0,2,13,13,1
3622,102,2071,384,251,317,7,8,52,391,11,70,44,84,81,128,467,811,6,5355,297,0,2,37,37,1
3623,36,702,373,158,315,8,0,51,381,5,76,44,79,81,123,486,779,2,2026,112,0,2,23,23,1
3624,7,338,42,7,35,4,0,5,46,1,2,1,2,3,3,2,4,0,2,0,0,2,3,3,1
3625,7,338,11,6,10,0,0,1,11,2,4,2,4,6,6,10,15,1,15,0,0,2,3,3,1
3626,12,564,1289,550,1043,56,32,155,1345,10,167,93,185,177,278,1266,2075,5,11498,638,0,2,5,5,1
3627,50,1037,1450,624,1228,12,26,181,1462,14,306,186,354,320,540,2580,4493,8,36391,2021,1,2,10,10,1
3628,20,590,182,127,129,0,0,53,182,5,39,21,42,44,63,217,343,2,926,51,0,2,8,8,1
3629,98,3995,1392,870,1177,35,17,170,1427,14,494,280,531,508,811,4473,7289,7,54850,3047,2,2,64,64,1
3630,59,2043,773,419,590,28,0,166,801,10,204,113,217,214,330,1598,2554,5,13587,754,0,2,30,30,1
3631,67,2671,1513,682,1277,25,13,200,1538,11,199,116,219,210,335,1557,2584,6,15641,868,0,2,63,63,1
3632,21,588,149,95,105,2,0,41,151,8,54,28,55,62,83,334,494,4,2013,111,0,2,7,7,1
3633,11,542,127,75,83,2,11,30,129,4,14,7,14,18,21,61,87,2,175,9,0,2,6,6,1
3634,11,542,652,304,544,16,6,88,668,6,89,51,101,95,152,591,998,3,3399,188,0,2,6,6,1
3635,11,542,2,2,2,0,0,0,2,0,0,0,0,0,0,0,0,0,0,0,0,2,6,6,1
3636,11,542,8,5,5,0,0,3,8,0,0,0,0,0,0,0,0,0,0,0,0,2,6,6,1
3637,11,542,2,2,2,0,0,0,2,0,0,0,0,0,0,0,0,0,0,0,0,2,6,6,1
3638,11,542,14,8,8,0,0,6,14,0,0,0,0,0,0,0,0,0,0,0,0,2,6,6,1
3639,11,542,6,4,4,0,0,2,6,0,0,0,0,0,0,0,0,0,0,0,0,2,6,6,1
3640,11,542,6,4,4,0,0,2,6,1,2,1,2,3,3,2,4,0,2,0,0,2,6,6,1
3641,11,542,6,4,4,0,0,2,6,0,0,0,0,0,0,0,0,0,0,0,0,2,6,6,1
3642,11,542,7,5,5,0,0,2,7,0,0,0,0,0,0,0,0,0,0,0,0,2,6,6,1
3643,11,542,6,4,4,0,0,2,6,0,0,0,0,0,0,0,0,0,0,0,0,2,6,6,1
3644,11,542,10,6,6,0,0,4,10,0,0,0,0,0,0,0,0,0,0,0,0,2,6,6,1
3645,11,542,1,1,1,0,0,0,1,0,0,0,0,0,0,0,0,0,0,0,0,2,6,6,1
3646,11,542,1,1,1,0,0,0,1,0,0,0,0,0,0,0,0,0,0,0,0,2,6,6,1
3647,11,542,14,10,10,0,0,4,14,1,1,1,1,2,2,0,2,0,1,0,0,2,6,6,1
3648,11,542,46,26,30,3,0,12,49,3,6,3,6,9,9,20,28,1,42,2,0,2,6,6,1
3649,7,168,127,75,83,2,11,30,129,4,14,7,14,18,21,61,87,2,175,9,0,2,5,5,1
3650,7,168,652,304,544,16,6,88,668,6,89,51,101,95,152,591,998,3,3399,188,0,2,5,5,1
3651,7,168,2,2,2,0,0,0,2,0,0,0,0,0,0,0,0,0,0,0,0,2,5,5,1
3652,7,168,8,5,5,0,0,3,8,0,0,0,0,0,0,0,0,0,0,0,0,2,5,5,1
3653,7,168,2,2,2,0,0,0,2,0,0,0,0,0,0,0,0,0,0,0,0,2,5,5,1
3654,7,168,14,8,8,0,0,6,14,0,0,0,0,0,0,0,0,0,0,0,0,2,5,5,1
3655,7,168,6,4,4,0,0,2,6,0,0,0,0,0,0,0,0,0,0,0,0,2,5,5,1
3656,7,168,6,4,4,0,0,2,6,1,2,1,2,3,3,2,4,0,2,0,0,2,5,5,1
3657,7,168,6,4,4,0,0,2,6,0,0,0,0,0,0,0,0,0,0,0,0,2,5,5,1
3658,7,168,7,5,5,0,0,2,7,0,0,0,0,0,0,0,0,0,0,0,0,2,5,5,1
3659,7,168,6,4,4,0,0,2,6,0,0,0,0,0,0,0,0,0,0,0,0,2,5,5,1
3660,7,168,10,6,6,0,0,4,10,0,0,0,0,0,0,0,0,0,0,0,0,2,5,5,1
3661,7,168,1,1,1,0,0,0,1,0,0,0,0,0,0,0,0,0,0,0,0,2,5,5,1
3662,7,168,1,1,1,0,0,0,1,0,0,0,0,0,0,0,0,0,0,0,0,2,5,5,1
3663,7,168,14,10,10,0,0,4,14,1,1,1,1,2,2,0,2,0,1,0,0,2,5,5,1
3664,7,168,46,26,30,3,0,12,49,3,6,3,6,9,9,20,28,1,42,2,0,2,5,5,1
3665,44,2723,1457,730,1242,11,6,188,1468,10,292,166,329,302,495,2424,4078,5,22973,1276,1,2,40,40,1
3666,61,2680,384,251,317,7,8,52,391,11,70,44,84,81,128,467,811,6,5355,297,0,2,32,32,1
3667,20,856,373,158,315,8,0,51,381,5,76,44,79,81,123,486,779,2,2026,112,0,2,29,29,1
3668,75,1712,773,419,590,28,0,166,801,10,204,113,217,214,330,1598,2554,5,13587,754,0,2,6,9,0
3669,75,1712,421,273,302,44,34,57,465,17,81,59,107,98,166,583,1098,11,12329,684,0,2,6,9,0
3670,60,2071,773,419,590,28,0,166,801,10,204,113,217,214,330,1598,2554,5,13587,754,0,2,7,0,0
3671,7,338,42,7,35,4,0,5,46,1,2,1,2,3,3,2,4,0,2,0,0,2,1,1,0
3672,7,338,11,6,10,0,0,1,11,2,4,2,4,6,6,10,15,1,15,0,0,2,1,1,0
3673,13,638,1289,550,1043,56,32,155,1345,10,167,93,185,177,278,1266,2075,5,11498,638,0,2,16,0,1
3674,7,338,42,7,35,4,0,5,46,1,2,1,2,3,3,2,4,0,2,0,0,2,1,1,1
3675,7,338,11,6,10,0,0,1,11,2,4,2,4,6,6,10,15,1,15,0,0,2,1,1,1
3676,17,491,1450,624,1228,12,26,181,1462,14,306,186,354,320,540,2580,4493,8,36391,2021,1,2,15,4,0
3677,38,354,647,139,84,35,284,233,682,0,0,0,0,0,0,0,0,0,0,0,0,2,13,0,0
3678,104,2098,384,251,317,7,8,52,391,11,70,44,84,81,128,467,811,6,5355,297,0,2,2,0,0
3679,62,2707,384,251,317,7,8,52,391,11,70,44,84,81,128,467,811,6,5355,297,0,2,4,0,0
3680,104,2098,384,251,317,7,8,52,391,11,70,44,84,81,128,467,811,6,5355,297,0,2,2,0,0
3681,62,2707,384,251,317,7,8,52,391,11,70,44,84,81,128,467,811,6,5355,297,0,2,4,0,0
3682,175,3780,182,127,129,0,0,53,182,5,39,21,42,44,63,217,343,2,926,51,0,2,9,1,1
3683,175,3780,1165,710,800,67,119,181,1232,18,243,153,282,261,435,2000,3492,10,36473,2026,1,2,9,1,1
3684,99,4033,1392,870,1177,35,17,170,1427,14,494,280,531,508,811,4473,7289,7,54850,3047,2,2,9,0,1
3685,100,4061,1392,870,1177,35,17,170,1427,14,494,280,531,508,811,4473,7289,7,54850,3047,2,2,5,1,0
3686,7,338,42,7,35,4,0,5,46,1,2,1,2,3,3,2,4,0,2,0,0,2,2,2,1
3687,7,338,11,6,10,0,0,1,11,2,4,2,4,6,6,10,15,1,15,0,0,2,2,2,1
3688,15,451,1450,624,1228,12,26,181,1462,14,306,186,354,320,540,2580,4493,8,36391,2021,1,2,1,1,1
3689,175,3780,182,127,129,0,0,53,182,5,39,21,42,44,63,217,343,2,926,51,0,2,1,1,1
3690,175,3780,1165,710,800,67,119,181,1232,18,243,153,282,261,435,2000,3492,10,36473,2026,1,2,1,1,1
3691,75,1712,773,419,590,28,0,166,801,10,204,113,217,214,330,1598,2554,5,13587,754,0,2,1,1,1
3692,75,1712,421,273,302,44,34,57,465,17,81,59,107,98,166,583,1098,11,12329,684,0,2,1,1,1
3693,9,265,149,95,105,2,0,41,151,8,54,28,55,62,83,334,494,4,2013,111,0,2,1,3,1
3694,9,265,82,56,54,0,13,15,82,4,13,8,16,17,24,56,98,2,241,13,0,2,1,3,1
3695,130,2241,1338,495,1086,10,64,173,1348,11,122,82,157,133,239,883,1686,7,11934,663,0,2,1,1,1
3696,7,338,42,7,35,4,0,5,46,1,2,1,2,3,3,2,4,0,2,0,0,2,5,1,1
3697,7,338,11,6,10,0,0,1,11,2,4,2,4,6,6,10,15,1,15,0,0,2,5,1,1
3698,42,383,647,139,84,35,284,233,682,0,0,0,0,0,0,0,0,0,0,0,0,2,20,4,1
3699,86,1559,1338,495,1086,10,64,173,1348,11,122,82,157,133,239,883,1686,7,11934,663,0,2,8,135,1
3700,46,1093,1457,730,1242,11,6,188,1468,10,292,166,329,302,495,2424,4078,5,22973,1276,1,2,3,96,1
3701,46,1093,74,35,59,1,0,14,75,3,14,7,14,17,21,58,85,1,128,7,0,2,3,96,1
3702,46,1093,245,125,200,5,7,34,250,7,30,17,34,37,51,166,265,3,1053,58,0,2,3,96,1
3703,104,2098,384,251,317,7,8,52,391,11,70,44,84,81,128,467,811,6,5355,297,0,2,1,1,1
3704,75,1481,373,158,315,8,0,51,381,5,76,44,79,81,123,486,779,2,2026,112,0,2,187,60,1
3705,7,338,42,7,35,4,0,5,46,1,2,1,2,3,3,2,4,0,2,0,0,2,1,1,1
3706,7,338,11,6,10,0,0,1,11,2,4,2,4,6,6,10,15,1,15,0,0,2,1,1,1
3707,16,756,1289,550,1043,56,32,155,1345,10,167,93,185,177,278,1266,2075,5,11498,638,0,2,30,2,1
3708,28,2004,1296,573,1062,40,33,157,1336,8,201,118,231,209,349,1561,2689,4,12365,686,0,0,314,0,1
3709,17,1070,1457,730,1242,11,6,188,1468,10,292,166,329,302,495,2424,4078,5,22973,1276,1,2,0,230,1
3710,19,830,373,158,315,8,0,51,381,5,76,44,79,81,123,486,779,2,2026,112,0,2,5,10,1
3711,42,626,282,196,195,3,0,86,285,8,130,71,141,138,212,936,1507,4,6538,363,0,2,20,0,0
3712,38,354,647,139,84,35,284,233,682,0,0,0,0,0,0,0,0,0,0,0,0,2,6,5,0
3713,17,491,1450,624,1228,12,26,181,1462,14,306,186,354,320,540,2580,4493,8,36391,2021,1,2,1,1,0
3714,175,3780,182,127,129,0,0,53,182,5,39,21,42,44,63,217,343,2,926,51,0,2,10,2,0
3715,175,3780,1165,710,800,67,119,181,1232,18,243,153,282,261,435,2000,3492,10,36473,2026,1,2,10,2,0
3716,75,1712,773,419,590,28,0,166,801,10,204,113,217,214,330,1598,2554,5,13587,754,0,2,1,1,0
3717,75,1712,421,273,302,44,34,57,465,17,81,59,107,98,166,583,1098,11,12329,684,0,2,1,1,0
3718,9,265,149,95,105,2,0,41,151,8,54,28,55,62,83,334,494,4,2013,111,0,2,1,3,0
3719,9,265,82,56,54,0,13,15,82,4,13,8,16,17,24,56,98,2,241,13,0,2,1,3,0
3720,130,2241,1338,495,1086,10,64,173,1348,11,122,82,157,133,239,883,1686,7,11934,663,0,2,1,1,0
3721,7,338,42,7,35,4,0,5,46,1,2,1,2,3,3,2,4,0,2,0,0,2,7,3,0
3722,7,338,11,6,10,0,0,1,11,2,4,2,4,6,6,10,15,1,15,0,0,2,7,3,0
3723,100,4061,1392,870,1177,35,17,170,1427,14,494,280,531,508,811,4473,7289,7,54850,3047,2,2,13,0,0
3724,104,2098,384,251,317,7,8,52,391,11,70,44,84,81,128,467,811,6,5355,297,0,2,1,1,1
3725,43,402,647,139,84,35,284,233,682,0,0,0,0,0,0,0,0,0,0,0,0,2,9,3,1
3726,105,2126,384,251,317,7,8,52,391,11,70,44,84,81,128,467,811,6,5355,297,0,2,7,4,1
3727,68,1433,373,158,315,8,0,51,381,5,76,44,79,81,123,486,779,2,2026,112,0,2,65,86,1
3728,28,2004,1296,573,1062,40,33,157,1336,8,201,118,231,209,349,1561,2689,4,12365,686,0,2,1,1,1
3729,63,2799,384,251,317,7,8,52,391,11,70,44,84,81,128,467,811,6,5355,297,0,2,13,0,1
3730,43,402,647,139,84,35,284,233,682,0,0,0,0,0,0,0,0,0,0,0,0,2,4,2,1
3731,86,1556,1338,495,1086,10,64,173,1348,11,122,82,157,133,239,883,1686,7,11934,663,0,2,0,1,1
3732,105,2126,384,251,317,7,8,52,391,11,70,44,84,81,128,467,811,6,5355,297,0,2,3,3,1
3733,69,1442,373,158,315,8,0,51,381,5,76,44,79,81,123,486,779,2,2026,112,0,2,3,0,1
3734,28,2012,1296,573,1062,40,33,157,1336,8,201,118,231,209,349,1561,2689,4,12365,686,0,2,8,8,1
3735,19,836,373,158,315,8,0,51,381,5,76,44,79,81,123,486,779,2,2026,112,0,2,3,3,1
3736,44,411,647,139,84,35,284,233,682,0,0,0,0,0,0,0,0,0,0,0,0,2,5,3,1
3737,44,415,647,139,84,35,284,233,682,0,0,0,0,0,0,0,0,0,0,0,0,2,2,2,1
3738,68,1426,373,158,315,8,0,51,381,5,76,44,79,81,123,486,779,2,2026,112,0,2,12,18,1
3739,69,1471,373,158,315,8,0,51,381,5,76,44,79,81,123,486,779,2,2026,112,0,2,37,28,1
3740,17,803,1289,550,1043,56,32,155,1345,10,167,93,185,177,278,1266,2075,5,11498,638,0,2,20,0,1
3741,71,1474,373,158,315,8,0,51,381,5,76,44,79,81,123,486,779,2,2026,112,0,2,1,1,0
3742,60,2071,773,419,590,28,0,166,801,10,204,113,217,214,330,1598,2554,5,13587,754,0,2,1,1,1
3743,46,754,282,196,195,3,0,86,285,8,130,71,141,138,212,936,1507,4,6538,363,0,2,18,0,0
3744,46,754,282,196,195,3,0,86,285,8,130,71,141,138,212,936,1507,4,6538,363,0,2,38,0,0
3745,17,491,1450,624,1228,12,26,181,1462,14,306,186,354,320,540,2580,4493,8,36391,2021,1,2,15,4,0
3746,45,426,647,139,84,35,284,233,682,0,0,0,0,0,0,0,0,0,0,0,0,2,14,0,0
3747,17,494,1450,624,1228,12,26,181,1462,14,306,186,354,320,540,2580,4493,8,36391,2021,1,2,1,1,1
3748,45,428,647,139,84,35,284,233,682,0,0,0,0,0,0,0,0,0,0,0,0,2,1,1,1
3749,52,1094,1450,624,1228,12,26,181,1462,14,306,186,354,320,540,2580,4493,8,36391,2021,1,2,10,0,1
3750,17,494,1450,624,1228,12,26,181,1462,14,306,186,354,320,540,2580,4493,8,36391,2021,1,2,1,1,1
3751,45,428,647,139,84,35,284,233,682,0,0,0,0,0,0,0,0,0,0,0,0,2,7,8,1
3752,52,1094,1450,624,1228,12,26,181,1462,14,306,186,354,320,540,2580,4493,8,36391,2021,1,2,2,2,1
3753,46,754,282,196,195,3,0,86,285,8,130,71,141,138,212,936,1507,4,6538,363,0,2,38,0,0
3754,17,494,1450,624,1228,12,26,181,1462,14,306,186,354,320,540,2580,4493,8,36391,2021,1,2,17,6,0
3755,175,3780,182,127,129,0,0,53,182,5,39,21,42,44,63,217,343,2,926,51,0,2,10,2,0
3756,175,3780,1165,710,800,67,119,181,1232,18,243,153,282,261,435,2000,3492,10,36473,2026,1,2,10,2,0
3757,75,1712,773,419,590,28,0,166,801,10,204,113,217,214,330,1598,2554,5,13587,754,0,2,1,1,0
3758,75,1712,421,273,302,44,34,57,465,17,81,59,107,98,166,583,1098,11,12329,684,0,2,1,1,0
3759,9,265,149,95,105,2,0,41,151,8,54,28,55,62,83,334,494,4,2013,111,0,2,1,3,0
3760,9,265,82,56,54,0,13,15,82,4,13,8,16,17,24,56,98,2,241,13,0,2,1,3,0
3761,45,428,647,139,84,35,284,233,682,0,0,0,0,0,0,0,0,0,0,0,0,2,46,7,0
3762,86,1556,1338,495,1086,10,64,173,1348,11,122,82,157,133,239,883,1686,7,11934,663,0,2,9,137,0
3763,46,1093,1457,730,1242,11,6,188,1468,10,292,166,329,302,495,2424,4078,5,22973,1276,1,2,3,96,0
3764,46,1093,74,35,59,1,0,14,75,3,14,7,14,17,21,58,85,1,128,7,0,2,3,96,0
3765,46,1093,245,125,200,5,7,34,250,7,30,17,34,37,51,166,265,3,1053,58,0,2,3,96,0
3766,105,2126,384,251,317,7,8,52,391,11,70,44,84,81,128,467,811,6,5355,297,0,2,12,7,0
3767,71,1474,373,158,315,8,0,51,381,5,76,44,79,81,123,486,779,2,2026,112,0,2,201,89,0
3768,7,338,42,7,35,4,0,5,46,1,2,1,2,3,3,2,4,0,2,0,0,2,7,3,0
3769,7,338,11,6,10,0,0,1,11,2,4,2,4,6,6,10,15,1,15,0,0,2,7,3,0
3770,17,803,1289,550,1043,56,32,155,1345,10,167,93,185,177,278,1266,2075,5,11498,638,0,2,50,2,0
3771,52,1094,1450,624,1228,12,26,181,1462,14,306,186,354,320,540,2580,4493,8,36391,2021,1,2,10,0,0
3772,100,4061,1392,870,1177,35,17,170,1427,14,494,280,531,508,811,4473,7289,7,54850,3047,2,2,13,0,0
3773,60,2071,773,419,590,28,0,166,801,10,204,113,217,214,330,1598,2554,5,13587,754,0,2,1,1,0
3774,28,2012,1296,573,1062,40,33,157,1336,8,201,118,231,209,349,1561,2689,4,12365,686,0,0,314,0,0
3775,17,1070,1457,730,1242,11,6,188,1468,10,292,166,329,302,495,2424,4078,5,22973,1276,1,2,0,230,0
3776,63,2799,384,251,317,7,8,52,391,11,70,44,84,81,128,467,811,6,5355,297,0,2,17,0,0
3777,19,836,373,158,315,8,0,51,381,5,76,44,79,81,123,486,779,2,2026,112,0,2,8,13,0
3778,16,817,1289,550,1043,56,32,155,1345,10,167,93,185,177,278,1266,2075,5,11498,638,0,2,25,28,1
3779,68,1428,373,158,315,8,0,51,381,5,76,44,79,81,123,486,779,2,2026,112,0,2,0,7,1
3780,28,1989,1296,573,1062,40,33,157,1336,8,201,118,231,209,349,1561,2689,4,12365,686,0,2,15,18,1
3781,47,774,282,196,195,3,0,86,285,8,130,71,141,138,212,936,1507,4,6538,363,0,2,3,0,1
3782,1,83,13,10,10,0,0,3,13,1,2,1,2,3,3,2,4,0,2,0,0,2,1,1,1
3783,107,2170,384,251,317,7,8,52,391,11,70,44,84,81,128,467,811,6,5355,297,0,2,6,1,0
3784,65,2882,384,251,317,7,8,52,391,11,70,44,84,81,128,467,811,6,5355,297,0,2,15,0,0
3785,17,899,1289,550,1043,56,32,155,1345,10,167,93,185,177,278,1266,2075,5,11498,638,0,2,8,0,1
3786,18,929,1289,550,1043,56,32,155,1345,10,167,93,185,177,278,1266,2075,5,11498,638,0,2,7,3,0
3787,52,895,282,196,195,3,0,86,285,8,130,71,141,138,212,936,1507,4,6538,363,0,2,30,0,0
3788,1,83,13,10,10,0,0,3,13,1,2,1,2,3,3,2,4,0,2,0,0,2,1,1,0
3789,56,1187,1450,624,1228,12,26,181,1462,14,306,186,354,320,540,2580,4493,8,36391,2021,1,2,21,0,0
3790,56,1209,1450,624,1228,12,26,181,1462,14,306,186,354,320,540,2580,4493,8,36391,2021,1,2,3,0,0
3791,175,3785,182,127,129,0,0,53,182,5,39,21,42,44,63,217,343,2,926,51,0,2,2,1,0
3792,175,3785,1165,710,800,67,119,181,1232,18,243,153,282,261,435,2000,3492,10,36473,2026,1,2,2,1,0
3793,83,1749,1457,730,1242,11,6,188,1468,10,292,166,329,302,495,2424,4078,5,22973,1276,1,2,121,1,0
3794,83,1749,74,35,59,1,0,14,75,3,14,7,14,17,21,58,85,1,128,7,0,2,121,1,0
3795,83,1749,245,125,200,5,7,34,250,7,30,17,34,37,51,166,265,3,1053,58,0,2,121,1,0
3796,24,1258,652,304,544,16,6,88,668,6,89,51,101,95,152,591,998,3,3399,188,0,3,1,1,0
3797,115,2359,1457,730,1242,11,6,188,1468,10,292,166,329,302,495,2424,4078,5,22973,1276,1,2,96,2,0
3798,115,2359,74,35,59,1,0,14,75,3,14,7,14,17,21,58,85,1,128,7,0,2,96,2,0
3799,115,2359,245,125,200,5,7,34,250,7,30,17,34,37,51,166,265,3,1053,58,0,2,96,2,0
3800,18,814,334,251,279,10,4,40,344,5,127,74,143,132,217,899,1528,2,4303,239,0,2,1,1,0
3801,1,34,2,2,2,0,0,0,2,0,0,0,0,0,0,0,0,0,0,0,0,0,15,0,1
3802,1,34,99,48,90,1,3,5,100,0,0,0,0,0,0,0,0,0,0,0,0,0,15,0,1
3803,1,34,8,5,5,2,0,1,10,0,0,0,0,0,0,0,0,0,0,0,0,0,15,0,1
3804,1,34,1217,716,841,84,126,174,1301,14,185,118,215,199,333,1446,2542,8,20687,1149,0,0,15,0,1
3805,1,34,160,89,115,0,13,31,160,7,15,11,17,22,28,78,124,3,495,27,0,0,15,0,1
3806,1,34,10,10,9,9,0,0,19,0,0,0,0,0,0,0,0,0,0,0,0,0,15,0,1
3807,1,34,173,84,99,8,29,36,181,5,12,7,13,17,20,54,81,2,221,12,0,0,15,0,1
3808,1,34,3,1,1,3,0,0,6,0,0,0,0,0,0,0,0,0,0,0,0,0,15,0,1
3809,115,2357,1457,730,1242,11,6,188,1468,10,292,166,329,302,495,2424,4078,5,22973,1276,1,3,1,1,1
3810,115,2357,74,35,59,1,0,14,75,3,14,7,14,17,21,58,85,1,128,7,0,3,1,1,1
3811,115,2357,245,125,200,5,7,34,250,7,30,17,34,37,51,166,265,3,1053,58,0,3,1,1,1
3812,110,2181,384,251,317,7,8,52,391,11,70,44,84,81,128,467,811,6,5355,297,0,3,19,8,1
3813,68,1413,373,158,315,8,0,51,381,5,76,44,79,81,123,486,779,2,2026,112,0,3,5,5,1
3814,6,277,42,7,35,4,0,5,46,1,2,1,2,3,3,2,4,0,2,0,0,2,9,29,1
3815,6,277,11,6,10,0,0,1,11,2,4,2,4,6,6,10,15,1,15,0,0,2,9,29,1
3816,17,333,127,75,83,2,11,30,129,4,14,7,14,18,21,61,87,2,175,9,0,2,57,1,1
3817,17,333,652,304,544,16,6,88,668,6,89,51,101,95,152,591,998,3,3399,188,0,2,57,1,1
3818,17,333,2,2,2,0,0,0,2,0,0,0,0,0,0,0,0,0,0,0,0,2,57,1,1
3819,17,333,8,5,5,0,0,3,8,0,0,0,0,0,0,0,0,0,0,0,0,2,57,1,1
3820,17,333,2,2,2,0,0,0,2,0,0,0,0,0,0,0,0,0,0,0,0,2,57,1,1
3821,17,333,14,8,8,0,0,6,14,0,0,0,0,0,0,0,0,0,0,0,0,2,57,1,1
3822,17,333,6,4,4,0,0,2,6,0,0,0,0,0,0,0,0,0,0,0,0,2,57,1,1
3823,17,333,6,4,4,0,0,2,6,1,2,1,2,3,3,2,4,0,2,0,0,2,57,1,1
3824,17,333,6,4,4,0,0,2,6,0,0,0,0,0,0,0,0,0,0,0,0,2,57,1,1
3825,17,333,7,5,5,0,0,2,7,0,0,0,0,0,0,0,0,0,0,0,0,2,57,1,1
3826,17,333,6,4,4,0,0,2,6,0,0,0,0,0,0,0,0,0,0,0,0,2,57,1,1
3827,17,333,10,6,6,0,0,4,10,0,0,0,0,0,0,0,0,0,0,0,0,2,57,1,1
3828,17,333,1,1,1,0,0,0,1,0,0,0,0,0,0,0,0,0,0,0,0,2,57,1,1
3829,17,333,1,1,1,0,0,0,1,0,0,0,0,0,0,0,0,0,0,0,0,2,57,1,1
3830,17,333,14,10,10,0,0,4,14,1,1,1,1,2,2,0,2,0,1,0,0,2,57,1,1
3831,17,333,46,26,30,3,0,12,49,3,6,3,6,9,9,20,28,1,42,2,0,2,57,1,1
3832,7,166,127,75,83,2,11,30,129,4,14,7,14,18,21,61,87,2,175,9,0,2,3,3,1
3833,7,166,652,304,544,16,6,88,668,6,89,51,101,95,152,591,998,3,3399,188,0,2,3,3,1
3834,7,166,2,2,2,0,0,0,2,0,0,0,0,0,0,0,0,0,0,0,0,2,3,3,1
3835,7,166,8,5,5,0,0,3,8,0,0,0,0,0,0,0,0,0,0,0,0,2,3,3,1
3836,7,166,2,2,2,0,0,0,2,0,0,0,0,0,0,0,0,0,0,0,0,2,3,3,1
3837,7,166,14,8,8,0,0,6,14,0,0,0,0,0,0,0,0,0,0,0,0,2,3,3,1
3838,7,166,6,4,4,0,0,2,6,0,0,0,0,0,0,0,0,0,0,0,0,2,3,3,1
3839,7,166,6,4,4,0,0,2,6,1,2,1,2,3,3,2,4,0,2,0,0,2,3,3,1
3840,7,166,6,4,4,0,0,2,6,0,0,0,0,0,0,0,0,0,0,0,0,2,3,3,1
3841,7,166,7,5,5,0,0,2,7,0,0,0,0,0,0,0,0,0,0,0,0,2,3,3,1
3842,7,166,6,4,4,0,0,2,6,0,0,0,0,0,0,0,0,0,0,0,0,2,3,3,1
3843,7,166,10,6,6,0,0,4,10,0,0,0,0,0,0,0,0,0,0,0,0,2,3,3,1
3844,7,166,1,1,1,0,0,0,1,0,0,0,0,0,0,0,0,0,0,0,0,2,3,3,1
3845,7,166,1,1,1,0,0,0,1,0,0,0,0,0,0,0,0,0,0,0,0,2,3,3,1
3846,7,166,14,10,10,0,0,4,14,1,1,1,1,2,2,0,2,0,1,0,0,2,3,3,1
3847,7,166,46,26,30,3,0,12,49,3,6,3,6,9,9,20,28,1,42,2,0,2,3,3,1
3848,28,1987,1296,573,1062,40,33,157,1336,8,201,118,231,209,349,1561,2689,4,12365,686,0,2,1,1,1
3849,24,1256,652,304,544,16,6,88,668,6,89,51,101,95,152,591,998,3,3399,188,0,2,1,1,1
3850,18,812,334,251,279,10,4,40,344,5,127,74,143,132,217,899,1528,2,4303,239,0,2,1,1,1
3851,65,2872,384,251,317,7,8,52,391,11,70,44,84,81,128,467,811,6,5355,297,0,2,5,5,1
3852,4,122,2,2,2,0,0,0,2,0,0,0,0,0,0,0,0,0,0,0,0,2,18,7,1
3853,4,122,99,48,90,1,3,5,100,0,0,0,0,0,0,0,0,0,0,0,0,2,18,7,1
3854,4,122,8,5,5,2,0,1,10,0,0,0,0,0,0,0,0,0,0,0,0,2,18,7,1
3855,4,122,1217,716,841,84,126,174,1301,14,185,118,215,199,333,1446,2542,8,20687,1149,0,2,18,7,1
3856,4,122,160,89,115,0,13,31,160,7,15,11,17,22,28,78,124,3,495,27,0,2,18,7,1
3857,4,122,10,10,9,9,0,0,19,0,0,0,0,0,0,0,0,0,0,0,0,2,18,7,1
3858,4,122,173,84,99,8,29,36,181,5,12,7,13,17,20,54,81,2,221,12,0,2,18,7,1
3859,4,122,3,1,1,3,0,0,6,0,0,0,0,0,0,0,0,0,0,0,0,2,18,7,1
3860,3,108,77,34,69,0,0,8,77,3,24,16,29,27,45,114,213,1,387,21,0,0,18,0,1
3861,3,108,712,438,573,51,9,84,763,14,102,71,128,116,199,733,1364,8,11988,666,0,0,18,0,1
3862,110,2181,384,251,317,7,8,52,391,11,70,44,84,81,128,467,811,6,5355,297,0,2,3,3,1
3863,6,277,42,7,35,4,0,5,46,1,2,1,2,3,3,2,4,0,2,0,0,2,1,1,1
3864,6,277,11,6,10,0,0,1,11,2,4,2,4,6,6,10,15,1,15,0,0,2,1,1,1
3865,28,1989,1296,573,1062,40,33,157,1336,8,201,118,231,209,349,1561,2689,4,12365,686,0,2,1,1,1
3866,25,1318,652,304,544,16,6,88,668,6,89,51,101,95,152,591,998,3,3399,188,0,2,10,0,1
3867,4,135,2,2,2,0,0,0,2,0,0,0,0,0,0,0,0,0,0,0,0,2,4,2,1
3868,4,135,99,48,90,1,3,5,100,0,0,0,0,0,0,0,0,0,0,0,0,2,4,2,1
3869,4,135,8,5,5,2,0,1,10,0,0,0,0,0,0,0,0,0,0,0,0,2,4,2,1
3870,4,135,1217,716,841,84,126,174,1301,14,185,118,215,199,333,1446,2542,8,20687,1149,0,2,4,2,1
3871,4,135,160,89,115,0,13,31,160,7,15,11,17,22,28,78,124,3,495,27,0,2,4,2,1
3872,4,135,10,10,9,9,0,0,19,0,0,0,0,0,0,0,0,0,0,0,0,2,4,2,1
3873,4,135,173,84,99,8,29,36,181,5,12,7,13,17,20,54,81,2,221,12,0,2,4,2,1
3874,4,135,3,1,1,3,0,0,6,0,0,0,0,0,0,0,0,0,0,0,0,2,4,2,1
3875,114,2331,1457,730,1242,11,6,188,1468,10,292,166,329,302,495,2424,4078,5,22973,1276,1,3,0,10,1
3876,111,2222,384,251,317,7,8,52,391,11,70,44,84,81,128,467,811,6,5355,297,0,2,3,3,1
3877,16,1031,1457,730,1242,11,6,188,1468,10,292,166,329,302,495,2424,4078,5,22973,1276,1,2,0,7,1
3878,25,1318,652,304,544,16,6,88,668,6,89,51,101,95,152,591,998,3,3399,188,0,2,1,1,1
3879,18,812,334,251,279,10,4,40,344,5,127,74,143,132,217,899,1528,2,4303,239,0,2,1,1,1
3880,65,2872,384,251,317,7,8,52,391,11,70,44,84,81,128,467,811,6,5355,297,0,2,3,3,1
3881,1,50,2,2,2,0,0,0,2,0,0,0,0,0,0,0,0,0,0,0,0,2,6,19,1
3882,1,50,99,48,90,1,3,5,100,0,0,0,0,0,0,0,0,0,0,0,0,2,6,19,1
3883,1,50,8,5,5,2,0,1,10,0,0,0,0,0,0,0,0,0,0,0,0,2,6,19,1
3884,1,50,1217,716,841,84,126,174,1301,14,185,118,215,199,333,1446,2542,8,20687,1149,0,2,6,19,1
3885,1,50,160,89,115,0,13,31,160,7,15,11,17,22,28,78,124,3,495,27,0,2,6,19,1
3886,1,50,10,10,9,9,0,0,19,0,0,0,0,0,0,0,0,0,0,0,0,2,6,19,1
3887,1,50,173,84,99,8,29,36,181,5,12,7,13,17,20,54,81,2,221,12,0,2,6,19,1
3888,1,50,3,1,1,3,0,0,6,0,0,0,0,0,0,0,0,0,0,0,0,2,6,19,1
3889,114,2326,1457,730,1242,11,6,188,1468,10,292,166,329,302,495,2424,4078,5,22973,1276,1,2,0,2,1
3890,86,1567,1338,495,1086,10,64,173,1348,11,122,82,157,133,239,883,1686,7,11934,663,0,2,2,0,1
3891,110,2212,384,251,317,7,8,52,391,11,70,44,84,81,128,467,811,6,5355,297,0,2,3,5,1
3892,6,283,42,7,35,4,0,5,46,1,2,1,2,3,3,2,4,0,2,0,0,2,1,0,1
3893,6,283,11,6,10,0,0,1,11,2,4,2,4,6,6,10,15,1,15,0,0,2,1,0,1
3894,6,283,42,7,35,4,0,5,46,1,2,1,2,3,3,2,4,0,2,0,0,2,1,1,0
3895,6,283,11,6,10,0,0,1,11,2,4,2,4,6,6,10,15,1,15,0,0,2,1,1,0
3896,45,428,647,139,84,35,284,233,682,0,0,0,0,0,0,0,0,0,0,0,0,3,17,10,1
3897,110,2210,384,251,317,7,8,52,391,11,70,44,84,81,128,467,811,6,5355,297,0,2,1,1,1
3898,17,570,1455,414,1257,16,76,112,1471,5,41,23,46,46,69,231,381,2,1069,59,0,3,2,23,0
3899,17,570,669,365,481,22,61,110,691,15,103,63,122,118,185,747,1273,8,11311,628,0,3,2,23,0
3900,137,3233,722,423,573,19,0,135,741,12,172,101,199,184,300,1320,2257,6,15668,870,0,3,1,1,0
3901,137,3233,1508,847,911,44,250,301,1552,14,148,88,169,162,257,1120,1886,7,15077,837,0,3,1,1,0
3902,194,4278,72,33,56,0,4,12,72,1,1,1,1,2,2,0,2,0,1,0,0,3,1,1,0
3903,194,4278,1454,835,1044,76,110,219,1530,17,275,158,296,292,454,2297,3718,9,34017,1889,1,3,1,1,0
3904,111,2230,384,251,317,7,8,52,391,11,70,44,84,81,128,467,811,6,5355,297,0,2,6,4,0
3905,26,920,1450,624,1228,12,26,181,1462,14,306,186,354,320,540,2580,4493,8,36391,2021,1,3,1,1,0
3906,34,1380,1513,682,1277,25,13,200,1538,11,199,116,219,210,335,1557,2584,6,15641,868,0,3,1,1,0
3907,10,403,1455,414,1257,16,76,112,1471,5,41,23,46,46,69,231,381,2,1069,59,0,3,1,1,0
3908,7,226,74,35,59,1,0,14,75,3,14,7,14,17,21,58,85,1,128,7,0,3,1,1,0
3909,15,734,1020,354,843,12,15,144,1032,8,134,77,144,142,221,970,1580,4,6792,377,0,3,1,1,0
3910,12,820,447,308,343,6,5,95,453,7,96,59,111,103,170,651,1136,4,4600,255,0,3,1,1,0
3911,5,333,722,423,573,19,0,135,741,12,172,101,199,184,300,1320,2257,6,15668,870,0,3,1,1,0
3912,12,418,386,256,301,16,9,68,402,4,59,35,69,63,104,355,621,2,1453,80,0,3,1,1,0
3913,13,1146,215,129,180,6,0,29,221,8,65,43,72,73,115,415,711,4,3153,175,0,3,2,2,0
3914,44,1644,1043,504,840,53,9,147,1096,9,180,112,198,189,310,1377,2344,4,11604,644,0,3,1,1,0
3915,24,1010,373,158,315,8,0,51,381,5,76,44,79,81,123,486,779,2,2026,112,0,3,1,1,0
3916,28,1387,1178,367,1042,6,15,115,1184,9,94,51,95,103,146,644,976,4,4439,246,0,3,3,4,0
3917,50,2500,1943,715,1694,26,18,214,1969,12,185,120,237,197,357,1436,2721,7,20915,1161,0,3,2,2,0
3918,2,103,442,244,305,14,16,103,456,11,68,45,75,79,120,452,756,6,4588,254,0,3,2,2,0
3919,28,1989,1296,573,1062,40,33,157,1336,8,201,118,231,209,349,1561,2689,4,12365,686,0,2,1,1,0
3920,86,1567,1338,495,1086,10,64,173,1348,11,122,82,157,133,239,883,1686,7,11934,663,0,2,24,19,1
3921,45,428,647,139,84,35,284,233,682,0,0,0,0,0,0,0,0,0,0,0,0,2,19,10,1
3922,100,2397,1043,504,840,53,9,147,1096,9,180,112,198,189,310,1377,2344,4,11604,644,0,2,24,0,1
3923,100,2397,383,288,292,26,6,62,409,11,65,38,67,76,105,429,656,5,3719,206,0,2,24,0,1
3924,114,2321,1457,730,1242,11,6,188,1468,10,292,166,329,302,495,2424,4078,5,22973,1276,1,2,10,10,1
3925,86,1567,1338,495,1086,10,64,173,1348,11,122,82,157,133,239,883,1686,7,11934,663,0,2,2,0,1
3926,18,379,1098,241,925,5,10,155,1103,7,46,25,49,53,74,273,423,3,1580,87,0,2,0,11,1
3927,18,379,282,202,222,14,2,44,296,8,42,24,43,50,67,250,378,4,1548,86,0,2,0,11,1
3928,17,587,1455,414,1257,16,76,112,1471,5,41,23,46,46,69,231,381,2,1069,59,0,2,6,7,1
3929,17,587,669,365,481,22,61,110,691,15,103,63,122,118,185,747,1273,8,11311,628,0,2,6,7,1
3930,1,46,2,2,2,0,0,0,2,0,0,0,0,0,0,0,0,0,0,0,0,2,0,1,1
3931,1,46,99,48,90,1,3,5,100,0,0,0,0,0,0,0,0,0,0,0,0,2,0,1,1
3932,1,46,8,5,5,2,0,1,10,0,0,0,0,0,0,0,0,0,0,0,0,2,0,1,1
3933,1,46,1217,716,841,84,126,174,1301,14,185,118,215,199,333,1446,2542,8,20687,1149,0,2,0,1,1
3934,1,46,160,89,115,0,13,31,160,7,15,11,17,22,28,78,124,3,495,27,0,2,0,1,1
3935,1,46,10,10,9,9,0,0,19,0,0,0,0,0,0,0,0,0,0,0,0,2,0,1,1
3936,1,46,173,84,99,8,29,36,181,5,12,7,13,17,20,54,81,2,221,12,0,2,0,1,1
3937,1,46,3,1,1,3,0,0,6,0,0,0,0,0,0,0,0,0,0,0,0,2,0,1,1
3938,194,4280,72,33,56,0,4,12,72,1,1,1,1,2,2,0,2,0,1,0,0,2,1,1,1
3939,194,4280,1454,835,1044,76,110,219,1530,17,275,158,296,292,454,2297,3718,9,34017,1889,1,2,1,1,1
3940,171,3359,373,158,315,8,0,51,381,5,76,44,79,81,123,486,779,2,2026,112,0,2,303,2,1
3941,112,2286,384,251,317,7,8,52,391,11,70,44,84,81,128,467,811,6,5355,297,0,2,8,1,1
3942,66,2902,384,251,317,7,8,52,391,11,70,44,84,81,128,467,811,6,5355,297,0,2,9,0,1
3943,1,42,2,2,2,0,0,0,2,0,0,0,0,0,0,0,0,0,0,0,0,2,7,4,1
3944,1,42,99,48,90,1,3,5,100,0,0,0,0,0,0,0,0,0,0,0,0,2,7,4,1
3945,1,42,8,5,5,2,0,1,10,0,0,0,0,0,0,0,0,0,0,0,0,2,7,4,1
3946,1,42,1217,716,841,84,126,174,1301,14,185,118,215,199,333,1446,2542,8,20687,1149,0,2,7,4,1
3947,1,42,160,89,115,0,13,31,160,7,15,11,17,22,28,78,124,3,495,27,0,2,7,4,1
3948,1,42,10,10,9,9,0,0,19,0,0,0,0,0,0,0,0,0,0,0,0,2,7,4,1
3949,1,42,173,84,99,8,29,36,181,5,12,7,13,17,20,54,81,2,221,12,0,2,7,4,1
3950,1,42,3,1,1,3,0,0,6,0,0,0,0,0,0,0,0,0,0,0,0,2,7,4,1
3951,45,428,647,139,84,35,284,233,682,0,0,0,0,0,0,0,0,0,0,0,0,2,1,3,1
3952,137,3229,722,423,573,19,0,135,741,12,172,101,199,184,300,1320,2257,6,15668,870,0,2,1,2,1
3953,137,3229,1508,847,911,44,250,301,1552,14,148,88,169,162,257,1120,1886,7,15077,837,0,2,1,2,1
3954,7,166,127,75,83,2,11,30,129,4,14,7,14,18,21,61,87,2,175,9,0,2,1,1,1
3955,7,166,652,304,544,16,6,88,668,6,89,51,101,95,152,591,998,3,3399,188,0,2,1,1,1
3956,7,166,2,2,2,0,0,0,2,0,0,0,0,0,0,0,0,0,0,0,0,2,1,1,1
3957,7,166,8,5,5,0,0,3,8,0,0,0,0,0,0,0,0,0,0,0,0,2,1,1,1
3958,7,166,2,2,2,0,0,0,2,0,0,0,0,0,0,0,0,0,0,0,0,2,1,1,1
3959,7,166,14,8,8,0,0,6,14,0,0,0,0,0,0,0,0,0,0,0,0,2,1,1,1
3960,7,166,6,4,4,0,0,2,6,0,0,0,0,0,0,0,0,0,0,0,0,2,1,1,1
3961,7,166,6,4,4,0,0,2,6,1,2,1,2,3,3,2,4,0,2,0,0,2,1,1,1
3962,7,166,6,4,4,0,0,2,6,0,0,0,0,0,0,0,0,0,0,0,0,2,1,1,1
3963,7,166,7,5,5,0,0,2,7,0,0,0,0,0,0,0,0,0,0,0,0,2,1,1,1
3964,7,166,6,4,4,0,0,2,6,0,0,0,0,0,0,0,0,0,0,0,0,2,1,1,1
3965,7,166,10,6,6,0,0,4,10,0,0,0,0,0,0,0,0,0,0,0,0,2,1,1,1
3966,7,166,1,1,1,0,0,0,1,0,0,0,0,0,0,0,0,0,0,0,0,2,1,1,1
3967,7,166,1,1,1,0,0,0,1,0,0,0,0,0,0,0,0,0,0,0,0,2,1,1,1
3968,7,166,14,10,10,0,0,4,14,1,1,1,1,2,2,0,2,0,1,0,0,2,1,1,1
3969,7,166,46,26,30,3,0,12,49,3,6,3,6,9,9,20,28,1,42,2,0,2,1,1,1
3970,13,1148,215,129,180,6,0,29,221,8,65,43,72,73,115,415,711,4,3153,175,0,2,1,1,1
3971,25,1318,652,304,544,16,6,88,668,6,89,51,101,95,152,591,998,3,3399,188,0,2,1,1,1
3972,18,814,334,251,279,10,4,40,344,5,127,74,143,132,217,899,1528,2,4303,239,0,2,2,2,1
3973,66,2890,384,251,317,7,8,52,391,11,70,44,84,81,128,467,811,6,5355,297,0,2,5,8,1
3974,54,886,1020,354,843,12,15,144,1032,8,134,77,144,142,221,970,1580,4,6792,377,0,2,65,0,1
3975,28,1384,1020,354,843,12,15,144,1032,8,134,77,144,142,221,970,1580,4,6792,377,0,2,127,0,1
3976,169,3958,722,423,573,19,0,135,741,12,172,101,199,184,300,1320,2257,6,15668,870,0,2,120,1,1
3977,169,3958,1508,847,911,44,250,301,1552,14,148,88,169,162,257,1120,1886,7,15077,837,0,2,120,1,1
3978,10,500,722,423,573,19,0,135,741,12,172,101,199,184,300,1320,2257,6,15668,870,0,2,44,1,1
3979,1,31,2,2,2,0,0,0,2,0,0,0,0,0,0,0,0,0,0,0,0,2,0,2,1
3980,1,31,99,48,90,1,3,5,100,0,0,0,0,0,0,0,0,0,0,0,0,2,0,2,1
3981,1,31,8,5,5,2,0,1,10,0,0,0,0,0,0,0,0,0,0,0,0,2,0,2,1
3982,1,31,1217,716,841,84,126,174,1301,14,185,118,215,199,333,1446,2542,8,20687,1149,0,2,0,2,1
3983,1,31,160,89,115,0,13,31,160,7,15,11,17,22,28,78,124,3,495,27,0,2,0,2,1
3984,1,31,10,10,9,9,0,0,19,0,0,0,0,0,0,0,0,0,0,0,0,2,0,2,1
3985,1,31,173,84,99,8,29,36,181,5,12,7,13,17,20,54,81,2,221,12,0,2,0,2,1
3986,1,31,3,1,1,3,0,0,6,0,0,0,0,0,0,0,0,0,0,0,0,2,0,2,1
3987,46,442,647,139,84,35,284,233,682,0,0,0,0,0,0,0,0,0,0,0,0,2,8,3,1
3988,115,2361,1457,730,1242,11,6,188,1468,10,292,166,329,302,495,2424,4078,5,22973,1276,1,0,395,0,1
3989,115,2361,74,35,59,1,0,14,75,3,14,7,14,17,21,58,85,1,128,7,0,0,395,0,1
3990,115,2361,245,125,200,5,7,34,250,7,30,17,34,37,51,166,265,3,1053,58,0,0,395,0,1
3991,168,3956,722,423,573,19,0,135,741,12,172,101,199,184,300,1320,2257,6,15668,870,0,2,4,7,1
3992,168,3956,1508,847,911,44,250,301,1552,14,148,88,169,162,257,1120,1886,7,15077,837,0,2,4,7,1
3993,171,3366,373,158,315,8,0,51,381,5,76,44,79,81,123,486,779,2,2026,112,0,2,1,1,1
3994,25,1320,652,304,544,16,6,88,668,6,89,51,101,95,152,591,998,3,3399,188,0,2,1,1,1
3995,18,816,334,251,279,10,4,40,344,5,127,74,143,132,217,899,1528,2,4303,239,0,2,1,1,1
3996,115,2364,1457,730,1242,11,6,188,1468,10,292,166,329,302,495,2424,4078,5,22973,1276,1,2,1,1,1
3997,115,2364,74,35,59,1,0,14,75,3,14,7,14,17,21,58,85,1,128,7,0,2,1,1,1
3998,115,2364,245,125,200,5,7,34,250,7,30,17,34,37,51,166,265,3,1053,58,0,2,1,1,1
3999,168,3956,722,423,573,19,0,135,741,12,172,101,199,184,300,1320,2257,6,15668,870,0,2,9,9,1
4000,168,3956,1508,847,911,44,250,301,1552,14,148,88,169,162,257,1120,1886,7,15077,837,0,2,9,9,1
4001,10,500,722,423,573,19,0,135,741,12,172,101,199,184,300,1320,2257,6,15668,870,0,2,6,6,1
4002,68,2956,384,251,317,7,8,52,391,11,70,44,84,81,128,467,811,6,5355,297,0,2,53,50,1
4003,54,886,1020,354,843,12,15,144,1032,8,134,77,144,142,221,970,1580,4,6792,377,0,2,1,83,1
4004,194,4305,72,33,56,0,4,12,72,1,1,1,1,2,2,0,2,0,1,0,0,2,4,3,1
4005,194,4305,1454,835,1044,76,110,219,1530,17,275,158,296,292,454,2297,3718,9,34017,1889,1,2,4,3,1
4006,19,975,1289,550,1043,56,32,155,1345,10,167,93,185,177,278,1266,2075,5,11498,638,0,2,16,0,1
4007,109,2197,1457,730,1242,11,6,188,1468,10,292,166,329,302,495,2424,4078,5,22973,1276,1,2,0,28,1
4008,109,2197,74,35,59,1,0,14,75,3,14,7,14,17,21,58,85,1,128,7,0,2,0,28,1
4009,109,2197,245,125,200,5,7,34,250,7,30,17,34,37,51,166,265,3,1053,58,0,2,0,28,1
4010,16,579,1455,414,1257,16,76,112,1471,5,41,23,46,46,69,231,381,2,1069,59,0,2,3,4,1
4011,16,579,669,365,481,22,61,110,691,15,103,63,122,118,185,747,1273,8,11311,628,0,2,3,4,1
4012,51,842,1020,354,843,12,15,144,1032,8,134,77,144,142,221,970,1580,4,6792,377,0,2,0,6,1
4013,186,4076,72,33,56,0,4,12,72,1,1,1,1,2,2,0,2,0,1,0,0,2,7,38,1
4014,186,4076,1454,835,1044,76,110,219,1530,17,275,158,296,292,454,2297,3718,9,34017,1889,1,2,7,38,1
4015,99,2389,1043,504,840,53,9,147,1096,9,180,112,198,189,310,1377,2344,4,11604,644,0,2,1,2,1
4016,99,2389,383,288,292,26,6,62,409,11,65,38,67,76,105,429,656,5,3719,206,0,2,1,2,1
4017,150,3028,373,158,315,8,0,51,381,5,76,44,79,81,123,486,779,2,2026,112,0,2,2,77,1
4018,27,1358,1020,354,843,12,15,144,1032,8,134,77,144,142,221,970,1580,4,6792,377,0,2,11,16,1
4019,25,1029,373,158,315,8,0,51,381,5,76,44,79,81,123,486,779,2,2026,112,0,2,7,5,1
4020,50,2502,1943,715,1694,26,18,214,1969,12,185,120,237,197,357,1436,2721,7,20915,1161,0,2,1,1,1
4021,17,771,334,251,279,10,4,40,344,5,127,74,143,132,217,899,1528,2,4303,239,0,2,2,9,1
4022,111,2192,1457,730,1242,11,6,188,1468,10,292,166,329,302,495,2424,4078,5,22973,1276,1,2,10,9,1
4023,111,2192,74,35,59,1,0,14,75,3,14,7,14,17,21,58,85,1,128,7,0,2,10,9,1
4024,111,2192,245,125,200,5,7,34,250,7,30,17,34,37,51,166,265,3,1053,58,0,2,10,9,1
4025,26,1354,652,304,544,16,6,88,668,6,89,51,101,95,152,591,998,3,3399,188,0,2,21,0,1
4026,51,843,1020,354,843,12,15,144,1032,8,134,77,144,142,221,970,1580,4,6792,377,0,2,30,5,1
4027,186,4076,72,33,56,0,4,12,72,1,1,1,1,2,2,0,2,0,1,0,0,2,5,7,1
4028,186,4076,1454,835,1044,76,110,219,1530,17,275,158,296,292,454,2297,3718,9,34017,1889,1,2,5,7,1
4029,6,283,42,7,35,4,0,5,46,1,2,1,2,3,3,2,4,0,2,0,0,2,5,9,1
4030,6,283,11,6,10,0,0,1,11,2,4,2,4,6,6,10,15,1,15,0,0,2,5,9,1
4031,186,4083,72,33,56,0,4,12,72,1,1,1,1,2,2,0,2,0,1,0,0,2,1,0,0
4032,186,4083,1454,835,1044,76,110,219,1530,17,275,158,296,292,454,2297,3718,9,34017,1889,1,2,1,0,0
4033,192,4137,72,33,56,0,4,12,72,1,1,1,1,2,2,0,2,0,1,0,0,2,41,9,0
4034,192,4137,1454,835,1044,76,110,219,1530,17,275,158,296,292,454,2297,3718,9,34017,1889,1,2,41,9,0
4035,3,70,442,244,305,14,16,103,456,11,68,45,75,79,120,452,756,6,4588,254,0,2,1,1,1
4036,3,70,182,102,99,11,40,35,193,3,11,6,11,14,17,42,64,1,97,5,0,2,1,1,1
4037,2,105,442,244,305,14,16,103,456,11,68,45,75,79,120,452,756,6,4588,254,0,2,7,2,1
4038,168,3913,722,423,573,19,0,135,741,12,172,101,199,184,300,1320,2257,6,15668,870,0,2,1,6,1
4039,168,3913,1508,847,911,44,250,301,1552,14,148,88,169,162,257,1120,1886,7,15077,837,0,2,1,6,1
4040,1,31,2,2,2,0,0,0,2,0,0,0,0,0,0,0,0,0,0,0,0,2,1,1,0
4041,1,31,99,48,90,1,3,5,100,0,0,0,0,0,0,0,0,0,0,0,0,2,1,1,0
4042,1,31,8,5,5,2,0,1,10,0,0,0,0,0,0,0,0,0,0,0,0,2,1,1,0
4043,1,31,1217,716,841,84,126,174,1301,14,185,118,215,199,333,1446,2542,8,20687,1149,0,2,1,1,0
4044,1,31,160,89,115,0,13,31,160,7,15,11,17,22,28,78,124,3,495,27,0,2,1,1,0
4045,1,31,10,10,9,9,0,0,19,0,0,0,0,0,0,0,0,0,0,0,0,2,1,1,0
4046,1,31,173,84,99,8,29,36,181,5,12,7,13,17,20,54,81,2,221,12,0,2,1,1,0
4047,1,31,3,1,1,3,0,0,6,0,0,0,0,0,0,0,0,0,0,0,0,2,1,1,0
4048,6,283,42,7,35,4,0,5,46,1,2,1,2,3,3,2,4,0,2,0,0,2,1,1,0
4049,6,283,11,6,10,0,0,1,11,2,4,2,4,6,6,10,15,1,15,0,0,2,1,1,0
4050,3,88,442,244,305,14,16,103,456,11,68,45,75,79,120,452,756,6,4588,254,0,2,2,1,1
4051,3,88,182,102,99,11,40,35,193,3,11,6,11,14,17,42,64,1,97,5,0,2,2,1,1
4052,2,139,442,244,305,14,16,103,456,11,68,45,75,79,120,452,756,6,4588,254,0,2,6,1,1
4053,1,31,2,2,2,0,0,0,2,0,0,0,0,0,0,0,0,0,0,0,0,2,1,1,1
4054,1,31,99,48,90,1,3,5,100,0,0,0,0,0,0,0,0,0,0,0,0,2,1,1,1
4055,1,31,8,5,5,2,0,1,10,0,0,0,0,0,0,0,0,0,0,0,0,2,1,1,1
4056,1,31,1217,716,841,84,126,174,1301,14,185,118,215,199,333,1446,2542,8,20687,1149,0,2,1,1,1
4057,1,31,160,89,115,0,13,31,160,7,15,11,17,22,28,78,124,3,495,27,0,2,1,1,1
4058,1,31,10,10,9,9,0,0,19,0,0,0,0,0,0,0,0,0,0,0,0,2,1,1,1
4059,1,31,173,84,99,8,29,36,181,5,12,7,13,17,20,54,81,2,221,12,0,2,1,1,1
4060,1,31,3,1,1,3,0,0,6,0,0,0,0,0,0,0,0,0,0,0,0,2,1,1,1
4061,151,3035,373,158,315,8,0,51,381,5,76,44,79,81,123,486,779,2,2026,112,0,2,1,1,1
4062,6,283,42,7,35,4,0,5,46,1,2,1,2,3,3,2,4,0,2,0,0,2,1,1,1
4063,6,283,11,6,10,0,0,1,11,2,4,2,4,6,6,10,15,1,15,0,0,2,1,1,1
4064,28,1387,1178,367,1042,6,15,115,1184,9,94,51,95,103,146,644,976,4,4439,246,0,2,1,1,1
4065,151,3041,373,158,315,8,0,51,381,5,76,44,79,81,123,486,779,2,2026,112,0,2,1,1,1
4066,1,31,2,2,2,0,0,0,2,0,0,0,0,0,0,0,0,0,0,0,0,2,2,2,1
4067,1,31,99,48,90,1,3,5,100,0,0,0,0,0,0,0,0,0,0,0,0,2,2,2,1
4068,1,31,8,5,5,2,0,1,10,0,0,0,0,0,0,0,0,0,0,0,0,2,2,2,1
4069,1,31,1217,716,841,84,126,174,1301,14,185,118,215,199,333,1446,2542,8,20687,1149,0,2,2,2,1
4070,1,31,160,89,115,0,13,31,160,7,15,11,17,22,28,78,124,3,495,27,0,2,2,2,1
4071,1,31,10,10,9,9,0,0,19,0,0,0,0,0,0,0,0,0,0,0,0,2,2,2,1
4072,1,31,173,84,99,8,29,36,181,5,12,7,13,17,20,54,81,2,221,12,0,2,2,2,1
4073,1,31,3,1,1,3,0,0,6,0,0,0,0,0,0,0,0,0,0,0,0,2,2,2,1
4074,6,283,42,7,35,4,0,5,46,1,2,1,2,3,3,2,4,0,2,0,0,2,2,3,1
4075,6,283,11,6,10,0,0,1,11,2,4,2,4,6,6,10,15,1,15,0,0,2,2,3,1
4076,1,31,2,2,2,0,0,0,2,0,0,0,0,0,0,0,0,0,0,0,0,2,1,1,1
4077,1,31,99,48,90,1,3,5,100,0,0,0,0,0,0,0,0,0,0,0,0,2,1,1,1
4078,1,31,8,5,5,2,0,1,10,0,0,0,0,0,0,0,0,0,0,0,0,2,1,1,1
4079,1,31,1217,716,841,84,126,174,1301,14,185,118,215,199,333,1446,2542,8,20687,1149,0,2,1,1,1
4080,1,31,160,89,115,0,13,31,160,7,15,11,17,22,28,78,124,3,495,27,0,2,1,1,1
4081,1,31,10,10,9,9,0,0,19,0,0,0,0,0,0,0,0,0,0,0,0,2,1,1,1
4082,1,31,173,84,99,8,29,36,181,5,12,7,13,17,20,54,81,2,221,12,0,2,1,1,1
4083,1,31,3,1,1,3,0,0,6,0,0,0,0,0,0,0,0,0,0,0,0,2,1,1,1
4084,116,2264,1457,730,1242,11,6,188,1468,10,292,166,329,302,495,2424,4078,5,22973,1276,1,2,16,1,1
4085,116,2264,74,35,59,1,0,14,75,3,14,7,14,17,21,58,85,1,128,7,0,2,16,1,1
4086,116,2264,245,125,200,5,7,34,250,7,30,17,34,37,51,166,265,3,1053,58,0,2,16,1,1
4087,6,283,42,7,35,4,0,5,46,1,2,1,2,3,3,2,4,0,2,0,0,2,1,1,1
4088,6,283,11,6,10,0,0,1,11,2,4,2,4,6,6,10,15,1,15,0,0,2,1,1,1
4089,20,1004,1289,550,1043,56,32,155,1345,10,167,93,185,177,278,1266,2075,5,11498,638,0,2,10,2,1
4090,1,31,2,2,2,0,0,0,2,0,0,0,0,0,0,0,0,0,0,0,0,2,1,1,0
4091,1,31,99,48,90,1,3,5,100,0,0,0,0,0,0,0,0,0,0,0,0,2,1,1,0
4092,1,31,8,5,5,2,0,1,10,0,0,0,0,0,0,0,0,0,0,0,0,2,1,1,0
4093,1,31,1217,716,841,84,126,174,1301,14,185,118,215,199,333,1446,2542,8,20687,1149,0,2,1,1,0
4094,1,31,160,89,115,0,13,31,160,7,15,11,17,22,28,78,124,3,495,27,0,2,1,1,0
4095,1,31,10,10,9,9,0,0,19,0,0,0,0,0,0,0,0,0,0,0,0,2,1,1,0
4096,1,31,173,84,99,8,29,36,181,5,12,7,13,17,20,54,81,2,221,12,0,2,1,1,0
4097,1,31,3,1,1,3,0,0,6,0,0,0,0,0,0,0,0,0,0,0,0,2,1,1,0
4098,6,283,42,7,35,4,0,5,46,1,2,1,2,3,3,2,4,0,2,0,0,2,1,1,0
4099,6,283,11,6,10,0,0,1,11,2,4,2,4,6,6,10,15,1,15,0,0,2,1,1,0
4100,20,1015,1289,550,1043,56,32,155,1345,10,167,93,185,177,278,1266,2075,5,11498,638,0,2,3,0,0
4101,169,3918,722,423,573,19,0,135,741,12,172,101,199,184,300,1320,2257,6,15668,870,0,2,2,1,1
4102,169,3918,1508,847,911,44,250,301,1552,14,148,88,169,162,257,1120,1886,7,15077,837,0,2,2,1,1
4103,156,3046,373,158,315,8,0,51,381,5,76,44,79,81,123,486,779,2,2026,112,0,2,39,39,1
4104,18,346,127,75,83,2,11,30,129,4,14,7,14,18,21,61,87,2,175,9,0,2,3,0,1
4105,18,346,652,304,544,16,6,88,668,6,89,51,101,95,152,591,998,3,3399,188,0,2,3,0,1
4106,18,346,2,2,2,0,0,0,2,0,0,0,0,0,0,0,0,0,0,0,0,2,3,0,1
4107,18,346,8,5,5,0,0,3,8,0,0,0,0,0,0,0,0,0,0,0,0,2,3,0,1
4108,18,346,2,2,2,0,0,0,2,0,0,0,0,0,0,0,0,0,0,0,0,2,3,0,1
4109,18,346,14,8,8,0,0,6,14,0,0,0,0,0,0,0,0,0,0,0,0,2,3,0,1
4110,18,346,6,4,4,0,0,2,6,0,0,0,0,0,0,0,0,0,0,0,0,2,3,0,1
4111,18,346,6,4,4,0,0,2,6,1,2,1,2,3,3,2,4,0,2,0,0,2,3,0,1
4112,18,346,6,4,4,0,0,2,6,0,0,0,0,0,0,0,0,0,0,0,0,2,3,0,1
4113,18,346,7,5,5,0,0,2,7,0,0,0,0,0,0,0,0,0,0,0,0,2,3,0,1
4114,18,346,6,4,4,0,0,2,6,0,0,0,0,0,0,0,0,0,0,0,0,2,3,0,1
4115,18,346,10,6,6,0,0,4,10,0,0,0,0,0,0,0,0,0,0,0,0,2,3,0,1
4116,18,346,1,1,1,0,0,0,1,0,0,0,0,0,0,0,0,0,0,0,0,2,3,0,1
4117,18,346,1,1,1,0,0,0,1,0,0,0,0,0,0,0,0,0,0,0,0,2,3,0,1
4118,18,346,14,10,10,0,0,4,14,1,1,1,1,2,2,0,2,0,1,0,0,2,3,0,1
4119,18,346,46,26,30,3,0,12,49,3,6,3,6,9,9,20,28,1,42,2,0,2,3,0,1
4120,1,31,2,2,2,0,0,0,2,0,0,0,0,0,0,0,0,0,0,0,0,2,1,1,1
4121,1,31,99,48,90,1,3,5,100,0,0,0,0,0,0,0,0,0,0,0,0,2,1,1,1
4122,1,31,8,5,5,2,0,1,10,0,0,0,0,0,0,0,0,0,0,0,0,2,1,1,1
4123,1,31,1217,716,841,84,126,174,1301,14,185,118,215,199,333,1446,2542,8,20687,1149,0,2,1,1,1
4124,1,31,160,89,115,0,13,31,160,7,15,11,17,22,28,78,124,3,495,27,0,2,1,1,1
4125,1,31,10,10,9,9,0,0,19,0,0,0,0,0,0,0,0,0,0,0,0,2,1,1,1
4126,1,31,173,84,99,8,29,36,181,5,12,7,13,17,20,54,81,2,221,12,0,2,1,1,1
4127,1,31,3,1,1,3,0,0,6,0,0,0,0,0,0,0,0,0,0,0,0,2,1,1,1
4128,44,777,1020,354,843,12,15,144,1032,8,134,77,144,142,221,970,1580,4,6792,377,0,2,41,40,1
4129,169,3902,722,423,573,19,0,135,741,12,172,101,199,184,300,1320,2257,6,15668,870,0,2,2,5,1
4130,169,3902,1508,847,911,44,250,301,1552,14,148,88,169,162,257,1120,1886,7,15077,837,0,2,2,5,1
4131,191,4128,72,33,56,0,4,12,72,1,1,1,1,2,2,0,2,0,1,0,0,2,2,3,1
4132,191,4128,1454,835,1044,76,110,219,1530,17,275,158,296,292,454,2297,3718,9,34017,1889,1,2,2,3,1
4133,100,2392,1043,504,840,53,9,147,1096,9,180,112,198,189,310,1377,2344,4,11604,644,0,2,1,1,1
4134,100,2392,383,288,292,26,6,62,409,11,65,38,67,76,105,429,656,5,3719,206,0,2,1,1,1
4135,152,3008,373,158,315,8,0,51,381,5,76,44,79,81,123,486,779,2,2026,112,0,2,3,9,1
4136,6,283,42,7,35,4,0,5,46,1,2,1,2,3,3,2,4,0,2,0,0,2,1,1,1
4137,6,283,11,6,10,0,0,1,11,2,4,2,4,6,6,10,15,1,15,0,0,2,1,1,1
4138,31,1247,1020,354,843,12,15,144,1032,8,134,77,144,142,221,970,1580,4,6792,377,0,2,23,25,1
4139,6,219,1098,241,925,5,10,155,1103,7,46,25,49,53,74,273,423,3,1580,87,0,2,11,0,1
4140,1,31,2,2,2,0,0,0,2,0,0,0,0,0,0,0,0,0,0,0,0,2,1,1,1
4141,1,31,99,48,90,1,3,5,100,0,0,0,0,0,0,0,0,0,0,0,0,2,1,1,1
4142,1,31,8,5,5,2,0,1,10,0,0,0,0,0,0,0,0,0,0,0,0,2,1,1,1
4143,1,31,1217,716,841,84,126,174,1301,14,185,118,215,199,333,1446,2542,8,20687,1149,0,2,1,1,1
4144,1,31,160,89,115,0,13,31,160,7,15,11,17,22,28,78,124,3,495,27,0,2,1,1,1
4145,1,31,10,10,9,9,0,0,19,0,0,0,0,0,0,0,0,0,0,0,0,2,1,1,1
4146,1,31,173,84,99,8,29,36,181,5,12,7,13,17,20,54,81,2,221,12,0,2,1,1,1
4147,1,31,3,1,1,3,0,0,6,0,0,0,0,0,0,0,0,0,0,0,0,2,1,1,1
4148,154,3077,373,158,315,8,0,51,381,5,76,44,79,81,123,486,779,2,2026,112,0,2,14,0,1
4149,6,283,42,7,35,4,0,5,46,1,2,1,2,3,3,2,4,0,2,0,0,2,1,1,1
4150,6,283,11,6,10,0,0,1,11,2,4,2,4,6,6,10,15,1,15,0,0,2,1,1,1
4151,64,1168,1513,682,1277,25,13,200,1538,11,199,116,219,210,335,1557,2584,6,15641,868,0,2,9,0,1
4152,64,1168,819,519,539,24,98,155,843,15,96,57,106,111,163,690,1107,8,9171,509,0,2,9,0,1
4153,169,3919,722,423,573,19,0,135,741,12,172,101,199,184,300,1320,2257,6,15668,870,0,2,2,0,1
4154,169,3919,1508,847,911,44,250,301,1552,14,148,88,169,162,257,1120,1886,7,15077,837,0,2,2,0,1
4155,133,2578,1943,715,1694,26,18,214,1969,12,185,120,237,197,357,1436,2721,7,20915,1161,0,2,18,10,1
4156,133,2578,1168,838,957,57,25,144,1225,19,348,224,416,367,640,3018,5452,11,61921,3440,1,2,18,10,1
4157,1,31,2,2,2,0,0,0,2,0,0,0,0,0,0,0,0,0,0,0,0,2,1,1,1
4158,1,31,99,48,90,1,3,5,100,0,0,0,0,0,0,0,0,0,0,0,0,2,1,1,1
4159,1,31,8,5,5,2,0,1,10,0,0,0,0,0,0,0,0,0,0,0,0,2,1,1,1
4160,1,31,1217,716,841,84,126,174,1301,14,185,118,215,199,333,1446,2542,8,20687,1149,0,2,1,1,1
4161,1,31,160,89,115,0,13,31,160,7,15,11,17,22,28,78,124,3,495,27,0,2,1,1,1
4162,1,31,10,10,9,9,0,0,19,0,0,0,0,0,0,0,0,0,0,0,0,2,1,1,1
4163,1,31,173,84,99,8,29,36,181,5,12,7,13,17,20,54,81,2,221,12,0,2,1,1,1
4164,1,31,3,1,1,3,0,0,6,0,0,0,0,0,0,0,0,0,0,0,0,2,1,1,1
4165,6,283,42,7,35,4,0,5,46,1,2,1,2,3,3,2,4,0,2,0,0,2,1,1,1
4166,6,283,11,6,10,0,0,1,11,2,4,2,4,6,6,10,15,1,15,0,0,2,1,1,1
4167,30,524,127,75,83,2,11,30,129,4,14,7,14,18,21,61,87,2,175,9,0,2,32,2,1
4168,30,524,652,304,544,16,6,88,668,6,89,51,101,95,152,591,998,3,3399,188,0,2,32,2,1
4169,30,524,2,2,2,0,0,0,2,0,0,0,0,0,0,0,0,0,0,0,0,2,32,2,1
4170,30,524,8,5,5,0,0,3,8,0,0,0,0,0,0,0,0,0,0,0,0,2,32,2,1
4171,30,524,2,2,2,0,0,0,2,0,0,0,0,0,0,0,0,0,0,0,0,2,32,2,1
4172,30,524,14,8,8,0,0,6,14,0,0,0,0,0,0,0,0,0,0,0,0,2,32,2,1
4173,30,524,6,4,4,0,0,2,6,0,0,0,0,0,0,0,0,0,0,0,0,2,32,2,1
4174,30,524,6,4,4,0,0,2,6,1,2,1,2,3,3,2,4,0,2,0,0,2,32,2,1
4175,30,524,6,4,4,0,0,2,6,0,0,0,0,0,0,0,0,0,0,0,0,2,32,2,1
4176,30,524,7,5,5,0,0,2,7,0,0,0,0,0,0,0,0,0,0,0,0,2,32,2,1
4177,30,524,6,4,4,0,0,2,6,0,0,0,0,0,0,0,0,0,0,0,0,2,32,2,1
4178,30,524,10,6,6,0,0,4,10,0,0,0,0,0,0,0,0,0,0,0,0,2,32,2,1
4179,30,524,1,1,1,0,0,0,1,0,0,0,0,0,0,0,0,0,0,0,0,2,32,2,1
4180,30,524,1,1,1,0,0,0,1,0,0,0,0,0,0,0,0,0,0,0,0,2,32,2,1
4181,30,524,14,10,10,0,0,4,14,1,1,1,1,2,2,0,2,0,1,0,0,2,32,2,1
4182,30,524,46,26,30,3,0,12,49,3,6,3,6,9,9,20,28,1,42,2,0,2,32,2,1
4183,12,228,127,75,83,2,11,30,129,4,14,7,14,18,21,61,87,2,175,9,0,0,40,0,1
4184,12,228,652,304,544,16,6,88,668,6,89,51,101,95,152,591,998,3,3399,188,0,0,40,0,1
4185,12,228,2,2,2,0,0,0,2,0,0,0,0,0,0,0,0,0,0,0,0,0,40,0,1
4186,12,228,8,5,5,0,0,3,8,0,0,0,0,0,0,0,0,0,0,0,0,0,40,0,1
4187,12,228,2,2,2,0,0,0,2,0,0,0,0,0,0,0,0,0,0,0,0,0,40,0,1
4188,12,228,14,8,8,0,0,6,14,0,0,0,0,0,0,0,0,0,0,0,0,0,40,0,1
4189,12,228,6,4,4,0,0,2,6,0,0,0,0,0,0,0,0,0,0,0,0,0,40,0,1
4190,12,228,6,4,4,0,0,2,6,1,2,1,2,3,3,2,4,0,2,0,0,0,40,0,1
4191,12,228,6,4,4,0,0,2,6,0,0,0,0,0,0,0,0,0,0,0,0,0,40,0,1
4192,12,228,7,5,5,0,0,2,7,0,0,0,0,0,0,0,0,0,0,0,0,0,40,0,1
4193,12,228,6,4,4,0,0,2,6,0,0,0,0,0,0,0,0,0,0,0,0,0,40,0,1
4194,12,228,10,6,6,0,0,4,10,0,0,0,0,0,0,0,0,0,0,0,0,0,40,0,1
4195,12,228,1,1,1,0,0,0,1,0,0,0,0,0,0,0,0,0,0,0,0,0,40,0,1
4196,12,228,1,1,1,0,0,0,1,0,0,0,0,0,0,0,0,0,0,0,0,0,40,0,1
4197,12,228,14,10,10,0,0,4,14,1,1,1,1,2,2,0,2,0,1,0,0,0,40,0,1
4198,12,228,46,26,30,3,0,12,49,3,6,3,6,9,9,20,28,1,42,2,0,0,40,0,1
4199,1,149,382,65,130,157,2,92,539,4,10,5,10,14,15,41,57,2,114,6,0,2,6,0,1
4200,1,36,2,2,2,0,0,0,2,0,0,0,0,0,0,0,0,0,0,0,0,2,2,1,1
4201,1,36,99,48,90,1,3,5,100,0,0,0,0,0,0,0,0,0,0,0,0,2,2,1,1
4202,1,36,8,5,5,2,0,1,10,0,0,0,0,0,0,0,0,0,0,0,0,2,2,1,1
4203,1,36,1217,716,841,84,126,174,1301,14,185,118,215,199,333,1446,2542,8,20687,1149,0,2,2,1,1
4204,1,36,160,89,115,0,13,31,160,7,15,11,17,22,28,78,124,3,495,27,0,2,2,1,1
4205,1,36,10,10,9,9,0,0,19,0,0,0,0,0,0,0,0,0,0,0,0,2,2,1,1
4206,1,36,173,84,99,8,29,36,181,5,12,7,13,17,20,54,81,2,221,12,0,2,2,1,1
4207,1,36,3,1,1,3,0,0,6,0,0,0,0,0,0,0,0,0,0,0,0,2,2,1,1
4208,132,2527,1457,730,1242,11,6,188,1468,10,292,166,329,302,495,2424,4078,5,22973,1276,1,2,45,5,1
4209,132,2527,74,35,59,1,0,14,75,3,14,7,14,17,21,58,85,1,128,7,0,2,45,5,1
4210,132,2527,245,125,200,5,7,34,250,7,30,17,34,37,51,166,265,3,1053,58,0,2,45,5,1
4211,154,3069,373,158,315,8,0,51,381,5,76,44,79,81,123,486,779,2,2026,112,0,2,4,4,1
4212,20,1015,1289,550,1043,56,32,155,1345,10,167,93,185,177,278,1266,2075,5,11498,638,0,2,2,1,1
4213,32,554,127,75,83,2,11,30,129,4,14,7,14,18,21,61,87,2,175,9,0,2,6,0,1
4214,32,554,652,304,544,16,6,88,668,6,89,51,101,95,152,591,998,3,3399,188,0,2,6,0,1
4215,32,554,2,2,2,0,0,0,2,0,0,0,0,0,0,0,0,0,0,0,0,2,6,0,1
4216,32,554,8,5,5,0,0,3,8,0,0,0,0,0,0,0,0,0,0,0,0,2,6,0,1
4217,32,554,2,2,2,0,0,0,2,0,0,0,0,0,0,0,0,0,0,0,0,2,6,0,1
4218,32,554,14,8,8,0,0,6,14,0,0,0,0,0,0,0,0,0,0,0,0,2,6,0,1
4219,32,554,6,4,4,0,0,2,6,0,0,0,0,0,0,0,0,0,0,0,0,2,6,0,1
4220,32,554,6,4,4,0,0,2,6,1,2,1,2,3,3,2,4,0,2,0,0,2,6,0,1
4221,32,554,6,4,4,0,0,2,6,0,0,0,0,0,0,0,0,0,0,0,0,2,6,0,1
4222,32,554,7,5,5,0,0,2,7,0,0,0,0,0,0,0,0,0,0,0,0,2,6,0,1
4223,32,554,6,4,4,0,0,2,6,0,0,0,0,0,0,0,0,0,0,0,0,2,6,0,1
4224,32,554,10,6,6,0,0,4,10,0,0,0,0,0,0,0,0,0,0,0,0,2,6,0,1
4225,32,554,1,1,1,0,0,0,1,0,0,0,0,0,0,0,0,0,0,0,0,2,6,0,1
4226,32,554,1,1,1,0,0,0,1,0,0,0,0,0,0,0,0,0,0,0,0,2,6,0,1
4227,32,554,14,10,10,0,0,4,14,1,1,1,1,2,2,0,2,0,1,0,0,2,6,0,1
4228,32,554,46,26,30,3,0,12,49,3,6,3,6,9,9,20,28,1,42,2,0,2,6,0,1
4229,20,1267,1457,730,1242,11,6,188,1468,10,292,166,329,302,495,2424,4078,5,22973,1276,1,2,46,0,1
4230,124,2402,1457,730,1242,11,6,188,1468,10,292,166,329,302,495,2424,4078,5,22973,1276,1,2,14,32,1
4231,124,2402,74,35,59,1,0,14,75,3,14,7,14,17,21,58,85,1,128,7,0,2,14,32,1
4232,124,2402,245,125,200,5,7,34,250,7,30,17,34,37,51,166,265,3,1053,58,0,2,14,32,1
4233,33,864,74,35,59,1,0,14,75,3,14,7,14,17,21,58,85,1,128,7,0,2,36,41,1
4234,33,864,245,125,200,5,7,34,250,7,30,17,34,37,51,166,265,3,1053,58,0,2,36,41,1
4235,170,3938,722,423,573,19,0,135,741,12,172,101,199,184,300,1320,2257,6,15668,870,0,2,3,0,1
4236,170,3938,1508,847,911,44,250,301,1552,14,148,88,169,162,257,1120,1886,7,15077,837,0,2,3,0,1
4237,7,230,74,35,59,1,0,14,75,3,14,7,14,17,21,58,85,1,128,7,0,2,5,3,1
4238,50,2502,1943,715,1694,26,18,214,1969,12,185,120,237,197,357,1436,2721,7,20915,1161,0,2,2,2,1
4239,17,1016,1457,730,1242,11,6,188,1468,10,292,166,329,302,495,2424,4078,5,22973,1276,1,2,1,36,1
4240,17,771,334,251,279,10,4,40,344,5,127,74,143,132,217,899,1528,2,4303,239,0,2,2,2,1
4241,128,2500,1457,730,1242,11,6,188,1468,10,292,166,329,302,495,2424,4078,5,22973,1276,1,2,21,2,1
4242,128,2500,74,35,59,1,0,14,75,3,14,7,14,17,21,58,85,1,128,7,0,2,21,2,1
4243,128,2500,245,125,200,5,7,34,250,7,30,17,34,37,51,166,265,3,1053,58,0,2,21,2,1
4244,33,859,74,35,59,1,0,14,75,3,14,7,14,17,21,58,85,1,128,7,0,2,3,7,1
4245,33,859,245,125,200,5,7,34,250,7,30,17,34,37,51,166,265,3,1053,58,0,2,3,7,1
4246,7,230,74,35,59,1,0,14,75,3,14,7,14,17,21,58,85,1,128,7,0,2,1,1,1
4247,18,834,334,251,279,10,4,40,344,5,127,74,143,132,217,899,1528,2,4303,239,0,2,13,0,1
4248,1,80,13,10,10,0,0,3,13,1,2,1,2,3,3,2,4,0,2,0,0,2,0,2,1
4249,133,2609,1457,730,1242,11,6,188,1468,10,292,166,329,302,495,2424,4078,5,22973,1276,1,2,38,26,1
4250,133,2609,74,35,59,1,0,14,75,3,14,7,14,17,21,58,85,1,128,7,0,2,38,26,1
4251,133,2609,245,125,200,5,7,34,250,7,30,17,34,37,51,166,265,3,1053,58,0,2,38,26,1
4252,33,844,74,35,59,1,0,14,75,3,14,7,14,17,21,58,85,1,128,7,0,2,11,12,1
4253,33,844,245,125,200,5,7,34,250,7,30,17,34,37,51,166,265,3,1053,58,0,2,11,12,1
4254,172,3985,722,423,573,19,0,135,741,12,172,101,199,184,300,1320,2257,6,15668,870,0,2,7,0,1
4255,172,3985,1508,847,911,44,250,301,1552,14,148,88,169,162,257,1120,1886,7,15077,837,0,2,7,0,1
4256,154,3068,373,158,315,8,0,51,381,5,76,44,79,81,123,486,779,2,2026,112,0,2,3,2,1
4257,32,536,127,75,83,2,11,30,129,4,14,7,14,18,21,61,87,2,175,9,0,2,0,3,1
4258,32,536,652,304,544,16,6,88,668,6,89,51,101,95,152,591,998,3,3399,188,0,2,0,3,1
4259,32,536,2,2,2,0,0,0,2,0,0,0,0,0,0,0,0,0,0,0,0,2,0,3,1
4260,32,536,8,5,5,0,0,3,8,0,0,0,0,0,0,0,0,0,0,0,0,2,0,3,1
4261,32,536,2,2,2,0,0,0,2,0,0,0,0,0,0,0,0,0,0,0,0,2,0,3,1
4262,32,536,14,8,8,0,0,6,14,0,0,0,0,0,0,0,0,0,0,0,0,2,0,3,1
4263,32,536,6,4,4,0,0,2,6,0,0,0,0,0,0,0,0,0,0,0,0,2,0,3,1
4264,32,536,6,4,4,0,0,2,6,1,2,1,2,3,3,2,4,0,2,0,0,2,0,3,1
4265,32,536,6,4,4,0,0,2,6,0,0,0,0,0,0,0,0,0,0,0,0,2,0,3,1
4266,32,536,7,5,5,0,0,2,7,0,0,0,0,0,0,0,0,0,0,0,0,2,0,3,1
4267,32,536,6,4,4,0,0,2,6,0,0,0,0,0,0,0,0,0,0,0,0,2,0,3,1
4268,32,536,10,6,6,0,0,4,10,0,0,0,0,0,0,0,0,0,0,0,0,2,0,3,1
4269,32,536,1,1,1,0,0,0,1,0,0,0,0,0,0,0,0,0,0,0,0,2,0,3,1
4270,32,536,1,1,1,0,0,0,1,0,0,0,0,0,0,0,0,0,0,0,0,2,0,3,1
4271,32,536,14,10,10,0,0,4,14,1,1,1,1,2,2,0,2,0,1,0,0,2,0,3,1
4272,32,536,46,26,30,3,0,12,49,3,6,3,6,9,9,20,28,1,42,2,0,2,0,3,1
4273,7,163,127,75,83,2,11,30,129,4,14,7,14,18,21,61,87,2,175,9,0,2,0,1,1
4274,7,163,652,304,544,16,6,88,668,6,89,51,101,95,152,591,998,3,3399,188,0,2,0,1,1
4275,7,163,2,2,2,0,0,0,2,0,0,0,0,0,0,0,0,0,0,0,0,2,0,1,1
4276,7,163,8,5,5,0,0,3,8,0,0,0,0,0,0,0,0,0,0,0,0,2,0,1,1
4277,7,163,2,2,2,0,0,0,2,0,0,0,0,0,0,0,0,0,0,0,0,2,0,1,1
4278,7,163,14,8,8,0,0,6,14,0,0,0,0,0,0,0,0,0,0,0,0,2,0,1,1
4279,7,163,6,4,4,0,0,2,6,0,0,0,0,0,0,0,0,0,0,0,0,2,0,1,1
4280,7,163,6,4,4,0,0,2,6,1,2,1,2,3,3,2,4,0,2,0,0,2,0,1,1
4281,7,163,6,4,4,0,0,2,6,0,0,0,0,0,0,0,0,0,0,0,0,2,0,1,1
4282,7,163,7,5,5,0,0,2,7,0,0,0,0,0,0,0,0,0,0,0,0,2,0,1,1
4283,7,163,6,4,4,0,0,2,6,0,0,0,0,0,0,0,0,0,0,0,0,2,0,1,1
4284,7,163,10,6,6,0,0,4,10,0,0,0,0,0,0,0,0,0,0,0,0,2,0,1,1
4285,7,163,1,1,1,0,0,0,1,0,0,0,0,0,0,0,0,0,0,0,0,2,0,1,1
4286,7,163,1,1,1,0,0,0,1,0,0,0,0,0,0,0,0,0,0,0,0,2,0,1,1
4287,7,163,14,10,10,0,0,4,14,1,1,1,1,2,2,0,2,0,1,0,0,2,0,1,1
4288,7,163,46,26,30,3,0,12,49,3,6,3,6,9,9,20,28,1,42,2,0,2,0,1,1
4289,7,230,74,35,59,1,0,14,75,3,14,7,14,17,21,58,85,1,128,7,0,2,2,2,1
4290,19,1151,1457,730,1242,11,6,188,1468,10,292,166,329,302,495,2424,4078,5,22973,1276,1,2,33,3,1
4291,17,775,334,251,279,10,4,40,344,5,127,74,143,132,217,899,1528,2,4303,239,0,2,0,11,1
4292,133,2600,1457,730,1242,11,6,188,1468,10,292,166,329,302,495,2424,4078,5,22973,1276,1,2,7,5,1
4293,133,2600,74,35,59,1,0,14,75,3,14,7,14,17,21,58,85,1,128,7,0,2,7,5,1
4294,133,2600,245,125,200,5,7,34,250,7,30,17,34,37,51,166,265,3,1053,58,0,2,7,5,1
4295,175,4013,722,423,573,19,0,135,741,12,172,101,199,184,300,1320,2257,6,15668,870,0,2,5,0,1
4296,175,4013,1508,847,911,44,250,301,1552,14,148,88,169,162,257,1120,1886,7,15077,837,0,2,5,0,1
4297,151,3042,373,158,315,8,0,51,381,5,76,44,79,81,123,486,779,2,2026,112,0,2,2,8,1
4298,1,36,2,2,2,0,0,0,2,0,0,0,0,0,0,0,0,0,0,0,0,2,2,2,0
4299,1,36,99,48,90,1,3,5,100,0,0,0,0,0,0,0,0,0,0,0,0,2,2,2,0
4300,1,36,8,5,5,2,0,1,10,0,0,0,0,0,0,0,0,0,0,0,0,2,2,2,0
4301,1,36,1217,716,841,84,126,174,1301,14,185,118,215,199,333,1446,2542,8,20687,1149,0,2,2,2,0
4302,1,36,160,89,115,0,13,31,160,7,15,11,17,22,28,78,124,3,495,27,0,2,2,2,0
4303,1,36,10,10,9,9,0,0,19,0,0,0,0,0,0,0,0,0,0,0,0,2,2,2,0
4304,1,36,173,84,99,8,29,36,181,5,12,7,13,17,20,54,81,2,221,12,0,2,2,2,0
4305,1,36,3,1,1,3,0,0,6,0,0,0,0,0,0,0,0,0,0,0,0,2,2,2,0
4306,6,283,42,7,35,4,0,5,46,1,2,1,2,3,3,2,4,0,2,0,0,2,1,1,0
4307,6,283,11,6,10,0,0,1,11,2,4,2,4,6,6,10,15,1,15,0,0,2,1,1,0
4308,1,149,382,65,130,157,2,92,539,4,10,5,10,14,15,41,57,2,114,6,0,2,6,0,0
4309,12,228,127,75,83,2,11,30,129,4,14,7,14,18,21,61,87,2,175,9,0,0,40,0,0
4310,12,228,652,304,544,16,6,88,668,6,89,51,101,95,152,591,998,3,3399,188,0,0,40,0,0
4311,12,228,2,2,2,0,0,0,2,0,0,0,0,0,0,0,0,0,0,0,0,0,40,0,0
4312,12,228,8,5,5,0,0,3,8,0,0,0,0,0,0,0,0,0,0,0,0,0,40,0,0
4313,12,228,2,2,2,0,0,0,2,0,0,0,0,0,0,0,0,0,0,0,0,0,40,0,0
4314,12,228,14,8,8,0,0,6,14,0,0,0,0,0,0,0,0,0,0,0,0,0,40,0,0
4315,12,228,6,4,4,0,0,2,6,0,0,0,0,0,0,0,0,0,0,0,0,0,40,0,0
4316,12,228,6,4,4,0,0,2,6,1,2,1,2,3,3,2,4,0,2,0,0,0,40,0,0
4317,12,228,6,4,4,0,0,2,6,0,0,0,0,0,0,0,0,0,0,0,0,0,40,0,0
4318,12,228,7,5,5,0,0,2,7,0,0,0,0,0,0,0,0,0,0,0,0,0,40,0,0
4319,12,228,6,4,4,0,0,2,6,0,0,0,0,0,0,0,0,0,0,0,0,0,40,0,0
4320,12,228,10,6,6,0,0,4,10,0,0,0,0,0,0,0,0,0,0,0,0,0,40,0,0
4321,12,228,1,1,1,0,0,0,1,0,0,0,0,0,0,0,0,0,0,0,0,0,40,0,0
4322,12,228,1,1,1,0,0,0,1,0,0,0,0,0,0,0,0,0,0,0,0,0,40,0,0
4323,12,228,14,10,10,0,0,4,14,1,1,1,1,2,2,0,2,0,1,0,0,0,40,0,0
4324,12,228,46,26,30,3,0,12,49,3,6,3,6,9,9,20,28,1,42,2,0,0,40,0,0
4325,1,80,13,10,10,0,0,3,13,1,2,1,2,3,3,2,4,0,2,0,0,2,0,2,0
4326,1,36,2,2,2,0,0,0,2,0,0,0,0,0,0,0,0,0,0,0,0,2,2,1,0
4327,1,36,99,48,90,1,3,5,100,0,0,0,0,0,0,0,0,0,0,0,0,2,2,1,0
4328,1,36,8,5,5,2,0,1,10,0,0,0,0,0,0,0,0,0,0,0,0,2,2,1,0
4329,1,36,1217,716,841,84,126,174,1301,14,185,118,215,199,333,1446,2542,8,20687,1149,0,2,2,1,0
4330,1,36,160,89,115,0,13,31,160,7,15,11,17,22,28,78,124,3,495,27,0,2,2,1,0
4331,1,36,10,10,9,9,0,0,19,0,0,0,0,0,0,0,0,0,0,0,0,2,2,1,0
4332,1,36,173,84,99,8,29,36,181,5,12,7,13,17,20,54,81,2,221,12,0,2,2,1,0
4333,1,36,3,1,1,3,0,0,6,0,0,0,0,0,0,0,0,0,0,0,0,2,2,1,0
4334,133,2600,1457,730,1242,11,6,188,1468,10,292,166,329,302,495,2424,4078,5,22973,1276,1,2,103,48,0
4335,133,2600,74,35,59,1,0,14,75,3,14,7,14,17,21,58,85,1,128,7,0,2,103,48,0
4336,133,2600,245,125,200,5,7,34,250,7,30,17,34,37,51,166,265,3,1053,58,0,2,103,48,0
4337,33,844,74,35,59,1,0,14,75,3,14,7,14,17,21,58,85,1,128,7,0,2,37,47,0
4338,33,844,245,125,200,5,7,34,250,7,30,17,34,37,51,166,265,3,1053,58,0,2,37,47,0
4339,175,4013,722,423,573,19,0,135,741,12,172,101,199,184,300,1320,2257,6,15668,870,0,2,15,0,0
4340,175,4013,1508,847,911,44,250,301,1552,14,148,88,169,162,257,1120,1886,7,15077,837,0,2,15,0,0
4341,151,3042,373,158,315,8,0,51,381,5,76,44,79,81,123,486,779,2,2026,112,0,2,9,14,0
4342,6,283,42,7,35,4,0,5,46,1,2,1,2,3,3,2,4,0,2,0,0,2,1,1,0
4343,6,283,11,6,10,0,0,1,11,2,4,2,4,6,6,10,15,1,15,0,0,2,1,1,0
4344,20,1015,1289,550,1043,56,32,155,1345,10,167,93,185,177,278,1266,2075,5,11498,638,0,2,2,1,0
4345,32,536,127,75,83,2,11,30,129,4,14,7,14,18,21,61,87,2,175,9,0,2,6,3,0
4346,32,536,652,304,544,16,6,88,668,6,89,51,101,95,152,591,998,3,3399,188,0,2,6,3,0
4347,32,536,2,2,2,0,0,0,2,0,0,0,0,0,0,0,0,0,0,0,0,2,6,3,0
4348,32,536,8,5,5,0,0,3,8,0,0,0,0,0,0,0,0,0,0,0,0,2,6,3,0
4349,32,536,2,2,2,0,0,0,2,0,0,0,0,0,0,0,0,0,0,0,0,2,6,3,0
4350,32,536,14,8,8,0,0,6,14,0,0,0,0,0,0,0,0,0,0,0,0,2,6,3,0
4351,32,536,6,4,4,0,0,2,6,0,0,0,0,0,0,0,0,0,0,0,0,2,6,3,0
4352,32,536,6,4,4,0,0,2,6,1,2,1,2,3,3,2,4,0,2,0,0,2,6,3,0
4353,32,536,6,4,4,0,0,2,6,0,0,0,0,0,0,0,0,0,0,0,0,2,6,3,0
4354,32,536,7,5,5,0,0,2,7,0,0,0,0,0,0,0,0,0,0,0,0,2,6,3,0
4355,32,536,6,4,4,0,0,2,6,0,0,0,0,0,0,0,0,0,0,0,0,2,6,3,0
4356,32,536,10,6,6,0,0,4,10,0,0,0,0,0,0,0,0,0,0,0,0,2,6,3,0
4357,32,536,1,1,1,0,0,0,1,0,0,0,0,0,0,0,0,0,0,0,0,2,6,3,0
4358,32,536,1,1,1,0,0,0,1,0,0,0,0,0,0,0,0,0,0,0,0,2,6,3,0
4359,32,536,14,10,10,0,0,4,14,1,1,1,1,2,2,0,2,0,1,0,0,2,6,3,0
4360,32,536,46,26,30,3,0,12,49,3,6,3,6,9,9,20,28,1,42,2,0,2,6,3,0
4361,7,163,127,75,83,2,11,30,129,4,14,7,14,18,21,61,87,2,175,9,0,2,0,1,0
4362,7,163,652,304,544,16,6,88,668,6,89,51,101,95,152,591,998,3,3399,188,0,2,0,1,0
4363,7,163,2,2,2,0,0,0,2,0,0,0,0,0,0,0,0,0,0,0,0,2,0,1,0
4364,7,163,8,5,5,0,0,3,8,0,0,0,0,0,0,0,0,0,0,0,0,2,0,1,0
4365,7,163,2,2,2,0,0,0,2,0,0,0,0,0,0,0,0,0,0,0,0,2,0,1,0
4366,7,163,14,8,8,0,0,6,14,0,0,0,0,0,0,0,0,0,0,0,0,2,0,1,0
4367,7,163,6,4,4,0,0,2,6,0,0,0,0,0,0,0,0,0,0,0,0,2,0,1,0
4368,7,163,6,4,4,0,0,2,6,1,2,1,2,3,3,2,4,0,2,0,0,2,0,1,0
4369,7,163,6,4,4,0,0,2,6,0,0,0,0,0,0,0,0,0,0,0,0,2,0,1,0
4370,7,163,7,5,5,0,0,2,7,0,0,0,0,0,0,0,0,0,0,0,0,2,0,1,0
4371,7,163,6,4,4,0,0,2,6,0,0,0,0,0,0,0,0,0,0,0,0,2,0,1,0
4372,7,163,10,6,6,0,0,4,10,0,0,0,0,0,0,0,0,0,0,0,0,2,0,1,0
4373,7,163,1,1,1,0,0,0,1,0,0,0,0,0,0,0,0,0,0,0,0,2,0,1,0
4374,7,163,1,1,1,0,0,0,1,0,0,0,0,0,0,0,0,0,0,0,0,2,0,1,0
4375,7,163,14,10,10,0,0,4,14,1,1,1,1,2,2,0,2,0,1,0,0,2,0,1,0
4376,7,163,46,26,30,3,0,12,49,3,6,3,6,9,9,20,28,1,42,2,0,2,0,1,0
4377,7,230,74,35,59,1,0,14,75,3,14,7,14,17,21,58,85,1,128,7,0,2,5,3,0
4378,50,2502,1943,715,1694,26,18,214,1969,12,185,120,237,197,357,1436,2721,7,20915,1161,0,2,2,2,0
4379,19,1151,1457,730,1242,11,6,188,1468,10,292,166,329,302,495,2424,4078,5,22973,1276,1,2,68,27,0
4380,17,775,334,251,279,10,4,40,344,5,127,74,143,132,217,899,1528,2,4303,239,0,2,4,2,0
4381,6,283,42,7,35,4,0,5,46,1,2,1,2,3,3,2,4,0,2,0,0,2,2,2,1
4382,6,283,11,6,10,0,0,1,11,2,4,2,4,6,6,10,15,1,15,0,0,2,2,2,1
4383,67,2915,384,251,317,7,8,52,391,11,70,44,84,81,128,467,811,6,5355,297,0,2,0,5,0
4384,33,844,74,35,59,1,0,14,75,3,14,7,14,17,21,58,85,1,128,7,0,2,1,1,1
4385,33,844,245,125,200,5,7,34,250,7,30,17,34,37,51,166,265,3,1053,58,0,2,1,1,1
4386,7,224,74,35,59,1,0,14,75,3,14,7,14,17,21,58,85,1,128,7,0,2,2,3,1
4387,68,2994,384,251,317,7,8,52,391,11,70,44,84,81,128,467,811,6,5355,297,0,2,12,0,1
4388,33,848,74,35,59,1,0,14,75,3,14,7,14,17,21,58,85,1,128,7,0,2,1,1,0
4389,33,848,245,125,200,5,7,34,250,7,30,17,34,37,51,166,265,3,1053,58,0,2,1,1,0
4390,138,2686,1943,715,1694,26,18,214,1969,12,185,120,237,197,357,1436,2721,7,20915,1161,0,2,23,7,1
4391,138,2686,1168,838,957,57,25,144,1225,19,348,224,416,367,640,3018,5452,11,61921,3440,1,2,23,7,1
4392,51,2576,1943,715,1694,26,18,214,1969,12,185,120,237,197,357,1436,2721,7,20915,1161,0,2,10,0,1
4393,1,36,2,2,2,0,0,0,2,0,0,0,0,0,0,0,0,0,0,0,0,2,1,1,0
4394,1,36,99,48,90,1,3,5,100,0,0,0,0,0,0,0,0,0,0,0,0,2,1,1,0
4395,1,36,8,5,5,2,0,1,10,0,0,0,0,0,0,0,0,0,0,0,0,2,1,1,0
4396,1,36,1217,716,841,84,126,174,1301,14,185,118,215,199,333,1446,2542,8,20687,1149,0,2,1,1,0
4397,1,36,160,89,115,0,13,31,160,7,15,11,17,22,28,78,124,3,495,27,0,2,1,1,0
4398,1,36,10,10,9,9,0,0,19,0,0,0,0,0,0,0,0,0,0,0,0,2,1,1,0
4399,1,36,173,84,99,8,29,36,181,5,12,7,13,17,20,54,81,2,221,12,0,2,1,1,0
4400,1,36,3,1,1,3,0,0,6,0,0,0,0,0,0,0,0,0,0,0,0,2,1,1,0
4401,6,283,42,7,35,4,0,5,46,1,2,1,2,3,3,2,4,0,2,0,0,2,2,2,0
4402,6,283,11,6,10,0,0,1,11,2,4,2,4,6,6,10,15,1,15,0,0,2,2,2,0
4403,46,442,647,139,84,35,284,233,682,0,0,0,0,0,0,0,0,0,0,0,0,2,17,16,1
4404,44,777,1020,354,843,12,15,144,1032,8,134,77,144,142,221,970,1580,4,6792,377,0,2,1,1,1
4405,191,4124,72,33,56,0,4,12,72,1,1,1,1,2,2,0,2,0,1,0,0,2,1,3,1
4406,191,4124,1454,835,1044,76,110,219,1530,17,275,158,296,292,454,2297,3718,9,34017,1889,1,2,1,3,1
4407,151,3042,373,158,315,8,0,51,381,5,76,44,79,81,123,486,779,2,2026,112,0,2,4,4,1
4408,69,1131,1178,367,1042,6,15,115,1184,9,94,51,95,103,146,644,976,4,4439,246,0,2,1,1,1
4409,69,1131,177,108,140,8,0,27,185,6,30,16,32,36,48,162,248,3,794,44,0,2,1,1,1
4410,138,2682,1943,715,1694,26,18,214,1969,12,185,120,237,197,357,1436,2721,7,20915,1161,0,2,7,7,1
4411,138,2682,1168,838,957,57,25,144,1225,19,348,224,416,367,640,3018,5452,11,61921,3440,1,2,7,7,1
4412,25,1029,373,158,315,8,0,51,381,5,76,44,79,81,123,486,779,2,2026,112,0,2,2,2,1
4413,50,2539,1943,715,1694,26,18,214,1969,12,185,120,237,197,357,1436,2721,7,20915,1161,0,2,10,11,1
4414,46,442,647,139,84,35,284,233,682,0,0,0,0,0,0,0,0,0,0,0,0,2,4,4,1
4415,150,3013,373,158,315,8,0,51,381,5,76,44,79,81,123,486,779,2,2026,112,0,2,37,44,1
4416,149,3000,373,158,315,8,0,51,381,5,76,44,79,81,123,486,779,2,2026,112,0,2,0,2,0
4417,68,2994,384,251,317,7,8,52,391,11,70,44,84,81,128,467,811,6,5355,297,0,2,4,4,0
4418,1,36,2,2,2,0,0,0,2,0,0,0,0,0,0,0,0,0,0,0,0,2,1,1,1
4419,1,36,99,48,90,1,3,5,100,0,0,0,0,0,0,0,0,0,0,0,0,2,1,1,1
4420,1,36,8,5,5,2,0,1,10,0,0,0,0,0,0,0,0,0,0,0,0,2,1,1,1
4421,1,36,1217,716,841,84,126,174,1301,14,185,118,215,199,333,1446,2542,8,20687,1149,0,2,1,1,1
4422,1,36,160,89,115,0,13,31,160,7,15,11,17,22,28,78,124,3,495,27,0,2,1,1,1
4423,1,36,10,10,9,9,0,0,19,0,0,0,0,0,0,0,0,0,0,0,0,2,1,1,1
4424,1,36,173,84,99,8,29,36,181,5,12,7,13,17,20,54,81,2,221,12,0,2,1,1,1
4425,1,36,3,1,1,3,0,0,6,0,0,0,0,0,0,0,0,0,0,0,0,2,1,1,1
4426,175,4016,722,423,573,19,0,135,741,12,172,101,199,184,300,1320,2257,6,15668,870,0,2,1,0,1
4427,175,4016,1508,847,911,44,250,301,1552,14,148,88,169,162,257,1120,1886,7,15077,837,0,2,1,0,1
4428,149,2995,373,158,315,8,0,51,381,5,76,44,79,81,123,486,779,2,2026,112,0,2,1,1,1
4429,6,283,42,7,35,4,0,5,46,1,2,1,2,3,3,2,4,0,2,0,0,2,1,1,1
4430,6,283,11,6,10,0,0,1,11,2,4,2,4,6,6,10,15,1,15,0,0,2,1,1,1
4431,1,36,2,2,2,0,0,0,2,0,0,0,0,0,0,0,0,0,0,0,0,2,1,1,0
4432,1,36,99,48,90,1,3,5,100,0,0,0,0,0,0,0,0,0,0,0,0,2,1,1,0
4433,1,36,8,5,5,2,0,1,10,0,0,0,0,0,0,0,0,0,0,0,0,2,1,1,0
4434,1,36,1217,716,841,84,126,174,1301,14,185,118,215,199,333,1446,2542,8,20687,1149,0,2,1,1,0
4435,1,36,160,89,115,0,13,31,160,7,15,11,17,22,28,78,124,3,495,27,0,2,1,1,0
4436,1,36,10,10,9,9,0,0,19,0,0,0,0,0,0,0,0,0,0,0,0,2,1,1,0
4437,1,36,173,84,99,8,29,36,181,5,12,7,13,17,20,54,81,2,221,12,0,2,1,1,0
4438,1,36,3,1,1,3,0,0,6,0,0,0,0,0,0,0,0,0,0,0,0,2,1,1,0
4439,135,2619,1457,730,1242,11,6,188,1468,10,292,166,329,302,495,2424,4078,5,22973,1276,1,2,2,1,0
4440,135,2619,74,35,59,1,0,14,75,3,14,7,14,17,21,58,85,1,128,7,0,2,2,1,0
4441,135,2619,245,125,200,5,7,34,250,7,30,17,34,37,51,166,265,3,1053,58,0,2,2,1,0
4442,6,283,42,7,35,4,0,5,46,1,2,1,2,3,3,2,4,0,2,0,0,2,1,1,0
4443,6,283,11,6,10,0,0,1,11,2,4,2,4,6,6,10,15,1,15,0,0,2,1,1,0
4444,21,1047,1289,550,1043,56,32,155,1345,10,167,93,185,177,278,1266,2075,5,11498,638,0,2,5,0,0
4445,20,1175,1457,730,1242,11,6,188,1468,10,292,166,329,302,495,2424,4078,5,22973,1276,1,2,3,0,0
4446,1,36,2,2,2,0,0,0,2,0,0,0,0,0,0,0,0,0,0,0,0,2,1,1,1
4447,1,36,99,48,90,1,3,5,100,0,0,0,0,0,0,0,0,0,0,0,0,2,1,1,1
4448,1,36,8,5,5,2,0,1,10,0,0,0,0,0,0,0,0,0,0,0,0,2,1,1,1
4449,1,36,1217,716,841,84,126,174,1301,14,185,118,215,199,333,1446,2542,8,20687,1149,0,2,1,1,1
4450,1,36,160,89,115,0,13,31,160,7,15,11,17,22,28,78,124,3,495,27,0,2,1,1,1
4451,1,36,10,10,9,9,0,0,19,0,0,0,0,0,0,0,0,0,0,0,0,2,1,1,1
4452,1,36,173,84,99,8,29,36,181,5,12,7,13,17,20,54,81,2,221,12,0,2,1,1,1
4453,1,36,3,1,1,3,0,0,6,0,0,0,0,0,0,0,0,0,0,0,0,2,1,1,1
4454,136,2631,1457,730,1242,11,6,188,1468,10,292,166,329,302,495,2424,4078,5,22973,1276,1,2,5,4,1
4455,136,2631,74,35,59,1,0,14,75,3,14,7,14,17,21,58,85,1,128,7,0,2,5,4,1
4456,136,2631,245,125,200,5,7,34,250,7,30,17,34,37,51,166,265,3,1053,58,0,2,5,4,1
4457,6,283,42,7,35,4,0,5,46,1,2,1,2,3,3,2,4,0,2,0,0,2,1,1,1
4458,6,283,11,6,10,0,0,1,11,2,4,2,4,6,6,10,15,1,15,0,0,2,1,1,1
4459,50,2539,1943,715,1694,26,18,214,1969,12,185,120,237,197,357,1436,2721,7,20915,1161,0,2,2,2,1
4460,20,1203,1457,730,1242,11,6,188,1468,10,292,166,329,302,495,2424,4078,5,22973,1276,1,2,5,1,1
4461,1,36,2,2,2,0,0,0,2,0,0,0,0,0,0,0,0,0,0,0,0,2,1,1,0
4462,1,36,99,48,90,1,3,5,100,0,0,0,0,0,0,0,0,0,0,0,0,2,1,1,0
4463,1,36,8,5,5,2,0,1,10,0,0,0,0,0,0,0,0,0,0,0,0,2,1,1,0
4464,1,36,1217,716,841,84,126,174,1301,14,185,118,215,199,333,1446,2542,8,20687,1149,0,2,1,1,0
4465,1,36,160,89,115,0,13,31,160,7,15,11,17,22,28,78,124,3,495,27,0,2,1,1,0
4466,1,36,10,10,9,9,0,0,19,0,0,0,0,0,0,0,0,0,0,0,0,2,1,1,0
4467,1,36,173,84,99,8,29,36,181,5,12,7,13,17,20,54,81,2,221,12,0,2,1,1,0
4468,1,36,3,1,1,3,0,0,6,0,0,0,0,0,0,0,0,0,0,0,0,2,1,1,0
4469,6,283,42,7,35,4,0,5,46,1,2,1,2,3,3,2,4,0,2,0,0,2,1,1,0
4470,6,283,11,6,10,0,0,1,11,2,4,2,4,6,6,10,15,1,15,0,0,2,1,1,0
4471,68,2996,384,251,317,7,8,52,391,11,70,44,84,81,128,467,811,6,5355,297,0,2,1,1,0
4472,1,36,2,2,2,0,0,0,2,0,0,0,0,0,0,0,0,0,0,0,0,2,1,1,1
4473,1,36,99,48,90,1,3,5,100,0,0,0,0,0,0,0,0,0,0,0,0,2,1,1,1
4474,1,36,8,5,5,2,0,1,10,0,0,0,0,0,0,0,0,0,0,0,0,2,1,1,1
4475,1,36,1217,716,841,84,126,174,1301,14,185,118,215,199,333,1446,2542,8,20687,1149,0,2,1,1,1
4476,1,36,160,89,115,0,13,31,160,7,15,11,17,22,28,78,124,3,495,27,0,2,1,1,1
4477,1,36,10,10,9,9,0,0,19,0,0,0,0,0,0,0,0,0,0,0,0,2,1,1,1
4478,1,36,173,84,99,8,29,36,181,5,12,7,13,17,20,54,81,2,221,12,0,2,1,1,1
4479,1,36,3,1,1,3,0,0,6,0,0,0,0,0,0,0,0,0,0,0,0,2,1,1,1
4480,191,4126,72,33,56,0,4,12,72,1,1,1,1,2,2,0,2,0,1,0,0,2,2,1,1
4481,191,4126,1454,835,1044,76,110,219,1530,17,275,158,296,292,454,2297,3718,9,34017,1889,1,2,2,1,1
4482,17,267,1098,241,925,5,10,155,1103,7,46,25,49,53,74,273,423,3,1580,87,0,2,22,42,1
4483,17,267,282,202,222,14,2,44,296,8,42,24,43,50,67,250,378,4,1548,86,0,2,22,42,1
4484,6,283,42,7,35,4,0,5,46,1,2,1,2,3,3,2,4,0,2,0,0,2,1,1,1
4485,6,283,11,6,10,0,0,1,11,2,4,2,4,6,6,10,15,1,15,0,0,2,1,1,1
4486,7,249,1098,241,925,5,10,155,1103,7,46,25,49,53,74,273,423,3,1580,87,0,2,22,0,1
4487,1,151,382,65,130,157,2,92,539,4,10,5,10,14,15,41,57,2,114,6,0,2,2,1,1
4488,136,2631,1457,730,1242,11,6,188,1468,10,292,166,329,302,495,2424,4078,5,22973,1276,1,2,3,2,1
4489,136,2631,74,35,59,1,0,14,75,3,14,7,14,17,21,58,85,1,128,7,0,2,3,2,1
4490,136,2631,245,125,200,5,7,34,250,7,30,17,34,37,51,166,265,3,1053,58,0,2,3,2,1
4491,50,2531,1943,715,1694,26,18,214,1969,12,185,120,237,197,357,1436,2721,7,20915,1161,0,2,0,1,0
4492,45,430,647,139,84,35,284,233,682,0,0,0,0,0,0,0,0,0,0,0,0,2,1,9,1
4493,17,295,424,94,331,4,0,89,428,1,5,5,5,6,10,11,25,0,12,0,0,2,0,13,1
4494,17,295,38,23,23,6,0,8,44,3,11,7,11,14,18,42,68,1,102,5,0,2,0,13,1
4495,193,4179,72,33,56,0,4,12,72,1,1,1,1,2,2,0,2,0,1,0,0,2,18,7,1
4496,193,4179,1454,835,1044,76,110,219,1530,17,275,158,296,292,454,2297,3718,9,34017,1889,1,2,18,7,1
4497,100,2387,1043,504,840,53,9,147,1096,9,180,112,198,189,310,1377,2344,4,11604,644,0,2,1,1,1
4498,100,2387,383,288,292,26,6,62,409,11,65,38,67,76,105,429,656,5,3719,206,0,2,1,1,1
4499,148,2983,373,158,315,8,0,51,381,5,76,44,79,81,123,486,779,2,2026,112,0,2,0,3,1
4500,23,990,373,158,315,8,0,51,381,5,76,44,79,81,123,486,779,2,2026,112,0,2,0,10,1
4501,50,2526,1943,715,1694,26,18,214,1969,12,185,120,237,197,357,1436,2721,7,20915,1161,0,2,1,1,1
4502,136,2682,1457,730,1242,11,6,188,1468,10,292,166,329,302,495,2424,4078,5,22973,1276,1,2,18,14,1
4503,136,2682,74,35,59,1,0,14,75,3,14,7,14,17,21,58,85,1,128,7,0,2,18,14,1
4504,136,2682,245,125,200,5,7,34,250,7,30,17,34,37,51,166,265,3,1053,58,0,2,18,14,1
4505,34,867,74,35,59,1,0,14,75,3,14,7,14,17,21,58,85,1,128,7,0,2,6,3,1
4506,34,867,245,125,200,5,7,34,250,7,30,17,34,37,51,166,265,3,1053,58,0,2,6,3,1
4507,148,2991,373,158,315,8,0,51,381,5,76,44,79,81,123,486,779,2,2026,112,0,2,11,12,1
4508,21,1272,1457,730,1242,11,6,188,1468,10,292,166,329,302,495,2424,4078,5,22973,1276,1,2,17,0,1
4509,1,148,382,65,130,157,2,92,539,4,10,5,10,14,15,41,57,2,114,6,0,2,1,1,1
4510,12,230,127,75,83,2,11,30,129,4,14,7,14,18,21,61,87,2,175,9,0,2,6,6,1
4511,12,230,652,304,544,16,6,88,668,6,89,51,101,95,152,591,998,3,3399,188,0,2,6,6,1
4512,12,230,2,2,2,0,0,0,2,0,0,0,0,0,0,0,0,0,0,0,0,2,6,6,1
4513,12,230,8,5,5,0,0,3,8,0,0,0,0,0,0,0,0,0,0,0,0,2,6,6,1
4514,12,230,2,2,2,0,0,0,2,0,0,0,0,0,0,0,0,0,0,0,0,2,6,6,1
4515,12,230,14,8,8,0,0,6,14,0,0,0,0,0,0,0,0,0,0,0,0,2,6,6,1
4516,12,230,6,4,4,0,0,2,6,0,0,0,0,0,0,0,0,0,0,0,0,2,6,6,1
4517,12,230,6,4,4,0,0,2,6,1,2,1,2,3,3,2,4,0,2,0,0,2,6,6,1
4518,12,230,6,4,4,0,0,2,6,0,0,0,0,0,0,0,0,0,0,0,0,2,6,6,1
4519,12,230,7,5,5,0,0,2,7,0,0,0,0,0,0,0,0,0,0,0,0,2,6,6,1
4520,12,230,6,4,4,0,0,2,6,0,0,0,0,0,0,0,0,0,0,0,0,2,6,6,1
4521,12,230,10,6,6,0,0,4,10,0,0,0,0,0,0,0,0,0,0,0,0,2,6,6,1
4522,12,230,1,1,1,0,0,0,1,0,0,0,0,0,0,0,0,0,0,0,0,2,6,6,1
4523,12,230,1,1,1,0,0,0,1,0,0,0,0,0,0,0,0,0,0,0,0,2,6,6,1
4524,12,230,14,10,10,0,0,4,14,1,1,1,1,2,2,0,2,0,1,0,0,2,6,6,1
4525,12,230,46,26,30,3,0,12,49,3,6,3,6,9,9,20,28,1,42,2,0,2,6,6,1
4526,1,36,2,2,2,0,0,0,2,0,0,0,0,0,0,0,0,0,0,0,0,2,2,2,1
4527,1,36,99,48,90,1,3,5,100,0,0,0,0,0,0,0,0,0,0,0,0,2,2,2,1
4528,1,36,8,5,5,2,0,1,10,0,0,0,0,0,0,0,0,0,0,0,0,2,2,2,1
4529,1,36,1217,716,841,84,126,174,1301,14,185,118,215,199,333,1446,2542,8,20687,1149,0,2,2,2,1
4530,1,36,160,89,115,0,13,31,160,7,15,11,17,22,28,78,124,3,495,27,0,2,2,2,1
4531,1,36,10,10,9,9,0,0,19,0,0,0,0,0,0,0,0,0,0,0,0,2,2,2,1
4532,1,36,173,84,99,8,29,36,181,5,12,7,13,17,20,54,81,2,221,12,0,2,2,2,1
4533,1,36,3,1,1,3,0,0,6,0,0,0,0,0,0,0,0,0,0,0,0,2,2,2,1
4534,204,4492,72,33,56,0,4,12,72,1,1,1,1,2,2,0,2,0,1,0,0,2,79,7,1
4535,204,4492,1454,835,1044,76,110,219,1530,17,275,158,296,292,454,2297,3718,9,34017,1889,1,2,79,7,1
4536,87,1972,1043,504,840,53,9,147,1096,9,180,112,198,189,310,1377,2344,4,11604,644,0,2,5,104,1
4537,87,1972,383,288,292,26,6,62,409,11,65,38,67,76,105,429,656,5,3719,206,0,2,5,104,1
4538,148,3003,373,158,315,8,0,51,381,5,76,44,79,81,123,486,779,2,2026,112,0,2,8,7,1
4539,71,1178,1178,367,1042,6,15,115,1184,9,94,51,95,103,146,644,976,4,4439,246,0,2,14,142,1
4540,71,1178,177,108,140,8,0,27,185,6,30,16,32,36,48,162,248,3,794,44,0,2,14,142,1
4541,13,1148,215,129,180,6,0,29,221,8,65,43,72,73,115,415,711,4,3153,175,0,2,1,1,1
4542,36,1462,1043,504,840,53,9,147,1096,9,180,112,198,189,310,1377,2344,4,11604,644,0,2,0,55,1
4543,28,1387,1178,367,1042,6,15,115,1184,9,94,51,95,103,146,644,976,4,4439,246,0,2,1,1,1
4544,50,2526,1943,715,1694,26,18,214,1969,12,185,120,237,197,357,1436,2721,7,20915,1161,0,2,1,1,1
4545,138,2702,1457,730,1242,11,6,188,1468,10,292,166,329,302,495,2424,4078,5,22973,1276,1,2,6,2,1
4546,138,2702,74,35,59,1,0,14,75,3,14,7,14,17,21,58,85,1,128,7,0,2,6,2,1
4547,138,2702,245,125,200,5,7,34,250,7,30,17,34,37,51,166,265,3,1053,58,0,2,6,2,1
4548,22,1337,1457,730,1242,11,6,188,1468,10,292,166,329,302,495,2424,4078,5,22973,1276,1,2,18,0,1
4549,138,2713,1457,730,1242,11,6,188,1468,10,292,166,329,302,495,2424,4078,5,22973,1276,1,2,3,3,0
4550,138,2713,74,35,59,1,0,14,75,3,14,7,14,17,21,58,85,1,128,7,0,2,3,3,0
4551,138,2713,245,125,200,5,7,34,250,7,30,17,34,37,51,166,265,3,1053,58,0,2,3,3,0
4552,137,2714,1457,730,1242,11,6,188,1468,10,292,166,329,302,495,2424,4078,5,22973,1276,1,2,3,4,1
4553,137,2714,74,35,59,1,0,14,75,3,14,7,14,17,21,58,85,1,128,7,0,2,3,4,1
4554,137,2714,245,125,200,5,7,34,250,7,30,17,34,37,51,166,265,3,1053,58,0,2,3,4,1
4555,137,2686,1943,715,1694,26,18,214,1969,12,185,120,237,197,357,1436,2721,7,20915,1161,0,2,6,6,1
4556,137,2686,1168,838,957,57,25,144,1225,19,348,224,416,367,640,3018,5452,11,61921,3440,1,2,6,6,1
4557,51,2570,1943,715,1694,26,18,214,1969,12,185,120,237,197,357,1436,2721,7,20915,1161,0,2,13,5,1
4558,23,1388,1457,730,1242,11,6,188,1468,10,292,166,329,302,495,2424,4078,5,22973,1276,1,2,8,0,1
4559,72,3397,384,251,317,7,8,52,391,11,70,44,84,81,128,467,811,6,5355,297,0,2,66,1,1
4560,45,430,647,139,84,35,284,233,682,0,0,0,0,0,0,0,0,0,0,0,0,2,1,1,1
4561,125,2558,77,34,69,0,0,8,77,3,24,16,29,27,45,114,213,1,387,21,0,3,22,7,1
4562,125,2558,712,438,573,51,9,84,763,14,102,71,128,116,199,733,1364,8,11988,666,0,3,22,7,1
4563,137,2714,1457,730,1242,11,6,188,1468,10,292,166,329,302,495,2424,4078,5,22973,1276,1,2,1,1,1
4564,137,2714,74,35,59,1,0,14,75,3,14,7,14,17,21,58,85,1,128,7,0,2,1,1,1
4565,137,2714,245,125,200,5,7,34,250,7,30,17,34,37,51,166,265,3,1053,58,0,2,1,1,1
4566,177,4051,722,423,573,19,0,135,741,12,172,101,199,184,300,1320,2257,6,15668,870,0,2,6,2,1
4567,177,4051,1508,847,911,44,250,301,1552,14,148,88,169,162,257,1120,1886,7,15077,837,0,2,6,2,1
4568,204,4492,72,33,56,0,4,12,72,1,1,1,1,2,2,0,2,0,1,0,0,2,1,1,1
4569,204,4492,1454,835,1044,76,110,219,1530,17,275,158,296,292,454,2297,3718,9,34017,1889,1,2,1,1,1
4570,6,283,42,7,35,4,0,5,46,1,2,1,2,3,3,2,4,0,2,0,0,2,2,2,1
4571,6,283,11,6,10,0,0,1,11,2,4,2,4,6,6,10,15,1,15,0,0,2,2,2,1
4572,28,1309,1289,550,1043,56,32,155,1345,10,167,93,185,177,278,1266,2075,5,11498,638,0,2,81,44,1
4573,7,163,127,75,83,2,11,30,129,4,14,7,14,18,21,61,87,2,175,9,0,2,1,1,1
4574,7,163,652,304,544,16,6,88,668,6,89,51,101,95,152,591,998,3,3399,188,0,2,1,1,1
4575,7,163,2,2,2,0,0,0,2,0,0,0,0,0,0,0,0,0,0,0,0,2,1,1,1
4576,7,163,8,5,5,0,0,3,8,0,0,0,0,0,0,0,0,0,0,0,0,2,1,1,1
4577,7,163,2,2,2,0,0,0,2,0,0,0,0,0,0,0,0,0,0,0,0,2,1,1,1
4578,7,163,14,8,8,0,0,6,14,0,0,0,0,0,0,0,0,0,0,0,0,2,1,1,1
4579,7,163,6,4,4,0,0,2,6,0,0,0,0,0,0,0,0,0,0,0,0,2,1,1,1
4580,7,163,6,4,4,0,0,2,6,1,2,1,2,3,3,2,4,0,2,0,0,2,1,1,1
4581,7,163,6,4,4,0,0,2,6,0,0,0,0,0,0,0,0,0,0,0,0,2,1,1,1
4582,7,163,7,5,5,0,0,2,7,0,0,0,0,0,0,0,0,0,0,0,0,2,1,1,1
4583,7,163,6,4,4,0,0,2,6,0,0,0,0,0,0,0,0,0,0,0,0,2,1,1,1
4584,7,163,10,6,6,0,0,4,10,0,0,0,0,0,0,0,0,0,0,0,0,2,1,1,1
4585,7,163,1,1,1,0,0,0,1,0,0,0,0,0,0,0,0,0,0,0,0,2,1,1,1
4586,7,163,1,1,1,0,0,0,1,0,0,0,0,0,0,0,0,0,0,0,0,2,1,1,1
4587,7,163,14,10,10,0,0,4,14,1,1,1,1,2,2,0,2,0,1,0,0,2,1,1,1
4588,7,163,46,26,30,3,0,12,49,3,6,3,6,9,9,20,28,1,42,2,0,2,1,1,1
4589,10,500,722,423,573,19,0,135,741,12,172,101,199,184,300,1320,2257,6,15668,870,0,2,2,2,1
4590,72,3397,77,34,69,0,0,8,77,3,24,16,29,27,45,114,213,1,387,21,0,3,5,5,1
4591,126,2604,77,34,69,0,0,8,77,3,24,16,29,27,45,114,213,1,387,21,0,2,10,5,1
4592,126,2604,712,438,573,51,9,84,763,14,102,71,128,116,199,733,1364,8,11988,666,0,2,10,5,1
4593,74,3546,77,34,69,0,0,8,77,3,24,16,29,27,45,114,213,1,387,21,0,2,25,3,1
4594,45,428,647,139,84,35,284,233,682,0,0,0,0,0,0,0,0,0,0,0,0,2,1,1,1
4595,128,2662,77,34,69,0,0,8,77,3,24,16,29,27,45,114,213,1,387,21,0,2,12,3,1
4596,128,2662,712,438,573,51,9,84,763,14,102,71,128,116,199,733,1364,8,11988,666,0,2,12,3,1
4597,65,1174,1513,682,1277,25,13,200,1538,11,199,116,219,210,335,1557,2584,6,15641,868,0,2,5,1,1
4598,65,1174,819,519,539,24,98,155,843,15,96,57,106,111,163,690,1107,8,9171,509,0,2,5,1,1
4599,137,2716,1457,730,1242,11,6,188,1468,10,292,166,329,302,495,2424,4078,5,22973,1276,1,2,1,1,1
4600,137,2716,74,35,59,1,0,14,75,3,14,7,14,17,21,58,85,1,128,7,0,2,1,1,1
4601,137,2716,245,125,200,5,7,34,250,7,30,17,34,37,51,166,265,3,1053,58,0,2,1,1,1
4602,16,578,1455,414,1257,16,76,112,1471,5,41,23,46,46,69,231,381,2,1069,59,0,2,1,1,1
4603,16,578,669,365,481,22,61,110,691,15,103,63,122,118,185,747,1273,8,11311,628,0,2,1,1,1
4604,37,1041,1523,757,1297,19,12,193,1542,12,193,117,230,205,347,1508,2664,7,19053,1058,0,2,4,1,1
4605,37,1041,701,378,504,33,58,109,734,13,110,68,126,123,194,794,1346,7,10027,557,0,2,4,1,1
4606,177,4149,722,423,573,19,0,135,741,12,172,101,199,184,300,1320,2257,6,15668,870,0,2,30,17,1
4607,177,4149,1508,847,911,44,250,301,1552,14,148,88,169,162,257,1120,1886,7,15077,837,0,2,30,17,1
4608,205,4488,72,33,56,0,4,12,72,1,1,1,1,2,2,0,2,0,1,0,0,2,9,8,1
4609,205,4488,1454,835,1044,76,110,219,1530,17,275,158,296,292,454,2297,3718,9,34017,1889,1,2,9,8,1
4610,84,1800,1043,504,840,53,9,147,1096,9,180,112,198,189,310,1377,2344,4,11604,644,0,2,19,53,1
4611,84,1800,383,288,292,26,6,62,409,11,65,38,67,76,105,429,656,5,3719,206,0,2,19,53,1
4612,125,2880,373,158,315,8,0,51,381,5,76,44,79,81,123,486,779,2,2026,112,0,2,191,214,1
4613,137,2668,1943,715,1694,26,18,214,1969,12,185,120,237,197,357,1436,2721,7,20915,1161,0,2,6,5,1
4614,137,2668,1168,838,957,57,25,144,1225,19,348,224,416,367,640,3018,5452,11,61921,3440,1,2,6,5,1
4615,6,283,42,7,35,4,0,5,46,1,2,1,2,3,3,2,4,0,2,0,0,2,2,2,1
4616,6,283,11,6,10,0,0,1,11,2,4,2,4,6,6,10,15,1,15,0,0,2,2,2,1
4617,30,1389,1289,550,1043,56,32,155,1345,10,167,93,185,177,278,1266,2075,5,11498,638,0,2,24,5,1
4618,19,1390,1523,757,1297,19,12,193,1542,12,193,117,230,205,347,1508,2664,7,19053,1058,0,2,24,10,1
4619,36,1466,1043,504,840,53,9,147,1096,9,180,112,198,189,310,1377,2344,4,11604,644,0,2,2,2,1
4620,23,996,373,158,315,8,0,51,381,5,76,44,79,81,123,486,779,2,2026,112,0,2,6,5,1
4621,51,2570,1943,715,1694,26,18,214,1969,12,185,120,237,197,357,1436,2721,7,20915,1161,0,2,3,8,1
4622,40,2822,1296,573,1062,40,33,157,1336,8,201,118,231,209,349,1561,2689,4,12365,686,0,2,345,114,1
4623,23,1388,1457,730,1242,11,6,188,1468,10,292,166,329,302,495,2424,4078,5,22973,1276,1,2,1,1,1
4624,1,149,382,65,130,157,2,92,539,4,10,5,10,14,15,41,57,2,114,6,0,2,2,2,1
4625,44,888,1450,624,1228,12,26,181,1462,14,306,186,354,320,540,2580,4493,8,36391,2021,1,2,3,0,1
4626,65,1174,1513,682,1277,25,13,200,1538,11,199,116,219,210,335,1557,2584,6,15641,868,0,2,1,3,1
4627,65,1174,819,519,539,24,98,155,843,15,96,57,106,111,163,690,1107,8,9171,509,0,2,1,3,1
4628,137,2717,1457,730,1242,11,6,188,1468,10,292,166,329,302,495,2424,4078,5,22973,1276,1,2,1,1,1
4629,137,2717,74,35,59,1,0,14,75,3,14,7,14,17,21,58,85,1,128,7,0,2,1,1,1
4630,137,2717,245,125,200,5,7,34,250,7,30,17,34,37,51,166,265,3,1053,58,0,2,1,1,1
4631,16,578,1455,414,1257,16,76,112,1471,5,41,23,46,46,69,231,381,2,1069,59,0,2,1,1,1
4632,16,578,669,365,481,22,61,110,691,15,103,63,122,118,185,747,1273,8,11311,628,0,2,1,1,1
4633,34,867,74,35,59,1,0,14,75,3,14,7,14,17,21,58,85,1,128,7,0,2,1,2,1
4634,34,867,245,125,200,5,7,34,250,7,30,17,34,37,51,166,265,3,1053,58,0,2,1,2,1
4635,37,1041,1523,757,1297,19,12,193,1542,12,193,117,230,205,347,1508,2664,7,19053,1058,0,2,3,2,1
4636,37,1041,701,378,504,33,58,109,734,13,110,68,126,123,194,794,1346,7,10027,557,0,2,3,2,1
4637,44,777,1020,354,843,12,15,144,1032,8,134,77,144,142,221,970,1580,4,6792,377,0,2,3,3,1
4638,24,514,447,308,343,6,5,95,453,7,96,59,111,103,170,651,1136,4,4600,255,0,2,1,1,1
4639,24,514,322,174,179,16,74,51,338,10,41,26,46,51,72,252,408,5,2291,127,0,2,1,1,1
4640,17,295,424,94,331,4,0,89,428,1,5,5,5,6,10,11,25,0,12,0,0,2,1,35,1
4641,17,295,38,23,23,6,0,8,44,3,11,7,11,14,18,42,68,1,102,5,0,2,1,35,1
4642,20,483,1293,570,1093,25,15,163,1318,10,195,123,241,205,364,1516,2795,6,17273,959,0,2,2,3,1
4643,177,4149,722,423,573,19,0,135,741,12,172,101,199,184,300,1320,2257,6,15668,870,0,2,1,3,1
4644,177,4149,1508,847,911,44,250,301,1552,14,148,88,169,162,257,1120,1886,7,15077,837,0,2,1,3,1
4645,205,4488,72,33,56,0,4,12,72,1,1,1,1,2,2,0,2,0,1,0,0,2,1,3,1
4646,205,4488,1454,835,1044,76,110,219,1530,17,275,158,296,292,454,2297,3718,9,34017,1889,1,2,1,3,1
4647,18,462,386,256,301,16,9,68,402,4,59,35,69,63,104,355,621,2,1453,80,0,2,1,1,1
4648,18,462,264,131,164,11,41,46,275,6,38,22,40,44,62,214,338,3,1068,59,0,2,1,1,1
4649,26,554,215,129,180,6,0,29,221,8,65,43,72,73,115,415,711,4,3153,175,0,2,1,1,1
4650,26,554,97,69,77,3,3,16,100,6,22,13,23,28,36,113,173,3,542,30,0,2,1,1,1
4651,84,1800,1043,504,840,53,9,147,1096,9,180,112,198,189,310,1377,2344,4,11604,644,0,2,4,5,1
4652,84,1800,383,288,292,26,6,62,409,11,65,38,67,76,105,429,656,5,3719,206,0,2,4,5,1
4653,125,2880,373,158,315,8,0,51,381,5,76,44,79,81,123,486,779,2,2026,112,0,2,3,7,1
4654,71,1178,1178,367,1042,6,15,115,1184,9,94,51,95,103,146,644,976,4,4439,246,0,2,1,3,1
4655,71,1178,177,108,140,8,0,27,185,6,30,16,32,36,48,162,248,3,794,44,0,2,1,3,1
4656,137,2668,1943,715,1694,26,18,214,1969,12,185,120,237,197,357,1436,2721,7,20915,1161,0,2,1,2,1
4657,137,2668,1168,838,957,57,25,144,1225,19,348,224,416,367,640,3018,5452,11,61921,3440,1,2,1,2,1
4658,3,88,442,244,305,14,16,103,456,11,68,45,75,79,120,452,756,6,4588,254,0,2,1,10,1
4659,3,88,182,102,99,11,40,35,193,3,11,6,11,14,17,42,64,1,97,5,0,2,1,10,1
4660,17,267,1098,241,925,5,10,155,1103,7,46,25,49,53,74,273,423,3,1580,87,0,2,1,3,1
4661,17,267,282,202,222,14,2,44,296,8,42,24,43,50,67,250,378,4,1548,86,0,2,1,3,1
4662,129,2662,77,34,69,0,0,8,77,3,24,16,29,27,45,114,213,1,387,21,0,2,5,4,0
4663,129,2662,712,438,573,51,9,84,763,14,102,71,128,116,199,733,1364,8,11988,666,0,2,5,4,0
4664,130,2666,77,34,69,0,0,8,77,3,24,16,29,27,45,114,213,1,387,21,0,2,6,4,0
4665,130,2666,712,438,573,51,9,84,763,14,102,71,128,116,199,733,1364,8,11988,666,0,2,6,4,0
4666,75,3605,77,34,69,0,0,8,77,3,24,16,29,27,45,114,213,1,387,21,0,2,13,5,0
4667,130,2674,77,34,69,0,0,8,77,3,24,16,29,27,45,114,213,1,387,21,0,2,1,1,0
4668,130,2674,712,438,573,51,9,84,763,14,102,71,128,116,199,733,1364,8,11988,666,0,2,1,1,0
4669,205,4488,72,33,56,0,4,12,72,1,1,1,1,2,2,0,2,0,1,0,0,2,2,2,1
4670,205,4488,1454,835,1044,76,110,219,1530,17,275,158,296,292,454,2297,3718,9,34017,1889,1,2,2,2,1
4671,130,2988,373,158,315,8,0,51,381,5,76,44,79,81,123,486,779,2,2026,112,0,2,20,1,1
4672,6,283,42,7,35,4,0,5,46,1,2,1,2,3,3,2,4,0,2,0,0,2,1,1,1
4673,6,283,11,6,10,0,0,1,11,2,4,2,4,6,6,10,15,1,15,0,0,2,1,1,1
4674,32,1512,1289,550,1043,56,32,155,1345,10,167,93,185,177,278,1266,2075,5,11498,638,0,2,21,0,1
4675,132,2708,77,34,69,0,0,8,77,3,24,16,29,27,45,114,213,1,387,21,0,2,5,1,1
4676,132,2708,712,438,573,51,9,84,763,14,102,71,128,116,199,733,1364,8,11988,666,0,2,5,1,1
4677,43,866,1450,624,1228,12,26,181,1462,14,306,186,354,320,540,2580,4493,8,36391,2021,1,2,6,9,1
4678,206,4499,72,33,56,0,4,12,72,1,1,1,1,2,2,0,2,0,1,0,0,2,3,0,1
4679,206,4499,1454,835,1044,76,110,219,1530,17,275,158,296,292,454,2297,3718,9,34017,1889,1,2,3,0,1
4680,17,270,1098,241,925,5,10,155,1103,7,46,25,49,53,74,273,423,3,1580,87,0,2,5,4,1
4681,17,270,282,202,222,14,2,44,296,8,42,24,43,50,67,250,378,4,1548,86,0,2,5,4,1
4682,33,1559,1289,550,1043,56,32,155,1345,10,167,93,185,177,278,1266,2075,5,11498,638,0,2,16,0,1
4683,27,949,1450,624,1228,12,26,181,1462,14,306,186,354,320,540,2580,4493,8,36391,2021,1,2,9,0,1
4684,131,3030,373,158,315,8,0,51,381,5,76,44,79,81,123,486,779,2,2026,112,0,2,11,6,1
4685,33,1567,1289,550,1043,56,32,155,1345,10,167,93,185,177,278,1266,2075,5,11498,638,0,2,2,1,1
4686,26,920,1450,624,1228,12,26,181,1462,14,306,186,354,320,540,2580,4493,8,36391,2021,1,2,0,9,1
4687,41,2892,1296,573,1062,40,33,157,1336,8,201,118,231,209,349,1561,2689,4,12365,686,0,2,13,0,1
4688,139,2720,1457,730,1242,11,6,188,1468,10,292,166,329,302,495,2424,4078,5,22973,1276,1,2,1,1,0
4689,139,2720,74,35,59,1,0,14,75,3,14,7,14,17,21,58,85,1,128,7,0,2,1,1,0
4690,139,2720,245,125,200,5,7,34,250,7,30,17,34,37,51,166,265,3,1053,58,0,2,1,1,0
4691,33,1569,1289,550,1043,56,32,155,1345,10,167,93,185,177,278,1266,2075,5,11498,638,0,2,1,1,0
4692,132,2720,77,34,69,0,0,8,77,3,24,16,29,27,45,114,213,1,387,21,0,2,5,2,0
4693,132,2720,712,438,573,51,9,84,763,14,102,71,128,116,199,733,1364,8,11988,666,0,2,5,2,0
4694,131,3034,373,158,315,8,0,51,381,5,76,44,79,81,123,486,779,2,2026,112,0,2,1,1,0
4695,19,284,1098,241,925,5,10,155,1103,7,46,25,49,53,74,273,423,3,1580,87,0,2,4,0,0
4696,19,284,282,202,222,14,2,44,296,8,42,24,43,50,67,250,378,4,1548,86,0,2,4,0,0
4697,33,1595,1289,550,1043,56,32,155,1345,10,167,93,185,177,278,1266,2075,5,11498,638,0,2,6,1,0
4698,41,2882,1296,573,1062,40,33,157,1336,8,201,118,231,209,349,1561,2689,4,12365,686,0,2,0,2,0
4699,24,1442,1457,730,1242,11,6,188,1468,10,292,166,329,302,495,2424,4078,5,22973,1276,1,2,11,0,0
4700,131,3031,373,158,315,8,0,51,381,5,76,44,79,81,123,486,779,2,2026,112,0,2,1,1,1
4701,6,283,42,7,35,4,0,5,46,1,2,1,2,3,3,2,4,0,2,0,0,2,1,1,0
4702,6,283,11,6,10,0,0,1,11,2,4,2,4,6,6,10,15,1,15,0,0,2,1,1,0
4703,33,1606,1289,550,1043,56,32,155,1345,10,167,93,185,177,278,1266,2075,5,11498,638,0,2,1,0,0
4704,6,283,42,7,35,4,0,5,46,1,2,1,2,3,3,2,4,0,2,0,0,2,1,1,0
4705,6,283,11,6,10,0,0,1,11,2,4,2,4,6,6,10,15,1,15,0,0,2,1,1,0
4706,45,430,647,139,84,35,284,233,682,0,0,0,0,0,0,0,0,0,0,0,0,2,5,5,1
4707,177,4149,722,423,573,19,0,135,741,12,172,101,199,184,300,1320,2257,6,15668,870,0,2,13,13,1
4708,177,4149,1508,847,911,44,250,301,1552,14,148,88,169,162,257,1120,1886,7,15077,837,0,2,13,13,1
4709,206,4499,72,33,56,0,4,12,72,1,1,1,1,2,2,0,2,0,1,0,0,2,9,9,1
4710,206,4499,1454,835,1044,76,110,219,1530,17,275,158,296,292,454,2297,3718,9,34017,1889,1,2,9,9,1
4711,138,3144,373,158,315,8,0,51,381,5,76,44,79,81,123,486,779,2,2026,112,0,2,40,22,1
4712,138,2675,1943,715,1694,26,18,214,1969,12,185,120,237,197,357,1436,2721,7,20915,1161,0,2,3,2,1
4713,138,2675,1168,838,957,57,25,144,1225,19,348,224,416,367,640,3018,5452,11,61921,3440,1,2,3,2,1
4714,6,283,42,7,35,4,0,5,46,1,2,1,2,3,3,2,4,0,2,0,0,2,1,1,1
4715,6,283,11,6,10,0,0,1,11,2,4,2,4,6,6,10,15,1,15,0,0,2,1,1,1
4716,13,1148,215,129,180,6,0,29,221,8,65,43,72,73,115,415,711,4,3153,175,0,2,4,4,1
4717,36,1466,1043,504,840,53,9,147,1096,9,180,112,198,189,310,1377,2344,4,11604,644,0,2,1,1,1
4718,51,2570,1943,715,1694,26,18,214,1969,12,185,120,237,197,357,1436,2721,7,20915,1161,0,2,1,1,1
4719,41,2894,1296,573,1062,40,33,157,1336,8,201,118,231,209,349,1561,2689,4,12365,686,0,2,14,13,1
4720,37,1039,1523,757,1297,19,12,193,1542,12,193,117,230,205,347,1508,2664,7,19053,1058,0,2,1,1,1
4721,37,1039,701,378,504,33,58,109,734,13,110,68,126,123,194,794,1346,7,10027,557,0,2,1,1,1
4722,206,4499,72,33,56,0,4,12,72,1,1,1,1,2,2,0,2,0,1,0,0,2,1,0,1
4723,206,4499,1454,835,1044,76,110,219,1530,17,275,158,296,292,454,2297,3718,9,34017,1889,1,2,1,0,1
4724,130,3030,373,158,315,8,0,51,381,5,76,44,79,81,123,486,779,2,2026,112,0,2,11,30,1
4725,133,2756,77,34,69,0,0,8,77,3,24,16,29,27,45,114,213,1,387,21,0,2,5,0,1
4726,133,2756,712,438,573,51,9,84,763,14,102,71,128,116,199,733,1364,8,11988,666,0,2,5,0,1
4727,141,2754,1457,730,1242,11,6,188,1468,10,292,166,329,302,495,2424,4078,5,22973,1276,1,2,16,11,1
4728,141,2754,74,35,59,1,0,14,75,3,14,7,14,17,21,58,85,1,128,7,0,2,16,11,1
4729,141,2754,245,125,200,5,7,34,250,7,30,17,34,37,51,166,265,3,1053,58,0,2,16,11,1
4730,34,866,74,35,59,1,0,14,75,3,14,7,14,17,21,58,85,1,128,7,0,2,2,1,1
4731,34,866,245,125,200,5,7,34,250,7,30,17,34,37,51,166,265,3,1053,58,0,2,2,1,1
4732,51,2564,1943,715,1694,26,18,214,1969,12,185,120,237,197,357,1436,2721,7,20915,1161,0,2,0,1,1
4733,26,1597,1457,730,1242,11,6,188,1468,10,292,166,329,302,495,2424,4078,5,22973,1276,1,2,24,0,1
4734,6,283,42,7,35,4,0,5,46,1,2,1,2,3,3,2,4,0,2,0,0,2,1,1,0
4735,6,283,11,6,10,0,0,1,11,2,4,2,4,6,6,10,15,1,15,0,0,2,1,1,0
4736,133,2758,77,34,69,0,0,8,77,3,24,16,29,27,45,114,213,1,387,21,0,2,2,2,0
4737,133,2758,712,438,573,51,9,84,763,14,102,71,128,116,199,733,1364,8,11988,666,0,2,2,2,0
4738,19,1390,1523,757,1297,19,12,193,1542,12,193,117,230,205,347,1508,2664,7,19053,1058,0,2,1,0,0
4739,177,4157,722,423,573,19,0,135,741,12,172,101,199,184,300,1320,2257,6,15668,870,0,2,1,1,0
4740,177,4157,1508,847,911,44,250,301,1552,14,148,88,169,162,257,1120,1886,7,15077,837,0,2,1,1,0
4741,12,222,127,75,83,2,11,30,129,4,14,7,14,18,21,61,87,2,175,9,0,2,2,2,1
4742,12,222,652,304,544,16,6,88,668,6,89,51,101,95,152,591,998,3,3399,188,0,2,2,2,1
4743,12,222,2,2,2,0,0,0,2,0,0,0,0,0,0,0,0,0,0,0,0,2,2,2,1
4744,12,222,8,5,5,0,0,3,8,0,0,0,0,0,0,0,0,0,0,0,0,2,2,2,1
4745,12,222,2,2,2,0,0,0,2,0,0,0,0,0,0,0,0,0,0,0,0,2,2,2,1
4746,12,222,14,8,8,0,0,6,14,0,0,0,0,0,0,0,0,0,0,0,0,2,2,2,1
4747,12,222,6,4,4,0,0,2,6,0,0,0,0,0,0,0,0,0,0,0,0,2,2,2,1
4748,12,222,6,4,4,0,0,2,6,1,2,1,2,3,3,2,4,0,2,0,0,2,2,2,1
4749,12,222,6,4,4,0,0,2,6,0,0,0,0,0,0,0,0,0,0,0,0,2,2,2,1
4750,12,222,7,5,5,0,0,2,7,0,0,0,0,0,0,0,0,0,0,0,0,2,2,2,1
4751,12,222,6,4,4,0,0,2,6,0,0,0,0,0,0,0,0,0,0,0,0,2,2,2,1
4752,12,222,10,6,6,0,0,4,10,0,0,0,0,0,0,0,0,0,0,0,0,2,2,2,1
4753,12,222,1,1,1,0,0,0,1,0,0,0,0,0,0,0,0,0,0,0,0,2,2,2,1
4754,12,222,1,1,1,0,0,0,1,0,0,0,0,0,0,0,0,0,0,0,0,2,2,2,1
4755,12,222,14,10,10,0,0,4,14,1,1,1,1,2,2,0,2,0,1,0,0,2,2,2,1
4756,12,222,46,26,30,3,0,12,49,3,6,3,6,9,9,20,28,1,42,2,0,2,2,2,1
4757,4,76,127,75,83,2,11,30,129,4,14,7,14,18,21,61,87,2,175,9,0,2,2,2,1
4758,4,76,652,304,544,16,6,88,668,6,89,51,101,95,152,591,998,3,3399,188,0,2,2,2,1
4759,4,76,2,2,2,0,0,0,2,0,0,0,0,0,0,0,0,0,0,0,0,2,2,2,1
4760,4,76,8,5,5,0,0,3,8,0,0,0,0,0,0,0,0,0,0,0,0,2,2,2,1
4761,4,76,2,2,2,0,0,0,2,0,0,0,0,0,0,0,0,0,0,0,0,2,2,2,1
4762,4,76,14,8,8,0,0,6,14,0,0,0,0,0,0,0,0,0,0,0,0,2,2,2,1
4763,4,76,6,4,4,0,0,2,6,0,0,0,0,0,0,0,0,0,0,0,0,2,2,2,1
4764,4,76,6,4,4,0,0,2,6,1,2,1,2,3,3,2,4,0,2,0,0,2,2,2,1
4765,4,76,6,4,4,0,0,2,6,0,0,0,0,0,0,0,0,0,0,0,0,2,2,2,1
4766,4,76,7,5,5,0,0,2,7,0,0,0,0,0,0,0,0,0,0,0,0,2,2,2,1
4767,4,76,6,4,4,0,0,2,6,0,0,0,0,0,0,0,0,0,0,0,0,2,2,2,1
4768,4,76,10,6,6,0,0,4,10,0,0,0,0,0,0,0,0,0,0,0,0,2,2,2,1
4769,4,76,1,1,1,0,0,0,1,0,0,0,0,0,0,0,0,0,0,0,0,2,2,2,1
4770,4,76,1,1,1,0,0,0,1,0,0,0,0,0,0,0,0,0,0,0,0,2,2,2,1
4771,4,76,14,10,10,0,0,4,14,1,1,1,1,2,2,0,2,0,1,0,0,2,2,2,1
4772,4,76,46,26,30,3,0,12,49,3,6,3,6,9,9,20,28,1,42,2,0,2,2,2,1
4773,45,430,647,139,84,35,284,233,682,0,0,0,0,0,0,0,0,0,0,0,0,2,1,1,1
4774,133,2760,77,34,69,0,0,8,77,3,24,16,29,27,45,114,213,1,387,21,0,2,13,4,1
4775,133,2760,712,438,573,51,9,84,763,14,102,71,128,116,199,733,1364,8,11988,666,0,2,13,4,1
4776,16,576,1455,414,1257,16,76,112,1471,5,41,23,46,46,69,231,381,2,1069,59,0,2,2,2,1
4777,16,576,669,365,481,22,61,110,691,15,103,63,122,118,185,747,1273,8,11311,628,0,2,2,2,1
4778,44,767,1020,354,843,12,15,144,1032,8,134,77,144,142,221,970,1580,4,6792,377,0,2,3,3,1
4779,17,277,424,94,331,4,0,89,428,1,5,5,5,6,10,11,25,0,12,0,0,2,6,6,1
4780,17,277,38,23,23,6,0,8,44,3,11,7,11,14,18,42,68,1,102,5,0,2,6,6,1
4781,206,4475,72,33,56,0,4,12,72,1,1,1,1,2,2,0,2,0,1,0,0,2,11,11,1
4782,206,4475,1454,835,1044,76,110,219,1530,17,275,158,296,292,454,2297,3718,9,34017,1889,1,2,11,11,1
4783,130,3020,373,158,315,8,0,51,381,5,76,44,79,81,123,486,779,2,2026,112,0,2,7,7,1
4784,71,1170,1178,367,1042,6,15,115,1184,9,94,51,95,103,146,644,976,4,4439,246,0,2,2,2,1
4785,71,1170,177,108,140,8,0,27,185,6,30,16,32,36,48,162,248,3,794,44,0,2,2,2,1
4786,19,278,1098,241,925,5,10,155,1103,7,46,25,49,53,74,273,423,3,1580,87,0,2,3,3,1
4787,19,278,282,202,222,14,2,44,296,8,42,24,43,50,67,250,378,4,1548,86,0,2,3,3,1
4788,6,283,42,7,35,4,0,5,46,1,2,1,2,3,3,2,4,0,2,0,0,2,1,1,1
4789,6,283,11,6,10,0,0,1,11,2,4,2,4,6,6,10,15,1,15,0,0,2,1,1,1
4790,35,1670,1289,550,1043,56,32,155,1345,10,167,93,185,177,278,1266,2075,5,11498,638,0,2,33,22,1
4791,19,1390,1523,757,1297,19,12,193,1542,12,193,117,230,205,347,1508,2664,7,19053,1058,0,2,2,2,1
4792,36,1466,1043,504,840,53,9,147,1096,9,180,112,198,189,310,1377,2344,4,11604,644,0,2,8,9,1
4793,23,994,373,158,315,8,0,51,381,5,76,44,79,81,123,486,779,2,2026,112,0,2,4,4,1
4794,41,2834,1296,573,1062,40,33,157,1336,8,201,118,231,209,349,1561,2689,4,12365,686,0,2,32,32,1
4795,26,1354,652,304,544,16,6,88,668,6,89,51,101,95,152,591,998,3,3399,188,0,2,1,1,1
4796,75,3605,77,34,69,0,0,8,77,3,24,16,29,27,45,114,213,1,387,21,0,2,2,2,1
4797,43,864,1450,624,1228,12,26,181,1462,14,306,186,354,320,540,2580,4493,8,36391,2021,1,3,1,1,1
4798,141,2754,1457,730,1242,11,6,188,1468,10,292,166,329,302,495,2424,4078,5,22973,1276,1,3,1,1,1
4799,141,2754,74,35,59,1,0,14,75,3,14,7,14,17,21,58,85,1,128,7,0,3,1,1,1
4800,141,2754,245,125,200,5,7,34,250,7,30,17,34,37,51,166,265,3,1053,58,0,3,1,1,1
4801,34,862,74,35,59,1,0,14,75,3,14,7,14,17,21,58,85,1,128,7,0,3,1,1,1
4802,34,862,245,125,200,5,7,34,250,7,30,17,34,37,51,166,265,3,1053,58,0,3,1,1,1
4803,45,430,647,139,84,35,284,233,682,0,0,0,0,0,0,0,0,0,0,0,0,3,3,3,1
4804,177,4162,722,423,573,19,0,135,741,12,172,101,199,184,300,1320,2257,6,15668,870,0,3,3,3,1
4805,177,4162,1508,847,911,44,250,301,1552,14,148,88,169,162,257,1120,1886,7,15077,837,0,3,3,3,1
4806,206,4475,72,33,56,0,4,12,72,1,1,1,1,2,2,0,2,0,1,0,0,3,4,4,1
4807,206,4475,1454,835,1044,76,110,219,1530,17,275,158,296,292,454,2297,3718,9,34017,1889,1,3,4,4,1
4808,130,3034,373,158,315,8,0,51,381,5,76,44,79,81,123,486,779,2,2026,112,0,3,4,3,1
4809,12,222,127,75,83,2,11,30,129,4,14,7,14,18,21,61,87,2,175,9,0,2,1,1,1
4810,12,222,652,304,544,16,6,88,668,6,89,51,101,95,152,591,998,3,3399,188,0,2,1,1,1
4811,12,222,2,2,2,0,0,0,2,0,0,0,0,0,0,0,0,0,0,0,0,2,1,1,1
4812,12,222,8,5,5,0,0,3,8,0,0,0,0,0,0,0,0,0,0,0,0,2,1,1,1
4813,12,222,2,2,2,0,0,0,2,0,0,0,0,0,0,0,0,0,0,0,0,2,1,1,1
4814,12,222,14,8,8,0,0,6,14,0,0,0,0,0,0,0,0,0,0,0,0,2,1,1,1
4815,12,222,6,4,4,0,0,2,6,0,0,0,0,0,0,0,0,0,0,0,0,2,1,1,1
4816,12,222,6,4,4,0,0,2,6,1,2,1,2,3,3,2,4,0,2,0,0,2,1,1,1
4817,12,222,6,4,4,0,0,2,6,0,0,0,0,0,0,0,0,0,0,0,0,2,1,1,1
4818,12,222,7,5,5,0,0,2,7,0,0,0,0,0,0,0,0,0,0,0,0,2,1,1,1
4819,12,222,6,4,4,0,0,2,6,0,0,0,0,0,0,0,0,0,0,0,0,2,1,1,1
4820,12,222,10,6,6,0,0,4,10,0,0,0,0,0,0,0,0,0,0,0,0,2,1,1,1
4821,12,222,1,1,1,0,0,0,1,0,0,0,0,0,0,0,0,0,0,0,0,2,1,1,1
4822,12,222,1,1,1,0,0,0,1,0,0,0,0,0,0,0,0,0,0,0,0,2,1,1,1
4823,12,222,14,10,10,0,0,4,14,1,1,1,1,2,2,0,2,0,1,0,0,2,1,1,1
4824,12,222,46,26,30,3,0,12,49,3,6,3,6,9,9,20,28,1,42,2,0,2,1,1,1
4825,6,287,42,7,35,4,0,5,46,1,2,1,2,3,3,2,4,0,2,0,0,2,3,2,1
4826,6,287,11,6,10,0,0,1,11,2,4,2,4,6,6,10,15,1,15,0,0,2,3,2,1
4827,35,1615,1289,550,1043,56,32,155,1345,10,167,93,185,177,278,1266,2075,5,11498,638,0,2,20,13,1
4828,7,159,127,75,83,2,11,30,129,4,14,7,14,18,21,61,87,2,175,9,0,2,3,3,1
4829,7,159,652,304,544,16,6,88,668,6,89,51,101,95,152,591,998,3,3399,188,0,2,3,3,1
4830,7,159,2,2,2,0,0,0,2,0,0,0,0,0,0,0,0,0,0,0,0,2,3,3,1
4831,7,159,8,5,5,0,0,3,8,0,0,0,0,0,0,0,0,0,0,0,0,2,3,3,1
4832,7,159,2,2,2,0,0,0,2,0,0,0,0,0,0,0,0,0,0,0,0,2,3,3,1
4833,7,159,14,8,8,0,0,6,14,0,0,0,0,0,0,0,0,0,0,0,0,2,3,3,1
4834,7,159,6,4,4,0,0,2,6,0,0,0,0,0,0,0,0,0,0,0,0,2,3,3,1
4835,7,159,6,4,4,0,0,2,6,1,2,1,2,3,3,2,4,0,2,0,0,2,3,3,1
4836,7,159,6,4,4,0,0,2,6,0,0,0,0,0,0,0,0,0,0,0,0,2,3,3,1
4837,7,159,7,5,5,0,0,2,7,0,0,0,0,0,0,0,0,0,0,0,0,2,3,3,1
4838,7,159,6,4,4,0,0,2,6,0,0,0,0,0,0,0,0,0,0,0,0,2,3,3,1
4839,7,159,10,6,6,0,0,4,10,0,0,0,0,0,0,0,0,0,0,0,0,2,3,3,1
4840,7,159,1,1,1,0,0,0,1,0,0,0,0,0,0,0,0,0,0,0,0,2,3,3,1
4841,7,159,1,1,1,0,0,0,1,0,0,0,0,0,0,0,0,0,0,0,0,2,3,3,1
4842,7,159,14,10,10,0,0,4,14,1,1,1,1,2,2,0,2,0,1,0,0,2,3,3,1
4843,7,159,46,26,30,3,0,12,49,3,6,3,6,9,9,20,28,1,42,2,0,2,3,3,1
4844,26,918,1450,624,1228,12,26,181,1462,14,306,186,354,320,540,2580,4493,8,36391,2021,1,2,1,1,1
4845,34,1378,1513,682,1277,25,13,200,1538,11,199,116,219,210,335,1557,2584,6,15641,868,0,2,1,1,1
4846,10,401,1455,414,1257,16,76,112,1471,5,41,23,46,46,69,231,381,2,1069,59,0,2,1,1,1
4847,7,222,74,35,59,1,0,14,75,3,14,7,14,17,21,58,85,1,128,7,0,2,1,1,1
4848,31,1245,1020,354,843,12,15,144,1032,8,134,77,144,142,221,970,1580,4,6792,377,0,2,1,1,1
4849,12,818,447,308,343,6,5,95,453,7,96,59,111,103,170,651,1136,4,4600,255,0,2,1,1,1
4850,10,498,722,423,573,19,0,135,741,12,172,101,199,184,300,1320,2257,6,15668,870,0,2,3,3,1
4851,12,416,386,256,301,16,9,68,402,4,59,35,69,63,104,355,621,2,1453,80,0,2,1,1,1
4852,13,1142,215,129,180,6,0,29,221,8,65,43,72,73,115,415,711,4,3153,175,0,2,3,3,1
4853,36,1464,1043,504,840,53,9,147,1096,9,180,112,198,189,310,1377,2344,4,11604,644,0,2,1,1,1
4854,28,1381,1178,367,1042,6,15,115,1184,9,94,51,95,103,146,644,976,4,4439,246,0,2,3,3,1
4855,51,2560,1943,715,1694,26,18,214,1969,12,185,120,237,197,357,1436,2721,7,20915,1161,0,2,2,2,1
4856,2,135,442,244,305,14,16,103,456,11,68,45,75,79,120,452,756,6,4588,254,0,2,2,2,1
4857,41,2832,1296,573,1062,40,33,157,1336,8,201,118,231,209,349,1561,2689,4,12365,686,0,2,1,1,1
4858,26,1595,1457,730,1242,11,6,188,1468,10,292,166,329,302,495,2424,4078,5,22973,1276,1,2,1,1,1
4859,26,1352,652,304,544,16,6,88,668,6,89,51,101,95,152,591,998,3,3399,188,0,2,2,2,1
4860,17,773,334,251,279,10,4,40,344,5,127,74,143,132,217,899,1528,2,4303,239,0,2,1,1,1
4861,177,4154,722,423,573,19,0,135,741,12,172,101,199,184,300,1320,2257,6,15668,870,0,2,4,1,1
4862,177,4154,1508,847,911,44,250,301,1552,14,148,88,169,162,257,1120,1886,7,15077,837,0,2,4,1,1
4863,176,4145,722,423,573,19,0,135,741,12,172,101,199,184,300,1320,2257,6,15668,870,0,2,4,5,1
4864,176,4145,1508,847,911,44,250,301,1552,14,148,88,169,162,257,1120,1886,7,15077,837,0,2,4,5,1
4865,6,287,42,7,35,4,0,5,46,1,2,1,2,3,3,2,4,0,2,0,0,2,1,1,1
4866,6,287,11,6,10,0,0,1,11,2,4,2,4,6,6,10,15,1,15,0,0,2,1,1,1
4867,26,560,215,129,180,6,0,29,221,8,65,43,72,73,115,415,711,4,3153,175,0,2,3,2,1
4868,26,560,97,69,77,3,3,16,100,6,22,13,23,28,36,113,173,3,542,30,0,2,3,2,1
4869,87,1903,1043,504,840,53,9,147,1096,9,180,112,198,189,310,1377,2344,4,11604,644,0,2,20,7,1
4870,87,1903,383,288,292,26,6,62,409,11,65,38,67,76,105,429,656,5,3719,206,0,2,20,7,1
4871,71,1168,1178,367,1042,6,15,115,1184,9,94,51,95,103,146,644,976,4,4439,246,0,2,2,2,1
4872,71,1168,177,108,140,8,0,27,185,6,30,16,32,36,48,162,248,3,794,44,0,2,2,2,1
4873,138,2676,1943,715,1694,26,18,214,1969,12,185,120,237,197,357,1436,2721,7,20915,1161,0,2,1,1,1
4874,138,2676,1168,838,957,57,25,144,1225,19,348,224,416,367,640,3018,5452,11,61921,3440,1,2,1,1,1
4875,6,287,42,7,35,4,0,5,46,1,2,1,2,3,3,2,4,0,2,0,0,2,1,1,1
4876,6,287,11,6,10,0,0,1,11,2,4,2,4,6,6,10,15,1,15,0,0,2,1,1,1
4877,37,1499,1043,504,840,53,9,147,1096,9,180,112,198,189,310,1377,2344,4,11604,644,0,2,7,2,1
4878,28,1372,1178,367,1042,6,15,115,1184,9,94,51,95,103,146,644,976,4,4439,246,0,2,7,8,1
4879,130,3043,373,158,315,8,0,51,381,5,76,44,79,81,123,486,779,2,2026,112,0,2,2,1,1
4880,137,2628,1943,715,1694,26,18,214,1969,12,185,120,237,197,357,1436,2721,7,20915,1161,0,2,1,5,1
4881,137,2628,1168,838,957,57,25,144,1225,19,348,224,416,367,640,3018,5452,11,61921,3440,1,2,1,5,1
4882,34,862,74,35,59,1,0,14,75,3,14,7,14,17,21,58,85,1,128,7,0,2,2,2,0
4883,34,862,245,125,200,5,7,34,250,7,30,17,34,37,51,166,265,3,1053,58,0,2,2,2,0
4884,4,78,127,75,83,2,11,30,129,4,14,7,14,18,21,61,87,2,175,9,0,2,1,1,0
4885,4,78,652,304,544,16,6,88,668,6,89,51,101,95,152,591,998,3,3399,188,0,2,1,1,0
4886,4,78,2,2,2,0,0,0,2,0,0,0,0,0,0,0,0,0,0,0,0,2,1,1,0
4887,4,78,8,5,5,0,0,3,8,0,0,0,0,0,0,0,0,0,0,0,0,2,1,1,0
4888,4,78,2,2,2,0,0,0,2,0,0,0,0,0,0,0,0,0,0,0,0,2,1,1,0
4889,4,78,14,8,8,0,0,6,14,0,0,0,0,0,0,0,0,0,0,0,0,2,1,1,0
4890,4,78,6,4,4,0,0,2,6,0,0,0,0,0,0,0,0,0,0,0,0,2,1,1,0
4891,4,78,6,4,4,0,0,2,6,1,2,1,2,3,3,2,4,0,2,0,0,2,1,1,0
4892,4,78,6,4,4,0,0,2,6,0,0,0,0,0,0,0,0,0,0,0,0,2,1,1,0
4893,4,78,7,5,5,0,0,2,7,0,0,0,0,0,0,0,0,0,0,0,0,2,1,1,0
4894,4,78,6,4,4,0,0,2,6,0,0,0,0,0,0,0,0,0,0,0,0,2,1,1,0
4895,4,78,10,6,6,0,0,4,10,0,0,0,0,0,0,0,0,0,0,0,0,2,1,1,0
4896,4,78,1,1,1,0,0,0,1,0,0,0,0,0,0,0,0,0,0,0,0,2,1,1,0
4897,4,78,1,1,1,0,0,0,1,0,0,0,0,0,0,0,0,0,0,0,0,2,1,1,0
4898,4,78,14,10,10,0,0,4,14,1,1,1,1,2,2,0,2,0,1,0,0,2,1,1,0
4899,4,78,46,26,30,3,0,12,49,3,6,3,6,9,9,20,28,1,42,2,0,2,1,1,0
4900,205,4464,72,33,56,0,4,12,72,1,1,1,1,2,2,0,2,0,1,0,0,2,2,2,0
4901,205,4464,1454,835,1044,76,110,219,1530,17,275,158,296,292,454,2297,3718,9,34017,1889,1,2,2,2,0
4902,6,287,42,7,35,4,0,5,46,1,2,1,2,3,3,2,4,0,2,0,0,2,1,1,0
4903,6,287,11,6,10,0,0,1,11,2,4,2,4,6,6,10,15,1,15,0,0,2,1,1,0
4904,35,1628,1289,550,1043,56,32,155,1345,10,167,93,185,177,278,1266,2075,5,11498,638,0,2,1,0,0
4905,18,598,1455,414,1257,16,76,112,1471,5,41,23,46,46,69,231,381,2,1069,59,0,2,2,1,1
4906,18,598,669,365,481,22,61,110,691,15,103,63,122,118,185,747,1273,8,11311,628,0,2,2,1,1
4907,10,415,1455,414,1257,16,76,112,1471,5,41,23,46,46,69,231,381,2,1069,59,0,2,3,3,1
4908,17,561,1455,414,1257,16,76,112,1471,5,41,23,46,46,69,231,381,2,1069,59,0,2,2,7,1
4909,17,561,669,365,481,22,61,110,691,15,103,63,122,118,185,747,1273,8,11311,628,0,2,2,7,1
4910,131,3044,373,158,315,8,0,51,381,5,76,44,79,81,123,486,779,2,2026,112,0,2,2,3,1
4911,38,1713,1289,550,1043,56,32,155,1345,10,167,93,185,177,278,1266,2075,5,11498,638,0,2,19,0,1
4912,41,2867,1296,573,1062,40,33,157,1336,8,201,118,231,209,349,1561,2689,4,12365,686,0,2,40,4,1
4913,6,287,42,7,35,4,0,5,46,1,2,1,2,3,3,2,4,0,2,0,0,2,1,1,0
4914,6,287,11,6,10,0,0,1,11,2,4,2,4,6,6,10,15,1,15,0,0,2,1,1,0
4915,38,1703,1289,550,1043,56,32,155,1345,10,167,93,185,177,278,1266,2075,5,11498,638,0,2,6,6,1
4916,32,534,127,75,83,2,11,30,129,4,14,7,14,18,21,61,87,2,175,9,0,2,2,2,1
4917,32,534,652,304,544,16,6,88,668,6,89,51,101,95,152,591,998,3,3399,188,0,2,2,2,1
4918,32,534,2,2,2,0,0,0,2,0,0,0,0,0,0,0,0,0,0,0,0,2,2,2,1
4919,32,534,8,5,5,0,0,3,8,0,0,0,0,0,0,0,0,0,0,0,0,2,2,2,1
4920,32,534,2,2,2,0,0,0,2,0,0,0,0,0,0,0,0,0,0,0,0,2,2,2,1
4921,32,534,14,8,8,0,0,6,14,0,0,0,0,0,0,0,0,0,0,0,0,2,2,2,1
4922,32,534,6,4,4,0,0,2,6,0,0,0,0,0,0,0,0,0,0,0,0,2,2,2,1
4923,32,534,6,4,4,0,0,2,6,1,2,1,2,3,3,2,4,0,2,0,0,2,2,2,1
4924,32,534,6,4,4,0,0,2,6,0,0,0,0,0,0,0,0,0,0,0,0,2,2,2,1
4925,32,534,7,5,5,0,0,2,7,0,0,0,0,0,0,0,0,0,0,0,0,2,2,2,1
4926,32,534,6,4,4,0,0,2,6,0,0,0,0,0,0,0,0,0,0,0,0,2,2,2,1
4927,32,534,10,6,6,0,0,4,10,0,0,0,0,0,0,0,0,0,0,0,0,2,2,2,1
4928,32,534,1,1,1,0,0,0,1,0,0,0,0,0,0,0,0,0,0,0,0,2,2,2,1
4929,32,534,1,1,1,0,0,0,1,0,0,0,0,0,0,0,0,0,0,0,0,2,2,2,1
4930,32,534,14,10,10,0,0,4,14,1,1,1,1,2,2,0,2,0,1,0,0,2,2,2,1
4931,32,534,46,26,30,3,0,12,49,3,6,3,6,9,9,20,28,1,42,2,0,2,2,2,1
4932,26,918,1450,624,1228,12,26,181,1462,14,306,186,354,320,540,2580,4493,8,36391,2021,1,2,2,2,1
4933,34,1366,1513,682,1277,25,13,200,1538,11,199,116,219,210,335,1557,2584,6,15641,868,0,2,9,9,1
4934,41,2863,1296,573,1062,40,33,157,1336,8,201,118,231,209,349,1561,2689,4,12365,686,0,2,2,2,1
4935,26,1575,1457,730,1242,11,6,188,1468,10,292,166,329,302,495,2424,4078,5,22973,1276,1,2,10,10,1
4936,26,1350,652,304,544,16,6,88,668,6,89,51,101,95,152,591,998,3,3399,188,0,2,6,6,1
4937,10,417,1455,414,1257,16,76,112,1471,5,41,23,46,46,69,231,381,2,1069,59,0,2,2,2,1
4938,7,222,74,35,59,1,0,14,75,3,14,7,14,17,21,58,85,1,128,7,0,2,2,2,1
4939,19,1390,1523,757,1297,19,12,193,1542,12,193,117,230,205,347,1508,2664,7,19053,1058,0,2,9,9,1
4940,31,1237,1020,354,843,12,15,144,1032,8,134,77,144,142,221,970,1580,4,6792,377,0,2,26,27,1
4941,12,810,447,308,343,6,5,95,453,7,96,59,111,103,170,651,1136,4,4600,255,0,2,5,5,1
4942,9,312,424,94,331,4,0,89,428,1,5,5,5,6,10,11,25,0,12,0,0,2,1,1,1
4943,17,769,334,251,279,10,4,40,344,5,127,74,143,132,217,899,1528,2,4303,239,0,2,4,4,1
4944,5,238,184,100,137,2,15,30,186,6,38,20,39,44,59,214,322,3,991,55,0,2,4,4,1
4945,15,596,1293,570,1093,25,15,163,1318,10,195,123,241,205,364,1516,2795,6,17273,959,0,2,16,16,1
4946,10,494,722,423,573,19,0,135,741,12,172,101,199,184,300,1320,2257,6,15668,870,0,2,6,5,1
4947,12,412,386,256,301,16,9,68,402,4,59,35,69,63,104,355,621,2,1453,80,0,2,4,4,1
4948,13,1144,215,129,180,6,0,29,221,8,65,43,72,73,115,415,711,4,3153,175,0,2,11,10,1
4949,37,1475,1043,504,840,53,9,147,1096,9,180,112,198,189,310,1377,2344,4,11604,644,0,2,19,19,1
4950,10,333,295,56,236,0,4,54,295,2,9,5,10,11,15,30,51,1,57,3,0,2,4,4,1
4951,23,990,373,158,315,8,0,51,381,5,76,44,79,81,123,486,779,2,2026,112,0,2,9,9,1
4952,28,1368,1178,367,1042,6,15,115,1184,9,94,51,95,103,146,644,976,4,4439,246,0,2,60,60,1
4953,51,2556,1943,715,1694,26,18,214,1969,12,185,120,237,197,357,1436,2721,7,20915,1161,0,2,13,13,1
4954,2,137,442,244,305,14,16,103,456,11,68,45,75,79,120,452,756,6,4588,254,0,2,1,1,1
4955,7,249,1098,241,925,5,10,155,1103,7,46,25,49,53,74,273,423,3,1580,87,0,2,4,4,1
4956,17,579,1455,414,1257,16,76,112,1471,5,41,23,46,46,69,231,381,2,1069,59,0,2,7,3,1
4957,17,579,669,365,481,22,61,110,691,15,103,63,122,118,185,747,1273,8,11311,628,0,2,7,3,1
4958,17,277,424,94,331,4,0,89,428,1,5,5,5,6,10,11,25,0,12,0,0,2,1,1,1
4959,17,277,38,23,23,6,0,8,44,3,11,7,11,14,18,42,68,1,102,5,0,2,1,1,1
4960,205,4464,72,33,56,0,4,12,72,1,1,1,1,2,2,0,2,0,1,0,0,2,22,13,1
4961,205,4464,1454,835,1044,76,110,219,1530,17,275,158,296,292,454,2297,3718,9,34017,1889,1,2,22,13,1
4962,18,462,386,256,301,16,9,68,402,4,59,35,69,63,104,355,621,2,1453,80,0,2,2,2,1
4963,18,462,264,131,164,11,41,46,275,6,38,22,40,44,62,214,338,3,1068,59,0,2,2,2,1
4964,131,3070,373,158,315,8,0,51,381,5,76,44,79,81,123,486,779,2,2026,112,0,2,4,2,1
4965,38,1703,1289,550,1043,56,32,155,1345,10,167,93,185,177,278,1266,2075,5,11498,638,0,2,3,4,1
4966,41,2878,1296,573,1062,40,33,157,1336,8,201,118,231,209,349,1561,2689,4,12365,686,0,2,4,4,1
4967,32,1257,1020,354,843,12,15,144,1032,8,134,77,144,142,221,970,1580,4,6792,377,0,2,4,0,1
4968,18,604,1455,414,1257,16,76,112,1471,5,41,23,46,46,69,231,381,2,1069,59,0,2,4,1,0
4969,18,604,669,365,481,22,61,110,691,15,103,63,122,118,185,747,1273,8,11311,628,0,2,4,1,0
4970,1,185,382,65,130,157,2,92,539,4,10,5,10,14,15,41,57,2,114,6,0,2,3,1,0
4971,207,4492,72,33,56,0,4,12,72,1,1,1,1,2,2,0,2,0,1,0,0,2,9,4,1
4972,207,4492,1454,835,1044,76,110,219,1530,17,275,158,296,292,454,2297,3718,9,34017,1889,1,2,9,4,1
4973,6,287,42,7,35,4,0,5,46,1,2,1,2,3,3,2,4,0,2,0,0,2,1,1,1
4974,6,287,11,6,10,0,0,1,11,2,4,2,4,6,6,10,15,1,15,0,0,2,1,1,1
4975,46,795,1020,354,843,12,15,144,1032,8,134,77,144,142,221,970,1580,4,6792,377,0,2,8,8,1
4976,35,1360,1020,354,843,12,15,144,1032,8,134,77,144,142,221,970,1580,4,6792,377,0,2,16,1,1
4977,1,84,13,10,10,0,0,3,13,1,2,1,2,3,3,2,4,0,2,0,0,3,1,0,1
4978,3,71,127,75,83,2,11,30,129,4,14,7,14,18,21,61,87,2,175,9,0,3,1,0,1
4979,3,71,652,304,544,16,6,88,668,6,89,51,101,95,152,591,998,3,3399,188,0,3,1,0,1
4980,3,71,2,2,2,0,0,0,2,0,0,0,0,0,0,0,0,0,0,0,0,3,1,0,1
4981,3,71,8,5,5,0,0,3,8,0,0,0,0,0,0,0,0,0,0,0,0,3,1,0,1
4982,3,71,2,2,2,0,0,0,2,0,0,0,0,0,0,0,0,0,0,0,0,3,1,0,1
4983,3,71,14,8,8,0,0,6,14,0,0,0,0,0,0,0,0,0,0,0,0,3,1,0,1
4984,3,71,6,4,4,0,0,2,6,0,0,0,0,0,0,0,0,0,0,0,0,3,1,0,1
4985,3,71,6,4,4,0,0,2,6,1,2,1,2,3,3,2,4,0,2,0,0,3,1,0,1
4986,3,71,6,4,4,0,0,2,6,0,0,0,0,0,0,0,0,0,0,0,0,3,1,0,1
4987,3,71,7,5,5,0,0,2,7,0,0,0,0,0,0,0,0,0,0,0,0,3,1,0,1
4988,3,71,6,4,4,0,0,2,6,0,0,0,0,0,0,0,0,0,0,0,0,3,1,0,1
4989,3,71,10,6,6,0,0,4,10,0,0,0,0,0,0,0,0,0,0,0,0,3,1,0,1
4990,3,71,1,1,1,0,0,0,1,0,0,0,0,0,0,0,0,0,0,0,0,3,1,0,1
4991,3,71,1,1,1,0,0,0,1,0,0,0,0,0,0,0,0,0,0,0,0,3,1,0,1
4992,3,71,14,10,10,0,0,4,14,1,1,1,1,2,2,0,2,0,1,0,0,3,1,0,1
4993,3,71,46,26,30,3,0,12,49,3,6,3,6,9,9,20,28,1,42,2,0,3,1,0,1
4994,13,380,72,33,56,0,4,12,72,1,1,1,1,2,2,0,2,0,1,0,0,3,1,3,1
4995,5,69,38,23,23,0,0,15,38,0,0,0,0,0,0,0,0,0,0,0,0,0,21,0,1
4996,134,2593,1457,730,1242,11,6,188,1468,10,292,166,329,302,495,2424,4078,5,22973,1276,1,2,1,26,1
4997,134,2593,74,35,59,1,0,14,75,3,14,7,14,17,21,58,85,1,128,7,0,2,1,26,1
4998,134,2593,245,125,200,5,7,34,250,7,30,17,34,37,51,166,265,3,1053,58,0,2,1,26,1
4999,178,4184,722,423,573,19,0,135,741,12,172,101,199,184,300,1320,2257,6,15668,870,0,2,9,3,1
5000,178,4184,1508,847,911,44,250,301,1552,14,148,88,169,162,257,1120,1886,7,15077,837,0,2,9,3,1
5001,12,359,442,244,305,14,16,103,456,11,68,45,75,79,120,452,756,6,4588,254,0,2,53,8,1
5002,12,359,182,102,99,11,40,35,193,3,11,6,11,14,17,42,64,1,97,5,0,2,53,8,1
5003,37,1648,1289,550,1043,56,32,155,1345,10,167,93,185,177,278,1266,2075,5,11498,638,0,2,0,10,1
5004,22,1351,1457,730,1242,11,6,188,1468,10,292,166,329,302,495,2424,4078,5,22973,1276,1,2,0,27,1
5005,7,476,442,244,305,14,16,103,456,11,68,45,75,79,120,452,756,6,4588,254,0,2,49,1,1
5006,65,1200,1513,682,1277,25,13,200,1538,11,199,116,219,210,335,1557,2584,6,15641,868,0,2,5,1,1
5007,65,1200,819,519,539,24,98,155,843,15,96,57,106,111,163,690,1107,8,9171,509,0,2,5,1,1
5008,20,489,1293,570,1093,25,15,163,1318,10,195,123,241,205,364,1516,2795,6,17273,959,0,2,4,2,1
5009,207,4492,72,33,56,0,4,12,72,1,1,1,1,2,2,0,2,0,1,0,0,2,2,2,1
5010,207,4492,1454,835,1044,76,110,219,1530,17,275,158,296,292,454,2297,3718,9,34017,1889,1,2,2,2,1
5011,6,287,42,7,35,4,0,5,46,1,2,1,2,3,3,2,4,0,2,0,0,2,1,1,1
5012,6,287,11,6,10,0,0,1,11,2,4,2,4,6,6,10,15,1,15,0,0,2,1,1,1
5013,35,1408,1513,682,1277,25,13,200,1538,11,199,116,219,210,335,1557,2584,6,15641,868,0,2,10,0,1
5014,133,2586,1457,730,1242,11,6,188,1468,10,292,166,329,302,495,2424,4078,5,22973,1276,1,2,7,8,1
5015,133,2586,74,35,59,1,0,14,75,3,14,7,14,17,21,58,85,1,128,7,0,2,7,8,1
5016,133,2586,245,125,200,5,7,34,250,7,30,17,34,37,51,166,265,3,1053,58,0,2,7,8,1
5017,44,421,647,139,84,35,284,233,682,0,0,0,0,0,0,0,0,0,0,0,0,2,0,3,1
5018,148,2800,1943,715,1694,26,18,214,1969,12,185,120,237,197,357,1436,2721,7,20915,1161,0,2,44,10,1
5019,148,2800,1168,838,957,57,25,144,1225,19,348,224,416,367,640,3018,5452,11,61921,3440,1,2,44,10,1
5020,4,77,127,75,83,2,11,30,129,4,14,7,14,18,21,61,87,2,175,9,0,2,1,1,1
5021,4,77,652,304,544,16,6,88,668,6,89,51,101,95,152,591,998,3,3399,188,0,2,1,1,1
5022,4,77,2,2,2,0,0,0,2,0,0,0,0,0,0,0,0,0,0,0,0,2,1,1,1
5023,4,77,8,5,5,0,0,3,8,0,0,0,0,0,0,0,0,0,0,0,0,2,1,1,1
5024,4,77,2,2,2,0,0,0,2,0,0,0,0,0,0,0,0,0,0,0,0,2,1,1,1
5025,4,77,14,8,8,0,0,6,14,0,0,0,0,0,0,0,0,0,0,0,0,2,1,1,1
5026,4,77,6,4,4,0,0,2,6,0,0,0,0,0,0,0,0,0,0,0,0,2,1,1,1
5027,4,77,6,4,4,0,0,2,6,1,2,1,2,3,3,2,4,0,2,0,0,2,1,1,1
5028,4,77,6,4,4,0,0,2,6,0,0,0,0,0,0,0,0,0,0,0,0,2,1,1,1
5029,4,77,7,5,5,0,0,2,7,0,0,0,0,0,0,0,0,0,0,0,0,2,1,1,1
5030,4,77,6,4,4,0,0,2,6,0,0,0,0,0,0,0,0,0,0,0,0,2,1,1,1
5031,4,77,10,6,6,0,0,4,10,0,0,0,0,0,0,0,0,0,0,0,0,2,1,1,1
5032,4,77,1,1,1,0,0,0,1,0,0,0,0,0,0,0,0,0,0,0,0,2,1,1,1
5033,4,77,1,1,1,0,0,0,1,0,0,0,0,0,0,0,0,0,0,0,0,2,1,1,1
5034,4,77,14,10,10,0,0,4,14,1,1,1,1,2,2,0,2,0,1,0,0,2,1,1,1
5035,4,77,46,26,30,3,0,12,49,3,6,3,6,9,9,20,28,1,42,2,0,2,1,1,1
5036,28,1364,1178,367,1042,6,15,115,1184,9,94,51,95,103,146,644,976,4,4439,246,0,2,0,2,1
5037,51,2554,1943,715,1694,26,18,214,1969,12,185,120,237,197,357,1436,2721,7,20915,1161,0,2,0,1,1
5038,178,4184,722,423,573,19,0,135,741,12,172,101,199,184,300,1320,2257,6,15668,870,0,2,1,1,0
5039,178,4184,1508,847,911,44,250,301,1552,14,148,88,169,162,257,1120,1886,7,15077,837,0,2,1,1,0
5040,179,4219,722,423,573,19,0,135,741,12,172,101,199,184,300,1320,2257,6,15668,870,0,2,4,1,1
5041,179,4219,1508,847,911,44,250,301,1552,14,148,88,169,162,257,1120,1886,7,15077,837,0,2,4,1,1
5042,10,498,722,423,573,19,0,135,741,12,172,101,199,184,300,1320,2257,6,15668,870,0,2,1,1,1
5043,209,4519,72,33,56,0,4,12,72,1,1,1,1,2,2,0,2,0,1,0,0,2,3,0,1
5044,209,4519,1454,835,1044,76,110,219,1530,17,275,158,296,292,454,2297,3718,9,34017,1889,1,2,3,0,1
5045,87,1925,1043,504,840,53,9,147,1096,9,180,112,198,189,310,1377,2344,4,11604,644,0,2,5,3,1
5046,87,1925,383,288,292,26,6,62,409,11,65,38,67,76,105,429,656,5,3719,206,0,2,5,3,1
5047,28,438,1098,241,925,5,10,155,1103,7,46,25,49,53,74,273,423,3,1580,87,0,2,34,2,1
5048,28,438,282,202,222,14,2,44,296,8,42,24,43,50,67,250,378,4,1548,86,0,2,34,2,1
5049,38,1504,1043,504,840,53,9,147,1096,9,180,112,198,189,310,1377,2344,4,11604,644,0,2,11,0,1
5050,10,396,1098,241,925,5,10,155,1103,7,46,25,49,53,74,273,423,3,1580,87,0,2,62,0,1
5051,19,477,1293,570,1093,25,15,163,1318,10,195,123,241,205,364,1516,2795,6,17273,959,0,2,1,4,1
5052,87,1925,1043,504,840,53,9,147,1096,9,180,112,198,189,310,1377,2344,4,11604,644,0,2,3,1,1
5053,87,1925,383,288,292,26,6,62,409,11,65,38,67,76,105,429,656,5,3719,206,0,2,3,1,1
5054,151,2856,1943,715,1694,26,18,214,1969,12,185,120,237,197,357,1436,2721,7,20915,1161,0,2,16,5,1
5055,151,2856,1168,838,957,57,25,144,1225,19,348,224,416,367,640,3018,5452,11,61921,3440,1,2,16,5,1
5056,6,287,42,7,35,4,0,5,46,1,2,1,2,3,3,2,4,0,2,0,0,2,1,1,1
5057,6,287,11,6,10,0,0,1,11,2,4,2,4,6,6,10,15,1,15,0,0,2,1,1,1
5058,16,635,1293,570,1093,25,15,163,1318,10,195,123,241,205,364,1516,2795,6,17273,959,0,2,8,0,1
5059,6,287,42,7,35,4,0,5,46,1,2,1,2,3,3,2,4,0,2,0,0,2,3,3,1
5060,6,287,11,6,10,0,0,1,11,2,4,2,4,6,6,10,15,1,15,0,0,2,3,3,1
5061,6,287,42,7,35,4,0,5,46,1,2,1,2,3,3,2,4,0,2,0,0,2,2,2,1
5062,6,287,11,6,10,0,0,1,11,2,4,2,4,6,6,10,15,1,15,0,0,2,2,2,1
5063,1,192,382,65,130,157,2,92,539,4,10,5,10,14,15,41,57,2,114,6,0,2,1,0,1
5064,28,458,1098,241,925,5,10,155,1103,7,46,25,49,53,74,273,423,3,1580,87,0,2,2,0,1
5065,28,458,282,202,222,14,2,44,296,8,42,24,43,50,67,250,378,4,1548,86,0,2,2,0,1
5066,6,287,42,7,35,4,0,5,46,1,2,1,2,3,3,2,4,0,2,0,0,2,1,1,1
5067,6,287,11,6,10,0,0,1,11,2,4,2,4,6,6,10,15,1,15,0,0,2,1,1,1
5068,11,426,1098,241,925,5,10,155,1103,7,46,25,49,53,74,273,423,3,1580,87,0,2,21,1,1
5069,37,1034,1523,757,1297,19,12,193,1542,12,193,117,230,205,347,1508,2664,7,19053,1058,0,2,1,2,1
5070,37,1034,701,378,504,33,58,109,734,13,110,68,126,123,194,794,1346,7,10027,557,0,2,1,2,1
5071,181,4234,722,423,573,19,0,135,741,12,172,101,199,184,300,1320,2257,6,15668,870,0,2,10,4,1
5072,181,4234,1508,847,911,44,250,301,1552,14,148,88,169,162,257,1120,1886,7,15077,837,0,2,10,4,1
5073,19,478,1293,570,1093,25,15,163,1318,10,195,123,241,205,364,1516,2795,6,17273,959,0,2,2,2,1
5074,36,627,1098,241,925,5,10,155,1103,7,46,25,49,53,74,273,423,3,1580,87,0,2,31,4,1
5075,36,627,282,202,222,14,2,44,296,8,42,24,43,50,67,250,378,4,1548,86,0,2,31,4,1
5076,6,287,42,7,35,4,0,5,46,1,2,1,2,3,3,2,4,0,2,0,0,2,1,1,1
5077,6,287,11,6,10,0,0,1,11,2,4,2,4,6,6,10,15,1,15,0,0,2,1,1,1
5078,15,570,1098,241,925,5,10,155,1103,7,46,25,49,53,74,273,423,3,1580,87,0,2,104,0,1
5079,37,640,1098,241,925,5,10,155,1103,7,46,25,49,53,74,273,423,3,1580,87,0,2,4,2,1
5080,37,640,282,202,222,14,2,44,296,8,42,24,43,50,67,250,378,4,1548,86,0,2,4,2,1
5081,16,591,1098,241,925,5,10,155,1103,7,46,25,49,53,74,273,423,3,1580,87,0,2,32,0,1
5082,16,591,1098,241,925,5,10,155,1103,7,46,25,49,53,74,273,423,3,1580,87,0,2,11,5,0
5083,38,659,1098,241,925,5,10,155,1103,7,46,25,49,53,74,273,423,3,1580,87,0,2,5,5,1
5084,38,659,282,202,222,14,2,44,296,8,42,24,43,50,67,250,378,4,1548,86,0,2,5,5,1
5085,18,710,1098,241,925,5,10,155,1103,7,46,25,49,53,74,273,423,3,1580,87,0,2,43,3,1
5086,183,4253,722,423,573,19,0,135,741,12,172,101,199,184,300,1320,2257,6,15668,870,0,2,3,1,1
5087,183,4253,1508,847,911,44,250,301,1552,14,148,88,169,162,257,1120,1886,7,15077,837,0,2,3,1,1
5088,39,708,1098,241,925,5,10,155,1103,7,46,25,49,53,74,273,423,3,1580,87,0,2,11,5,1
5089,39,708,282,202,222,14,2,44,296,8,42,24,43,50,67,250,378,4,1548,86,0,2,11,5,1
5090,6,287,42,7,35,4,0,5,46,1,2,1,2,3,3,2,4,0,2,0,0,2,1,1,1
5091,6,287,11,6,10,0,0,1,11,2,4,2,4,6,6,10,15,1,15,0,0,2,1,1,1
5092,19,732,1098,241,925,5,10,155,1103,7,46,25,49,53,74,273,423,3,1580,87,0,2,60,54,1
5093,209,4519,72,33,56,0,4,12,72,1,1,1,1,2,2,0,2,0,1,0,0,2,3,3,1
5094,209,4519,1454,835,1044,76,110,219,1530,17,275,158,296,292,454,2297,3718,9,34017,1889,1,2,3,3,1
5095,38,1518,1043,504,840,53,9,147,1096,9,180,112,198,189,310,1377,2344,4,11604,644,0,2,5,1,1
5096,135,2629,1457,730,1242,11,6,188,1468,10,292,166,329,302,495,2424,4078,5,22973,1276,1,2,8,0,1
5097,135,2629,74,35,59,1,0,14,75,3,14,7,14,17,21,58,85,1,128,7,0,2,8,0,1
5098,135,2629,245,125,200,5,7,34,250,7,30,17,34,37,51,166,265,3,1053,58,0,2,8,0,1
5099,213,4623,72,33,56,0,4,12,72,1,1,1,1,2,2,0,2,0,1,0,0,2,21,4,1
5100,213,4623,1454,835,1044,76,110,219,1530,17,275,158,296,292,454,2297,3718,9,34017,1889,1,2,21,4,1
5101,210,4583,72,33,56,0,4,12,72,1,1,1,1,2,2,0,2,0,1,0,0,2,8,15,1
5102,210,4583,1454,835,1044,76,110,219,1530,17,275,158,296,292,454,2297,3718,9,34017,1889,1,2,8,15,1
5103,132,3087,373,158,315,8,0,51,381,5,76,44,79,81,123,486,779,2,2026,112,0,2,3,0,1
5104,212,4586,72,33,56,0,4,12,72,1,1,1,1,2,2,0,2,0,1,0,0,2,1,1,0
5105,212,4586,1454,835,1044,76,110,219,1530,17,275,158,296,292,454,2297,3718,9,34017,1889,1,2,1,1,0
5106,34,863,74,35,59,1,0,14,75,3,14,7,14,17,21,58,85,1,128,7,0,2,2,1,1
5107,34,863,245,125,200,5,7,34,250,7,30,17,34,37,51,166,265,3,1053,58,0,2,2,1,1
5108,212,4586,72,33,56,0,4,12,72,1,1,1,1,2,2,0,2,0,1,0,0,2,22,21,1
5109,212,4586,1454,835,1044,76,110,219,1530,17,275,158,296,292,454,2297,3718,9,34017,1889,1,2,22,21,1
5110,1,192,382,65,130,157,2,92,539,4,10,5,10,14,15,41,57,2,114,6,0,2,2,0,1
5111,52,901,282,196,195,3,0,86,285,8,130,71,141,138,212,936,1507,4,6538,363,0,2,85,81,1
5112,6,287,42,7,35,4,0,5,46,1,2,1,2,3,3,2,4,0,2,0,0,2,1,1,1
5113,6,287,11,6,10,0,0,1,11,2,4,2,4,6,6,10,15,1,15,0,0,2,1,1,1
5114,46,860,1098,241,925,5,10,155,1103,7,46,25,49,53,74,273,423,3,1580,87,0,2,18,0,1
5115,46,860,282,202,222,14,2,44,296,8,42,24,43,50,67,250,378,4,1548,86,0,2,18,0,1
5116,19,752,1098,241,925,5,10,155,1103,7,46,25,49,53,74,273,423,3,1580,87,0,2,26,3,1
5117,6,287,42,7,35,4,0,5,46,1,2,1,2,3,3,2,4,0,2,0,0,2,1,1,0
5118,6,287,11,6,10,0,0,1,11,2,4,2,4,6,6,10,15,1,15,0,0,2,1,1,0
5119,152,2888,1943,715,1694,26,18,214,1969,12,185,120,237,197,357,1436,2721,7,20915,1161,0,2,3,0,1
5120,152,2888,1168,838,957,57,25,144,1225,19,348,224,416,367,640,3018,5452,11,61921,3440,1,2,3,0,1
5121,6,287,42,7,35,4,0,5,46,1,2,1,2,3,3,2,4,0,2,0,0,2,1,1,1
5122,6,287,11,6,10,0,0,1,11,2,4,2,4,6,6,10,15,1,15,0,0,2,1,1,1
5123,35,1417,1513,682,1277,25,13,200,1538,11,199,116,219,210,335,1557,2584,6,15641,868,0,2,1,0,1
5124,6,287,42,7,35,4,0,5,46,1,2,1,2,3,3,2,4,0,2,0,0,2,2,2,0
5125,6,287,11,6,10,0,0,1,11,2,4,2,4,6,6,10,15,1,15,0,0,2,2,2,0
5126,153,2910,1943,715,1694,26,18,214,1969,12,185,120,237,197,357,1436,2721,7,20915,1161,0,2,4,1,1
5127,153,2910,1168,838,957,57,25,144,1225,19,348,224,416,367,640,3018,5452,11,61921,3440,1,2,4,1,1
5128,1,192,382,65,130,157,2,92,539,4,10,5,10,14,15,41,57,2,114,6,0,2,1,1,1
5129,6,287,42,7,35,4,0,5,46,1,2,1,2,3,3,2,4,0,2,0,0,2,3,3,1
5130,6,287,11,6,10,0,0,1,11,2,4,2,4,6,6,10,15,1,15,0,0,2,3,3,1
5131,185,4279,722,423,573,19,0,135,741,12,172,101,199,184,300,1320,2257,6,15668,870,0,2,2,0,0
5132,185,4279,1508,847,911,44,250,301,1552,14,148,88,169,162,257,1120,1886,7,15077,837,0,2,2,0,0
5133,135,2629,1457,730,1242,11,6,188,1468,10,292,166,329,302,495,2424,4078,5,22973,1276,1,2,1,1,1
5134,135,2629,74,35,59,1,0,14,75,3,14,7,14,17,21,58,85,1,128,7,0,2,1,1,1
5135,135,2629,245,125,200,5,7,34,250,7,30,17,34,37,51,166,265,3,1053,58,0,2,1,1,1
5136,35,881,74,35,59,1,0,14,75,3,14,7,14,17,21,58,85,1,128,7,0,2,5,1,1
5137,35,881,245,125,200,5,7,34,250,7,30,17,34,37,51,166,265,3,1053,58,0,2,5,1,1
5138,132,3088,77,34,69,0,0,8,77,3,24,16,29,27,45,114,213,1,387,21,0,3,2,2,1
5139,132,3088,712,438,573,51,9,84,763,14,102,71,128,116,199,733,1364,8,11988,666,0,3,2,2,1
5140,185,4279,722,423,573,19,0,135,741,12,172,101,199,184,300,1320,2257,6,15668,870,0,2,1,1,1
5141,185,4279,1508,847,911,44,250,301,1552,14,148,88,169,162,257,1120,1886,7,15077,837,0,2,1,1,1
5142,212,4586,72,33,56,0,4,12,72,1,1,1,1,2,2,0,2,0,1,0,0,2,1,1,1
5143,212,4586,1454,835,1044,76,110,219,1530,17,275,158,296,292,454,2297,3718,9,34017,1889,1,2,1,1,1
5144,26,562,215,129,180,6,0,29,221,8,65,43,72,73,115,415,711,4,3153,175,0,2,6,6,1
5145,26,562,97,69,77,3,3,16,100,6,22,13,23,28,36,113,173,3,542,30,0,2,6,6,1
5146,37,1648,1289,550,1043,56,32,155,1345,10,167,93,185,177,278,1266,2075,5,11498,638,0,2,1,1,1
5147,41,2878,1296,573,1062,40,33,157,1336,8,201,118,231,209,349,1561,2689,4,12365,686,0,2,1,1,1
5148,25,1439,1457,730,1242,11,6,188,1468,10,292,166,329,302,495,2424,4078,5,22973,1276,1,2,14,1,1
5149,13,1144,215,129,180,6,0,29,221,8,65,43,72,73,115,415,711,4,3153,175,0,2,2,2,1
5150,23,990,373,158,315,8,0,51,381,5,76,44,79,81,123,486,779,2,2026,112,0,2,2,2,1
5151,65,1200,1513,682,1277,25,13,200,1538,11,199,116,219,210,335,1557,2584,6,15641,868,0,2,3,1,1
5152,65,1200,819,519,539,24,98,155,843,15,96,57,106,111,163,690,1107,8,9171,509,0,2,3,1,1
5153,36,1475,1513,682,1277,25,13,200,1538,11,199,116,219,210,335,1557,2584,6,15641,868,0,2,20,0,1
5154,71,1174,1178,367,1042,6,15,115,1184,9,94,51,95,103,146,644,976,4,4439,246,0,2,12,12,1
5155,71,1174,177,108,140,8,0,27,185,6,30,16,32,36,48,162,248,3,794,44,0,2,12,12,1
5156,30,1431,1178,367,1042,6,15,115,1184,9,94,51,95,103,146,644,976,4,4439,246,0,2,31,0,1
5157,18,611,1455,414,1257,16,76,112,1471,5,41,23,46,46,69,231,381,2,1069,59,0,2,11,6,1
5158,18,611,669,365,481,22,61,110,691,15,103,63,122,118,185,747,1273,8,11311,628,0,2,11,6,1
5159,10,414,1455,414,1257,16,76,112,1471,5,41,23,46,46,69,231,381,2,1069,59,0,2,8,11,1
5160,6,287,42,7,35,4,0,5,46,1,2,1,2,3,3,2,4,0,2,0,0,2,1,1,0
5161,6,287,11,6,10,0,0,1,11,2,4,2,4,6,6,10,15,1,15,0,0,2,1,1,0
5162,136,2646,1457,730,1242,11,6,188,1468,10,292,166,329,302,495,2424,4078,5,22973,1276,1,2,2,0,1
5163,136,2646,74,35,59,1,0,14,75,3,14,7,14,17,21,58,85,1,128,7,0,2,2,0,1
5164,136,2646,245,125,200,5,7,34,250,7,30,17,34,37,51,166,265,3,1053,58,0,2,2,0,1
5165,45,430,647,139,84,35,284,233,682,0,0,0,0,0,0,0,0,0,0,0,0,2,3,1,1
5166,26,1471,1457,730,1242,11,6,188,1468,10,292,166,329,302,495,2424,4078,5,22973,1276,1,2,11,1,1
5167,136,2649,1457,730,1242,11,6,188,1468,10,292,166,329,302,495,2424,4078,5,22973,1276,1,2,3,1,0
5168,136,2649,74,35,59,1,0,14,75,3,14,7,14,17,21,58,85,1,128,7,0,2,3,1,0
5169,136,2649,245,125,200,5,7,34,250,7,30,17,34,37,51,166,265,3,1053,58,0,2,3,1,0
5170,6,287,42,7,35,4,0,5,46,1,2,1,2,3,3,2,4,0,2,0,0,2,1,1,0
5171,6,287,11,6,10,0,0,1,11,2,4,2,4,6,6,10,15,1,15,0,0,2,1,1,0
5172,28,1508,1457,730,1242,11,6,188,1468,10,292,166,329,302,495,2424,4078,5,22973,1276,1,2,9,2,0
5173,136,2649,1457,730,1242,11,6,188,1468,10,292,166,329,302,495,2424,4078,5,22973,1276,1,2,1,1,1
5174,136,2649,74,35,59,1,0,14,75,3,14,7,14,17,21,58,85,1,128,7,0,2,1,1,1
5175,136,2649,245,125,200,5,7,34,250,7,30,17,34,37,51,166,265,3,1053,58,0,2,1,1,1
5176,45,430,647,139,84,35,284,233,682,0,0,0,0,0,0,0,0,0,0,0,0,2,1,1,1
5177,6,287,42,7,35,4,0,5,46,1,2,1,2,3,3,2,4,0,2,0,0,2,1,1,1
5178,6,287,11,6,10,0,0,1,11,2,4,2,4,6,6,10,15,1,15,0,0,2,1,1,1
5179,28,1508,1457,730,1242,11,6,188,1468,10,292,166,329,302,495,2424,4078,5,22973,1276,1,2,1,1,1
5180,43,862,1450,624,1228,12,26,181,1462,14,306,186,354,320,540,2580,4493,8,36391,2021,1,2,3,4,1
5181,40,1688,1289,550,1043,56,32,155,1345,10,167,93,185,177,278,1266,2075,5,11498,638,0,2,6,0,1
5182,27,999,1450,624,1228,12,26,181,1462,14,306,186,354,320,540,2580,4493,8,36391,2021,1,2,11,0,1
5183,47,952,1450,624,1228,12,26,181,1462,14,306,186,354,320,540,2580,4493,8,36391,2021,1,2,14,2,1
5184,56,977,282,196,195,3,0,86,285,8,130,71,141,138,212,936,1507,4,6538,363,0,2,16,0,1
5185,28,1028,1450,624,1228,12,26,181,1462,14,306,186,354,320,540,2580,4493,8,36391,2021,1,2,5,0,1
5186,1,84,13,10,10,0,0,3,13,1,2,1,2,3,3,2,4,0,2,0,0,2,1,1,1
5187,135,2612,1457,730,1242,11,6,188,1468,10,292,166,329,302,495,2424,4078,5,22973,1276,1,2,1,9,1
5188,135,2612,74,35,59,1,0,14,75,3,14,7,14,17,21,58,85,1,128,7,0,2,1,9,1
5189,135,2612,245,125,200,5,7,34,250,7,30,17,34,37,51,166,265,3,1053,58,0,2,1,9,1
5190,25,1227,652,304,544,16,6,88,668,6,89,51,101,95,152,591,998,3,3399,188,0,2,0,15,1
5191,6,287,42,7,35,4,0,5,46,1,2,1,2,3,3,2,4,0,2,0,0,2,1,1,1
5192,6,287,11,6,10,0,0,1,11,2,4,2,4,6,6,10,15,1,15,0,0,2,1,1,1
5193,9,312,424,94,331,4,0,89,428,1,5,5,5,6,10,11,25,0,12,0,0,2,21,18,1
5194,6,287,42,7,35,4,0,5,46,1,2,1,2,3,3,2,4,0,2,0,0,2,2,2,1
5195,6,287,11,6,10,0,0,1,11,2,4,2,4,6,6,10,15,1,15,0,0,2,2,2,1
5196,28,1028,1450,624,1228,12,26,181,1462,14,306,186,354,320,540,2580,4493,8,36391,2021,1,2,1,1,0
5197,41,991,74,35,59,1,0,14,75,3,14,7,14,17,21,58,85,1,128,7,0,2,19,0,1
5198,41,991,245,125,200,5,7,34,250,7,30,17,34,37,51,166,265,3,1053,58,0,2,19,0,1
5199,6,287,42,7,35,4,0,5,46,1,2,1,2,3,3,2,4,0,2,0,0,2,1,1,1
5200,6,287,11,6,10,0,0,1,11,2,4,2,4,6,6,10,15,1,15,0,0,2,1,1,1
5201,28,1512,1457,730,1242,11,6,188,1468,10,292,166,329,302,495,2424,4078,5,22973,1276,1,2,2,0,1
5202,9,271,74,35,59,1,0,14,75,3,14,7,14,17,21,58,85,1,128,7,0,2,12,1,1
5203,213,4608,72,33,56,0,4,12,72,1,1,1,1,2,2,0,2,0,1,0,0,2,5,2,1
5204,213,4608,1454,835,1044,76,110,219,1530,17,275,158,296,292,454,2297,3718,9,34017,1889,1,2,5,2,1
5205,132,3094,77,34,69,0,0,8,77,3,24,16,29,27,45,114,213,1,387,21,0,2,1,0,1
5206,132,3094,712,438,573,51,9,84,763,14,102,71,128,116,199,733,1364,8,11988,666,0,2,1,0,1
5207,213,4618,72,33,56,0,4,12,72,1,1,1,1,2,2,0,2,0,1,0,0,2,14,13,1
5208,213,4618,1454,835,1044,76,110,219,1530,17,275,158,296,292,454,2297,3718,9,34017,1889,1,2,14,13,1
5209,69,1220,1513,682,1277,25,13,200,1538,11,199,116,219,210,335,1557,2584,6,15641,868,0,2,9,3,1
5210,69,1220,819,519,539,24,98,155,843,15,96,57,106,111,163,690,1107,8,9171,509,0,2,9,3,1
5211,133,2620,1457,730,1242,11,6,188,1468,10,292,166,329,302,495,2424,4078,5,22973,1276,1,2,8,5,1
5212,133,2620,74,35,59,1,0,14,75,3,14,7,14,17,21,58,85,1,128,7,0,2,8,5,1
5213,133,2620,245,125,200,5,7,34,250,7,30,17,34,37,51,166,265,3,1053,58,0,2,8,5,1
5214,6,287,42,7,35,4,0,5,46,1,2,1,2,3,3,2,4,0,2,0,0,2,2,2,1
5215,6,287,11,6,10,0,0,1,11,2,4,2,4,6,6,10,15,1,15,0,0,2,2,2,1
5216,38,1602,1513,682,1277,25,13,200,1538,11,199,116,219,210,335,1557,2584,6,15641,868,0,2,34,0,1
5217,51,1024,1450,624,1228,12,26,181,1462,14,306,186,354,320,540,2580,4493,8,36391,2021,1,2,12,1,0
5218,28,1030,1450,624,1228,12,26,181,1462,14,306,186,354,320,540,2580,4493,8,36391,2021,1,2,1,2,0
5219,132,3097,77,34,69,0,0,8,77,3,24,16,29,27,45,114,213,1,387,21,0,2,1,1,1
5220,132,3097,712,438,573,51,9,84,763,14,102,71,128,116,199,733,1364,8,11988,666,0,2,1,1,1
5221,6,287,42,7,35,4,0,5,46,1,2,1,2,3,3,2,4,0,2,0,0,2,2,2,1
5222,6,287,11,6,10,0,0,1,11,2,4,2,4,6,6,10,15,1,15,0,0,2,2,2,1
5223,40,1725,1289,550,1043,56,32,155,1345,10,167,93,185,177,278,1266,2075,5,11498,638,0,2,6,0,1
5224,6,287,42,7,35,4,0,5,46,1,2,1,2,3,3,2,4,0,2,0,0,2,2,2,1
5225,6,287,11,6,10,0,0,1,11,2,4,2,4,6,6,10,15,1,15,0,0,2,2,2,1
5226,40,1725,1289,550,1043,56,32,155,1345,10,167,93,185,177,278,1266,2075,5,11498,638,0,2,1,1,1
5227,40,1725,1289,550,1043,56,32,155,1345,10,167,93,185,177,278,1266,2075,5,11498,638,0,2,1,1,0
5228,135,3145,77,34,69,0,0,8,77,3,24,16,29,27,45,114,213,1,387,21,0,2,6,0,1
5229,135,3145,712,438,573,51,9,84,763,14,102,71,128,116,199,733,1364,8,11988,666,0,2,6,0,1
5230,42,2947,1296,573,1062,40,33,157,1336,8,201,118,231,209,349,1561,2689,4,12365,686,0,2,15,0,1
5231,6,287,42,7,35,4,0,5,46,1,2,1,2,3,3,2,4,0,2,0,0,2,2,2,1
5232,6,287,11,6,10,0,0,1,11,2,4,2,4,6,6,10,15,1,15,0,0,2,2,2,1
5233,46,795,1020,354,843,12,15,144,1032,8,134,77,144,142,221,970,1580,4,6792,377,0,2,2,2,1
5234,213,4618,72,33,56,0,4,12,72,1,1,1,1,2,2,0,2,0,1,0,0,2,11,7,1
5235,213,4618,1454,835,1044,76,110,219,1530,17,275,158,296,292,454,2297,3718,9,34017,1889,1,2,11,7,1
5236,1,192,382,65,130,157,2,92,539,4,10,5,10,14,15,41,57,2,114,6,0,2,6,6,1
5237,51,1027,1450,624,1228,12,26,181,1462,14,306,186,354,320,540,2580,4493,8,36391,2021,1,2,2,2,1
5238,29,1054,1450,624,1228,12,26,181,1462,14,306,186,354,320,540,2580,4493,8,36391,2021,1,2,4,0,1
5239,153,2910,1943,715,1694,26,18,214,1969,12,185,120,237,197,357,1436,2721,7,20915,1161,0,2,1,1,0
5240,153,2910,1168,838,957,57,25,144,1225,19,348,224,416,367,640,3018,5452,11,61921,3440,1,2,1,1,0
5241,213,4618,72,33,56,0,4,12,72,1,1,1,1,2,2,0,2,0,1,0,0,2,4,5,1
5242,213,4618,1454,835,1044,76,110,219,1530,17,275,158,296,292,454,2297,3718,9,34017,1889,1,2,4,5,1
5243,6,287,42,7,35,4,0,5,46,1,2,1,2,3,3,2,4,0,2,0,0,2,1,1,1
5244,6,287,11,6,10,0,0,1,11,2,4,2,4,6,6,10,15,1,15,0,0,2,1,1,1
5245,77,1330,1178,367,1042,6,15,115,1184,9,94,51,95,103,146,644,976,4,4439,246,0,2,35,11,1
5246,77,1330,177,108,140,8,0,27,185,6,30,16,32,36,48,162,248,3,794,44,0,2,35,11,1
5247,6,287,42,7,35,4,0,5,46,1,2,1,2,3,3,2,4,0,2,0,0,2,2,2,1
5248,6,287,11,6,10,0,0,1,11,2,4,2,4,6,6,10,15,1,15,0,0,2,2,2,1
5249,31,1477,1178,367,1042,6,15,115,1184,9,94,51,95,103,146,644,976,4,4439,246,0,2,28,0,1
5250,79,1379,1178,367,1042,6,15,115,1184,9,94,51,95,103,146,644,976,4,4439,246,0,2,12,3,1
5251,79,1379,177,108,140,8,0,27,185,6,30,16,32,36,48,162,248,3,794,44,0,2,12,3,1
5252,6,81,38,23,23,0,0,15,38,0,0,0,0,0,0,0,0,0,0,0,0,2,4,0,1
5253,6,287,42,7,35,4,0,5,46,1,2,1,2,3,3,2,4,0,2,0,0,2,2,2,1
5254,6,287,11,6,10,0,0,1,11,2,4,2,4,6,6,10,15,1,15,0,0,2,2,2,1
5255,33,1542,1178,367,1042,6,15,115,1184,9,94,51,95,103,146,644,976,4,4439,246,0,2,30,0,1
5256,69,1220,1513,682,1277,25,13,200,1538,11,199,116,219,210,335,1557,2584,6,15641,868,0,2,6,8,1
5257,69,1220,819,519,539,24,98,155,843,15,96,57,106,111,163,690,1107,8,9171,509,0,2,6,8,1
5258,24,514,447,308,343,6,5,95,453,7,96,59,111,103,170,651,1136,4,4600,255,0,2,2,2,1
5259,24,514,322,174,179,16,74,51,338,10,41,26,46,51,72,252,408,5,2291,127,0,2,2,2,1
5260,18,462,386,256,301,16,9,68,402,4,59,35,69,63,104,355,621,2,1453,80,0,2,3,0,1
5261,18,462,264,131,164,11,41,46,275,6,38,22,40,44,62,214,338,3,1068,59,0,2,3,0,1
5262,12,359,442,244,305,14,16,103,456,11,68,45,75,79,120,452,756,6,4588,254,0,2,1,1,1
5263,12,359,182,102,99,11,40,35,193,3,11,6,11,14,17,42,64,1,97,5,0,2,1,1,1
5264,217,4664,72,33,56,0,4,12,72,1,1,1,1,2,2,0,2,0,1,0,0,2,15,6,1
5265,217,4664,1454,835,1044,76,110,219,1530,17,275,158,296,292,454,2297,3718,9,34017,1889,1,2,15,6,1
5266,6,287,42,7,35,4,0,5,46,1,2,1,2,3,3,2,4,0,2,0,0,2,1,1,1
5267,6,287,11,6,10,0,0,1,11,2,4,2,4,6,6,10,15,1,15,0,0,2,1,1,1
5268,137,3174,77,34,69,0,0,8,77,3,24,16,29,27,45,114,213,1,387,21,0,2,8,3,1
5269,137,3174,712,438,573,51,9,84,763,14,102,71,128,116,199,733,1364,8,11988,666,0,2,8,3,1
5270,217,4677,72,33,56,0,4,12,72,1,1,1,1,2,2,0,2,0,1,0,0,2,7,4,1
5271,217,4677,1454,835,1044,76,110,219,1530,17,275,158,296,292,454,2297,3718,9,34017,1889,1,2,7,4,1
5272,42,2917,1296,573,1062,40,33,157,1336,8,201,118,231,209,349,1561,2689,4,12365,686,0,2,0,5,1
5273,217,4674,72,33,56,0,4,12,72,1,1,1,1,2,2,0,2,0,1,0,0,2,1,1,0
5274,217,4674,1454,835,1044,76,110,219,1530,17,275,158,296,292,454,2297,3718,9,34017,1889,1,2,1,1,0
5275,33,1551,1178,367,1042,6,15,115,1184,9,94,51,95,103,146,644,976,4,4439,246,0,2,1,0,1
5276,47,903,1098,241,925,5,10,155,1103,7,46,25,49,53,74,273,423,3,1580,87,0,2,4,0,1
5277,47,903,282,202,222,14,2,44,296,8,42,24,43,50,67,250,378,4,1548,86,0,2,4,0,1
5278,20,782,1098,241,925,5,10,155,1103,7,46,25,49,53,74,273,423,3,1580,87,0,2,12,0,1
5279,6,287,42,7,35,4,0,5,46,1,2,1,2,3,3,2,4,0,2,0,0,2,1,1,1
5280,6,287,11,6,10,0,0,1,11,2,4,2,4,6,6,10,15,1,15,0,0,2,1,1,1
5281,217,4677,72,33,56,0,4,12,72,1,1,1,1,2,2,0,2,0,1,0,0,2,1,1,1
5282,217,4677,1454,835,1044,76,110,219,1530,17,275,158,296,292,454,2297,3718,9,34017,1889,1,2,1,1,1
5283,146,2815,1943,715,1694,26,18,214,1969,12,185,120,237,197,357,1436,2721,7,20915,1161,0,2,47,63,1
5284,146,2815,1168,838,957,57,25,144,1225,19,348,224,416,367,640,3018,5452,11,61921,3440,1,2,47,63,1
5285,6,287,42,7,35,4,0,5,46,1,2,1,2,3,3,2,4,0,2,0,0,2,1,1,1
5286,6,287,11,6,10,0,0,1,11,2,4,2,4,6,6,10,15,1,15,0,0,2,1,1,1
5287,40,1725,1289,550,1043,56,32,155,1345,10,167,93,185,177,278,1266,2075,5,11498,638,0,2,3,1,1
5288,43,2933,1296,573,1062,40,33,157,1336,8,201,118,231,209,349,1561,2689,4,12365,686,0,2,2,0,1
5289,51,2363,1943,715,1694,26,18,214,1969,12,185,120,237,197,357,1436,2721,7,20915,1161,0,2,28,47,1
5290,19,483,1293,570,1093,25,15,163,1318,10,195,123,241,205,364,1516,2795,6,17273,959,0,2,4,1,0
5291,6,287,42,7,35,4,0,5,46,1,2,1,2,3,3,2,4,0,2,0,0,2,1,1,0
5292,6,287,11,6,10,0,0,1,11,2,4,2,4,6,6,10,15,1,15,0,0,2,1,1,0
5293,38,958,74,35,59,1,0,14,75,3,14,7,14,17,21,58,85,1,128,7,0,2,3,8,1
5294,38,958,245,125,200,5,7,34,250,7,30,17,34,37,51,166,265,3,1053,58,0,2,3,8,1
5295,138,3212,77,34,69,0,0,8,77,3,24,16,29,27,45,114,213,1,387,21,0,2,7,1,1
5296,138,3212,712,438,573,51,9,84,763,14,102,71,128,116,199,733,1364,8,11988,666,0,2,7,1,1
5297,6,287,42,7,35,4,0,5,46,1,2,1,2,3,3,2,4,0,2,0,0,2,1,1,1
5298,6,287,11,6,10,0,0,1,11,2,4,2,4,6,6,10,15,1,15,0,0,2,1,1,1
5299,146,2822,1943,715,1694,26,18,214,1969,12,185,120,237,197,357,1436,2721,7,20915,1161,0,2,2,2,1
5300,146,2822,1168,838,957,57,25,144,1225,19,348,224,416,367,640,3018,5452,11,61921,3440,1,2,2,2,1
5301,52,2433,1943,715,1694,26,18,214,1969,12,185,120,237,197,357,1436,2721,7,20915,1161,0,2,16,1,1
5302,141,2820,1943,715,1694,26,18,214,1969,12,185,120,237,197,357,1436,2721,7,20915,1161,0,2,10,10,1
5303,141,2820,1168,838,957,57,25,144,1225,19,348,224,416,367,640,3018,5452,11,61921,3440,1,2,10,10,1
5304,6,287,42,7,35,4,0,5,46,1,2,1,2,3,3,2,4,0,2,0,0,2,1,1,1
5305,6,287,11,6,10,0,0,1,11,2,4,2,4,6,6,10,15,1,15,0,0,2,1,1,1
5306,87,1920,1043,504,840,53,9,147,1096,9,180,112,198,189,310,1377,2344,4,11604,644,0,2,1,1,0
5307,87,1920,383,288,292,26,6,62,409,11,65,38,67,76,105,429,656,5,3719,206,0,2,1,1,0
5308,6,287,42,7,35,4,0,5,46,1,2,1,2,3,3,2,4,0,2,0,0,2,2,2,0
5309,6,287,11,6,10,0,0,1,11,2,4,2,4,6,6,10,15,1,15,0,0,2,2,2,0
5310,6,287,42,7,35,4,0,5,46,1,2,1,2,3,3,2,4,0,2,0,0,2,2,2,1
5311,6,287,11,6,10,0,0,1,11,2,4,2,4,6,6,10,15,1,15,0,0,2,2,2,1
5312,215,4654,72,33,56,0,4,12,72,1,1,1,1,2,2,0,2,0,1,0,0,2,5,11,1
5313,215,4654,1454,835,1044,76,110,219,1530,17,275,158,296,292,454,2297,3718,9,34017,1889,1,2,5,11,1
5314,6,287,42,7,35,4,0,5,46,1,2,1,2,3,3,2,4,0,2,0,0,2,1,1,1
5315,6,287,11,6,10,0,0,1,11,2,4,2,4,6,6,10,15,1,15,0,0,2,1,1,1
5316,135,2677,1457,730,1242,11,6,188,1468,10,292,166,329,302,495,2424,4078,5,22973,1276,1,2,10,0,1
5317,135,2677,74,35,59,1,0,14,75,3,14,7,14,17,21,58,85,1,128,7,0,2,10,0,1
5318,135,2677,245,125,200,5,7,34,250,7,30,17,34,37,51,166,265,3,1053,58,0,2,10,0,1
5319,38,1068,1523,757,1297,19,12,193,1542,12,193,117,230,205,347,1508,2664,7,19053,1058,0,2,7,1,1
5320,38,1068,701,378,504,33,58,109,734,13,110,68,126,123,194,794,1346,7,10027,557,0,2,7,1,1
5321,6,287,42,7,35,4,0,5,46,1,2,1,2,3,3,2,4,0,2,0,0,2,1,1,1
5322,6,287,11,6,10,0,0,1,11,2,4,2,4,6,6,10,15,1,15,0,0,2,1,1,1
5323,20,1484,1523,757,1297,19,12,193,1542,12,193,117,230,205,347,1508,2664,7,19053,1058,0,2,20,0,1
5324,185,4301,722,423,573,19,0,135,741,12,172,101,199,184,300,1320,2257,6,15668,870,0,2,3,2,1
5325,185,4301,1508,847,911,44,250,301,1552,14,148,88,169,162,257,1120,1886,7,15077,837,0,2,3,2,1
5326,12,529,722,423,573,19,0,135,741,12,172,101,199,184,300,1320,2257,6,15668,870,0,2,10,0,1
5327,40,1244,1523,757,1297,19,12,193,1542,12,193,117,230,205,347,1508,2664,7,19053,1058,0,2,43,1,1
5328,40,1244,701,378,504,33,58,109,734,13,110,68,126,123,194,794,1346,7,10027,557,0,2,43,1,1
5329,28,1749,1523,757,1297,19,12,193,1542,12,193,117,230,205,347,1508,2664,7,19053,1058,0,2,68,0,1
5330,138,3216,77,34,69,0,0,8,77,3,24,16,29,27,45,114,213,1,387,21,0,2,1,1,1
5331,138,3216,712,438,573,51,9,84,763,14,102,71,128,116,199,733,1364,8,11988,666,0,2,1,1,1
5332,41,1799,1289,550,1043,56,32,155,1345,10,167,93,185,177,278,1266,2075,5,11498,638,0,2,20,0,1
5333,50,1020,1450,624,1228,12,26,181,1462,14,306,186,354,320,540,2580,4493,8,36391,2021,1,2,2,4,1
5334,137,2699,1457,730,1242,11,6,188,1468,10,292,166,329,302,495,2424,4078,5,22973,1276,1,2,6,1,1
5335,137,2699,74,35,59,1,0,14,75,3,14,7,14,17,21,58,85,1,128,7,0,2,6,1,1
5336,137,2699,245,125,200,5,7,34,250,7,30,17,34,37,51,166,265,3,1053,58,0,2,6,1,1
5337,11,351,442,244,305,14,16,103,456,11,68,45,75,79,120,452,756,6,4588,254,0,2,2,5,1
5338,11,351,182,102,99,11,40,35,193,3,11,6,11,14,17,42,64,1,97,5,0,2,2,5,1
5339,6,287,42,7,35,4,0,5,46,1,2,1,2,3,3,2,4,0,2,0,0,2,1,1,1
5340,6,287,11,6,10,0,0,1,11,2,4,2,4,6,6,10,15,1,15,0,0,2,1,1,1
5341,42,1842,1289,550,1043,56,32,155,1345,10,167,93,185,177,278,1266,2075,5,11498,638,0,2,13,0,1
5342,29,1058,1450,624,1228,12,26,181,1462,14,306,186,354,320,540,2580,4493,8,36391,2021,1,2,2,1,1
5343,6,287,42,7,35,4,0,5,46,1,2,1,2,3,3,2,4,0,2,0,0,2,1,1,0
5344,6,287,11,6,10,0,0,1,11,2,4,2,4,6,6,10,15,1,15,0,0,2,1,1,0
5345,1,162,382,65,130,157,2,92,539,4,10,5,10,14,15,41,57,2,114,6,0,2,1,1,0
5346,6,287,42,7,35,4,0,5,46,1,2,1,2,3,3,2,4,0,2,0,0,2,1,1,0
5347,6,287,11,6,10,0,0,1,11,2,4,2,4,6,6,10,15,1,15,0,0,2,1,1,0
5348,1,179,382,65,130,157,2,92,539,4,10,5,10,14,15,41,57,2,114,6,0,2,2,1,0
5349,6,287,42,7,35,4,0,5,46,1,2,1,2,3,3,2,4,0,2,0,0,2,1,1,0
5350,6,287,11,6,10,0,0,1,11,2,4,2,4,6,6,10,15,1,15,0,0,2,1,1,0
5351,46,437,647,139,84,35,284,233,682,0,0,0,0,0,0,0,0,0,0,0,0,2,3,0,0
5352,216,4677,72,33,56,0,4,12,72,1,1,1,1,2,2,0,2,0,1,0,0,2,13,8,0
5353,216,4677,1454,835,1044,76,110,219,1530,17,275,158,296,292,454,2297,3718,9,34017,1889,1,2,13,8,0
5354,6,287,42,7,35,4,0,5,46,1,2,1,2,3,3,2,4,0,2,0,0,2,1,1,1
5355,6,287,11,6,10,0,0,1,11,2,4,2,4,6,6,10,15,1,15,0,0,2,1,1,1
5356,57,2323,1660,832,1314,41,38,274,1701,20,312,209,395,332,604,2671,5058,12,64042,3557,1,0,295,0,1
5357,57,999,1660,832,1314,41,38,274,1701,20,312,209,395,332,604,2671,5058,12,64042,3557,1,0,195,0,1
5358,63,2372,1660,832,1314,41,38,274,1701,20,312,209,395,332,604,2671,5058,12,64042,3557,1,2,11,3,1
5359,62,1194,1660,832,1314,41,38,274,1701,20,312,209,395,332,604,2671,5058,12,64042,3557,1,2,26,2,1
5360,64,2382,1660,832,1314,41,38,274,1701,20,312,209,395,332,604,2671,5058,12,64042,3557,1,2,8,4,0
5361,63,2389,1660,832,1314,41,38,274,1701,20,312,209,395,332,604,2671,5058,12,64042,3557,1,2,8,5,0
5362,63,1225,1660,832,1314,41,38,274,1701,20,312,209,395,332,604,2671,5058,12,64042,3557,1,2,5,0,0
5363,63,2373,1660,832,1314,41,38,274,1701,20,312,209,395,332,604,2671,5058,12,64042,3557,1,2,0,2,0
5364,48,451,647,139,84,35,284,233,682,0,0,0,0,0,0,0,0,0,0,0,0,2,6,0,0
5365,217,4699,72,33,56,0,4,12,72,1,1,1,1,2,2,0,2,0,1,0,0,2,3,0,0
5366,217,4699,1454,835,1044,76,110,219,1530,17,275,158,296,292,454,2297,3718,9,34017,1889,1,2,3,0,0
5367,68,2438,1660,832,1314,41,38,274,1701,20,312,209,395,332,604,2671,5058,12,64042,3557,1,2,14,3,0
5368,60,1255,1450,624,1228,12,26,181,1462,14,306,186,354,320,540,2580,4493,8,36391,2021,1,2,56,0,0
5369,68,2414,1660,832,1314,41,38,274,1701,20,312,209,395,332,604,2671,5058,12,64042,3557,1,2,1,2,0
5370,69,2432,1660,832,1314,41,38,274,1701,20,312,209,395,332,604,2671,5058,12,64042,3557,1,2,4,1,0
5371,63,1270,1660,832,1314,41,38,274,1701,20,312,209,395,332,604,2671,5058,12,64042,3557,1,2,9,6,0
5372,69,2456,1660,832,1314,41,38,274,1701,20,312,209,395,332,604,2671,5058,12,64042,3557,1,2,5,2,1
5373,63,1306,1660,832,1314,41,38,274,1701,20,312,209,395,332,604,2671,5058,12,64042,3557,1,2,6,0,1
5374,69,2456,1660,832,1314,41,38,274,1701,20,312,209,395,332,604,2671,5058,12,64042,3557,1,2,2,2,0
5375,70,2461,1660,832,1314,41,38,274,1701,20,312,209,395,332,604,2671,5058,12,64042,3557,1,2,5,1,1
5376,64,1371,1660,832,1314,41,38,274,1701,20,312,209,395,332,604,2671,5058,12,64042,3557,1,2,8,0,1
5377,61,1266,1450,624,1228,12,26,181,1462,14,306,186,354,320,540,2580,4493,8,36391,2021,1,2,18,15,1
5378,30,1106,1450,624,1228,12,26,181,1462,14,306,186,354,320,540,2580,4493,8,36391,2021,1,2,7,0,0
5379,71,2472,1660,832,1314,41,38,274,1701,20,312,209,395,332,604,2671,5058,12,64042,3557,1,2,5,1,0
5380,70,1443,1660,832,1314,41,38,274,1701,20,312,209,395,332,604,2671,5058,12,64042,3557,1,2,14,0,0
5381,70,1449,1660,832,1314,41,38,274,1701,20,312,209,395,332,604,2671,5058,12,64042,3557,1,2,1,1,1
5382,71,2475,1660,832,1314,41,38,274,1701,20,312,209,395,332,604,2671,5058,12,64042,3557,1,2,1,1,0
5383,70,1452,1660,832,1314,41,38,274,1701,20,312,209,395,332,604,2671,5058,12,64042,3557,1,2,1,1,1
5384,217,4701,72,33,56,0,4,12,72,1,1,1,1,2,2,0,2,0,1,0,0,2,4,3,0
5385,217,4701,1454,835,1044,76,110,219,1530,17,275,158,296,292,454,2297,3718,9,34017,1889,1,2,4,3,0
5386,61,1268,2,2,2,0,0,0,2,0,0,0,0,0,0,0,0,0,0,0,0,3,1,1,0
5387,61,1268,99,48,90,1,3,5,100,0,0,0,0,0,0,0,0,0,0,0,0,3,1,1,0
5388,61,1268,8,5,5,2,0,1,10,0,0,0,0,0,0,0,0,0,0,0,0,3,1,1,0
5389,61,1268,1217,716,841,84,126,174,1301,14,185,118,215,199,333,1446,2542,8,20687,1149,0,3,1,1,0
5390,61,1268,160,89,115,0,13,31,160,7,15,11,17,22,28,78,124,3,495,27,0,3,1,1,0
5391,61,1268,10,10,9,9,0,0,19,0,0,0,0,0,0,0,0,0,0,0,0,3,1,1,0
5392,61,1268,173,84,99,8,29,36,181,5,12,7,13,17,20,54,81,2,221,12,0,3,1,1,0
5393,61,1268,3,1,1,3,0,0,6,0,0,0,0,0,0,0,0,0,0,0,0,3,1,1,0
5394,71,2475,1660,832,1314,41,38,274,1701,20,312,209,395,332,604,2671,5058,12,64042,3557,1,3,1,1,0
5395,71,2475,1057,646,719,113,100,145,1170,18,215,134,248,233,382,1740,3004,10,31186,1732,1,3,1,1,0
5396,70,1454,1660,832,1314,41,38,274,1701,20,312,209,395,332,604,2671,5058,12,64042,3557,1,2,1,1,0
5397,71,1528,2,2,2,0,0,0,2,0,0,0,0,0,0,0,0,0,0,0,0,2,51,3,1
5398,71,1528,99,48,90,1,3,5,100,0,0,0,0,0,0,0,0,0,0,0,0,2,51,3,1
5399,71,1528,8,5,5,2,0,1,10,0,0,0,0,0,0,0,0,0,0,0,0,2,51,3,1
5400,71,1528,1217,716,841,84,126,174,1301,14,185,118,215,199,333,1446,2542,8,20687,1149,0,2,51,3,1
5401,71,1528,160,89,115,0,13,31,160,7,15,11,17,22,28,78,124,3,495,27,0,2,51,3,1
5402,71,1528,10,10,9,9,0,0,19,0,0,0,0,0,0,0,0,0,0,0,0,2,51,3,1
5403,71,1528,173,84,99,8,29,36,181,5,12,7,13,17,20,54,81,2,221,12,0,2,51,3,1
5404,71,1528,3,1,1,3,0,0,6,0,0,0,0,0,0,0,0,0,0,0,0,2,51,3,1
5405,71,2478,1660,832,1314,41,38,274,1701,20,312,209,395,332,604,2671,5058,12,64042,3557,1,2,11,10,1
5406,71,2478,1057,646,719,113,100,145,1170,18,215,134,248,233,382,1740,3004,10,31186,1732,1,2,11,10,1
5407,30,1102,1450,624,1228,12,26,181,1462,14,306,186,354,320,540,2580,4493,8,36391,2021,1,2,6,5,1
5408,70,1450,1660,832,1314,41,38,274,1701,20,312,209,395,332,604,2671,5058,12,64042,3557,1,2,5,4,1
5409,20,449,2,2,2,0,0,0,2,0,0,0,0,0,0,0,0,0,0,0,0,2,3,185,1
5410,20,449,99,48,90,1,3,5,100,0,0,0,0,0,0,0,0,0,0,0,0,2,3,185,1
5411,20,449,8,5,5,2,0,1,10,0,0,0,0,0,0,0,0,0,0,0,0,2,3,185,1
5412,20,449,1217,716,841,84,126,174,1301,14,185,118,215,199,333,1446,2542,8,20687,1149,0,2,3,185,1
5413,20,449,160,89,115,0,13,31,160,7,15,11,17,22,28,78,124,3,495,27,0,2,3,185,1
5414,20,449,10,10,9,9,0,0,19,0,0,0,0,0,0,0,0,0,0,0,0,2,3,185,1
5415,20,449,173,84,99,8,29,36,181,5,12,7,13,17,20,54,81,2,221,12,0,2,3,185,1
5416,20,449,3,1,1,3,0,0,6,0,0,0,0,0,0,0,0,0,0,0,0,2,3,185,1
5417,71,2471,1660,832,1314,41,38,274,1701,20,312,209,395,332,604,2671,5058,12,64042,3557,1,2,10,10,1
5418,71,2471,1057,646,719,113,100,145,1170,18,215,134,248,233,382,1740,3004,10,31186,1732,1,2,10,10,1
5419,30,1104,1450,624,1228,12,26,181,1462,14,306,186,354,320,540,2580,4493,8,36391,2021,1,2,5,5,1
5420,70,1452,1660,832,1314,41,38,274,1701,20,312,209,395,332,604,2671,5058,12,64042,3557,1,2,11,11,1
5421,20,449,2,2,2,0,0,0,2,0,0,0,0,0,0,0,0,0,0,0,0,2,1,1,0
5422,20,449,99,48,90,1,3,5,100,0,0,0,0,0,0,0,0,0,0,0,0,2,1,1,0
5423,20,449,8,5,5,2,0,1,10,0,0,0,0,0,0,0,0,0,0,0,0,2,1,1,0
5424,20,449,1217,716,841,84,126,174,1301,14,185,118,215,199,333,1446,2542,8,20687,1149,0,2,1,1,0
5425,20,449,160,89,115,0,13,31,160,7,15,11,17,22,28,78,124,3,495,27,0,2,1,1,0
5426,20,449,10,10,9,9,0,0,19,0,0,0,0,0,0,0,0,0,0,0,0,2,1,1,0
5427,20,449,173,84,99,8,29,36,181,5,12,7,13,17,20,54,81,2,221,12,0,2,1,1,0
5428,20,449,3,1,1,3,0,0,6,0,0,0,0,0,0,0,0,0,0,0,0,2,1,1,0
5429,20,449,2,2,2,0,0,0,2,0,0,0,0,0,0,0,0,0,0,0,0,2,1,1,0
5430,20,449,99,48,90,1,3,5,100,0,0,0,0,0,0,0,0,0,0,0,0,2,1,1,0
5431,20,449,8,5,5,2,0,1,10,0,0,0,0,0,0,0,0,0,0,0,0,2,1,1,0
5432,20,449,1217,716,841,84,126,174,1301,14,185,118,215,199,333,1446,2542,8,20687,1149,0,2,1,1,0
5433,20,449,160,89,115,0,13,31,160,7,15,11,17,22,28,78,124,3,495,27,0,2,1,1,0
5434,20,449,10,10,9,9,0,0,19,0,0,0,0,0,0,0,0,0,0,0,0,2,1,1,0
5435,20,449,173,84,99,8,29,36,181,5,12,7,13,17,20,54,81,2,221,12,0,2,1,1,0
5436,20,449,3,1,1,3,0,0,6,0,0,0,0,0,0,0,0,0,0,0,0,2,1,1,0
5437,51,1084,477,336,357,30,23,73,507,16,194,134,250,210,384,1538,2962,10,30538,1696,0,0,191,0,1
5438,20,449,2,2,2,0,0,0,2,0,0,0,0,0,0,0,0,0,0,0,0,2,0,4,0
5439,20,449,99,48,90,1,3,5,100,0,0,0,0,0,0,0,0,0,0,0,0,2,0,4,0
5440,20,449,8,5,5,2,0,1,10,0,0,0,0,0,0,0,0,0,0,0,0,2,0,4,0
5441,20,449,1217,716,841,84,126,174,1301,14,185,118,215,199,333,1446,2542,8,20687,1149,0,2,0,4,0
5442,20,449,160,89,115,0,13,31,160,7,15,11,17,22,28,78,124,3,495,27,0,2,0,4,0
5443,20,449,10,10,9,9,0,0,19,0,0,0,0,0,0,0,0,0,0,0,0,2,0,4,0
5444,20,449,173,84,99,8,29,36,181,5,12,7,13,17,20,54,81,2,221,12,0,2,0,4,0
5445,20,449,3,1,1,3,0,0,6,0,0,0,0,0,0,0,0,0,0,0,0,2,0,4,0
5446,24,552,2,2,2,0,0,0,2,0,0,0,0,0,0,0,0,0,0,0,0,2,21,6,1
5447,24,552,99,48,90,1,3,5,100,0,0,0,0,0,0,0,0,0,0,0,0,2,21,6,1
5448,24,552,8,5,5,2,0,1,10,0,0,0,0,0,0,0,0,0,0,0,0,2,21,6,1
5449,24,552,1217,716,841,84,126,174,1301,14,185,118,215,199,333,1446,2542,8,20687,1149,0,2,21,6,1
5450,24,552,160,89,115,0,13,31,160,7,15,11,17,22,28,78,124,3,495,27,0,2,21,6,1
5451,24,552,10,10,9,9,0,0,19,0,0,0,0,0,0,0,0,0,0,0,0,2,21,6,1
5452,24,552,173,84,99,8,29,36,181,5,12,7,13,17,20,54,81,2,221,12,0,2,21,6,1
5453,24,552,3,1,1,3,0,0,6,0,0,0,0,0,0,0,0,0,0,0,0,2,21,6,1
5454,38,936,74,35,59,1,0,14,75,3,14,7,14,17,21,58,85,1,128,7,0,2,0,3,1
5455,38,936,245,125,200,5,7,34,250,7,30,17,34,37,51,166,265,3,1053,58,0,2,0,3,1
5456,34,1230,1450,624,1228,12,26,181,1462,14,306,186,354,320,540,2580,4493,8,36391,2021,1,2,25,3,1
5457,25,694,2,2,2,0,0,0,2,0,0,0,0,0,0,0,0,0,0,0,0,2,14,1,0
5458,25,694,99,48,90,1,3,5,100,0,0,0,0,0,0,0,0,0,0,0,0,2,14,1,0
5459,25,694,8,5,5,2,0,1,10,0,0,0,0,0,0,0,0,0,0,0,0,2,14,1,0
5460,25,694,1217,716,841,84,126,174,1301,14,185,118,215,199,333,1446,2542,8,20687,1149,0,2,14,1,0
5461,25,694,160,89,115,0,13,31,160,7,15,11,17,22,28,78,124,3,495,27,0,2,14,1,0
5462,25,694,10,10,9,9,0,0,19,0,0,0,0,0,0,0,0,0,0,0,0,2,14,1,0
5463,25,694,173,84,99,8,29,36,181,5,12,7,13,17,20,54,81,2,221,12,0,2,14,1,0
5464,25,694,3,1,1,3,0,0,6,0,0,0,0,0,0,0,0,0,0,0,0,2,14,1,0
5465,25,694,2,2,2,0,0,0,2,0,0,0,0,0,0,0,0,0,0,0,0,2,2,2,0
5466,25,694,99,48,90,1,3,5,100,0,0,0,0,0,0,0,0,0,0,0,0,2,2,2,0
5467,25,694,8,5,5,2,0,1,10,0,0,0,0,0,0,0,0,0,0,0,0,2,2,2,0
5468,25,694,1217,716,841,84,126,174,1301,14,185,118,215,199,333,1446,2542,8,20687,1149,0,2,2,2,0
5469,25,694,160,89,115,0,13,31,160,7,15,11,17,22,28,78,124,3,495,27,0,2,2,2,0
5470,25,694,10,10,9,9,0,0,19,0,0,0,0,0,0,0,0,0,0,0,0,2,2,2,0
5471,25,694,173,84,99,8,29,36,181,5,12,7,13,17,20,54,81,2,221,12,0,2,2,2,0
5472,25,694,3,1,1,3,0,0,6,0,0,0,0,0,0,0,0,0,0,0,0,2,2,2,0
5473,43,2933,1296,573,1062,40,33,157,1336,8,201,118,231,209,349,1561,2689,4,12365,686,0,2,7,7,0
5474,185,4381,722,423,573,19,0,135,741,12,172,101,199,184,300,1320,2257,6,15668,870,0,2,11,3,1
5475,185,4381,1508,847,911,44,250,301,1552,14,148,88,169,162,257,1120,1886,7,15077,837,0,2,11,3,1
5476,217,4703,72,33,56,0,4,12,72,1,1,1,1,2,2,0,2,0,1,0,0,2,2,2,1
5477,217,4703,1454,835,1044,76,110,219,1530,17,275,158,296,292,454,2297,3718,9,34017,1889,1,2,2,2,1
5478,86,1908,1043,504,840,53,9,147,1096,9,180,112,198,189,310,1377,2344,4,11604,644,0,2,10,12,1
5479,86,1908,383,288,292,26,6,62,409,11,65,38,67,76,105,429,656,5,3719,206,0,2,10,12,1
5480,26,708,2,2,2,0,0,0,2,0,0,0,0,0,0,0,0,0,0,0,0,2,4,5,0
5481,26,708,99,48,90,1,3,5,100,0,0,0,0,0,0,0,0,0,0,0,0,2,4,5,0
5482,26,708,8,5,5,2,0,1,10,0,0,0,0,0,0,0,0,0,0,0,0,2,4,5,0
5483,26,708,1217,716,841,84,126,174,1301,14,185,118,215,199,333,1446,2542,8,20687,1149,0,2,4,5,0
5484,26,708,160,89,115,0,13,31,160,7,15,11,17,22,28,78,124,3,495,27,0,2,4,5,0
5485,26,708,10,10,9,9,0,0,19,0,0,0,0,0,0,0,0,0,0,0,0,2,4,5,0
5486,26,708,173,84,99,8,29,36,181,5,12,7,13,17,20,54,81,2,221,12,0,2,4,5,0
5487,26,708,3,1,1,3,0,0,6,0,0,0,0,0,0,0,0,0,0,0,0,2,4,5,0
5488,43,2933,1296,573,1062,40,33,157,1336,8,201,118,231,209,349,1561,2689,4,12365,686,0,2,1,1,0
5489,185,4406,722,423,573,19,0,135,741,12,172,101,199,184,300,1320,2257,6,15668,870,0,2,2,0,0
5490,185,4406,1508,847,911,44,250,301,1552,14,148,88,169,162,257,1120,1886,7,15077,837,0,2,2,0,0
5491,185,4406,722,423,573,19,0,135,741,12,172,101,199,184,300,1320,2257,6,15668,870,0,2,1,1,0
5492,185,4406,1508,847,911,44,250,301,1552,14,148,88,169,162,257,1120,1886,7,15077,837,0,2,1,1,0
5493,49,458,647,139,84,35,284,233,682,0,0,0,0,0,0,0,0,0,0,0,0,2,3,0,0
5494,218,4722,72,33,56,0,4,12,72,1,1,1,1,2,2,0,2,0,1,0,0,2,4,1,0
5495,218,4722,1454,835,1044,76,110,219,1530,17,275,158,296,292,454,2297,3718,9,34017,1889,1,2,4,1,0
5496,50,465,647,139,84,35,284,233,682,0,0,0,0,0,0,0,0,0,0,0,0,2,3,0,0
5497,139,3230,77,34,69,0,0,8,77,3,24,16,29,27,45,114,213,1,387,21,0,2,4,1,0
5498,139,3230,712,438,573,51,9,84,763,14,102,71,128,116,199,733,1364,8,11988,666,0,2,4,1,0
5499,139,3237,77,34,69,0,0,8,77,3,24,16,29,27,45,114,213,1,387,21,0,2,2,1,1
5500,139,3237,712,438,573,51,9,84,763,14,102,71,128,116,199,733,1364,8,11988,666,0,2,2,1,1
5501,141,3267,77,34,69,0,0,8,77,3,24,16,29,27,45,114,213,1,387,21,0,2,12,5,1
5502,141,3267,712,438,573,51,9,84,763,14,102,71,128,116,199,733,1364,8,11988,666,0,2,12,5,1
5503,219,4731,72,33,56,0,4,12,72,1,1,1,1,2,2,0,2,0,1,0,0,2,4,2,1
5504,219,4731,1454,835,1044,76,110,219,1530,17,275,158,296,292,454,2297,3718,9,34017,1889,1,2,4,2,1
5505,49,458,647,139,84,35,284,233,682,0,0,0,0,0,0,0,0,0,0,0,0,2,0,3,1
5506,140,3253,77,34,69,0,0,8,77,3,24,16,29,27,45,114,213,1,387,21,0,2,1,4,1
5507,140,3253,712,438,573,51,9,84,763,14,102,71,128,116,199,733,1364,8,11988,666,0,2,1,4,1
5508,142,3276,77,34,69,0,0,8,77,3,24,16,29,27,45,114,213,1,387,21,0,2,11,6,1
5509,142,3276,712,438,573,51,9,84,763,14,102,71,128,116,199,733,1364,8,11988,666,0,2,11,6,1
5510,29,742,2,2,2,0,0,0,2,0,0,0,0,0,0,0,0,0,0,0,0,2,25,16,0
5511,29,742,99,48,90,1,3,5,100,0,0,0,0,0,0,0,0,0,0,0,0,2,25,16,0
5512,29,742,8,5,5,2,0,1,10,0,0,0,0,0,0,0,0,0,0,0,0,2,25,16,0
5513,29,742,1217,716,841,84,126,174,1301,14,185,118,215,199,333,1446,2542,8,20687,1149,0,2,25,16,0
5514,29,742,160,89,115,0,13,31,160,7,15,11,17,22,28,78,124,3,495,27,0,2,25,16,0
5515,29,742,10,10,9,9,0,0,19,0,0,0,0,0,0,0,0,0,0,0,0,2,25,16,0
5516,29,742,173,84,99,8,29,36,181,5,12,7,13,17,20,54,81,2,221,12,0,2,25,16,0
5517,29,742,3,1,1,3,0,0,6,0,0,0,0,0,0,0,0,0,0,0,0,2,25,16,0
5518,47,444,647,139,84,35,284,233,682,0,0,0,0,0,0,0,0,0,0,0,0,2,0,6,0
5519,218,4707,72,33,56,0,4,12,72,1,1,1,1,2,2,0,2,0,1,0,0,2,1,5,0
5520,218,4707,1454,835,1044,76,110,219,1530,17,275,158,296,292,454,2297,3718,9,34017,1889,1,2,1,5,0
5521,35,1250,1450,624,1228,12,26,181,1462,14,306,186,354,320,540,2580,4493,8,36391,2021,1,2,4,0,0
5522,29,742,2,2,2,0,0,0,2,0,0,0,0,0,0,0,0,0,0,0,0,2,5,1,1
5523,29,742,99,48,90,1,3,5,100,0,0,0,0,0,0,0,0,0,0,0,0,2,5,1,1
5524,29,742,8,5,5,2,0,1,10,0,0,0,0,0,0,0,0,0,0,0,0,2,5,1,1
5525,29,742,1217,716,841,84,126,174,1301,14,185,118,215,199,333,1446,2542,8,20687,1149,0,2,5,1,1
5526,29,742,160,89,115,0,13,31,160,7,15,11,17,22,28,78,124,3,495,27,0,2,5,1,1
5527,29,742,10,10,9,9,0,0,19,0,0,0,0,0,0,0,0,0,0,0,0,2,5,1,1
5528,29,742,173,84,99,8,29,36,181,5,12,7,13,17,20,54,81,2,221,12,0,2,5,1,1
5529,29,742,3,1,1,3,0,0,6,0,0,0,0,0,0,0,0,0,0,0,0,2,5,1,1
5530,29,742,2,2,2,0,0,0,2,0,0,0,0,0,0,0,0,0,0,0,0,2,2,2,0
5531,29,742,99,48,90,1,3,5,100,0,0,0,0,0,0,0,0,0,0,0,0,2,2,2,0
5532,29,742,8,5,5,2,0,1,10,0,0,0,0,0,0,0,0,0,0,0,0,2,2,2,0
5533,29,742,1217,716,841,84,126,174,1301,14,185,118,215,199,333,1446,2542,8,20687,1149,0,2,2,2,0
5534,29,742,160,89,115,0,13,31,160,7,15,11,17,22,28,78,124,3,495,27,0,2,2,2,0
5535,29,742,10,10,9,9,0,0,19,0,0,0,0,0,0,0,0,0,0,0,0,2,2,2,0
5536,29,742,173,84,99,8,29,36,181,5,12,7,13,17,20,54,81,2,221,12,0,2,2,2,0
5537,29,742,3,1,1,3,0,0,6,0,0,0,0,0,0,0,0,0,0,0,0,2,2,2,0
5538,72,2533,1660,832,1314,41,38,274,1701,20,312,209,395,332,604,2671,5058,12,64042,3557,1,2,8,1,1
5539,72,2533,1057,646,719,113,100,145,1170,18,215,134,248,233,382,1740,3004,10,31186,1732,1,2,8,1,1
5540,29,742,2,2,2,0,0,0,2,0,0,0,0,0,0,0,0,0,0,0,0,2,7,8,1
5541,29,742,99,48,90,1,3,5,100,0,0,0,0,0,0,0,0,0,0,0,0,2,7,8,1
5542,29,742,8,5,5,2,0,1,10,0,0,0,0,0,0,0,0,0,0,0,0,2,7,8,1
5543,29,742,1217,716,841,84,126,174,1301,14,185,118,215,199,333,1446,2542,8,20687,1149,0,2,7,8,1
5544,29,742,160,89,115,0,13,31,160,7,15,11,17,22,28,78,124,3,495,27,0,2,7,8,1
5545,29,742,10,10,9,9,0,0,19,0,0,0,0,0,0,0,0,0,0,0,0,2,7,8,1
5546,29,742,173,84,99,8,29,36,181,5,12,7,13,17,20,54,81,2,221,12,0,2,7,8,1
5547,29,742,3,1,1,3,0,0,6,0,0,0,0,0,0,0,0,0,0,0,0,2,7,8,1
5548,40,1258,1523,757,1297,19,12,193,1542,12,193,117,230,205,347,1508,2664,7,19053,1058,0,2,1,1,1
5549,40,1258,701,378,504,33,58,109,734,13,110,68,126,123,194,794,1346,7,10027,557,0,2,1,1,1
5550,29,1824,1523,757,1297,19,12,193,1542,12,193,117,230,205,347,1508,2664,7,19053,1058,0,2,14,1,1
5551,40,1252,1523,757,1297,19,12,193,1542,12,193,117,230,205,347,1508,2664,7,19053,1058,0,2,2,3,1
5552,40,1252,701,378,504,33,58,109,734,13,110,68,126,123,194,794,1346,7,10027,557,0,2,2,3,1
5553,6,287,42,7,35,4,0,5,46,1,2,1,2,3,3,2,4,0,2,0,0,2,1,1,1
5554,6,287,11,6,10,0,0,1,11,2,4,2,4,6,6,10,15,1,15,0,0,2,1,1,1
5555,30,1887,1523,757,1297,19,12,193,1542,12,193,117,230,205,347,1508,2664,7,19053,1058,0,2,12,0,1
5556,18,628,1455,414,1257,16,76,112,1471,5,41,23,46,46,69,231,381,2,1069,59,0,2,1,1,1
5557,18,628,669,365,481,22,61,110,691,15,103,63,122,118,185,747,1273,8,11311,628,0,2,1,1,1
5558,11,473,1455,414,1257,16,76,112,1471,5,41,23,46,46,69,231,381,2,1069,59,0,2,15,0,1
5559,40,1262,1523,757,1297,19,12,193,1542,12,193,117,230,205,347,1508,2664,7,19053,1058,0,2,2,1,1
5560,40,1262,701,378,504,33,58,109,734,13,110,68,126,123,194,794,1346,7,10027,557,0,2,2,1,1
5561,30,1873,1523,757,1297,19,12,193,1542,12,193,117,230,205,347,1508,2664,7,19053,1058,0,2,2,2,1
5562,6,287,42,7,35,4,0,5,46,1,2,1,2,3,3,2,4,0,2,0,0,2,2,2,0
5563,6,287,11,6,10,0,0,1,11,2,4,2,4,6,6,10,15,1,15,0,0,2,2,2,0
5564,30,1880,1523,757,1297,19,12,193,1542,12,193,117,230,205,347,1508,2664,7,19053,1058,0,2,1,1,0
5565,30,1887,1523,757,1297,19,12,193,1542,12,193,117,230,205,347,1508,2664,7,19053,1058,0,2,1,1,0
5566,30,1887,1523,757,1297,19,12,193,1542,12,193,117,230,205,347,1508,2664,7,19053,1058,0,2,1,1,0
5567,25,697,2,2,2,0,0,0,2,0,0,0,0,0,0,0,0,0,0,0,0,2,16,25,1
5568,25,697,99,48,90,1,3,5,100,0,0,0,0,0,0,0,0,0,0,0,0,2,16,25,1
5569,25,697,8,5,5,2,0,1,10,0,0,0,0,0,0,0,0,0,0,0,0,2,16,25,1
5570,25,697,1217,716,841,84,126,174,1301,14,185,118,215,199,333,1446,2542,8,20687,1149,0,2,16,25,1
5571,25,697,160,89,115,0,13,31,160,7,15,11,17,22,28,78,124,3,495,27,0,2,16,25,1
5572,25,697,10,10,9,9,0,0,19,0,0,0,0,0,0,0,0,0,0,0,0,2,16,25,1
5573,25,697,173,84,99,8,29,36,181,5,12,7,13,17,20,54,81,2,221,12,0,2,16,25,1
5574,25,697,3,1,1,3,0,0,6,0,0,0,0,0,0,0,0,0,0,0,0,2,16,25,1
5575,46,437,647,139,84,35,284,233,682,0,0,0,0,0,0,0,0,0,0,0,0,2,0,3,1
5576,218,4708,72,33,56,0,4,12,72,1,1,1,1,2,2,0,2,0,1,0,0,2,7,5,1
5577,218,4708,1454,835,1044,76,110,219,1530,17,275,158,296,292,454,2297,3718,9,34017,1889,1,2,7,5,1
5578,11,475,1455,414,1257,16,76,112,1471,5,41,23,46,46,69,231,381,2,1069,59,0,2,1,1,0
5579,25,697,2,2,2,0,0,0,2,0,0,0,0,0,0,0,0,0,0,0,0,0,128,0,1
5580,25,697,99,48,90,1,3,5,100,0,0,0,0,0,0,0,0,0,0,0,0,0,128,0,1
5581,25,697,8,5,5,2,0,1,10,0,0,0,0,0,0,0,0,0,0,0,0,0,128,0,1
5582,25,697,1217,716,841,84,126,174,1301,14,185,118,215,199,333,1446,2542,8,20687,1149,0,0,128,0,1
5583,25,697,160,89,115,0,13,31,160,7,15,11,17,22,28,78,124,3,495,27,0,0,128,0,1
5584,25,697,10,10,9,9,0,0,19,0,0,0,0,0,0,0,0,0,0,0,0,0,128,0,1
5585,25,697,173,84,99,8,29,36,181,5,12,7,13,17,20,54,81,2,221,12,0,0,128,0,1
5586,25,697,3,1,1,3,0,0,6,0,0,0,0,0,0,0,0,0,0,0,0,0,128,0,1
5587,72,2533,1660,832,1314,41,38,274,1701,20,312,209,395,332,604,2671,5058,12,64042,3557,1,0,340,0,1
5588,72,2533,1057,646,719,113,100,145,1170,18,215,134,248,233,382,1740,3004,10,31186,1732,1,0,340,0,1
5589,51,1084,477,336,357,30,23,73,507,16,194,134,250,210,384,1538,2962,10,30538,1696,0,3,54,40,1
5590,38,936,74,35,59,1,0,14,75,3,14,7,14,17,21,58,85,1,128,7,0,2,0,3,1
5591,38,936,245,125,200,5,7,34,250,7,30,17,34,37,51,166,265,3,1053,58,0,2,0,3,1
5592,142,3276,77,34,69,0,0,8,77,3,24,16,29,27,45,114,213,1,387,21,0,2,25,12,1
5593,142,3276,712,438,573,51,9,84,763,14,102,71,128,116,199,733,1364,8,11988,666,0,2,25,12,1
5594,185,4406,722,423,573,19,0,135,741,12,172,101,199,184,300,1320,2257,6,15668,870,0,2,14,4,1
5595,185,4406,1508,847,911,44,250,301,1552,14,148,88,169,162,257,1120,1886,7,15077,837,0,2,14,4,1
5596,218,4708,72,33,56,0,4,12,72,1,1,1,1,2,2,0,2,0,1,0,0,2,12,5,1
5597,218,4708,1454,835,1044,76,110,219,1530,17,275,158,296,292,454,2297,3718,9,34017,1889,1,2,12,5,1
5598,86,1908,1043,504,840,53,9,147,1096,9,180,112,198,189,310,1377,2344,4,11604,644,0,2,10,12,1
5599,86,1908,383,288,292,26,6,62,409,11,65,38,67,76,105,429,656,5,3719,206,0,2,10,12,1
5600,6,287,42,7,35,4,0,5,46,1,2,1,2,3,3,2,4,0,2,0,0,2,2,2,1
5601,6,287,11,6,10,0,0,1,11,2,4,2,4,6,6,10,15,1,15,0,0,2,2,2,1
5602,35,1250,1450,624,1228,12,26,181,1462,14,306,186,354,320,540,2580,4493,8,36391,2021,1,2,42,8,1
5603,70,1452,1660,832,1314,41,38,274,1701,20,312,209,395,332,604,2671,5058,12,64042,3557,1,0,256,0,1
5604,43,2933,1296,573,1062,40,33,157,1336,8,201,118,231,209,349,1561,2689,4,12365,686,0,2,8,8,1
5605,218,4708,72,33,56,0,4,12,72,1,1,1,1,2,2,0,2,0,1,0,0,2,1,1,0
5606,218,4708,1454,835,1044,76,110,219,1530,17,275,158,296,292,454,2297,3718,9,34017,1889,1,2,1,1,0
5607,6,288,42,7,35,4,0,5,46,1,2,1,2,3,3,2,4,0,2,0,0,2,2,2,0
5608,6,288,11,6,10,0,0,1,11,2,4,2,4,6,6,10,15,1,15,0,0,2,2,2,0
5609,6,288,42,7,35,4,0,5,46,1,2,1,2,3,3,2,4,0,2,0,0,2,4,4,1
5610,6,288,11,6,10,0,0,1,11,2,4,2,4,6,6,10,15,1,15,0,0,2,4,4,1
5611,46,795,1020,354,843,12,15,144,1032,8,134,77,144,142,221,970,1580,4,6792,377,0,2,1,1,1
5612,36,1391,1020,354,843,12,15,144,1032,8,134,77,144,142,221,970,1580,4,6792,377,0,2,5,0,1
5613,144,3295,77,34,69,0,0,8,77,3,24,16,29,27,45,114,213,1,387,21,0,2,8,3,1
5614,144,3295,712,438,573,51,9,84,763,14,102,71,128,116,199,733,1364,8,11988,666,0,2,8,3,1
5615,43,1893,1289,550,1043,56,32,155,1345,10,167,93,185,177,278,1266,2075,5,11498,638,0,2,13,0,1
5616,45,430,647,139,84,35,284,233,682,0,0,0,0,0,0,0,0,0,0,0,0,2,0,3,1
5617,217,4685,72,33,56,0,4,12,72,1,1,1,1,2,2,0,2,0,1,0,0,2,8,13,1
5618,217,4685,1454,835,1044,76,110,219,1530,17,275,158,296,292,454,2297,3718,9,34017,1889,1,2,8,13,1
5619,6,288,42,7,35,4,0,5,46,1,2,1,2,3,3,2,4,0,2,0,0,2,2,2,1
5620,6,288,11,6,10,0,0,1,11,2,4,2,4,6,6,10,15,1,15,0,0,2,2,2,1
5621,25,697,2,2,2,0,0,0,2,0,0,0,0,0,0,0,0,0,0,0,0,2,2,2,0
5622,25,697,99,48,90,1,3,5,100,0,0,0,0,0,0,0,0,0,0,0,0,2,2,2,0
5623,25,697,8,5,5,2,0,1,10,0,0,0,0,0,0,0,0,0,0,0,0,2,2,2,0
5624,25,697,1217,716,841,84,126,174,1301,14,185,118,215,199,333,1446,2542,8,20687,1149,0,2,2,2,0
5625,25,697,160,89,115,0,13,31,160,7,15,11,17,22,28,78,124,3,495,27,0,2,2,2,0
5626,25,697,10,10,9,9,0,0,19,0,0,0,0,0,0,0,0,0,0,0,0,2,2,2,0
5627,25,697,173,84,99,8,29,36,181,5,12,7,13,17,20,54,81,2,221,12,0,2,2,2,0
5628,25,697,3,1,1,3,0,0,6,0,0,0,0,0,0,0,0,0,0,0,0,2,2,2,0
5629,43,1893,1289,550,1043,56,32,155,1345,10,167,93,185,177,278,1266,2075,5,11498,638,0,2,1,1,1
5630,52,2433,1943,715,1694,26,18,214,1969,12,185,120,237,197,357,1436,2721,7,20915,1161,0,2,1,1,1
5631,58,1208,477,336,357,30,23,73,507,16,194,134,250,210,384,1538,2962,10,30538,1696,0,2,22,0,1
5632,70,1452,1660,832,1314,41,38,274,1701,20,312,209,395,332,604,2671,5058,12,64042,3557,1,2,6,12,1
5633,72,2533,1660,832,1314,41,38,274,1701,20,312,209,395,332,604,2671,5058,12,64042,3557,1,2,2,2,1
5634,72,2533,1057,646,719,113,100,145,1170,18,215,134,248,233,382,1740,3004,10,31186,1732,1,2,2,2,1
5635,71,1508,1660,832,1314,41,38,274,1701,20,312,209,395,332,604,2671,5058,12,64042,3557,1,2,7,0,1
5636,75,2768,1660,832,1314,41,38,274,1701,20,312,209,395,332,604,2671,5058,12,64042,3557,1,2,52,27,1
5637,75,2768,1057,646,719,113,100,145,1170,18,215,134,248,233,382,1740,3004,10,31186,1732,1,2,52,27,1
5638,75,1550,1660,832,1314,41,38,274,1701,20,312,209,395,332,604,2671,5058,12,64042,3557,1,2,8,1,1
5639,75,2763,1660,832,1314,41,38,274,1701,20,312,209,395,332,604,2671,5058,12,64042,3557,1,2,2,2,0
5640,75,2763,1057,646,719,113,100,145,1170,18,215,134,248,233,382,1740,3004,10,31186,1732,1,2,2,2,0
5641,27,581,2,2,2,0,0,0,2,0,0,0,0,0,0,0,0,0,0,0,0,2,45,64,1
5642,27,581,99,48,90,1,3,5,100,0,0,0,0,0,0,0,0,0,0,0,0,2,45,64,1
5643,27,581,8,5,5,2,0,1,10,0,0,0,0,0,0,0,0,0,0,0,0,2,45,64,1
5644,27,581,1217,716,841,84,126,174,1301,14,185,118,215,199,333,1446,2542,8,20687,1149,0,2,45,64,1
5645,27,581,160,89,115,0,13,31,160,7,15,11,17,22,28,78,124,3,495,27,0,2,45,64,1
5646,27,581,10,10,9,9,0,0,19,0,0,0,0,0,0,0,0,0,0,0,0,2,45,64,1
5647,27,581,173,84,99,8,29,36,181,5,12,7,13,17,20,54,81,2,221,12,0,2,45,64,1
5648,27,581,3,1,1,3,0,0,6,0,0,0,0,0,0,0,0,0,0,0,0,2,45,64,1
5649,111,3586,1660,832,1314,41,38,274,1701,20,312,209,395,332,604,2671,5058,12,64042,3557,1,2,161,0,1
5650,111,3586,1057,646,719,113,100,145,1170,18,215,134,248,233,382,1740,3004,10,31186,1732,1,2,161,0,1
5651,216,4665,72,33,56,0,4,12,72,1,1,1,1,2,2,0,2,0,1,0,0,2,1,6,1
5652,216,4665,1454,835,1044,76,110,219,1530,17,275,158,296,292,454,2297,3718,9,34017,1889,1,2,1,6,1
5653,35,1267,1450,624,1228,12,26,181,1462,14,306,186,354,320,540,2580,4493,8,36391,2021,1,2,3,2,1
5654,27,581,2,2,2,0,0,0,2,0,0,0,0,0,0,0,0,0,0,0,0,2,12,12,1
5655,27,581,99,48,90,1,3,5,100,0,0,0,0,0,0,0,0,0,0,0,0,2,12,12,1
5656,27,581,8,5,5,2,0,1,10,0,0,0,0,0,0,0,0,0,0,0,0,2,12,12,1
5657,27,581,1217,716,841,84,126,174,1301,14,185,118,215,199,333,1446,2542,8,20687,1149,0,2,12,12,1
5658,27,581,160,89,115,0,13,31,160,7,15,11,17,22,28,78,124,3,495,27,0,2,12,12,1
5659,27,581,10,10,9,9,0,0,19,0,0,0,0,0,0,0,0,0,0,0,0,2,12,12,1
5660,27,581,173,84,99,8,29,36,181,5,12,7,13,17,20,54,81,2,221,12,0,2,12,12,1
5661,27,581,3,1,1,3,0,0,6,0,0,0,0,0,0,0,0,0,0,0,0,2,12,12,1
5662,35,1267,1450,624,1228,12,26,181,1462,14,306,186,354,320,540,2580,4493,8,36391,2021,1,2,2,2,1
5663,111,3593,1660,832,1314,41,38,274,1701,20,312,209,395,332,604,2671,5058,12,64042,3557,1,2,1,0,0
5664,111,3593,1057,646,719,113,100,145,1170,18,215,134,248,233,382,1740,3004,10,31186,1732,1,2,1,0,0
5665,35,1267,1450,624,1228,12,26,181,1462,14,306,186,354,320,540,2580,4493,8,36391,2021,1,2,1,1,0
5666,111,3596,1660,832,1314,41,38,274,1701,20,312,209,395,332,604,2671,5058,12,64042,3557,1,2,1,1,0
5667,111,3596,1057,646,719,113,100,145,1170,18,215,134,248,233,382,1740,3004,10,31186,1732,1,2,1,1,0
5668,110,3591,1660,832,1314,41,38,274,1701,20,312,209,395,332,604,2671,5058,12,64042,3557,1,2,4,7,0
5669,110,3591,1057,646,719,113,100,145,1170,18,215,134,248,233,382,1740,3004,10,31186,1732,1,2,4,7,0
5670,35,1269,1450,624,1228,12,26,181,1462,14,306,186,354,320,540,2580,4493,8,36391,2021,1,2,6,3,0
5671,27,578,2,2,2,0,0,0,2,0,0,0,0,0,0,0,0,0,0,0,0,2,5,4,1
5672,27,578,99,48,90,1,3,5,100,0,0,0,0,0,0,0,0,0,0,0,0,2,5,4,1
5673,27,578,8,5,5,2,0,1,10,0,0,0,0,0,0,0,0,0,0,0,0,2,5,4,1
5674,27,578,1217,716,841,84,126,174,1301,14,185,118,215,199,333,1446,2542,8,20687,1149,0,2,5,4,1
5675,27,578,160,89,115,0,13,31,160,7,15,11,17,22,28,78,124,3,495,27,0,2,5,4,1
5676,27,578,10,10,9,9,0,0,19,0,0,0,0,0,0,0,0,0,0,0,0,2,5,4,1
5677,27,578,173,84,99,8,29,36,181,5,12,7,13,17,20,54,81,2,221,12,0,2,5,4,1
5678,27,578,3,1,1,3,0,0,6,0,0,0,0,0,0,0,0,0,0,0,0,2,5,4,1
5679,6,288,42,7,35,4,0,5,46,1,2,1,2,3,3,2,4,0,2,0,0,2,1,1,1
5680,6,288,11,6,10,0,0,1,11,2,4,2,4,6,6,10,15,1,15,0,0,2,1,1,1
5681,35,1271,1450,624,1228,12,26,181,1462,14,306,186,354,320,540,2580,4493,8,36391,2021,1,2,1,0,1
5682,25,553,2,2,2,0,0,0,2,0,0,0,0,0,0,0,0,0,0,0,0,2,13,16,1
5683,25,553,99,48,90,1,3,5,100,0,0,0,0,0,0,0,0,0,0,0,0,2,13,16,1
5684,25,553,8,5,5,2,0,1,10,0,0,0,0,0,0,0,0,0,0,0,0,2,13,16,1
5685,25,553,1217,716,841,84,126,174,1301,14,185,118,215,199,333,1446,2542,8,20687,1149,0,2,13,16,1
5686,25,553,160,89,115,0,13,31,160,7,15,11,17,22,28,78,124,3,495,27,0,2,13,16,1
5687,25,553,10,10,9,9,0,0,19,0,0,0,0,0,0,0,0,0,0,0,0,2,13,16,1
5688,25,553,173,84,99,8,29,36,181,5,12,7,13,17,20,54,81,2,221,12,0,2,13,16,1
5689,25,553,3,1,1,3,0,0,6,0,0,0,0,0,0,0,0,0,0,0,0,2,13,16,1
5690,6,288,42,7,35,4,0,5,46,1,2,1,2,3,3,2,4,0,2,0,0,2,1,1,1
5691,6,288,11,6,10,0,0,1,11,2,4,2,4,6,6,10,15,1,15,0,0,2,1,1,1
5692,33,1221,1450,624,1228,12,26,181,1462,14,306,186,354,320,540,2580,4493,8,36391,2021,1,2,7,13,1
5693,25,553,2,2,2,0,0,0,2,0,0,0,0,0,0,0,0,0,0,0,0,2,4,1,0
5694,25,553,99,48,90,1,3,5,100,0,0,0,0,0,0,0,0,0,0,0,0,2,4,1,0
5695,25,553,8,5,5,2,0,1,10,0,0,0,0,0,0,0,0,0,0,0,0,2,4,1,0
5696,25,553,1217,716,841,84,126,174,1301,14,185,118,215,199,333,1446,2542,8,20687,1149,0,2,4,1,0
5697,25,553,160,89,115,0,13,31,160,7,15,11,17,22,28,78,124,3,495,27,0,2,4,1,0
5698,25,553,10,10,9,9,0,0,19,0,0,0,0,0,0,0,0,0,0,0,0,2,4,1,0
5699,25,553,173,84,99,8,29,36,181,5,12,7,13,17,20,54,81,2,221,12,0,2,4,1,0
5700,25,553,3,1,1,3,0,0,6,0,0,0,0,0,0,0,0,0,0,0,0,2,4,1,0
5701,6,288,42,7,35,4,0,5,46,1,2,1,2,3,3,2,4,0,2,0,0,2,1,1,0
5702,6,288,11,6,10,0,0,1,11,2,4,2,4,6,6,10,15,1,15,0,0,2,1,1,0
5703,111,3633,1660,832,1314,41,38,274,1701,20,312,209,395,332,604,2671,5058,12,64042,3557,1,2,8,2,0
5704,111,3633,1057,646,719,113,100,145,1170,18,215,134,248,233,382,1740,3004,10,31186,1732,1,2,8,2,0
5705,6,288,42,7,35,4,0,5,46,1,2,1,2,3,3,2,4,0,2,0,0,2,2,2,1
5706,6,288,11,6,10,0,0,1,11,2,4,2,4,6,6,10,15,1,15,0,0,2,2,2,1
5707,17,283,424,94,331,4,0,89,428,1,5,5,5,6,10,11,25,0,12,0,0,2,1,0,1
5708,17,283,38,23,23,6,0,8,44,3,11,7,11,14,18,42,68,1,102,5,0,2,1,0,1
5709,6,288,42,7,35,4,0,5,46,1,2,1,2,3,3,2,4,0,2,0,0,2,1,1,1
5710,6,288,11,6,10,0,0,1,11,2,4,2,4,6,6,10,15,1,15,0,0,2,1,1,1
5711,10,342,424,94,331,4,0,89,428,1,5,5,5,6,10,11,25,0,12,0,0,2,16,0,1
5712,141,2829,1943,715,1694,26,18,214,1969,12,185,120,237,197,357,1436,2721,7,20915,1161,0,2,1,1,0
5713,141,2829,1168,838,957,57,25,144,1225,19,348,224,416,367,640,3018,5452,11,61921,3440,1,2,1,1,0
5714,6,288,42,7,35,4,0,5,46,1,2,1,2,3,3,2,4,0,2,0,0,2,1,1,0
5715,6,288,11,6,10,0,0,1,11,2,4,2,4,6,6,10,15,1,15,0,0,2,1,1,0
5716,1,189,382,65,130,157,2,92,539,4,10,5,10,14,15,41,57,2,114,6,0,2,6,6,0
5717,1,187,382,65,130,157,2,92,539,4,10,5,10,14,15,41,57,2,114,6,0,2,1,2,0
5718,6,288,42,7,35,4,0,5,46,1,2,1,2,3,3,2,4,0,2,0,0,2,4,2,0
5719,6,288,11,6,10,0,0,1,11,2,4,2,4,6,6,10,15,1,15,0,0,2,4,2,0
5720,1,187,382,65,130,157,2,92,539,4,10,5,10,14,15,41,57,2,114,6,0,2,2,2,1
5721,23,509,2,2,2,0,0,0,2,0,0,0,0,0,0,0,0,0,0,0,0,2,0,5,1
5722,23,509,99,48,90,1,3,5,100,0,0,0,0,0,0,0,0,0,0,0,0,2,0,5,1
5723,23,509,8,5,5,2,0,1,10,0,0,0,0,0,0,0,0,0,0,0,0,2,0,5,1
5724,23,509,1217,716,841,84,126,174,1301,14,185,118,215,199,333,1446,2542,8,20687,1149,0,2,0,5,1
5725,23,509,160,89,115,0,13,31,160,7,15,11,17,22,28,78,124,3,495,27,0,2,0,5,1
5726,23,509,10,10,9,9,0,0,19,0,0,0,0,0,0,0,0,0,0,0,0,2,0,5,1
5727,23,509,173,84,99,8,29,36,181,5,12,7,13,17,20,54,81,2,221,12,0,2,0,5,1
5728,23,509,3,1,1,3,0,0,6,0,0,0,0,0,0,0,0,0,0,0,0,2,0,5,1
5729,109,3599,1660,832,1314,41,38,274,1701,20,312,209,395,332,604,2671,5058,12,64042,3557,1,2,81,66,1
5730,109,3599,1057,646,719,113,100,145,1170,18,215,134,248,233,382,1740,3004,10,31186,1732,1,2,81,66,1
5731,32,1156,1450,624,1228,12,26,181,1462,14,306,186,354,320,540,2580,4493,8,36391,2021,1,2,0,8,1
5732,1,187,382,65,130,157,2,92,539,4,10,5,10,14,15,41,57,2,114,6,0,2,2,2,0
5733,6,288,42,7,35,4,0,5,46,1,2,1,2,3,3,2,4,0,2,0,0,2,4,2,0
5734,6,288,11,6,10,0,0,1,11,2,4,2,4,6,6,10,15,1,15,0,0,2,4,2,0
5735,109,3605,1660,832,1314,41,38,274,1701,20,312,209,395,332,604,2671,5058,12,64042,3557,1,2,1,1,1
5736,109,3605,1057,646,719,113,100,145,1170,18,215,134,248,233,382,1740,3004,10,31186,1732,1,2,1,1,1
5737,10,333,295,56,236,0,4,54,295,2,9,5,10,11,15,30,51,1,57,3,0,2,1,1,0
5738,143,2852,1943,715,1694,26,18,214,1969,12,185,120,237,197,357,1436,2721,7,20915,1161,0,2,5,0,1
5739,143,2852,1168,838,957,57,25,144,1225,19,348,224,416,367,640,3018,5452,11,61921,3440,1,2,5,0,1
5740,53,2478,1943,715,1694,26,18,214,1969,12,185,120,237,197,357,1436,2721,7,20915,1161,0,2,13,0,1
5741,6,288,42,7,35,4,0,5,46,1,2,1,2,3,3,2,4,0,2,0,0,2,2,2,1
5742,6,288,11,6,10,0,0,1,11,2,4,2,4,6,6,10,15,1,15,0,0,2,2,2,1
5743,1,184,382,65,130,157,2,92,539,4,10,5,10,14,15,41,57,2,114,6,0,2,3,4,0
5744,6,288,42,7,35,4,0,5,46,1,2,1,2,3,3,2,4,0,2,0,0,2,1,1,0
5745,6,288,11,6,10,0,0,1,11,2,4,2,4,6,6,10,15,1,15,0,0,2,1,1,0
5746,6,288,42,7,35,4,0,5,46,1,2,1,2,3,3,2,4,0,2,0,0,2,2,3,1
5747,6,288,11,6,10,0,0,1,11,2,4,2,4,6,6,10,15,1,15,0,0,2,2,3,1
5748,110,3625,1660,832,1314,41,38,274,1701,20,312,209,395,332,604,2671,5058,12,64042,3557,1,2,10,5,1
5749,110,3625,1057,646,719,113,100,145,1170,18,215,134,248,233,382,1740,3004,10,31186,1732,1,2,10,5,1
5750,110,3649,1660,832,1314,41,38,274,1701,20,312,209,395,332,604,2671,5058,12,64042,3557,1,2,8,2,0
5751,110,3649,1057,646,719,113,100,145,1170,18,215,134,248,233,382,1740,3004,10,31186,1732,1,2,8,2,0
5752,6,298,42,7,35,4,0,5,46,1,2,1,2,3,3,2,4,0,2,0,0,2,7,3,1
5753,6,298,11,6,10,0,0,1,11,2,4,2,4,6,6,10,15,1,15,0,0,2,7,3,1
5754,6,286,42,7,35,4,0,5,46,1,2,1,2,3,3,2,4,0,2,0,0,2,0,2,0
5755,6,286,11,6,10,0,0,1,11,2,4,2,4,6,6,10,15,1,15,0,0,2,0,2,0
5756,110,3652,1660,832,1314,41,38,274,1701,20,312,209,395,332,604,2671,5058,12,64042,3557,1,2,1,1,0
5757,110,3652,1057,646,719,113,100,145,1170,18,215,134,248,233,382,1740,3004,10,31186,1732,1,2,1,1,0
5758,79,1590,1660,832,1314,41,38,274,1701,20,312,209,395,332,604,2671,5058,12,64042,3557,1,2,6,0,0
5759,78,1584,1660,832,1314,41,38,274,1701,20,312,209,395,332,604,2671,5058,12,64042,3557,1,2,0,2,0
5760,6,286,42,7,35,4,0,5,46,1,2,1,2,3,3,2,4,0,2,0,0,2,2,2,1
5761,6,286,11,6,10,0,0,1,11,2,4,2,4,6,6,10,15,1,15,0,0,2,2,2,1
5762,110,3652,1660,832,1314,41,38,274,1701,20,312,209,395,332,604,2671,5058,12,64042,3557,1,2,1,1,0
5763,110,3652,1057,646,719,113,100,145,1170,18,215,134,248,233,382,1740,3004,10,31186,1732,1,2,1,1,0
5764,6,286,42,7,35,4,0,5,46,1,2,1,2,3,3,2,4,0,2,0,0,2,2,2,0
5765,6,286,11,6,10,0,0,1,11,2,4,2,4,6,6,10,15,1,15,0,0,2,2,2,0
5766,78,1584,1660,832,1314,41,38,274,1701,20,312,209,395,332,604,2671,5058,12,64042,3557,1,2,4,0,0
5767,68,1200,1513,682,1277,25,13,200,1538,11,199,116,219,210,335,1557,2584,6,15641,868,0,2,1,4,1
5768,68,1200,819,519,539,24,98,155,843,15,96,57,106,111,163,690,1107,8,9171,509,0,2,1,4,1
5769,42,1319,1523,757,1297,19,12,193,1542,12,193,117,230,205,347,1508,2664,7,19053,1058,0,2,10,2,1
5770,42,1319,701,378,504,33,58,109,734,13,110,68,126,123,194,794,1346,7,10027,557,0,2,10,2,1
5771,86,1940,1043,504,840,53,9,147,1096,9,180,112,198,189,310,1377,2344,4,11604,644,0,2,8,2,1
5772,86,1940,383,288,292,26,6,62,409,11,65,38,67,76,105,429,656,5,3719,206,0,2,8,2,1
5773,146,2909,1943,715,1694,26,18,214,1969,12,185,120,237,197,357,1436,2721,7,20915,1161,0,2,10,2,1
5774,146,2909,1168,838,957,57,25,144,1225,19,348,224,416,367,640,3018,5452,11,61921,3440,1,2,10,2,1
5775,6,286,42,7,35,4,0,5,46,1,2,1,2,3,3,2,4,0,2,0,0,2,2,2,1
5776,6,286,11,6,10,0,0,1,11,2,4,2,4,6,6,10,15,1,15,0,0,2,2,2,1
5777,30,1925,1523,757,1297,19,12,193,1542,12,193,117,230,205,347,1508,2664,7,19053,1058,0,2,12,1,1
5778,54,2487,1943,715,1694,26,18,214,1969,12,185,120,237,197,357,1436,2721,7,20915,1161,0,2,7,4,1
5779,113,3706,1660,832,1314,41,38,274,1701,20,312,209,395,332,604,2671,5058,12,64042,3557,1,2,19,9,1
5780,113,3706,1057,646,719,113,100,145,1170,18,215,134,248,233,382,1740,3004,10,31186,1732,1,2,19,9,1
5781,79,1630,1660,832,1314,41,38,274,1701,20,312,209,395,332,604,2671,5058,12,64042,3557,1,2,11,0,1
5782,42,1306,1523,757,1297,19,12,193,1542,12,193,117,230,205,347,1508,2664,7,19053,1058,0,2,4,6,1
5783,42,1306,701,378,504,33,58,109,734,13,110,68,126,123,194,794,1346,7,10027,557,0,2,4,6,1
5784,6,286,42,7,35,4,0,5,46,1,2,1,2,3,3,2,4,0,2,0,0,2,1,1,1
5785,6,286,11,6,10,0,0,1,11,2,4,2,4,6,6,10,15,1,15,0,0,2,1,1,1
5786,30,1925,1523,757,1297,19,12,193,1542,12,193,117,230,205,347,1508,2664,7,19053,1058,0,2,4,2,1
5787,114,3710,1660,832,1314,41,38,274,1701,20,312,209,395,332,604,2671,5058,12,64042,3557,1,2,7,7,1
5788,114,3710,1057,646,719,113,100,145,1170,18,215,134,248,233,382,1740,3004,10,31186,1732,1,2,7,7,1
5789,80,1664,1660,832,1314,41,38,274,1701,20,312,209,395,332,604,2671,5058,12,64042,3557,1,2,10,0,1
5790,42,1306,1523,757,1297,19,12,193,1542,12,193,117,230,205,347,1508,2664,7,19053,1058,0,2,4,6,0
5791,42,1306,701,378,504,33,58,109,734,13,110,68,126,123,194,794,1346,7,10027,557,0,2,4,6,0
5792,6,286,42,7,35,4,0,5,46,1,2,1,2,3,3,2,4,0,2,0,0,2,1,1,0
5793,6,286,11,6,10,0,0,1,11,2,4,2,4,6,6,10,15,1,15,0,0,2,1,1,0
5794,30,1925,1523,757,1297,19,12,193,1542,12,193,117,230,205,347,1508,2664,7,19053,1058,0,2,4,2,0
5795,114,3710,1660,832,1314,41,38,274,1701,20,312,209,395,332,604,2671,5058,12,64042,3557,1,2,1,1,1
5796,114,3710,1057,646,719,113,100,145,1170,18,215,134,248,233,382,1740,3004,10,31186,1732,1,2,1,1,1
5797,81,1691,1660,832,1314,41,38,274,1701,20,312,209,395,332,604,2671,5058,12,64042,3557,1,2,4,0,1
5798,82,1720,1660,832,1314,41,38,274,1701,20,312,209,395,332,604,2671,5058,12,64042,3557,1,2,4,0,0
5799,136,2683,1457,730,1242,11,6,188,1468,10,292,166,329,302,495,2424,4078,5,22973,1276,1,2,1,2,1
5800,136,2683,74,35,59,1,0,14,75,3,14,7,14,17,21,58,85,1,128,7,0,2,1,2,1
5801,136,2683,245,125,200,5,7,34,250,7,30,17,34,37,51,166,265,3,1053,58,0,2,1,2,1
5802,42,1096,74,35,59,1,0,14,75,3,14,7,14,17,21,58,85,1,128,7,0,2,24,2,1
5803,42,1096,245,125,200,5,7,34,250,7,30,17,34,37,51,166,265,3,1053,58,0,2,24,2,1
5804,28,1512,1457,730,1242,11,6,188,1468,10,292,166,329,302,495,2424,4078,5,22973,1276,1,2,1,1,1
5805,11,350,74,35,59,1,0,14,75,3,14,7,14,17,21,58,85,1,128,7,0,2,14,0,1
5806,52,2415,1943,715,1694,26,18,214,1969,12,185,120,237,197,357,1436,2721,7,20915,1161,0,2,0,15,1
5807,115,3763,1660,832,1314,41,38,274,1701,20,312,209,395,332,604,2671,5058,12,64042,3557,1,2,9,0,1
5808,115,3763,1057,646,719,113,100,145,1170,18,215,134,248,233,382,1740,3004,10,31186,1732,1,2,9,0,1
5809,6,286,42,7,35,4,0,5,46,1,2,1,2,3,3,2,4,0,2,0,0,2,1,1,1
5810,6,286,11,6,10,0,0,1,11,2,4,2,4,6,6,10,15,1,15,0,0,2,1,1,1
5811,1,191,382,65,130,157,2,92,539,4,10,5,10,14,15,41,57,2,114,6,0,2,9,7,0
5812,24,527,2,2,2,0,0,0,2,0,0,0,0,0,0,0,0,0,0,0,0,2,7,1,1
5813,24,527,99,48,90,1,3,5,100,0,0,0,0,0,0,0,0,0,0,0,0,2,7,1,1
5814,24,527,8,5,5,2,0,1,10,0,0,0,0,0,0,0,0,0,0,0,0,2,7,1,1
5815,24,527,1217,716,841,84,126,174,1301,14,185,118,215,199,333,1446,2542,8,20687,1149,0,2,7,1,1
5816,24,527,160,89,115,0,13,31,160,7,15,11,17,22,28,78,124,3,495,27,0,2,7,1,1
5817,24,527,10,10,9,9,0,0,19,0,0,0,0,0,0,0,0,0,0,0,0,2,7,1,1
5818,24,527,173,84,99,8,29,36,181,5,12,7,13,17,20,54,81,2,221,12,0,2,7,1,1
5819,24,527,3,1,1,3,0,0,6,0,0,0,0,0,0,0,0,0,0,0,0,2,7,1,1
5820,84,1745,1660,832,1314,41,38,274,1701,20,312,209,395,332,604,2671,5058,12,64042,3557,1,2,5,0,1
5821,84,1745,1660,832,1314,41,38,274,1701,20,312,209,395,332,604,2671,5058,12,64042,3557,1,2,2,1,0
5822,84,1747,1660,832,1314,41,38,274,1701,20,312,209,395,332,604,2671,5058,12,64042,3557,1,2,1,1,0
5823,84,1759,1660,832,1314,41,38,274,1701,20,312,209,395,332,604,2671,5058,12,64042,3557,1,2,3,2,1
5824,120,3799,1660,832,1314,41,38,274,1701,20,312,209,395,332,604,2671,5058,12,64042,3557,1,2,29,12,1
5825,120,3799,1057,646,719,113,100,145,1170,18,215,134,248,233,382,1740,3004,10,31186,1732,1,2,29,12,1
5826,87,1884,1660,832,1314,41,38,274,1701,20,312,209,395,332,604,2671,5058,12,64042,3557,1,2,24,0,1
5827,120,3797,1660,832,1314,41,38,274,1701,20,312,209,395,332,604,2671,5058,12,64042,3557,1,2,0,1,0
5828,120,3797,1057,646,719,113,100,145,1170,18,215,134,248,233,382,1740,3004,10,31186,1732,1,2,0,1,0
5829,22,519,1293,570,1093,25,15,163,1318,10,195,123,241,205,364,1516,2795,6,17273,959,0,2,11,1,0
5830,17,678,1293,570,1093,25,15,163,1318,10,195,123,241,205,364,1516,2795,6,17273,959,0,2,13,0,0
5831,122,3814,1660,832,1314,41,38,274,1701,20,312,209,395,332,604,2671,5058,12,64042,3557,1,2,3,1,1
5832,122,3814,1057,646,719,113,100,145,1170,18,215,134,248,233,382,1740,3004,10,31186,1732,1,2,3,1,1
5833,124,3828,1660,832,1314,41,38,274,1701,20,312,209,395,332,604,2671,5058,12,64042,3557,1,2,2,1,0
5834,124,3828,1057,646,719,113,100,145,1170,18,215,134,248,233,382,1740,3004,10,31186,1732,1,2,2,1,0
5835,43,1893,1289,550,1043,56,32,155,1345,10,167,93,185,177,278,1266,2075,5,11498,638,0,2,1,1,0
5836,120,3818,1660,832,1314,41,38,274,1701,20,312,209,395,332,604,2671,5058,12,64042,3557,1,2,8,4,1
5837,120,3818,1057,646,719,113,100,145,1170,18,215,134,248,233,382,1740,3004,10,31186,1732,1,2,8,4,1
5838,6,286,42,7,35,4,0,5,46,1,2,1,2,3,3,2,4,0,2,0,0,2,1,1,0
5839,6,286,11,6,10,0,0,1,11,2,4,2,4,6,6,10,15,1,15,0,0,2,1,1,0
5840,120,3818,1660,832,1314,41,38,274,1701,20,312,209,395,332,604,2671,5058,12,64042,3557,1,2,8,4,0
5841,120,3818,1057,646,719,113,100,145,1170,18,215,134,248,233,382,1740,3004,10,31186,1732,1,2,8,4,0
5842,33,542,127,75,83,2,11,30,129,4,14,7,14,18,21,61,87,2,175,9,0,2,4,2,1
5843,33,542,652,304,544,16,6,88,668,6,89,51,101,95,152,591,998,3,3399,188,0,2,4,2,1
5844,33,542,2,2,2,0,0,0,2,0,0,0,0,0,0,0,0,0,0,0,0,2,4,2,1
5845,33,542,8,5,5,0,0,3,8,0,0,0,0,0,0,0,0,0,0,0,0,2,4,2,1
5846,33,542,2,2,2,0,0,0,2,0,0,0,0,0,0,0,0,0,0,0,0,2,4,2,1
5847,33,542,14,8,8,0,0,6,14,0,0,0,0,0,0,0,0,0,0,0,0,2,4,2,1
5848,33,542,6,4,4,0,0,2,6,0,0,0,0,0,0,0,0,0,0,0,0,2,4,2,1
5849,33,542,6,4,4,0,0,2,6,1,2,1,2,3,3,2,4,0,2,0,0,2,4,2,1
5850,33,542,6,4,4,0,0,2,6,0,0,0,0,0,0,0,0,0,0,0,0,2,4,2,1
5851,33,542,7,5,5,0,0,2,7,0,0,0,0,0,0,0,0,0,0,0,0,2,4,2,1
5852,33,542,6,4,4,0,0,2,6,0,0,0,0,0,0,0,0,0,0,0,0,2,4,2,1
5853,33,542,10,6,6,0,0,4,10,0,0,0,0,0,0,0,0,0,0,0,0,2,4,2,1
5854,33,542,1,1,1,0,0,0,1,0,0,0,0,0,0,0,0,0,0,0,0,2,4,2,1
5855,33,542,1,1,1,0,0,0,1,0,0,0,0,0,0,0,0,0,0,0,0,2,4,2,1
5856,33,542,14,10,10,0,0,4,14,1,1,1,1,2,2,0,2,0,1,0,0,2,4,2,1
5857,33,542,46,26,30,3,0,12,49,3,6,3,6,9,9,20,28,1,42,2,0,2,4,2,1
5858,6,286,42,7,35,4,0,5,46,1,2,1,2,3,3,2,4,0,2,0,0,2,3,3,1
5859,6,286,11,6,10,0,0,1,11,2,4,2,4,6,6,10,15,1,15,0,0,2,3,3,1
5860,120,3830,1660,832,1314,41,38,274,1701,20,312,209,395,332,604,2671,5058,12,64042,3557,1,2,4,1,1
5861,120,3830,1057,646,719,113,100,145,1170,18,215,134,248,233,382,1740,3004,10,31186,1732,1,2,4,1,1
5862,88,1968,1660,832,1314,41,38,274,1701,20,312,209,395,332,604,2671,5058,12,64042,3557,1,2,14,0,1
5863,120,3838,1660,832,1314,41,38,274,1701,20,312,209,395,332,604,2671,5058,12,64042,3557,1,2,1,1,0
5864,120,3838,1057,646,719,113,100,145,1170,18,215,134,248,233,382,1740,3004,10,31186,1732,1,2,1,1,0
5865,89,2022,1660,832,1314,41,38,274,1701,20,312,209,395,332,604,2671,5058,12,64042,3557,1,2,9,0,0
5866,118,3763,1660,832,1314,41,38,274,1701,20,312,209,395,332,604,2671,5058,12,64042,3557,1,2,7,18,1
5867,118,3763,1057,646,719,113,100,145,1170,18,215,134,248,233,382,1740,3004,10,31186,1732,1,2,7,18,1
5868,117,3766,1660,832,1314,41,38,274,1701,20,312,209,395,332,604,2671,5058,12,64042,3557,1,2,12,13,1
5869,117,3766,1057,646,719,113,100,145,1170,18,215,134,248,233,382,1740,3004,10,31186,1732,1,2,12,13,1
5870,94,2079,1660,832,1314,41,38,274,1701,20,312,209,395,332,604,2671,5058,12,64042,3557,1,2,8,0,1
5871,146,3319,77,34,69,0,0,8,77,3,24,16,29,27,45,114,213,1,387,21,0,2,17,11,1
5872,146,3319,712,438,573,51,9,84,763,14,102,71,128,116,199,733,1364,8,11988,666,0,2,17,11,1
5873,44,1956,1289,550,1043,56,32,155,1345,10,167,93,185,177,278,1266,2075,5,11498,638,0,2,11,0,1
5874,44,1956,1289,550,1043,56,32,155,1345,10,167,93,185,177,278,1266,2075,5,11498,638,0,2,2,0,0
5875,146,3319,77,34,69,0,0,8,77,3,24,16,29,27,45,114,213,1,387,21,0,2,17,11,0
5876,146,3319,712,438,573,51,9,84,763,14,102,71,128,116,199,733,1364,8,11988,666,0,2,17,11,0
5877,6,286,42,7,35,4,0,5,46,1,2,1,2,3,3,2,4,0,2,0,0,2,1,1,0
5878,6,286,11,6,10,0,0,1,11,2,4,2,4,6,6,10,15,1,15,0,0,2,1,1,0
5879,44,1956,1289,550,1043,56,32,155,1345,10,167,93,185,177,278,1266,2075,5,11498,638,0,2,15,2,0
5880,118,3822,1660,832,1314,41,38,274,1701,20,312,209,395,332,604,2671,5058,12,64042,3557,1,2,9,0,1
5881,118,3822,1057,646,719,113,100,145,1170,18,215,134,248,233,382,1740,3004,10,31186,1732,1,2,9,0,1
5882,95,2123,1660,832,1314,41,38,274,1701,20,312,209,395,332,604,2671,5058,12,64042,3557,1,2,6,0,1
5883,44,1956,1289,550,1043,56,32,155,1345,10,167,93,185,177,278,1266,2075,5,11498,638,0,2,1,1,1
5884,25,542,2,2,2,0,0,0,2,0,0,0,0,0,0,0,0,0,0,0,0,2,3,0,1
5885,25,542,99,48,90,1,3,5,100,0,0,0,0,0,0,0,0,0,0,0,0,2,3,0,1
5886,25,542,8,5,5,2,0,1,10,0,0,0,0,0,0,0,0,0,0,0,0,2,3,0,1
5887,25,542,1217,716,841,84,126,174,1301,14,185,118,215,199,333,1446,2542,8,20687,1149,0,2,3,0,1
5888,25,542,160,89,115,0,13,31,160,7,15,11,17,22,28,78,124,3,495,27,0,2,3,0,1
5889,25,542,10,10,9,9,0,0,19,0,0,0,0,0,0,0,0,0,0,0,0,2,3,0,1
5890,25,542,173,84,99,8,29,36,181,5,12,7,13,17,20,54,81,2,221,12,0,2,3,0,1
5891,25,542,3,1,1,3,0,0,6,0,0,0,0,0,0,0,0,0,0,0,0,2,3,0,1
5892,6,286,42,7,35,4,0,5,46,1,2,1,2,3,3,2,4,0,2,0,0,2,1,1,1
5893,6,286,11,6,10,0,0,1,11,2,4,2,4,6,6,10,15,1,15,0,0,2,1,1,1
5894,44,1965,1289,550,1043,56,32,155,1345,10,167,93,185,177,278,1266,2075,5,11498,638,0,2,1,0,1
5895,32,1156,1450,624,1228,12,26,181,1462,14,306,186,354,320,540,2580,4493,8,36391,2021,1,2,1,1,1
5896,95,2139,1660,832,1314,41,38,274,1701,20,312,209,395,332,604,2671,5058,12,64042,3557,1,2,3,0,1
5897,25,1230,652,304,544,16,6,88,668,6,89,51,101,95,152,591,998,3,3399,188,0,2,1,1,1
5898,6,286,42,7,35,4,0,5,46,1,2,1,2,3,3,2,4,0,2,0,0,2,1,1,0
5899,6,286,11,6,10,0,0,1,11,2,4,2,4,6,6,10,15,1,15,0,0,2,1,1,0
5900,40,1253,1523,757,1297,19,12,193,1542,12,193,117,230,205,347,1508,2664,7,19053,1058,0,2,1,9,1
5901,40,1253,701,378,504,33,58,109,734,13,110,68,126,123,194,794,1346,7,10027,557,0,2,1,9,1
5902,87,1986,1043,504,840,53,9,147,1096,9,180,112,198,189,310,1377,2344,4,11604,644,0,2,17,8,1
5903,87,1986,383,288,292,26,6,62,409,11,65,38,67,76,105,429,656,5,3719,206,0,2,17,8,1
5904,6,286,42,7,35,4,0,5,46,1,2,1,2,3,3,2,4,0,2,0,0,2,1,1,0
5905,6,286,11,6,10,0,0,1,11,2,4,2,4,6,6,10,15,1,15,0,0,2,1,1,0
5906,40,1253,1523,757,1297,19,12,193,1542,12,193,117,230,205,347,1508,2664,7,19053,1058,0,2,1,9,0
5907,40,1253,701,378,504,33,58,109,734,13,110,68,126,123,194,794,1346,7,10027,557,0,2,1,9,0
5908,87,1986,1043,504,840,53,9,147,1096,9,180,112,198,189,310,1377,2344,4,11604,644,0,2,17,8,0
5909,87,1986,383,288,292,26,6,62,409,11,65,38,67,76,105,429,656,5,3719,206,0,2,17,8,0
5910,185,4416,722,423,573,19,0,135,741,12,172,101,199,184,300,1320,2257,6,15668,870,0,2,1,0,0
5911,185,4416,1508,847,911,44,250,301,1552,14,148,88,169,162,257,1120,1886,7,15077,837,0,2,1,0,0
5912,34,1575,1178,367,1042,6,15,115,1184,9,94,51,95,103,146,644,976,4,4439,246,0,2,6,1,0
5913,136,2684,1457,730,1242,11,6,188,1468,10,292,166,329,302,495,2424,4078,5,22973,1276,1,2,1,1,1
5914,136,2684,74,35,59,1,0,14,75,3,14,7,14,17,21,58,85,1,128,7,0,2,1,1,1
5915,136,2684,245,125,200,5,7,34,250,7,30,17,34,37,51,166,265,3,1053,58,0,2,1,1,1
5916,29,1532,1457,730,1242,11,6,188,1468,10,292,166,329,302,495,2424,4078,5,22973,1276,1,2,3,0,1
5917,80,1402,1178,367,1042,6,15,115,1184,9,94,51,95,103,146,644,976,4,4439,246,0,2,6,4,1
5918,80,1402,177,108,140,8,0,27,185,6,30,16,32,36,48,162,248,3,794,44,0,2,6,4,1
5919,146,2909,1943,715,1694,26,18,214,1969,12,185,120,237,197,357,1436,2721,7,20915,1161,0,2,1,1,1
5920,146,2909,1168,838,957,57,25,144,1225,19,348,224,416,367,640,3018,5452,11,61921,3440,1,2,1,1,1
5921,35,1612,1178,367,1042,6,15,115,1184,9,94,51,95,103,146,644,976,4,4439,246,0,2,15,0,1
5922,118,3822,1660,832,1314,41,38,274,1701,20,312,209,395,332,604,2671,5058,12,64042,3557,1,2,3,3,1
5923,118,3822,1057,646,719,113,100,145,1170,18,215,134,248,233,382,1740,3004,10,31186,1732,1,2,3,3,1
5924,99,2192,1660,832,1314,41,38,274,1701,20,312,209,395,332,604,2671,5058,12,64042,3557,1,2,8,0,1
5925,118,3825,1660,832,1314,41,38,274,1701,20,312,209,395,332,604,2671,5058,12,64042,3557,1,2,1,1,0
5926,118,3825,1057,646,719,113,100,145,1170,18,215,134,248,233,382,1740,3004,10,31186,1732,1,2,1,1,0
5927,27,563,2,2,2,0,0,0,2,0,0,0,0,0,0,0,0,0,0,0,0,2,18,13,1
5928,27,563,99,48,90,1,3,5,100,0,0,0,0,0,0,0,0,0,0,0,0,2,18,13,1
5929,27,563,8,5,5,2,0,1,10,0,0,0,0,0,0,0,0,0,0,0,0,2,18,13,1
5930,27,563,1217,716,841,84,126,174,1301,14,185,118,215,199,333,1446,2542,8,20687,1149,0,2,18,13,1
5931,27,563,160,89,115,0,13,31,160,7,15,11,17,22,28,78,124,3,495,27,0,2,18,13,1
5932,27,563,10,10,9,9,0,0,19,0,0,0,0,0,0,0,0,0,0,0,0,2,18,13,1
5933,27,563,173,84,99,8,29,36,181,5,12,7,13,17,20,54,81,2,221,12,0,2,18,13,1
5934,27,563,3,1,1,3,0,0,6,0,0,0,0,0,0,0,0,0,0,0,0,2,18,13,1
5935,32,1222,1450,624,1228,12,26,181,1462,14,306,186,354,320,540,2580,4493,8,36391,2021,1,2,22,9,1
5936,6,286,42,7,35,4,0,5,46,1,2,1,2,3,3,2,4,0,2,0,0,2,1,1,1
5937,6,286,11,6,10,0,0,1,11,2,4,2,4,6,6,10,15,1,15,0,0,2,1,1,1
5938,147,3343,77,34,69,0,0,8,77,3,24,16,29,27,45,114,213,1,387,21,0,2,9,0,1
5939,147,3343,712,438,573,51,9,84,763,14,102,71,128,116,199,733,1364,8,11988,666,0,2,9,0,1
5940,44,1999,1289,550,1043,56,32,155,1345,10,167,93,185,177,278,1266,2075,5,11498,638,0,2,8,0,1
5941,44,1989,1289,550,1043,56,32,155,1345,10,167,93,185,177,278,1266,2075,5,11498,638,0,2,2,5,0
5942,147,3343,77,34,69,0,0,8,77,3,24,16,29,27,45,114,213,1,387,21,0,2,3,3,0
5943,147,3343,712,438,573,51,9,84,763,14,102,71,128,116,199,733,1364,8,11988,666,0,2,3,3,0
5944,187,4460,722,423,573,19,0,135,741,12,172,101,199,184,300,1320,2257,6,15668,870,0,2,9,0,0
5945,187,4460,1508,847,911,44,250,301,1552,14,148,88,169,162,257,1120,1886,7,15077,837,0,2,9,0,0
5946,6,286,42,7,35,4,0,5,46,1,2,1,2,3,3,2,4,0,2,0,0,2,1,1,0
5947,6,286,11,6,10,0,0,1,11,2,4,2,4,6,6,10,15,1,15,0,0,2,1,1,0
5948,33,542,127,75,83,2,11,30,129,4,14,7,14,18,21,61,87,2,175,9,0,2,1,1,0
5949,33,542,652,304,544,16,6,88,668,6,89,51,101,95,152,591,998,3,3399,188,0,2,1,1,0
5950,33,542,2,2,2,0,0,0,2,0,0,0,0,0,0,0,0,0,0,0,0,2,1,1,0
5951,33,542,8,5,5,0,0,3,8,0,0,0,0,0,0,0,0,0,0,0,0,2,1,1,0
5952,33,542,2,2,2,0,0,0,2,0,0,0,0,0,0,0,0,0,0,0,0,2,1,1,0
5953,33,542,14,8,8,0,0,6,14,0,0,0,0,0,0,0,0,0,0,0,0,2,1,1,0
5954,33,542,6,4,4,0,0,2,6,0,0,0,0,0,0,0,0,0,0,0,0,2,1,1,0
5955,33,542,6,4,4,0,0,2,6,1,2,1,2,3,3,2,4,0,2,0,0,2,1,1,0
5956,33,542,6,4,4,0,0,2,6,0,0,0,0,0,0,0,0,0,0,0,0,2,1,1,0
5957,33,542,7,5,5,0,0,2,7,0,0,0,0,0,0,0,0,0,0,0,0,2,1,1,0
5958,33,542,6,4,4,0,0,2,6,0,0,0,0,0,0,0,0,0,0,0,0,2,1,1,0
5959,33,542,10,6,6,0,0,4,10,0,0,0,0,0,0,0,0,0,0,0,0,2,1,1,0
5960,33,542,1,1,1,0,0,0,1,0,0,0,0,0,0,0,0,0,0,0,0,2,1,1,0
5961,33,542,1,1,1,0,0,0,1,0,0,0,0,0,0,0,0,0,0,0,0,2,1,1,0
5962,33,542,14,10,10,0,0,4,14,1,1,1,1,2,2,0,2,0,1,0,0,2,1,1,0
5963,33,542,46,26,30,3,0,12,49,3,6,3,6,9,9,20,28,1,42,2,0,2,1,1,0
5964,11,347,442,244,305,14,16,103,456,11,68,45,75,79,120,452,756,6,4588,254,0,2,2,2,1
5965,11,347,182,102,99,11,40,35,193,3,11,6,11,14,17,42,64,1,97,5,0,2,2,2,1
5966,6,286,42,7,35,4,0,5,46,1,2,1,2,3,3,2,4,0,2,0,0,2,1,1,1
5967,6,286,11,6,10,0,0,1,11,2,4,2,4,6,6,10,15,1,15,0,0,2,1,1,1
5968,8,544,442,244,305,14,16,103,456,11,68,45,75,79,120,452,756,6,4588,254,0,2,13,0,1
5969,69,1231,1513,682,1277,25,13,200,1538,11,199,116,219,210,335,1557,2584,6,15641,868,0,2,21,19,1
5970,69,1231,819,519,539,24,98,155,843,15,96,57,106,111,163,690,1107,8,9171,509,0,2,21,19,1
5971,137,2694,1457,730,1242,11,6,188,1468,10,292,166,329,302,495,2424,4078,5,22973,1276,1,2,14,8,1
5972,137,2694,74,35,59,1,0,14,75,3,14,7,14,17,21,58,85,1,128,7,0,2,14,8,1
5973,137,2694,245,125,200,5,7,34,250,7,30,17,34,37,51,166,265,3,1053,58,0,2,14,8,1
5974,42,1104,74,35,59,1,0,14,75,3,14,7,14,17,21,58,85,1,128,7,0,2,2,1,1
5975,42,1104,245,125,200,5,7,34,250,7,30,17,34,37,51,166,265,3,1053,58,0,2,2,1,1
5976,147,3343,77,34,69,0,0,8,77,3,24,16,29,27,45,114,213,1,387,21,0,2,6,6,1
5977,147,3343,712,438,573,51,9,84,763,14,102,71,128,116,199,733,1364,8,11988,666,0,2,6,6,1
5978,179,4314,722,423,573,19,0,135,741,12,172,101,199,184,300,1320,2257,6,15668,870,0,2,42,68,1
5979,179,4314,1508,847,911,44,250,301,1552,14,148,88,169,162,257,1120,1886,7,15077,837,0,2,42,68,1
5980,144,2897,1943,715,1694,26,18,214,1969,12,185,120,237,197,357,1436,2721,7,20915,1161,0,2,2,6,1
5981,144,2897,1168,838,957,57,25,144,1225,19,348,224,416,367,640,3018,5452,11,61921,3440,1,2,2,6,1
5982,6,286,42,7,35,4,0,5,46,1,2,1,2,3,3,2,4,0,2,0,0,2,1,1,1
5983,6,286,11,6,10,0,0,1,11,2,4,2,4,6,6,10,15,1,15,0,0,2,1,1,1
5984,45,2034,1289,550,1043,56,32,155,1345,10,167,93,185,177,278,1266,2075,5,11498,638,0,2,11,5,1
5985,35,613,127,75,83,2,11,30,129,4,14,7,14,18,21,61,87,2,175,9,0,2,19,11,1
5986,35,613,652,304,544,16,6,88,668,6,89,51,101,95,152,591,998,3,3399,188,0,2,19,11,1
5987,35,613,2,2,2,0,0,0,2,0,0,0,0,0,0,0,0,0,0,0,0,2,19,11,1
5988,35,613,8,5,5,0,0,3,8,0,0,0,0,0,0,0,0,0,0,0,0,2,19,11,1
5989,35,613,2,2,2,0,0,0,2,0,0,0,0,0,0,0,0,0,0,0,0,2,19,11,1
5990,35,613,14,8,8,0,0,6,14,0,0,0,0,0,0,0,0,0,0,0,0,2,19,11,1
5991,35,613,6,4,4,0,0,2,6,0,0,0,0,0,0,0,0,0,0,0,0,2,19,11,1
5992,35,613,6,4,4,0,0,2,6,1,2,1,2,3,3,2,4,0,2,0,0,2,19,11,1
5993,35,613,6,4,4,0,0,2,6,0,0,0,0,0,0,0,0,0,0,0,0,2,19,11,1
5994,35,613,7,5,5,0,0,2,7,0,0,0,0,0,0,0,0,0,0,0,0,2,19,11,1
5995,35,613,6,4,4,0,0,2,6,0,0,0,0,0,0,0,0,0,0,0,0,2,19,11,1
5996,35,613,10,6,6,0,0,4,10,0,0,0,0,0,0,0,0,0,0,0,0,2,19,11,1
5997,35,613,1,1,1,0,0,0,1,0,0,0,0,0,0,0,0,0,0,0,0,2,19,11,1
5998,35,613,1,1,1,0,0,0,1,0,0,0,0,0,0,0,0,0,0,0,0,2,19,11,1
5999,35,613,14,10,10,0,0,4,14,1,1,1,1,2,2,0,2,0,1,0,0,2,19,11,1
6000,35,613,46,26,30,3,0,12,49,3,6,3,6,9,9,20,28,1,42,2,0,2,19,11,1
6001,39,1597,1513,682,1277,25,13,200,1538,11,199,116,219,210,335,1557,2584,6,15641,868,0,2,17,14,1
6002,42,2708,1296,573,1062,40,33,157,1336,8,201,118,231,209,349,1561,2689,4,12365,686,0,2,17,50,1
6003,29,1472,1457,730,1242,11,6,188,1468,10,292,166,329,302,495,2424,4078,5,22973,1276,1,2,17,21,1
6004,30,1144,1020,354,843,12,15,144,1032,8,134,77,144,142,221,970,1580,4,6792,377,0,2,0,52,1
6005,6,462,442,244,305,14,16,103,456,11,68,45,75,79,120,452,756,6,4588,254,0,2,0,11,1
6006,180,4318,722,423,573,19,0,135,741,12,172,101,199,184,300,1320,2257,6,15668,870,0,2,1,1,0
6007,180,4318,1508,847,911,44,250,301,1552,14,148,88,169,162,257,1120,1886,7,15077,837,0,2,1,1,0
6008,6,472,442,244,305,14,16,103,456,11,68,45,75,79,120,452,756,6,4588,254,0,2,2,1,1
6009,6,464,442,244,305,14,16,103,456,11,68,45,75,79,120,452,756,6,4588,254,0,2,2,2,1
6010,184,4339,722,423,573,19,0,135,741,12,172,101,199,184,300,1320,2257,6,15668,870,0,2,8,1,1
6011,184,4339,1508,847,911,44,250,301,1552,14,148,88,169,162,257,1120,1886,7,15077,837,0,2,8,1,1
6012,96,2185,1043,504,840,53,9,147,1096,9,180,112,198,189,310,1377,2344,4,11604,644,0,2,34,2,1
6013,96,2185,383,288,292,26,6,62,409,11,65,38,67,76,105,429,656,5,3719,206,0,2,34,2,1
6014,6,286,42,7,35,4,0,5,46,1,2,1,2,3,3,2,4,0,2,0,0,2,1,1,1
6015,6,286,11,6,10,0,0,1,11,2,4,2,4,6,6,10,15,1,15,0,0,2,1,1,1
6016,51,2211,1289,550,1043,56,32,155,1345,10,167,93,185,177,278,1266,2075,5,11498,638,0,2,45,0,1
6017,45,430,647,139,84,35,284,233,682,0,0,0,0,0,0,0,0,0,0,0,0,2,2,1,1
6018,41,1260,1523,757,1297,19,12,193,1542,12,193,117,230,205,347,1508,2664,7,19053,1058,0,2,2,1,1
6019,41,1260,701,378,504,33,58,109,734,13,110,68,126,123,194,794,1346,7,10027,557,0,2,2,1,1
6020,184,4339,722,423,573,19,0,135,741,12,172,101,199,184,300,1320,2257,6,15668,870,0,2,2,2,1
6021,184,4339,1508,847,911,44,250,301,1552,14,148,88,169,162,257,1120,1886,7,15077,837,0,2,2,2,1
6022,28,574,215,129,180,6,0,29,221,8,65,43,72,73,115,415,711,4,3153,175,0,2,2,0,1
6023,28,574,97,69,77,3,3,16,100,6,22,13,23,28,36,113,173,3,542,30,0,2,2,0,1
6024,95,2257,1043,504,840,53,9,147,1096,9,180,112,198,189,310,1377,2344,4,11604,644,0,2,14,3,1
6025,95,2257,383,288,292,26,6,62,409,11,65,38,67,76,105,429,656,5,3719,206,0,2,14,3,1
6026,145,2900,1943,715,1694,26,18,214,1969,12,185,120,237,197,357,1436,2721,7,20915,1161,0,2,4,3,1
6027,145,2900,1168,838,957,57,25,144,1225,19,348,224,416,367,640,3018,5452,11,61921,3440,1,2,4,3,1
6028,6,286,42,7,35,4,0,5,46,1,2,1,2,3,3,2,4,0,2,0,0,2,1,1,1
6029,6,286,11,6,10,0,0,1,11,2,4,2,4,6,6,10,15,1,15,0,0,2,1,1,1
6030,52,2269,1289,550,1043,56,32,155,1345,10,167,93,185,177,278,1266,2075,5,11498,638,0,2,25,0,1
6031,30,1144,1020,354,843,12,15,144,1032,8,134,77,144,142,221,970,1580,4,6792,377,0,2,1,1,1
6032,55,2337,1289,550,1043,56,32,155,1345,10,167,93,185,177,278,1266,2075,5,11498,638,0,2,66,52,1
6033,95,2262,1043,504,840,53,9,147,1096,9,180,112,198,189,310,1377,2344,4,11604,644,0,2,2,1,1
6034,95,2262,383,288,292,26,6,62,409,11,65,38,67,76,105,429,656,5,3719,206,0,2,2,1,1
6035,6,286,42,7,35,4,0,5,46,1,2,1,2,3,3,2,4,0,2,0,0,2,1,1,1
6036,6,286,11,6,10,0,0,1,11,2,4,2,4,6,6,10,15,1,15,0,0,2,1,1,1
6037,95,2264,1043,504,840,53,9,147,1096,9,180,112,198,189,310,1377,2344,4,11604,644,0,2,3,4,1
6038,95,2264,383,288,292,26,6,62,409,11,65,38,67,76,105,429,656,5,3719,206,0,2,3,4,1
6039,6,286,42,7,35,4,0,5,46,1,2,1,2,3,3,2,4,0,2,0,0,2,1,1,1
6040,6,286,11,6,10,0,0,1,11,2,4,2,4,6,6,10,15,1,15,0,0,2,1,1,1
6041,56,2390,1289,550,1043,56,32,155,1345,10,167,93,185,177,278,1266,2075,5,11498,638,0,2,10,0,1
6042,94,2179,1043,504,840,53,9,147,1096,9,180,112,198,189,310,1377,2344,4,11604,644,0,2,8,12,1
6043,94,2179,383,288,292,26,6,62,409,11,65,38,67,76,105,429,656,5,3719,206,0,2,8,12,1
6044,6,286,42,7,35,4,0,5,46,1,2,1,2,3,3,2,4,0,2,0,0,2,1,1,1
6045,6,286,11,6,10,0,0,1,11,2,4,2,4,6,6,10,15,1,15,0,0,2,1,1,1
6046,56,2377,1289,550,1043,56,32,155,1345,10,167,93,185,177,278,1266,2075,5,11498,638,0,2,0,2,1
6047,56,2375,1289,550,1043,56,32,155,1345,10,167,93,185,177,278,1266,2075,5,11498,638,0,2,0,2,0
6048,56,2373,1289,550,1043,56,32,155,1345,10,167,93,185,177,278,1266,2075,5,11498,638,0,2,3,4,1
6049,94,2175,1043,504,840,53,9,147,1096,9,180,112,198,189,310,1377,2344,4,11604,644,0,2,1,8,0
6050,94,2175,383,288,292,26,6,62,409,11,65,38,67,76,105,429,656,5,3719,206,0,2,1,8,0
6051,185,4352,722,423,573,19,0,135,741,12,172,101,199,184,300,1320,2257,6,15668,870,0,2,2,0,0
6052,185,4352,1508,847,911,44,250,301,1552,14,148,88,169,162,257,1120,1886,7,15077,837,0,2,2,0,0
6053,138,2726,1457,730,1242,11,6,188,1468,10,292,166,329,302,495,2424,4078,5,22973,1276,1,2,9,0,1
6054,138,2726,74,35,59,1,0,14,75,3,14,7,14,17,21,58,85,1,128,7,0,2,9,0,1
6055,138,2726,245,125,200,5,7,34,250,7,30,17,34,37,51,166,265,3,1053,58,0,2,9,0,1
6056,31,1642,1457,730,1242,11,6,188,1468,10,292,166,329,302,495,2424,4078,5,22973,1276,1,2,34,0,1
6057,147,3357,77,34,69,0,0,8,77,3,24,16,29,27,45,114,213,1,387,21,0,2,3,0,1
6058,147,3357,712,438,573,51,9,84,763,14,102,71,128,116,199,733,1364,8,11988,666,0,2,3,0,1
6059,57,1036,1020,354,843,12,15,144,1032,8,134,77,144,142,221,970,1580,4,6792,377,0,2,40,2,1
6060,81,1431,1178,367,1042,6,15,115,1184,9,94,51,95,103,146,644,976,4,4439,246,0,2,15,0,1
6061,81,1431,177,108,140,8,0,27,185,6,30,16,32,36,48,162,248,3,794,44,0,2,15,0,1
6062,6,286,42,7,35,4,0,5,46,1,2,1,2,3,3,2,4,0,2,0,0,2,1,1,1
6063,6,286,11,6,10,0,0,1,11,2,4,2,4,6,6,10,15,1,15,0,0,2,1,1,1
6064,35,622,127,75,83,2,11,30,129,4,14,7,14,18,21,61,87,2,175,9,0,2,4,0,1
6065,35,622,652,304,544,16,6,88,668,6,89,51,101,95,152,591,998,3,3399,188,0,2,4,0,1
6066,35,622,2,2,2,0,0,0,2,0,0,0,0,0,0,0,0,0,0,0,0,2,4,0,1
6067,35,622,8,5,5,0,0,3,8,0,0,0,0,0,0,0,0,0,0,0,0,2,4,0,1
6068,35,622,2,2,2,0,0,0,2,0,0,0,0,0,0,0,0,0,0,0,0,2,4,0,1
6069,35,622,14,8,8,0,0,6,14,0,0,0,0,0,0,0,0,0,0,0,0,2,4,0,1
6070,35,622,6,4,4,0,0,2,6,0,0,0,0,0,0,0,0,0,0,0,0,2,4,0,1
6071,35,622,6,4,4,0,0,2,6,1,2,1,2,3,3,2,4,0,2,0,0,2,4,0,1
6072,35,622,6,4,4,0,0,2,6,0,0,0,0,0,0,0,0,0,0,0,0,2,4,0,1
6073,35,622,7,5,5,0,0,2,7,0,0,0,0,0,0,0,0,0,0,0,0,2,4,0,1
6074,35,622,6,4,4,0,0,2,6,0,0,0,0,0,0,0,0,0,0,0,0,2,4,0,1
6075,35,622,10,6,6,0,0,4,10,0,0,0,0,0,0,0,0,0,0,0,0,2,4,0,1
6076,35,622,1,1,1,0,0,0,1,0,0,0,0,0,0,0,0,0,0,0,0,2,4,0,1
6077,35,622,1,1,1,0,0,0,1,0,0,0,0,0,0,0,0,0,0,0,0,2,4,0,1
6078,35,622,14,10,10,0,0,4,14,1,1,1,1,2,2,0,2,0,1,0,0,2,4,0,1
6079,35,622,46,26,30,3,0,12,49,3,6,3,6,9,9,20,28,1,42,2,0,2,4,0,1
6080,33,1248,1020,354,843,12,15,144,1032,8,134,77,144,142,221,970,1580,4,6792,377,0,2,47,0,1
6081,36,1639,1178,367,1042,6,15,115,1184,9,94,51,95,103,146,644,976,4,4439,246,0,2,7,0,1
6082,63,1149,1020,354,843,12,15,144,1032,8,134,77,144,142,221,970,1580,4,6792,377,0,2,23,3,1
6083,147,2943,1943,715,1694,26,18,214,1969,12,185,120,237,197,357,1436,2721,7,20915,1161,0,2,8,1,1
6084,147,2943,1168,838,957,57,25,144,1225,19,348,224,416,367,640,3018,5452,11,61921,3440,1,2,8,1,1
6085,6,286,42,7,35,4,0,5,46,1,2,1,2,3,3,2,4,0,2,0,0,2,1,1,1
6086,6,286,11,6,10,0,0,1,11,2,4,2,4,6,6,10,15,1,15,0,0,2,1,1,1
6087,35,1375,1020,354,843,12,15,144,1032,8,134,77,144,142,221,970,1580,4,6792,377,0,2,24,0,1
6088,52,2415,1943,715,1694,26,18,214,1969,12,185,120,237,197,357,1436,2721,7,20915,1161,0,2,1,1,1
6089,14,457,184,100,137,2,15,30,186,6,38,20,39,44,59,214,322,3,991,55,0,2,5,1,1
6090,14,457,103,65,74,8,5,16,111,7,17,9,17,24,26,89,119,3,417,23,0,2,5,1,1
6091,7,293,184,100,137,2,15,30,186,6,38,20,39,44,59,214,322,3,991,55,0,2,12,0,1
6092,23,554,1293,570,1093,25,15,163,1318,10,195,123,241,205,364,1516,2795,6,17273,959,0,2,7,1,1
6093,19,756,1293,570,1093,25,15,163,1318,10,195,123,241,205,364,1516,2795,6,17273,959,0,2,20,0,1
6094,14,457,184,100,137,2,15,30,186,6,38,20,39,44,59,214,322,3,991,55,0,2,5,1,0
6095,14,457,103,65,74,8,5,16,111,7,17,9,17,24,26,89,119,3,417,23,0,2,5,1,0
6096,7,293,184,100,137,2,15,30,186,6,38,20,39,44,59,214,322,3,991,55,0,2,12,0,0
6097,247,5301,72,33,56,0,4,12,72,1,1,1,1,2,2,0,2,0,1,0,0,2,146,23,1
6098,247,5301,1454,835,1044,76,110,219,1530,17,275,158,296,292,454,2297,3718,9,34017,1889,1,2,146,23,1
6099,11,347,72,33,56,0,4,12,72,1,1,1,1,2,2,0,2,0,1,0,0,2,7,12,1
6100,6,286,42,7,35,4,0,5,46,1,2,1,2,3,3,2,4,0,2,0,0,2,1,1,1
6101,6,286,11,6,10,0,0,1,11,2,4,2,4,6,6,10,15,1,15,0,0,2,1,1,1
6102,94,2175,1043,504,840,53,9,147,1096,9,180,112,198,189,310,1377,2344,4,11604,644,0,2,1,1,0
6103,94,2175,383,288,292,26,6,62,409,11,65,38,67,76,105,429,656,5,3719,206,0,2,1,1,0
6104,66,1174,1513,682,1277,25,13,200,1538,11,199,116,219,210,335,1557,2584,6,15641,868,0,2,0,11,1
6105,66,1174,819,519,539,24,98,155,843,15,96,57,106,111,163,690,1107,8,9171,509,0,2,0,11,1
6106,149,3363,77,34,69,0,0,8,77,3,24,16,29,27,45,114,213,1,387,21,0,2,4,4,1
6107,149,3363,712,438,573,51,9,84,763,14,102,71,128,116,199,733,1364,8,11988,666,0,2,4,4,1
6108,185,4362,722,423,573,19,0,135,741,12,172,101,199,184,300,1320,2257,6,15668,870,0,2,4,2,1
6109,185,4362,1508,847,911,44,250,301,1552,14,148,88,169,162,257,1120,1886,7,15077,837,0,2,4,2,1
6110,247,5301,72,33,56,0,4,12,72,1,1,1,1,2,2,0,2,0,1,0,0,2,1,0,1
6111,247,5301,1454,835,1044,76,110,219,1530,17,275,158,296,292,454,2297,3718,9,34017,1889,1,2,1,0,1
6112,98,2209,1043,504,840,53,9,147,1096,9,180,112,198,189,310,1377,2344,4,11604,644,0,2,40,16,1
6113,98,2209,383,288,292,26,6,62,409,11,65,38,67,76,105,429,656,5,3719,206,0,2,40,16,1
6114,6,286,42,7,35,4,0,5,46,1,2,1,2,3,3,2,4,0,2,0,0,2,1,1,1
6115,6,286,11,6,10,0,0,1,11,2,4,2,4,6,6,10,15,1,15,0,0,2,1,1,1
6116,42,1675,1043,504,840,53,9,147,1096,9,180,112,198,189,310,1377,2344,4,11604,644,0,2,39,0,1
6117,48,926,1098,241,925,5,10,155,1103,7,46,25,49,53,74,273,423,3,1580,87,0,2,7,2,0
6118,48,926,282,202,222,14,2,44,296,8,42,24,43,50,67,250,378,4,1548,86,0,2,7,2,0
6119,149,3366,77,34,69,0,0,8,77,3,24,16,29,27,45,114,213,1,387,21,0,2,2,0,1
6120,149,3366,712,438,573,51,9,84,763,14,102,71,128,116,199,733,1364,8,11988,666,0,2,2,0,1
6121,97,2199,1043,504,840,53,9,147,1096,9,180,112,198,189,310,1377,2344,4,11604,644,0,2,1,7,1
6122,97,2199,383,288,292,26,6,62,409,11,65,38,67,76,105,429,656,5,3719,206,0,2,1,7,1
6123,6,286,42,7,35,4,0,5,46,1,2,1,2,3,3,2,4,0,2,0,0,2,1,1,1
6124,6,286,11,6,10,0,0,1,11,2,4,2,4,6,6,10,15,1,15,0,0,2,1,1,1
6125,97,2191,1043,504,840,53,9,147,1096,9,180,112,198,189,310,1377,2344,4,11604,644,0,2,8,9,1
6126,97,2191,383,288,292,26,6,62,409,11,65,38,67,76,105,429,656,5,3719,206,0,2,8,9,1
6127,6,286,42,7,35,4,0,5,46,1,2,1,2,3,3,2,4,0,2,0,0,2,1,1,1
6128,6,286,11,6,10,0,0,1,11,2,4,2,4,6,6,10,15,1,15,0,0,2,1,1,1
6129,97,2193,1043,504,840,53,9,147,1096,9,180,112,198,189,310,1377,2344,4,11604,644,0,2,4,4,1
6130,97,2193,383,288,292,26,6,62,409,11,65,38,67,76,105,429,656,5,3719,206,0,2,4,4,1
6131,63,1148,1020,354,843,12,15,144,1032,8,134,77,144,142,221,970,1580,4,6792,377,0,2,3,3,1
6132,247,5301,72,33,56,0,4,12,72,1,1,1,1,2,2,0,2,0,1,0,0,2,1,1,1
6133,247,5301,1454,835,1044,76,110,219,1530,17,275,158,296,292,454,2297,3718,9,34017,1889,1,2,1,1,1
6134,10,326,72,33,56,0,4,12,72,1,1,1,1,2,2,0,2,0,1,0,0,2,7,5,1
6135,6,286,42,7,35,4,0,5,46,1,2,1,2,3,3,2,4,0,2,0,0,2,1,1,1
6136,6,286,11,6,10,0,0,1,11,2,4,2,4,6,6,10,15,1,15,0,0,2,1,1,1
6137,247,5301,72,33,56,0,4,12,72,1,1,1,1,2,2,0,2,0,1,0,0,2,10,9,1
6138,247,5301,1454,835,1044,76,110,219,1530,17,275,158,296,292,454,2297,3718,9,34017,1889,1,2,10,9,1
6139,6,286,42,7,35,4,0,5,46,1,2,1,2,3,3,2,4,0,2,0,0,2,2,2,1
6140,6,286,11,6,10,0,0,1,11,2,4,2,4,6,6,10,15,1,15,0,0,2,2,2,1
6141,148,3361,77,34,69,0,0,8,77,3,24,16,29,27,45,114,213,1,387,21,0,2,7,7,1
6142,148,3361,712,438,573,51,9,84,763,14,102,71,128,116,199,733,1364,8,11988,666,0,2,7,7,1
6143,39,1240,1523,757,1297,19,12,193,1542,12,193,117,230,205,347,1508,2664,7,19053,1058,0,2,60,66,1
6144,39,1240,701,378,504,33,58,109,734,13,110,68,126,123,194,794,1346,7,10027,557,0,2,60,66,1
6145,50,966,1098,241,925,5,10,155,1103,7,46,25,49,53,74,273,423,3,1580,87,0,2,4,0,1
6146,50,966,282,202,222,14,2,44,296,8,42,24,43,50,67,250,378,4,1548,86,0,2,4,0,1
6147,22,846,1098,241,925,5,10,155,1103,7,46,25,49,53,74,273,423,3,1580,87,0,2,23,0,1
6148,45,434,647,139,84,35,284,233,682,0,0,0,0,0,0,0,0,0,0,0,0,2,19,6,1
6149,149,3388,77,34,69,0,0,8,77,3,24,16,29,27,45,114,213,1,387,21,0,2,6,2,1
6150,149,3388,712,438,573,51,9,84,763,14,102,71,128,116,199,733,1364,8,11988,666,0,2,6,2,1
6151,93,2136,1043,504,840,53,9,147,1096,9,180,112,198,189,310,1377,2344,4,11604,644,0,2,13,36,1
6152,93,2136,383,288,292,26,6,62,409,11,65,38,67,76,105,429,656,5,3719,206,0,2,13,36,1
6153,6,286,42,7,35,4,0,5,46,1,2,1,2,3,3,2,4,0,2,0,0,2,2,2,1
6154,6,286,11,6,10,0,0,1,11,2,4,2,4,6,6,10,15,1,15,0,0,2,2,2,1
6155,42,1681,1043,504,840,53,9,147,1096,9,180,112,198,189,310,1377,2344,4,11604,644,0,2,3,3,1
6156,43,413,647,139,84,35,284,233,682,0,0,0,0,0,0,0,0,0,0,0,0,2,0,8,1
6157,91,2091,1043,504,840,53,9,147,1096,9,180,112,198,189,310,1377,2344,4,11604,644,0,2,0,7,1
6158,91,2091,383,288,292,26,6,62,409,11,65,38,67,76,105,429,656,5,3719,206,0,2,0,7,1
6159,146,2919,1943,715,1694,26,18,214,1969,12,185,120,237,197,357,1436,2721,7,20915,1161,0,2,0,3,1
6160,146,2919,1168,838,957,57,25,144,1225,19,348,224,416,367,640,3018,5452,11,61921,3440,1,2,0,3,1
6161,6,286,42,7,35,4,0,5,46,1,2,1,2,3,3,2,4,0,2,0,0,2,1,1,1
6162,6,286,11,6,10,0,0,1,11,2,4,2,4,6,6,10,15,1,15,0,0,2,1,1,1
6163,39,1597,1513,682,1277,25,13,200,1538,11,199,116,219,210,335,1557,2584,6,15641,868,0,2,1,1,1
6164,247,5301,72,33,56,0,4,12,72,1,1,1,1,2,2,0,2,0,1,0,0,2,16,18,1
6165,247,5301,1454,835,1044,76,110,219,1530,17,275,158,296,292,454,2297,3718,9,34017,1889,1,2,16,18,1
6166,29,603,215,129,180,6,0,29,221,8,65,43,72,73,115,415,711,4,3153,175,0,2,4,1,1
6167,29,603,97,69,77,3,3,16,100,6,22,13,23,28,36,113,173,3,542,30,0,2,4,1,1
6168,6,286,42,7,35,4,0,5,46,1,2,1,2,3,3,2,4,0,2,0,0,2,3,3,1
6169,6,286,11,6,10,0,0,1,11,2,4,2,4,6,6,10,15,1,15,0,0,2,3,3,1
6170,14,1171,215,129,180,6,0,29,221,8,65,43,72,73,115,415,711,4,3153,175,0,2,7,4,1
6171,6,286,42,7,35,4,0,5,46,1,2,1,2,3,3,2,4,0,2,0,0,2,2,2,1
6172,6,286,11,6,10,0,0,1,11,2,4,2,4,6,6,10,15,1,15,0,0,2,2,2,1
6173,247,5322,72,33,56,0,4,12,72,1,1,1,1,2,2,0,2,0,1,0,0,2,2,0,1
6174,247,5322,1454,835,1044,76,110,219,1530,17,275,158,296,292,454,2297,3718,9,34017,1889,1,2,2,0,1
6175,6,286,42,7,35,4,0,5,46,1,2,1,2,3,3,2,4,0,2,0,0,2,3,3,1
6176,6,286,11,6,10,0,0,1,11,2,4,2,4,6,6,10,15,1,15,0,0,2,3,3,1
6177,23,882,1098,241,925,5,10,155,1103,7,46,25,49,53,74,273,423,3,1580,87,0,2,18,1,1
6178,6,286,42,7,35,4,0,5,46,1,2,1,2,3,3,2,4,0,2,0,0,2,3,3,1
6179,6,286,11,6,10,0,0,1,11,2,4,2,4,6,6,10,15,1,15,0,0,2,3,3,1
6180,24,517,447,308,343,6,5,95,453,7,96,59,111,103,170,651,1136,4,4600,255,0,2,1,1,1
6181,24,517,322,174,179,16,74,51,338,10,41,26,46,51,72,252,408,5,2291,127,0,2,1,1,1
6182,6,286,42,7,35,4,0,5,46,1,2,1,2,3,3,2,4,0,2,0,0,2,2,2,1
6183,6,286,11,6,10,0,0,1,11,2,4,2,4,6,6,10,15,1,15,0,0,2,2,2,1
6184,14,877,447,308,343,6,5,95,453,7,96,59,111,103,170,651,1136,4,4600,255,0,2,14,0,1
6185,14,884,447,308,343,6,5,95,453,7,96,59,111,103,170,651,1136,4,4600,255,0,2,1,0,0
6186,51,972,1098,241,925,5,10,155,1103,7,46,25,49,53,74,273,423,3,1580,87,0,2,4,1,1
6187,51,972,282,202,222,14,2,44,296,8,42,24,43,50,67,250,378,4,1548,86,0,2,4,1,1
6188,6,286,42,7,35,4,0,5,46,1,2,1,2,3,3,2,4,0,2,0,0,2,1,1,1
6189,6,286,11,6,10,0,0,1,11,2,4,2,4,6,6,10,15,1,15,0,0,2,1,1,1
6190,24,917,1098,241,925,5,10,155,1103,7,46,25,49,53,74,273,423,3,1580,87,0,2,11,0,1
6191,58,2413,1289,550,1043,56,32,155,1345,10,167,93,185,177,278,1266,2075,5,11498,638,0,2,7,2,1
6192,247,5323,72,33,56,0,4,12,72,1,1,1,1,2,2,0,2,0,1,0,0,2,2,1,0
6193,247,5323,1454,835,1044,76,110,219,1530,17,275,158,296,292,454,2297,3718,9,34017,1889,1,2,2,1,0
6194,6,286,42,7,35,4,0,5,46,1,2,1,2,3,3,2,4,0,2,0,0,2,3,3,0
6195,6,286,11,6,10,0,0,1,11,2,4,2,4,6,6,10,15,1,15,0,0,2,3,3,0
6196,42,1673,1043,504,840,53,9,147,1096,9,180,112,198,189,310,1377,2344,4,11604,644,0,2,4,6,1
6197,66,1221,1020,354,843,12,15,144,1032,8,134,77,144,142,221,970,1580,4,6792,377,0,2,13,2,1
6198,36,1508,1020,354,843,12,15,144,1032,8,134,77,144,142,221,970,1580,4,6792,377,0,2,25,0,1
6199,58,1088,1020,354,843,12,15,144,1032,8,134,77,144,142,221,970,1580,4,6792,377,0,2,0,19,1
6200,253,5394,72,33,56,0,4,12,72,1,1,1,1,2,2,0,2,0,1,0,0,2,18,2,1
6201,253,5394,1454,835,1044,76,110,219,1530,17,275,158,296,292,454,2297,3718,9,34017,1889,1,2,18,2,1
6202,36,1526,1020,354,843,12,15,144,1032,8,134,77,144,142,221,970,1580,4,6792,377,0,2,7,7,1
6203,25,520,447,308,343,6,5,95,453,7,96,59,111,103,170,651,1136,4,4600,255,0,2,4,1,1
6204,25,520,322,174,179,16,74,51,338,10,41,26,46,51,72,252,408,5,2291,127,0,2,4,1,1
6205,16,935,447,308,343,6,5,95,453,7,96,59,111,103,170,651,1136,4,4600,255,0,2,12,4,1
6206,42,1668,1043,504,840,53,9,147,1096,9,180,112,198,189,310,1377,2344,4,11604,644,0,2,1,2,1
6207,6,286,42,7,35,4,0,5,46,1,2,1,2,3,3,2,4,0,2,0,0,2,2,2,1
6208,6,286,11,6,10,0,0,1,11,2,4,2,4,6,6,10,15,1,15,0,0,2,2,2,1
6209,253,5394,72,33,56,0,4,12,72,1,1,1,1,2,2,0,2,0,1,0,0,2,5,6,1
6210,253,5394,1454,835,1044,76,110,219,1530,17,275,158,296,292,454,2297,3718,9,34017,1889,1,2,5,6,1
6211,51,1023,1098,241,925,5,10,155,1103,7,46,25,49,53,74,273,423,3,1580,87,0,2,8,0,1
6212,51,1023,282,202,222,14,2,44,296,8,42,24,43,50,67,250,378,4,1548,86,0,2,8,0,1
6213,6,286,42,7,35,4,0,5,46,1,2,1,2,3,3,2,4,0,2,0,0,2,1,1,1
6214,6,286,11,6,10,0,0,1,11,2,4,2,4,6,6,10,15,1,15,0,0,2,1,1,1
6215,50,983,1098,241,925,5,10,155,1103,7,46,25,49,53,74,273,423,3,1580,87,0,2,2,6,1
6216,50,983,282,202,222,14,2,44,296,8,42,24,43,50,67,250,378,4,1548,86,0,2,2,6,1
6217,18,1009,447,308,343,6,5,95,453,7,96,59,111,103,170,651,1136,4,4600,255,0,2,27,15,1
6218,25,524,447,308,343,6,5,95,453,7,96,59,111,103,170,651,1136,4,4600,255,0,2,1,0,0
6219,25,524,322,174,179,16,74,51,338,10,41,26,46,51,72,252,408,5,2291,127,0,2,1,0,0
6220,29,595,447,308,343,6,5,95,453,7,96,59,111,103,170,651,1136,4,4600,255,0,2,13,0,0
6221,29,595,322,174,179,16,74,51,338,10,41,26,46,51,72,252,408,5,2291,127,0,2,13,0,0
6222,22,1134,447,308,343,6,5,95,453,7,96,59,111,103,170,651,1136,4,4600,255,0,2,21,0,0
6223,29,596,447,308,343,6,5,95,453,7,96,59,111,103,170,651,1136,4,4600,255,0,2,4,0,0
6224,29,596,322,174,179,16,74,51,338,10,41,26,46,51,72,252,408,5,2291,127,0,2,4,0,0
6225,6,286,42,7,35,4,0,5,46,1,2,1,2,3,3,2,4,0,2,0,0,2,1,1,1
6226,6,286,11,6,10,0,0,1,11,2,4,2,4,6,6,10,15,1,15,0,0,2,1,1,1
6227,92,2141,1043,504,840,53,9,147,1096,9,180,112,198,189,310,1377,2344,4,11604,644,0,2,11,3,1
6228,92,2141,383,288,292,26,6,62,409,11,65,38,67,76,105,429,656,5,3719,206,0,2,11,3,1
6229,43,1766,1043,504,840,53,9,147,1096,9,180,112,198,189,310,1377,2344,4,11604,644,0,2,15,0,1
6230,93,2154,1043,504,840,53,9,147,1096,9,180,112,198,189,310,1377,2344,4,11604,644,0,2,2,0,1
6231,93,2154,383,288,292,26,6,62,409,11,65,38,67,76,105,429,656,5,3719,206,0,2,2,0,1
6232,6,286,42,7,35,4,0,5,46,1,2,1,2,3,3,2,4,0,2,0,0,2,2,2,1
6233,6,286,11,6,10,0,0,1,11,2,4,2,4,6,6,10,15,1,15,0,0,2,2,2,1
6234,149,3388,77,34,69,0,0,8,77,3,24,16,29,27,45,114,213,1,387,21,0,2,1,1,1
6235,149,3388,712,438,573,51,9,84,763,14,102,71,128,116,199,733,1364,8,11988,666,0,2,1,1,1
6236,53,2451,1943,715,1694,26,18,214,1969,12,185,120,237,197,357,1436,2721,7,20915,1161,0,2,11,0,1
6237,149,3000,1943,715,1694,26,18,214,1969,12,185,120,237,197,357,1436,2721,7,20915,1161,0,2,12,4,1
6238,149,3000,1168,838,957,57,25,144,1225,19,348,224,416,367,640,3018,5452,11,61921,3440,1,2,12,4,1
6239,55,2523,1943,715,1694,26,18,214,1969,12,185,120,237,197,357,1436,2721,7,20915,1161,0,2,14,0,1
6240,254,5398,72,33,56,0,4,12,72,1,1,1,1,2,2,0,2,0,1,0,0,2,5,3,1
6241,254,5398,1454,835,1044,76,110,219,1530,17,275,158,296,292,454,2297,3718,9,34017,1889,1,2,5,3,1
6242,6,286,42,7,35,4,0,5,46,1,2,1,2,3,3,2,4,0,2,0,0,2,1,1,1
6243,6,286,11,6,10,0,0,1,11,2,4,2,4,6,6,10,15,1,15,0,0,2,1,1,1
6244,6,286,42,7,35,4,0,5,46,1,2,1,2,3,3,2,4,0,2,0,0,2,1,1,1
6245,6,286,11,6,10,0,0,1,11,2,4,2,4,6,6,10,15,1,15,0,0,2,1,1,1
6246,39,1254,1523,757,1297,19,12,193,1542,12,193,117,230,205,347,1508,2664,7,19053,1058,0,2,14,8,1
6247,39,1254,701,378,504,33,58,109,734,13,110,68,126,123,194,794,1346,7,10027,557,0,2,14,8,1
6248,29,1871,1523,757,1297,19,12,193,1542,12,193,117,230,205,347,1508,2664,7,19053,1058,0,2,13,17,1
6249,6,286,42,7,35,4,0,5,46,1,2,1,2,3,3,2,4,0,2,0,0,2,1,1,0
6250,6,286,11,6,10,0,0,1,11,2,4,2,4,6,6,10,15,1,15,0,0,2,1,1,0
6251,118,3823,1660,832,1314,41,38,274,1701,20,312,209,395,332,604,2671,5058,12,64042,3557,1,2,0,1,0
6252,118,3823,1057,646,719,113,100,145,1170,18,215,134,248,233,382,1740,3004,10,31186,1732,1,2,0,1,0
6253,83,1472,1178,367,1042,6,15,115,1184,9,94,51,95,103,146,644,976,4,4439,246,0,2,8,0,1
6254,83,1472,177,108,140,8,0,27,185,6,30,16,32,36,48,162,248,3,794,44,0,2,8,0,1
6255,50,991,1098,241,925,5,10,155,1103,7,46,25,49,53,74,273,423,3,1580,87,0,2,9,3,1
6256,50,991,282,202,222,14,2,44,296,8,42,24,43,50,67,250,378,4,1548,86,0,2,9,3,1
6257,6,286,42,7,35,4,0,5,46,1,2,1,2,3,3,2,4,0,2,0,0,2,1,1,1
6258,6,286,11,6,10,0,0,1,11,2,4,2,4,6,6,10,15,1,15,0,0,2,1,1,1
6259,25,961,1098,241,925,5,10,155,1103,7,46,25,49,53,74,273,423,3,1580,87,0,2,21,0,1
6260,118,3823,1660,832,1314,41,38,274,1701,20,312,209,395,332,604,2671,5058,12,64042,3557,1,2,0,1,0
6261,118,3823,1057,646,719,113,100,145,1170,18,215,134,248,233,382,1740,3004,10,31186,1732,1,2,0,1,0
6262,58,1217,477,336,357,30,23,73,507,16,194,134,250,210,384,1538,2962,10,30538,1696,0,2,1,0,1
6263,29,1871,1523,757,1297,19,12,193,1542,12,193,117,230,205,347,1508,2664,7,19053,1058,0,2,1,1,1
6264,93,2152,1043,504,840,53,9,147,1096,9,180,112,198,189,310,1377,2344,4,11604,644,0,2,2,1,1
6265,93,2152,383,288,292,26,6,62,409,11,65,38,67,76,105,429,656,5,3719,206,0,2,2,1,1
6266,118,3823,1660,832,1314,41,38,274,1701,20,312,209,395,332,604,2671,5058,12,64042,3557,1,2,1,1,1
6267,118,3823,1057,646,719,113,100,145,1170,18,215,134,248,233,382,1740,3004,10,31186,1732,1,2,1,1,1
6268,100,2215,1660,832,1314,41,38,274,1701,20,312,209,395,332,604,2671,5058,12,64042,3557,1,2,4,0,1
6269,27,565,2,2,2,0,0,0,2,0,0,0,0,0,0,0,0,0,0,0,0,2,1,1,1
6270,27,565,99,48,90,1,3,5,100,0,0,0,0,0,0,0,0,0,0,0,0,2,1,1,1
6271,27,565,8,5,5,2,0,1,10,0,0,0,0,0,0,0,0,0,0,0,0,2,1,1,1
6272,27,565,1217,716,841,84,126,174,1301,14,185,118,215,199,333,1446,2542,8,20687,1149,0,2,1,1,1
6273,27,565,160,89,115,0,13,31,160,7,15,11,17,22,28,78,124,3,495,27,0,2,1,1,1
6274,27,565,10,10,9,9,0,0,19,0,0,0,0,0,0,0,0,0,0,0,0,2,1,1,1
6275,27,565,173,84,99,8,29,36,181,5,12,7,13,17,20,54,81,2,221,12,0,2,1,1,1
6276,27,565,3,1,1,3,0,0,6,0,0,0,0,0,0,0,0,0,0,0,0,2,1,1,1
6277,254,5418,72,33,56,0,4,12,72,1,1,1,1,2,2,0,2,0,1,0,0,2,2,0,1
6278,254,5418,1454,835,1044,76,110,219,1530,17,275,158,296,292,454,2297,3718,9,34017,1889,1,2,2,0,1
6279,14,457,184,100,137,2,15,30,186,6,38,20,39,44,59,214,322,3,991,55,0,2,1,1,1
6280,14,457,103,65,74,8,5,16,111,7,17,9,17,24,26,89,119,3,417,23,0,2,1,1,1
6281,6,286,42,7,35,4,0,5,46,1,2,1,2,3,3,2,4,0,2,0,0,2,1,1,0
6282,6,286,11,6,10,0,0,1,11,2,4,2,4,6,6,10,15,1,15,0,0,2,1,1,0
6283,83,1475,1178,367,1042,6,15,115,1184,9,94,51,95,103,146,644,976,4,4439,246,0,2,1,1,1
6284,83,1475,177,108,140,8,0,27,185,6,30,16,32,36,48,162,248,3,794,44,0,2,1,1,1
6285,6,286,42,7,35,4,0,5,46,1,2,1,2,3,3,2,4,0,2,0,0,2,1,1,1
6286,6,286,11,6,10,0,0,1,11,2,4,2,4,6,6,10,15,1,15,0,0,2,1,1,1
6287,6,286,42,7,35,4,0,5,46,1,2,1,2,3,3,2,4,0,2,0,0,2,2,2,1
6288,6,286,11,6,10,0,0,1,11,2,4,2,4,6,6,10,15,1,15,0,0,2,2,2,1
6289,6,286,42,7,35,4,0,5,46,1,2,1,2,3,3,2,4,0,2,0,0,2,2,2,1
6290,6,286,11,6,10,0,0,1,11,2,4,2,4,6,6,10,15,1,15,0,0,2,2,2,1
6291,150,3427,77,34,69,0,0,8,77,3,24,16,29,27,45,114,213,1,387,21,0,2,29,24,1
6292,150,3427,712,438,573,51,9,84,763,14,102,71,128,116,199,733,1364,8,11988,666,0,2,29,24,1
6293,59,2468,1289,550,1043,56,32,155,1345,10,167,93,185,177,278,1266,2075,5,11498,638,0,2,16,0,1
6294,55,2523,1943,715,1694,26,18,214,1969,12,185,120,237,197,357,1436,2721,7,20915,1161,0,2,1,1,1
6295,59,2468,1289,550,1043,56,32,155,1345,10,167,93,185,177,278,1266,2075,5,11498,638,0,2,2,2,0
6296,14,457,184,100,137,2,15,30,186,6,38,20,39,44,59,214,322,3,991,55,0,2,1,1,1
6297,14,457,103,65,74,8,5,16,111,7,17,9,17,24,26,89,119,3,417,23,0,2,1,1,1
6298,100,2224,1660,832,1314,41,38,274,1701,20,312,209,395,332,604,2671,5058,12,64042,3557,1,2,1,0,0
6299,40,1265,1523,757,1297,19,12,193,1542,12,193,117,230,205,347,1508,2664,7,19053,1058,0,2,6,3,1
6300,40,1265,701,378,504,33,58,109,734,13,110,68,126,123,194,794,1346,7,10027,557,0,2,6,3,1
6301,30,1909,1523,757,1297,19,12,193,1542,12,193,117,230,205,347,1508,2664,7,19053,1058,0,2,7,0,1
6302,6,71,127,75,83,2,11,30,129,4,14,7,14,18,21,61,87,2,175,9,0,0,16,0,1
6303,6,71,652,304,544,16,6,88,668,6,89,51,101,95,152,591,998,3,3399,188,0,0,16,0,1
6304,6,71,2,2,2,0,0,0,2,0,0,0,0,0,0,0,0,0,0,0,0,0,16,0,1
6305,6,71,8,5,5,0,0,3,8,0,0,0,0,0,0,0,0,0,0,0,0,0,16,0,1
6306,6,71,2,2,2,0,0,0,2,0,0,0,0,0,0,0,0,0,0,0,0,0,16,0,1
6307,6,71,14,8,8,0,0,6,14,0,0,0,0,0,0,0,0,0,0,0,0,0,16,0,1
6308,6,71,6,4,4,0,0,2,6,0,0,0,0,0,0,0,0,0,0,0,0,0,16,0,1
6309,6,71,6,4,4,0,0,2,6,1,2,1,2,3,3,2,4,0,2,0,0,0,16,0,1
6310,6,71,6,4,4,0,0,2,6,0,0,0,0,0,0,0,0,0,0,0,0,0,16,0,1
6311,6,71,7,5,5,0,0,2,7,0,0,0,0,0,0,0,0,0,0,0,0,0,16,0,1
6312,6,71,6,4,4,0,0,2,6,0,0,0,0,0,0,0,0,0,0,0,0,0,16,0,1
6313,6,71,10,6,6,0,0,4,10,0,0,0,0,0,0,0,0,0,0,0,0,0,16,0,1
6314,6,71,1,1,1,0,0,0,1,0,0,0,0,0,0,0,0,0,0,0,0,0,16,0,1
6315,6,71,1,1,1,0,0,0,1,0,0,0,0,0,0,0,0,0,0,0,0,0,16,0,1
6316,6,71,14,10,10,0,0,4,14,1,1,1,1,2,2,0,2,0,1,0,0,0,16,0,1
6317,6,71,46,26,30,3,0,12,49,3,6,3,6,9,9,20,28,1,42,2,0,0,16,0,1
6318,69,1238,1513,682,1277,25,13,200,1538,11,199,116,219,210,335,1557,2584,6,15641,868,0,2,24,13,1
6319,69,1238,819,519,539,24,98,155,843,15,96,57,106,111,163,690,1107,8,9171,509,0,2,24,13,1
6320,6,286,42,7,35,4,0,5,46,1,2,1,2,3,3,2,4,0,2,0,0,2,1,1,1
6321,6,286,11,6,10,0,0,1,11,2,4,2,4,6,6,10,15,1,15,0,0,2,1,1,1
6322,41,1693,1513,682,1277,25,13,200,1538,11,199,116,219,210,335,1557,2584,6,15641,868,0,2,27,0,1
6323,68,1218,1513,682,1277,25,13,200,1538,11,199,116,219,210,335,1557,2584,6,15641,868,0,2,6,10,0
6324,68,1218,819,519,539,24,98,155,843,15,96,57,106,111,163,690,1107,8,9171,509,0,2,6,10,0
6325,1,194,382,65,130,157,2,92,539,4,10,5,10,14,15,41,57,2,114,6,0,0,273,0,1
6326,56,977,282,196,195,3,0,86,285,8,130,71,141,138,212,936,1507,4,6538,363,0,0,213,0,1
6327,4,77,127,75,83,2,11,30,129,4,14,7,14,18,21,61,87,2,175,9,0,0,10,0,1
6328,4,77,652,304,544,16,6,88,668,6,89,51,101,95,152,591,998,3,3399,188,0,0,10,0,1
6329,4,77,2,2,2,0,0,0,2,0,0,0,0,0,0,0,0,0,0,0,0,0,10,0,1
6330,4,77,8,5,5,0,0,3,8,0,0,0,0,0,0,0,0,0,0,0,0,0,10,0,1
6331,4,77,2,2,2,0,0,0,2,0,0,0,0,0,0,0,0,0,0,0,0,0,10,0,1
6332,4,77,14,8,8,0,0,6,14,0,0,0,0,0,0,0,0,0,0,0,0,0,10,0,1
6333,4,77,6,4,4,0,0,2,6,0,0,0,0,0,0,0,0,0,0,0,0,0,10,0,1
6334,4,77,6,4,4,0,0,2,6,1,2,1,2,3,3,2,4,0,2,0,0,0,10,0,1
6335,4,77,6,4,4,0,0,2,6,0,0,0,0,0,0,0,0,0,0,0,0,0,10,0,1
6336,4,77,7,5,5,0,0,2,7,0,0,0,0,0,0,0,0,0,0,0,0,0,10,0,1
6337,4,77,6,4,4,0,0,2,6,0,0,0,0,0,0,0,0,0,0,0,0,0,10,0,1
6338,4,77,10,6,6,0,0,4,10,0,0,0,0,0,0,0,0,0,0,0,0,0,10,0,1
6339,4,77,1,1,1,0,0,0,1,0,0,0,0,0,0,0,0,0,0,0,0,0,10,0,1
6340,4,77,1,1,1,0,0,0,1,0,0,0,0,0,0,0,0,0,0,0,0,0,10,0,1
6341,4,77,14,10,10,0,0,4,14,1,1,1,1,2,2,0,2,0,1,0,0,0,10,0,1
6342,4,77,46,26,30,3,0,12,49,3,6,3,6,9,9,20,28,1,42,2,0,0,10,0,1
6343,1,9,2,2,2,0,0,0,2,0,0,0,0,0,0,0,0,0,0,0,0,0,5,0,1
6344,1,84,13,10,10,0,0,3,13,1,2,1,2,3,3,2,4,0,2,0,0,0,14,0,1
6345,7,111,44,19,17,0,16,11,44,3,14,7,14,17,21,58,85,1,128,7,0,0,42,0,1
6346,3,71,127,75,83,2,11,30,129,4,14,7,14,18,21,61,87,2,175,9,0,0,17,0,1
6347,3,71,652,304,544,16,6,88,668,6,89,51,101,95,152,591,998,3,3399,188,0,0,17,0,1
6348,3,71,2,2,2,0,0,0,2,0,0,0,0,0,0,0,0,0,0,0,0,0,17,0,1
6349,3,71,8,5,5,0,0,3,8,0,0,0,0,0,0,0,0,0,0,0,0,0,17,0,1
6350,3,71,2,2,2,0,0,0,2,0,0,0,0,0,0,0,0,0,0,0,0,0,17,0,1
6351,3,71,14,8,8,0,0,6,14,0,0,0,0,0,0,0,0,0,0,0,0,0,17,0,1
6352,3,71,6,4,4,0,0,2,6,0,0,0,0,0,0,0,0,0,0,0,0,0,17,0,1
6353,3,71,6,4,4,0,0,2,6,1,2,1,2,3,3,2,4,0,2,0,0,0,17,0,1
6354,3,71,6,4,4,0,0,2,6,0,0,0,0,0,0,0,0,0,0,0,0,0,17,0,1
6355,3,71,7,5,5,0,0,2,7,0,0,0,0,0,0,0,0,0,0,0,0,0,17,0,1
6356,3,71,6,4,4,0,0,2,6,0,0,0,0,0,0,0,0,0,0,0,0,0,17,0,1
6357,3,71,10,6,6,0,0,4,10,0,0,0,0,0,0,0,0,0,0,0,0,0,17,0,1
6358,3,71,1,1,1,0,0,0,1,0,0,0,0,0,0,0,0,0,0,0,0,0,17,0,1
6359,3,71,1,1,1,0,0,0,1,0,0,0,0,0,0,0,0,0,0,0,0,0,17,0,1
6360,3,71,14,10,10,0,0,4,14,1,1,1,1,2,2,0,2,0,1,0,0,0,17,0,1
6361,3,71,46,26,30,3,0,12,49,3,6,3,6,9,9,20,28,1,42,2,0,0,17,0,1
6362,10,326,72,33,56,0,4,12,72,1,1,1,1,2,2,0,2,0,1,0,0,0,60,0,1
6363,12,222,127,75,83,2,11,30,129,4,14,7,14,18,21,61,87,2,175,9,0,0,40,0,1
6364,12,222,652,304,544,16,6,88,668,6,89,51,101,95,152,591,998,3,3399,188,0,0,40,0,1
6365,12,222,2,2,2,0,0,0,2,0,0,0,0,0,0,0,0,0,0,0,0,0,40,0,1
6366,12,222,8,5,5,0,0,3,8,0,0,0,0,0,0,0,0,0,0,0,0,0,40,0,1
6367,12,222,2,2,2,0,0,0,2,0,0,0,0,0,0,0,0,0,0,0,0,0,40,0,1
6368,12,222,14,8,8,0,0,6,14,0,0,0,0,0,0,0,0,0,0,0,0,0,40,0,1
6369,12,222,6,4,4,0,0,2,6,0,0,0,0,0,0,0,0,0,0,0,0,0,40,0,1
6370,12,222,6,4,4,0,0,2,6,1,2,1,2,3,3,2,4,0,2,0,0,0,40,0,1
6371,12,222,6,4,4,0,0,2,6,0,0,0,0,0,0,0,0,0,0,0,0,0,40,0,1
6372,12,222,7,5,5,0,0,2,7,0,0,0,0,0,0,0,0,0,0,0,0,0,40,0,1
6373,12,222,6,4,4,0,0,2,6,0,0,0,0,0,0,0,0,0,0,0,0,0,40,0,1
6374,12,222,10,6,6,0,0,4,10,0,0,0,0,0,0,0,0,0,0,0,0,0,40,0,1
6375,12,222,1,1,1,0,0,0,1,0,0,0,0,0,0,0,0,0,0,0,0,0,40,0,1
6376,12,222,1,1,1,0,0,0,1,0,0,0,0,0,0,0,0,0,0,0,0,0,40,0,1
6377,12,222,14,10,10,0,0,4,14,1,1,1,1,2,2,0,2,0,1,0,0,0,40,0,1
6378,12,222,46,26,30,3,0,12,49,3,6,3,6,9,9,20,28,1,42,2,0,0,40,0,1
6379,6,71,127,75,83,2,11,30,129,4,14,7,14,18,21,61,87,2,175,9,0,0,16,0,1
6380,6,71,652,304,544,16,6,88,668,6,89,51,101,95,152,591,998,3,3399,188,0,0,16,0,1
6381,6,71,2,2,2,0,0,0,2,0,0,0,0,0,0,0,0,0,0,0,0,0,16,0,1
6382,6,71,8,5,5,0,0,3,8,0,0,0,0,0,0,0,0,0,0,0,0,0,16,0,1
6383,6,71,2,2,2,0,0,0,2,0,0,0,0,0,0,0,0,0,0,0,0,0,16,0,1
6384,6,71,14,8,8,0,0,6,14,0,0,0,0,0,0,0,0,0,0,0,0,0,16,0,1
6385,6,71,6,4,4,0,0,2,6,0,0,0,0,0,0,0,0,0,0,0,0,0,16,0,1
6386,6,71,6,4,4,0,0,2,6,1,2,1,2,3,3,2,4,0,2,0,0,0,16,0,1
6387,6,71,6,4,4,0,0,2,6,0,0,0,0,0,0,0,0,0,0,0,0,0,16,0,1
6388,6,71,7,5,5,0,0,2,7,0,0,0,0,0,0,0,0,0,0,0,0,0,16,0,1
6389,6,71,6,4,4,0,0,2,6,0,0,0,0,0,0,0,0,0,0,0,0,0,16,0,1
6390,6,71,10,6,6,0,0,4,10,0,0,0,0,0,0,0,0,0,0,0,0,0,16,0,1
6391,6,71,1,1,1,0,0,0,1,0,0,0,0,0,0,0,0,0,0,0,0,0,16,0,1
6392,6,71,1,1,1,0,0,0,1,0,0,0,0,0,0,0,0,0,0,0,0,0,16,0,1
6393,6,71,14,10,10,0,0,4,14,1,1,1,1,2,2,0,2,0,1,0,0,0,16,0,1
6394,6,71,46,26,30,3,0,12,49,3,6,3,6,9,9,20,28,1,42,2,0,0,16,0,1
6395,3,23,14,7,7,2,0,5,16,0,0,0,0,0,0,0,0,0,0,0,0,0,11,0,1
6396,6,81,38,23,23,0,0,15,38,0,0,0,0,0,0,0,0,0,0,0,0,0,25,0,1
6397,1,170,382,65,130,157,2,92,539,4,10,5,10,14,15,41,57,2,114,6,0,2,1,3,0
6398,1,173,382,65,130,157,2,92,539,4,10,5,10,14,15,41,57,2,114,6,0,2,1,3,0
6399,1,172,382,65,130,157,2,92,539,4,10,5,10,14,15,41,57,2,114,6,0,2,1,1,1
6400,1,175,382,65,130,157,2,92,539,4,10,5,10,14,15,41,57,2,114,6,0,2,1,1,1
6401,1,172,382,65,130,157,2,92,539,4,10,5,10,14,15,41,57,2,114,6,0,2,8,7,1
6402,118,3823,1660,832,1314,41,38,274,1701,20,312,209,395,332,604,2671,5058,12,64042,3557,1,2,1,1,0
6403,118,3823,1057,646,719,113,100,145,1170,18,215,134,248,233,382,1740,3004,10,31186,1732,1,2,1,1,0
6404,6,286,42,7,35,4,0,5,46,1,2,1,2,3,3,2,4,0,2,0,0,2,1,1,1
6405,6,286,11,6,10,0,0,1,11,2,4,2,4,6,6,10,15,1,15,0,0,2,1,1,1
6406,1,172,382,65,130,157,2,92,539,4,10,5,10,14,15,41,57,2,114,6,0,2,1,1,1
6407,83,1481,1178,367,1042,6,15,115,1184,9,94,51,95,103,146,644,976,4,4439,246,0,2,1,0,1
6408,83,1481,177,108,140,8,0,27,185,6,30,16,32,36,48,162,248,3,794,44,0,2,1,0,1
6409,37,1694,1178,367,1042,6,15,115,1184,9,94,51,95,103,146,644,976,4,4439,246,0,2,16,0,1
6410,153,3064,1943,715,1694,26,18,214,1969,12,185,120,237,197,357,1436,2721,7,20915,1161,0,2,11,0,1
6411,153,3064,1168,838,957,57,25,144,1225,19,348,224,416,367,640,3018,5452,11,61921,3440,1,2,11,0,1
6412,56,2543,1943,715,1694,26,18,214,1969,12,185,120,237,197,357,1436,2721,7,20915,1161,0,2,4,0,1
6413,43,415,647,139,84,35,284,233,682,0,0,0,0,0,0,0,0,0,0,0,0,2,1,1,1
6414,150,3427,77,34,69,0,0,8,77,3,24,16,29,27,45,114,213,1,387,21,0,2,0,1,1
6415,150,3427,712,438,573,51,9,84,763,14,102,71,128,116,199,733,1364,8,11988,666,0,2,0,1,1
6416,154,3083,1943,715,1694,26,18,214,1969,12,185,120,237,197,357,1436,2721,7,20915,1161,0,2,11,7,1
6417,154,3083,1168,838,957,57,25,144,1225,19,348,224,416,367,640,3018,5452,11,61921,3440,1,2,11,7,1
6418,6,286,42,7,35,4,0,5,46,1,2,1,2,3,3,2,4,0,2,0,0,2,1,1,1
6419,6,286,11,6,10,0,0,1,11,2,4,2,4,6,6,10,15,1,15,0,0,2,1,1,1
6420,56,2548,1943,715,1694,26,18,214,1969,12,185,120,237,197,357,1436,2721,7,20915,1161,0,2,8,5,1
6421,118,3820,1660,832,1314,41,38,274,1701,20,312,209,395,332,604,2671,5058,12,64042,3557,1,2,43,40,1
6422,118,3820,1057,646,719,113,100,145,1170,18,215,134,248,233,382,1740,3004,10,31186,1732,1,2,43,40,1
6423,58,1217,477,336,357,30,23,73,507,16,194,134,250,210,384,1538,2962,10,30538,1696,0,2,1,3,1
6424,150,3428,77,34,69,0,0,8,77,3,24,16,29,27,45,114,213,1,387,21,0,2,13,8,1
6425,150,3428,712,438,573,51,9,84,763,14,102,71,128,116,199,733,1364,8,11988,666,0,2,13,8,1
6426,35,628,127,75,83,2,11,30,129,4,14,7,14,18,21,61,87,2,175,9,0,2,1,0,0
6427,35,628,652,304,544,16,6,88,668,6,89,51,101,95,152,591,998,3,3399,188,0,2,1,0,0
6428,35,628,2,2,2,0,0,0,2,0,0,0,0,0,0,0,0,0,0,0,0,2,1,0,0
6429,35,628,8,5,5,0,0,3,8,0,0,0,0,0,0,0,0,0,0,0,0,2,1,0,0
6430,35,628,2,2,2,0,0,0,2,0,0,0,0,0,0,0,0,0,0,0,0,2,1,0,0
6431,35,628,14,8,8,0,0,6,14,0,0,0,0,0,0,0,0,0,0,0,0,2,1,0,0
6432,35,628,6,4,4,0,0,2,6,0,0,0,0,0,0,0,0,0,0,0,0,2,1,0,0
6433,35,628,6,4,4,0,0,2,6,1,2,1,2,3,3,2,4,0,2,0,0,2,1,0,0
6434,35,628,6,4,4,0,0,2,6,0,0,0,0,0,0,0,0,0,0,0,0,2,1,0,0
6435,35,628,7,5,5,0,0,2,7,0,0,0,0,0,0,0,0,0,0,0,0,2,1,0,0
6436,35,628,6,4,4,0,0,2,6,0,0,0,0,0,0,0,0,0,0,0,0,2,1,0,0
6437,35,628,10,6,6,0,0,4,10,0,0,0,0,0,0,0,0,0,0,0,0,2,1,0,0
6438,35,628,1,1,1,0,0,0,1,0,0,0,0,0,0,0,0,0,0,0,0,2,1,0,0
6439,35,628,1,1,1,0,0,0,1,0,0,0,0,0,0,0,0,0,0,0,0,2,1,0,0
6440,35,628,14,10,10,0,0,4,14,1,1,1,1,2,2,0,2,0,1,0,0,2,1,0,0
6441,35,628,46,26,30,3,0,12,49,3,6,3,6,9,9,20,28,1,42,2,0,2,1,0,0
6442,40,1264,1523,757,1297,19,12,193,1542,12,193,117,230,205,347,1508,2664,7,19053,1058,0,2,3,3,1
6443,40,1264,701,378,504,33,58,109,734,13,110,68,126,123,194,794,1346,7,10027,557,0,2,3,3,1
6444,150,3423,77,34,69,0,0,8,77,3,24,16,29,27,45,114,213,1,387,21,0,2,1,1,1
6445,150,3423,712,438,573,51,9,84,763,14,102,71,128,116,199,733,1364,8,11988,666,0,2,1,1,1
6446,23,555,1293,570,1093,25,15,163,1318,10,195,123,241,205,364,1516,2795,6,17273,959,0,2,2,2,1
6447,83,1451,1178,367,1042,6,15,115,1184,9,94,51,95,103,146,644,976,4,4439,246,0,2,16,16,1
6448,83,1451,177,108,140,8,0,27,185,6,30,16,32,36,48,162,248,3,794,44,0,2,16,16,1
6449,6,286,42,7,35,4,0,5,46,1,2,1,2,3,3,2,4,0,2,0,0,2,1,1,1
6450,6,286,11,6,10,0,0,1,11,2,4,2,4,6,6,10,15,1,15,0,0,2,1,1,1
6451,30,1909,1523,757,1297,19,12,193,1542,12,193,117,230,205,347,1508,2664,7,19053,1058,0,2,2,2,1
6452,38,1723,1178,367,1042,6,15,115,1184,9,94,51,95,103,146,644,976,4,4439,246,0,2,29,5,1
6453,94,2157,1043,504,840,53,9,147,1096,9,180,112,198,189,310,1377,2344,4,11604,644,0,2,5,2,1
6454,94,2157,383,288,292,26,6,62,409,11,65,38,67,76,105,429,656,5,3719,206,0,2,5,2,1
6455,154,3088,1943,715,1694,26,18,214,1969,12,185,120,237,197,357,1436,2721,7,20915,1161,0,2,5,4,1
6456,154,3088,1168,838,957,57,25,144,1225,19,348,224,416,367,640,3018,5452,11,61921,3440,1,2,5,4,1
6457,44,1808,1043,504,840,53,9,147,1096,9,180,112,198,189,310,1377,2344,4,11604,644,0,2,18,0,1
6458,68,1215,1513,682,1277,25,13,200,1538,11,199,116,219,210,335,1557,2584,6,15641,868,0,2,3,3,1
6459,68,1215,819,519,539,24,98,155,843,15,96,57,106,111,163,690,1107,8,9171,509,0,2,3,3,1
6460,181,4153,77,34,69,0,0,8,77,3,24,16,29,27,45,114,213,1,387,21,0,2,168,9,1
6461,181,4153,712,438,573,51,9,84,763,14,102,71,128,116,199,733,1364,8,11988,666,0,2,168,9,1
6462,185,4355,722,423,573,19,0,135,741,12,172,101,199,184,300,1320,2257,6,15668,870,0,2,1,1,1
6463,185,4355,1508,847,911,44,250,301,1552,14,148,88,169,162,257,1120,1886,7,15077,837,0,2,1,1,1
6464,233,4981,72,33,56,0,4,12,72,1,1,1,1,2,2,0,2,0,1,0,0,2,178,271,1
6465,233,4981,1454,835,1044,76,110,219,1530,17,275,158,296,292,454,2297,3718,9,34017,1889,1,2,178,271,1
6466,29,603,215,129,180,6,0,29,221,8,65,43,72,73,115,415,711,4,3153,175,0,2,3,1,1
6467,29,603,97,69,77,3,3,16,100,6,22,13,23,28,36,113,173,3,542,30,0,2,3,1,1
6468,11,345,442,244,305,14,16,103,456,11,68,45,75,79,120,452,756,6,4588,254,0,2,3,3,1
6469,11,345,182,102,99,11,40,35,193,3,11,6,11,14,17,42,64,1,97,5,0,2,3,3,1
6470,1,178,382,65,130,157,2,92,539,4,10,5,10,14,15,41,57,2,114,6,0,2,7,2,1
6471,6,286,42,7,35,4,0,5,46,1,2,1,2,3,3,2,4,0,2,0,0,2,1,1,1
6472,6,286,11,6,10,0,0,1,11,2,4,2,4,6,6,10,15,1,15,0,0,2,1,1,1
6473,28,1113,1450,624,1228,12,26,181,1462,14,306,186,354,320,540,2580,4493,8,36391,2021,1,2,19,27,1
6474,6,452,442,244,305,14,16,103,456,11,68,45,75,79,120,452,756,6,4588,254,0,2,2,3,1
6475,233,4981,72,33,56,0,4,12,72,1,1,1,1,2,2,0,2,0,1,0,0,2,3,3,0
6476,233,4981,1454,835,1044,76,110,219,1530,17,275,158,296,292,454,2297,3718,9,34017,1889,1,2,3,3,0
6477,137,2710,1457,730,1242,11,6,188,1468,10,292,166,329,302,495,2424,4078,5,22973,1276,1,2,0,3,0
6478,137,2710,74,35,59,1,0,14,75,3,14,7,14,17,21,58,85,1,128,7,0,2,0,3,0
6479,137,2710,245,125,200,5,7,34,250,7,30,17,34,37,51,166,265,3,1053,58,0,2,0,3,0
6480,139,2729,1457,730,1242,11,6,188,1468,10,292,166,329,302,495,2424,4078,5,22973,1276,1,2,14,10,1
6481,139,2729,74,35,59,1,0,14,75,3,14,7,14,17,21,58,85,1,128,7,0,2,14,10,1
6482,139,2729,245,125,200,5,7,34,250,7,30,17,34,37,51,166,265,3,1053,58,0,2,14,10,1
6483,6,286,42,7,35,4,0,5,46,1,2,1,2,3,3,2,4,0,2,0,0,2,1,1,1
6484,6,286,11,6,10,0,0,1,11,2,4,2,4,6,6,10,15,1,15,0,0,2,1,1,1
6485,27,1295,652,304,544,16,6,88,668,6,89,51,101,95,152,591,998,3,3399,188,0,2,13,1,1
6486,29,603,2,2,2,0,0,0,2,0,0,0,0,0,0,0,0,0,0,0,0,2,4,0,1
6487,29,603,99,48,90,1,3,5,100,0,0,0,0,0,0,0,0,0,0,0,0,2,4,0,1
6488,29,603,8,5,5,2,0,1,10,0,0,0,0,0,0,0,0,0,0,0,0,2,4,0,1
6489,29,603,1217,716,841,84,126,174,1301,14,185,118,215,199,333,1446,2542,8,20687,1149,0,2,4,0,1
6490,29,603,160,89,115,0,13,31,160,7,15,11,17,22,28,78,124,3,495,27,0,2,4,0,1
6491,29,603,10,10,9,9,0,0,19,0,0,0,0,0,0,0,0,0,0,0,0,2,4,0,1
6492,29,603,173,84,99,8,29,36,181,5,12,7,13,17,20,54,81,2,221,12,0,2,4,0,1
6493,29,603,3,1,1,3,0,0,6,0,0,0,0,0,0,0,0,0,0,0,0,2,4,0,1
6494,57,1197,477,336,357,30,23,73,507,16,194,134,250,210,384,1538,2962,10,30538,1696,0,2,0,3,1
6495,29,1163,1450,624,1228,12,26,181,1462,14,306,186,354,320,540,2580,4493,8,36391,2021,1,2,23,0,1
6496,118,3822,1660,832,1314,41,38,274,1701,20,312,209,395,332,604,2671,5058,12,64042,3557,1,2,1,1,0
6497,118,3822,1057,646,719,113,100,145,1170,18,215,134,248,233,382,1740,3004,10,31186,1732,1,2,1,1,0
6498,100,2272,1660,832,1314,41,38,274,1701,20,312,209,395,332,604,2671,5058,12,64042,3557,1,2,6,0,0
6499,100,2255,1660,832,1314,41,38,274,1701,20,312,209,395,332,604,2671,5058,12,64042,3557,1,2,4,6,1
6500,154,3088,1943,715,1694,26,18,214,1969,12,185,120,237,197,357,1436,2721,7,20915,1161,0,2,1,1,1
6501,154,3088,1168,838,957,57,25,144,1225,19,348,224,416,367,640,3018,5452,11,61921,3440,1,2,1,1,1
6502,68,1224,1513,682,1277,25,13,200,1538,11,199,116,219,210,335,1557,2584,6,15641,868,0,2,3,2,1
6503,68,1224,819,519,539,24,98,155,843,15,96,57,106,111,163,690,1107,8,9171,509,0,2,3,2,1
6504,153,3459,77,34,69,0,0,8,77,3,24,16,29,27,45,114,213,1,387,21,0,2,10,143,1
6505,153,3459,712,438,573,51,9,84,763,14,102,71,128,116,199,733,1364,8,11988,666,0,2,10,143,1
6506,261,5627,72,33,56,0,4,12,72,1,1,1,1,2,2,0,2,0,1,0,0,2,144,12,1
6507,261,5627,1454,835,1044,76,110,219,1530,17,275,158,296,292,454,2297,3718,9,34017,1889,1,2,144,12,1
6508,154,3478,77,34,69,0,0,8,77,3,24,16,29,27,45,114,213,1,387,21,0,2,26,0,0
6509,154,3478,712,438,573,51,9,84,763,14,102,71,128,116,199,733,1364,8,11988,666,0,2,26,0,0
6510,1,178,382,65,130,157,2,92,539,4,10,5,10,14,15,41,57,2,114,6,0,2,1,1,1
6511,154,3478,77,34,69,0,0,8,77,3,24,16,29,27,45,114,213,1,387,21,0,2,1,1,1
6512,154,3478,712,438,573,51,9,84,763,14,102,71,128,116,199,733,1364,8,11988,666,0,2,1,1,1
6513,1,181,382,65,130,157,2,92,539,4,10,5,10,14,15,41,57,2,114,6,0,2,1,0,1
6514,68,1224,1513,682,1277,25,13,200,1538,11,199,116,219,210,335,1557,2584,6,15641,868,0,2,2,2,1
6515,68,1224,819,519,539,24,98,155,843,15,96,57,106,111,163,690,1107,8,9171,509,0,2,2,2,1
6516,153,3466,77,34,69,0,0,8,77,3,24,16,29,27,45,114,213,1,387,21,0,2,4,4,1
6517,153,3466,712,438,573,51,9,84,763,14,102,71,128,116,199,733,1364,8,11988,666,0,2,4,4,1
6518,277,5802,72,33,56,0,4,12,72,1,1,1,1,2,2,0,2,0,1,0,0,2,221,172,1
6519,277,5802,1454,835,1044,76,110,219,1530,17,275,158,296,292,454,2297,3718,9,34017,1889,1,2,221,172,1
6520,11,347,442,244,305,14,16,103,456,11,68,45,75,79,120,452,756,6,4588,254,0,2,3,3,1
6521,11,347,182,102,99,11,40,35,193,3,11,6,11,14,17,42,64,1,97,5,0,2,3,3,1
6522,68,1223,1513,682,1277,25,13,200,1538,11,199,116,219,210,335,1557,2584,6,15641,868,0,2,2,2,1
6523,68,1223,819,519,539,24,98,155,843,15,96,57,106,111,163,690,1107,8,9171,509,0,2,2,2,1
6524,175,4097,77,34,69,0,0,8,77,3,24,16,29,27,45,114,213,1,387,21,0,2,97,0,1
6525,175,4097,712,438,573,51,9,84,763,14,102,71,128,116,199,733,1364,8,11988,666,0,2,97,0,1
6526,258,5343,72,33,56,0,4,12,72,1,1,1,1,2,2,0,2,0,1,0,0,2,26,91,1
6527,258,5343,1454,835,1044,76,110,219,1530,17,275,158,296,292,454,2297,3718,9,34017,1889,1,2,26,91,1
6528,36,1526,1020,354,843,12,15,144,1032,8,134,77,144,142,221,970,1580,4,6792,377,0,2,1,1,1
6529,23,970,373,158,315,8,0,51,381,5,76,44,79,81,123,486,779,2,2026,112,0,2,9,9,1
6530,182,4179,77,34,69,0,0,8,77,3,24,16,29,27,45,114,213,1,387,21,0,2,72,55,1
6531,182,4179,712,438,573,51,9,84,763,14,102,71,128,116,199,733,1364,8,11988,666,0,2,72,55,1
6532,185,4360,722,423,573,19,0,135,741,12,172,101,199,184,300,1320,2257,6,15668,870,0,2,4,2,1
6533,185,4360,1508,847,911,44,250,301,1552,14,148,88,169,162,257,1120,1886,7,15077,837,0,2,4,2,1
6534,260,5490,72,33,56,0,4,12,72,1,1,1,1,2,2,0,2,0,1,0,0,2,47,27,1
6535,260,5490,1454,835,1044,76,110,219,1530,17,275,158,296,292,454,2297,3718,9,34017,1889,1,2,47,27,1
6536,23,946,373,158,315,8,0,51,381,5,76,44,79,81,123,486,779,2,2026,112,0,2,6,5,1
6537,6,484,442,244,305,14,16,103,456,11,68,45,75,79,120,452,756,6,4588,254,0,2,8,2,1
6538,189,4278,77,34,69,0,0,8,77,3,24,16,29,27,45,114,213,1,387,21,0,2,18,3,1
6539,189,4278,712,438,573,51,9,84,763,14,102,71,128,116,199,733,1364,8,11988,666,0,2,18,3,1
6540,257,5478,72,33,56,0,4,12,72,1,1,1,1,2,2,0,2,0,1,0,0,2,4,7,1
6541,257,5478,1454,835,1044,76,110,219,1530,17,275,158,296,292,454,2297,3718,9,34017,1889,1,2,4,7,1
6542,260,5629,72,33,56,0,4,12,72,1,1,1,1,2,2,0,2,0,1,0,0,2,35,7,1
6543,260,5629,1454,835,1044,76,110,219,1530,17,275,158,296,292,454,2297,3718,9,34017,1889,1,2,35,7,1
6544,191,4316,77,34,69,0,0,8,77,3,24,16,29,27,45,114,213,1,387,21,0,2,14,5,0
6545,191,4316,712,438,573,51,9,84,763,14,102,71,128,116,199,733,1364,8,11988,666,0,2,14,5,0
6546,261,5650,72,33,56,0,4,12,72,1,1,1,1,2,2,0,2,0,1,0,0,2,4,1,1
6547,261,5650,1454,835,1044,76,110,219,1530,17,275,158,296,292,454,2297,3718,9,34017,1889,1,2,4,1,1
6548,1,181,382,65,130,157,2,92,539,4,10,5,10,14,15,41,57,2,114,6,0,2,1,1,1
6549,6,286,42,7,35,4,0,5,46,1,2,1,2,3,3,2,4,0,2,0,0,2,1,1,1
6550,6,286,11,6,10,0,0,1,11,2,4,2,4,6,6,10,15,1,15,0,0,2,1,1,1
6551,198,4459,77,34,69,0,0,8,77,3,24,16,29,27,45,114,213,1,387,21,0,2,23,2,1
6552,198,4459,712,438,573,51,9,84,763,14,102,71,128,116,199,733,1364,8,11988,666,0,2,23,2,1
6553,263,5769,72,33,56,0,4,12,72,1,1,1,1,2,2,0,2,0,1,0,0,2,50,24,1
6554,263,5769,1454,835,1044,76,110,219,1530,17,275,158,296,292,454,2297,3718,9,34017,1889,1,2,50,24,1
6555,203,4578,77,34,69,0,0,8,77,3,24,16,29,27,45,114,213,1,387,21,0,2,28,4,1
6556,203,4578,712,438,573,51,9,84,763,14,102,71,128,116,199,733,1364,8,11988,666,0,2,28,4,1
6557,270,5894,72,33,56,0,4,12,72,1,1,1,1,2,2,0,2,0,1,0,0,2,24,4,1
6558,270,5894,1454,835,1044,76,110,219,1530,17,275,158,296,292,454,2297,3718,9,34017,1889,1,2,24,4,1
6559,6,286,42,7,35,4,0,5,46,1,2,1,2,3,3,2,4,0,2,0,0,2,1,1,1
6560,6,286,11,6,10,0,0,1,11,2,4,2,4,6,6,10,15,1,15,0,0,2,1,1,1
6561,215,4791,77,34,69,0,0,8,77,3,24,16,29,27,45,114,213,1,387,21,0,2,37,2,1
6562,215,4791,712,438,573,51,9,84,763,14,102,71,128,116,199,733,1364,8,11988,666,0,2,37,2,1
6563,273,5991,72,33,56,0,4,12,72,1,1,1,1,2,2,0,2,0,1,0,0,2,27,9,1
6564,273,5991,1454,835,1044,76,110,219,1530,17,275,158,296,292,454,2297,3718,9,34017,1889,1,2,27,9,1
6565,96,2180,1043,504,840,53,9,147,1096,9,180,112,198,189,310,1377,2344,4,11604,644,0,2,7,3,1
6566,96,2180,383,288,292,26,6,62,409,11,65,38,67,76,105,429,656,5,3719,206,0,2,7,3,1
6567,6,286,42,7,35,4,0,5,46,1,2,1,2,3,3,2,4,0,2,0,0,2,1,1,1
6568,6,286,11,6,10,0,0,1,11,2,4,2,4,6,6,10,15,1,15,0,0,2,1,1,1
6569,220,4925,77,34,69,0,0,8,77,3,24,16,29,27,45,114,213,1,387,21,0,2,40,8,1
6570,220,4925,712,438,573,51,9,84,763,14,102,71,128,116,199,733,1364,8,11988,666,0,2,40,8,1
6571,271,5960,72,33,56,0,4,12,72,1,1,1,1,2,2,0,2,0,1,0,0,2,8,12,1
6572,271,5960,1454,835,1044,76,110,219,1530,17,275,158,296,292,454,2297,3718,9,34017,1889,1,2,8,12,1
6573,223,5008,77,34,69,0,0,8,77,3,24,16,29,27,45,114,213,1,387,21,0,2,34,20,1
6574,223,5008,712,438,573,51,9,84,763,14,102,71,128,116,199,733,1364,8,11988,666,0,2,34,20,1
6575,272,5978,72,33,56,0,4,12,72,1,1,1,1,2,2,0,2,0,1,0,0,2,20,18,1
6576,272,5978,1454,835,1044,76,110,219,1530,17,275,158,296,292,454,2297,3718,9,34017,1889,1,2,20,18,1
6577,259,5695,77,34,69,0,0,8,77,3,24,16,29,27,45,114,213,1,387,21,0,2,154,39,1
6578,259,5695,712,438,573,51,9,84,763,14,102,71,128,116,199,733,1364,8,11988,666,0,2,154,39,1
6579,267,5870,72,33,56,0,4,12,72,1,1,1,1,2,2,0,2,0,1,0,0,2,1,20,1
6580,267,5870,1454,835,1044,76,110,219,1530,17,275,158,296,292,454,2297,3718,9,34017,1889,1,2,1,20,1
6581,6,286,42,7,35,4,0,5,46,1,2,1,2,3,3,2,4,0,2,0,0,2,1,1,1
6582,6,286,11,6,10,0,0,1,11,2,4,2,4,6,6,10,15,1,15,0,0,2,1,1,1
6583,29,1172,1450,624,1228,12,26,181,1462,14,306,186,354,320,540,2580,4493,8,36391,2021,1,2,1,0,0
6584,158,3594,77,34,69,0,0,8,77,3,24,16,29,27,45,114,213,1,387,21,0,2,3,385,1
6585,158,3594,712,438,573,51,9,84,763,14,102,71,128,116,199,733,1364,8,11988,666,0,2,3,385,1
6586,366,7926,72,33,56,0,4,12,72,1,1,1,1,2,2,0,2,0,1,0,0,2,357,1,1
6587,366,7926,1454,835,1044,76,110,219,1530,17,275,158,296,292,454,2297,3718,9,34017,1889,1,2,357,1,1
6588,379,8210,72,33,56,0,4,12,72,1,1,1,1,2,2,0,2,0,1,0,0,2,77,23,1
6589,379,8210,1454,835,1044,76,110,219,1530,17,275,158,296,292,454,2297,3718,9,34017,1889,1,2,77,23,1
6590,379,8214,72,33,56,0,4,12,72,1,1,1,1,2,2,0,2,0,1,0,0,2,5,2,1
6591,379,8214,1454,835,1044,76,110,219,1530,17,275,158,296,292,454,2297,3718,9,34017,1889,1,2,5,2,1
6592,1,181,382,65,130,157,2,92,539,4,10,5,10,14,15,41,57,2,114,6,0,2,1,1,1
6593,6,286,42,7,35,4,0,5,46,1,2,1,2,3,3,2,4,0,2,0,0,2,1,1,1
6594,6,286,11,6,10,0,0,1,11,2,4,2,4,6,6,10,15,1,15,0,0,2,1,1,1
6595,383,8290,72,33,56,0,4,12,72,1,1,1,1,2,2,0,2,0,1,0,0,2,44,8,1
6596,383,8290,1454,835,1044,76,110,219,1530,17,275,158,296,292,454,2297,3718,9,34017,1889,1,2,44,8,1
6597,1,181,382,65,130,157,2,92,539,4,10,5,10,14,15,41,57,2,114,6,0,2,1,1,1
6598,6,286,42,7,35,4,0,5,46,1,2,1,2,3,3,2,4,0,2,0,0,2,1,1,1
6599,6,286,11,6,10,0,0,1,11,2,4,2,4,6,6,10,15,1,15,0,0,2,1,1,1
6600,383,8290,72,33,56,0,4,12,72,1,1,1,1,2,2,0,2,0,1,0,0,2,5,2,1
6601,383,8290,1454,835,1044,76,110,219,1530,17,275,158,296,292,454,2297,3718,9,34017,1889,1,2,5,2,1
6602,1,181,382,65,130,157,2,92,539,4,10,5,10,14,15,41,57,2,114,6,0,2,1,1,1
6603,40,1271,1523,757,1297,19,12,193,1542,12,193,117,230,205,347,1508,2664,7,19053,1058,0,2,1,1,1
6604,40,1271,701,378,504,33,58,109,734,13,110,68,126,123,194,794,1346,7,10027,557,0,2,1,1,1
6605,6,286,42,7,35,4,0,5,46,1,2,1,2,3,3,2,4,0,2,0,0,2,1,1,1
6606,6,286,11,6,10,0,0,1,11,2,4,2,4,6,6,10,15,1,15,0,0,2,1,1,1
6607,31,1956,1523,757,1297,19,12,193,1542,12,193,117,230,205,347,1508,2664,7,19053,1058,0,2,12,0,1
6608,158,3603,77,34,69,0,0,8,77,3,24,16,29,27,45,114,213,1,387,21,0,2,2,1,1
6609,158,3603,712,438,573,51,9,84,763,14,102,71,128,116,199,733,1364,8,11988,666,0,2,2,1,1
6610,388,8375,72,33,56,0,4,12,72,1,1,1,1,2,2,0,2,0,1,0,0,2,34,18,1
6611,388,8375,1454,835,1044,76,110,219,1530,17,275,158,296,292,454,2297,3718,9,34017,1889,1,2,34,18,1
6612,6,286,42,7,35,4,0,5,46,1,2,1,2,3,3,2,4,0,2,0,0,2,1,1,1
6613,6,286,11,6,10,0,0,1,11,2,4,2,4,6,6,10,15,1,15,0,0,2,1,1,1
6614,390,8417,72,33,56,0,4,12,72,1,1,1,1,2,2,0,2,0,1,0,0,2,23,19,1
6615,390,8417,1454,835,1044,76,110,219,1530,17,275,158,296,292,454,2297,3718,9,34017,1889,1,2,23,19,1
6616,3,66,127,75,83,2,11,30,129,4,14,7,14,18,21,61,87,2,175,9,0,2,7,6,1
6617,3,66,652,304,544,16,6,88,668,6,89,51,101,95,152,591,998,3,3399,188,0,2,7,6,1
6618,3,66,2,2,2,0,0,0,2,0,0,0,0,0,0,0,0,0,0,0,0,2,7,6,1
6619,3,66,8,5,5,0,0,3,8,0,0,0,0,0,0,0,0,0,0,0,0,2,7,6,1
6620,3,66,2,2,2,0,0,0,2,0,0,0,0,0,0,0,0,0,0,0,0,2,7,6,1
6621,3,66,14,8,8,0,0,6,14,0,0,0,0,0,0,0,0,0,0,0,0,2,7,6,1
6622,3,66,6,4,4,0,0,2,6,0,0,0,0,0,0,0,0,0,0,0,0,2,7,6,1
6623,3,66,6,4,4,0,0,2,6,1,2,1,2,3,3,2,4,0,2,0,0,2,7,6,1
6624,3,66,6,4,4,0,0,2,6,0,0,0,0,0,0,0,0,0,0,0,0,2,7,6,1
6625,3,66,7,5,5,0,0,2,7,0,0,0,0,0,0,0,0,0,0,0,0,2,7,6,1
6626,3,66,6,4,4,0,0,2,6,0,0,0,0,0,0,0,0,0,0,0,0,2,7,6,1
6627,3,66,10,6,6,0,0,4,10,0,0,0,0,0,0,0,0,0,0,0,0,2,7,6,1
6628,3,66,1,1,1,0,0,0,1,0,0,0,0,0,0,0,0,0,0,0,0,2,7,6,1
6629,3,66,1,1,1,0,0,0,1,0,0,0,0,0,0,0,0,0,0,0,0,2,7,6,1
6630,3,66,14,10,10,0,0,4,14,1,1,1,1,2,2,0,2,0,1,0,0,2,7,6,1
6631,3,66,46,26,30,3,0,12,49,3,6,3,6,9,9,20,28,1,42,2,0,2,7,6,1
6632,7,298,72,33,56,0,4,12,72,1,1,1,1,2,2,0,2,0,1,0,0,2,11,21,1
6633,393,8455,72,33,56,0,4,12,72,1,1,1,1,2,2,0,2,0,1,0,0,2,22,12,1
6634,393,8455,1454,835,1044,76,110,219,1530,17,275,158,296,292,454,2297,3718,9,34017,1889,1,2,22,12,1
6635,40,1278,1523,757,1297,19,12,193,1542,12,193,117,230,205,347,1508,2664,7,19053,1058,0,2,1,1,1
6636,40,1278,701,378,504,33,58,109,734,13,110,68,126,123,194,794,1346,7,10027,557,0,2,1,1,1
6637,32,1972,1523,757,1297,19,12,193,1542,12,193,117,230,205,347,1508,2664,7,19053,1058,0,2,15,12,1
6638,393,8467,72,33,56,0,4,12,72,1,1,1,1,2,2,0,2,0,1,0,0,2,6,2,1
6639,393,8467,1454,835,1044,76,110,219,1530,17,275,158,296,292,454,2297,3718,9,34017,1889,1,2,6,2,1
6640,394,8478,72,33,56,0,4,12,72,1,1,1,1,2,2,0,2,0,1,0,0,2,5,0,1
6641,394,8478,1454,835,1044,76,110,219,1530,17,275,158,296,292,454,2297,3718,9,34017,1889,1,2,5,0,1
6642,394,8468,72,33,56,0,4,12,72,1,1,1,1,2,2,0,2,0,1,0,0,2,4,6,1
6643,394,8468,1454,835,1044,76,110,219,1530,17,275,158,296,292,454,2297,3718,9,34017,1889,1,2,4,6,1
6644,394,8492,72,33,56,0,4,12,72,1,1,1,1,2,2,0,2,0,1,0,0,2,8,2,1
6645,394,8492,1454,835,1044,76,110,219,1530,17,275,158,296,292,454,2297,3718,9,34017,1889,1,2,8,2,1
6646,394,8496,72,33,56,0,4,12,72,1,1,1,1,2,2,0,2,0,1,0,0,2,1,1,1
6647,394,8496,1454,835,1044,76,110,219,1530,17,275,158,296,292,454,2297,3718,9,34017,1889,1,2,1,1,1
6648,32,1972,1523,757,1297,19,12,193,1542,12,193,117,230,205,347,1508,2664,7,19053,1058,0,2,1,1,0
6649,394,8496,72,33,56,0,4,12,72,1,1,1,1,2,2,0,2,0,1,0,0,2,13,9,0
6650,394,8496,1454,835,1044,76,110,219,1530,17,275,158,296,292,454,2297,3718,9,34017,1889,1,2,13,9,0
6651,32,1972,1523,757,1297,19,12,193,1542,12,193,117,230,205,347,1508,2664,7,19053,1058,0,2,1,1,0
6652,96,2178,1043,504,840,53,9,147,1096,9,180,112,198,189,310,1377,2344,4,11604,644,0,2,4,3,1
6653,96,2178,383,288,292,26,6,62,409,11,65,38,67,76,105,429,656,5,3719,206,0,2,4,3,1
6654,6,286,42,7,35,4,0,5,46,1,2,1,2,3,3,2,4,0,2,0,0,2,1,1,1
6655,6,286,11,6,10,0,0,1,11,2,4,2,4,6,6,10,15,1,15,0,0,2,1,1,1
6656,23,1161,447,308,343,6,5,95,453,7,96,59,111,103,170,651,1136,4,4600,255,0,2,13,0,1
6657,32,1976,1523,757,1297,19,12,193,1542,12,193,117,230,205,347,1508,2664,7,19053,1058,0,2,2,2,0
6658,185,4356,722,423,573,19,0,135,741,12,172,101,199,184,300,1320,2257,6,15668,870,0,2,1,1,0
6659,185,4356,1508,847,911,44,250,301,1552,14,148,88,169,162,257,1120,1886,7,15077,837,0,2,1,1,0
6660,14,577,722,423,573,19,0,135,741,12,172,101,199,184,300,1320,2257,6,15668,870,0,2,10,0,0
6661,395,8517,72,33,56,0,4,12,72,1,1,1,1,2,2,0,2,0,1,0,0,2,8,4,1
6662,395,8517,1454,835,1044,76,110,219,1530,17,275,158,296,292,454,2297,3718,9,34017,1889,1,2,8,4,1
6663,159,3613,77,34,69,0,0,8,77,3,24,16,29,27,45,114,213,1,387,21,0,2,10,3,0
6664,159,3613,712,438,573,51,9,84,763,14,102,71,128,116,199,733,1364,8,11988,666,0,2,10,3,0
6665,44,1808,1043,504,840,53,9,147,1096,9,180,112,198,189,310,1377,2344,4,11604,644,0,2,6,1,0
6666,159,3613,77,34,69,0,0,8,77,3,24,16,29,27,45,114,213,1,387,21,0,2,10,3,0
6667,159,3613,712,438,573,51,9,84,763,14,102,71,128,116,199,733,1364,8,11988,666,0,2,10,3,0
6668,44,1808,1043,504,840,53,9,147,1096,9,180,112,198,189,310,1377,2344,4,11604,644,0,2,6,1,0
6669,384,8296,72,33,56,0,4,12,72,1,1,1,1,2,2,0,2,0,1,0,0,2,108,146,1
6670,384,8296,1454,835,1044,76,110,219,1530,17,275,158,296,292,454,2297,3718,9,34017,1889,1,2,108,146,1
6671,3,66,127,75,83,2,11,30,129,4,14,7,14,18,21,61,87,2,175,9,0,2,2,2,1
6672,3,66,652,304,544,16,6,88,668,6,89,51,101,95,152,591,998,3,3399,188,0,2,2,2,1
6673,3,66,2,2,2,0,0,0,2,0,0,0,0,0,0,0,0,0,0,0,0,2,2,2,1
6674,3,66,8,5,5,0,0,3,8,0,0,0,0,0,0,0,0,0,0,0,0,2,2,2,1
6675,3,66,2,2,2,0,0,0,2,0,0,0,0,0,0,0,0,0,0,0,0,2,2,2,1
6676,3,66,14,8,8,0,0,6,14,0,0,0,0,0,0,0,0,0,0,0,0,2,2,2,1
6677,3,66,6,4,4,0,0,2,6,0,0,0,0,0,0,0,0,0,0,0,0,2,2,2,1
6678,3,66,6,4,4,0,0,2,6,1,2,1,2,3,3,2,4,0,2,0,0,2,2,2,1
6679,3,66,6,4,4,0,0,2,6,0,0,0,0,0,0,0,0,0,0,0,0,2,2,2,1
6680,3,66,7,5,5,0,0,2,7,0,0,0,0,0,0,0,0,0,0,0,0,2,2,2,1
6681,3,66,6,4,4,0,0,2,6,0,0,0,0,0,0,0,0,0,0,0,0,2,2,2,1
6682,3,66,10,6,6,0,0,4,10,0,0,0,0,0,0,0,0,0,0,0,0,2,2,2,1
6683,3,66,1,1,1,0,0,0,1,0,0,0,0,0,0,0,0,0,0,0,0,2,2,2,1
6684,3,66,1,1,1,0,0,0,1,0,0,0,0,0,0,0,0,0,0,0,0,2,2,2,1
6685,3,66,14,10,10,0,0,4,14,1,1,1,1,2,2,0,2,0,1,0,0,2,2,2,1
6686,3,66,46,26,30,3,0,12,49,3,6,3,6,9,9,20,28,1,42,2,0,2,2,2,1
6687,7,298,72,33,56,0,4,12,72,1,1,1,1,2,2,0,2,0,1,0,0,2,4,4,1
6688,162,3649,77,34,69,0,0,8,77,3,24,16,29,27,45,114,213,1,387,21,0,2,10,3,1
6689,162,3649,712,438,573,51,9,84,763,14,102,71,128,116,199,733,1364,8,11988,666,0,2,10,3,1
6690,385,8343,72,33,56,0,4,12,72,1,1,1,1,2,2,0,2,0,1,0,0,2,11,6,1
6691,385,8343,1454,835,1044,76,110,219,1530,17,275,158,296,292,454,2297,3718,9,34017,1889,1,2,11,6,1
6692,6,286,42,7,35,4,0,5,46,1,2,1,2,3,3,2,4,0,2,0,0,2,1,1,1
6693,6,286,11,6,10,0,0,1,11,2,4,2,4,6,6,10,15,1,15,0,0,2,1,1,1
6694,36,1526,1020,354,843,12,15,144,1032,8,134,77,144,142,221,970,1580,4,6792,377,0,2,1,1,1
6695,385,8344,72,33,56,0,4,12,72,1,1,1,1,2,2,0,2,0,1,0,0,2,5,5,1
6696,385,8344,1454,835,1044,76,110,219,1530,17,275,158,296,292,454,2297,3718,9,34017,1889,1,2,5,5,1
6697,385,8329,72,33,56,0,4,12,72,1,1,1,1,2,2,0,2,0,1,0,0,2,2,7,1
6698,385,8329,1454,835,1044,76,110,219,1530,17,275,158,296,292,454,2297,3718,9,34017,1889,1,2,2,7,1
6699,387,8382,72,33,56,0,4,12,72,1,1,1,1,2,2,0,2,0,1,0,0,2,19,10,1
6700,387,8382,1454,835,1044,76,110,219,1530,17,275,158,296,292,454,2297,3718,9,34017,1889,1,2,19,10,1
6701,51,1026,1098,241,925,5,10,155,1103,7,46,25,49,53,74,273,423,3,1580,87,0,2,4,0,1
6702,51,1026,282,202,222,14,2,44,296,8,42,24,43,50,67,250,378,4,1548,86,0,2,4,0,1
6703,6,286,42,7,35,4,0,5,46,1,2,1,2,3,3,2,4,0,2,0,0,2,1,1,1
6704,6,286,11,6,10,0,0,1,11,2,4,2,4,6,6,10,15,1,15,0,0,2,1,1,1
6705,26,988,1098,241,925,5,10,155,1103,7,46,25,49,53,74,273,423,3,1580,87,0,2,25,0,1
6706,389,8386,72,33,56,0,4,12,72,1,1,1,1,2,2,0,2,0,1,0,0,2,2,1,1
6707,389,8386,1454,835,1044,76,110,219,1530,17,275,158,296,292,454,2297,3718,9,34017,1889,1,2,2,1,1
6708,390,8394,72,33,56,0,4,12,72,1,1,1,1,2,2,0,2,0,1,0,0,2,6,3,1
6709,390,8394,1454,835,1044,76,110,219,1530,17,275,158,296,292,454,2297,3718,9,34017,1889,1,2,6,3,1
6710,187,4423,722,423,573,19,0,135,741,12,172,101,199,184,300,1320,2257,6,15668,870,0,2,32,22,1
6711,187,4423,1508,847,911,44,250,301,1552,14,148,88,169,162,257,1120,1886,7,15077,837,0,2,32,22,1
6712,6,286,42,7,35,4,0,5,46,1,2,1,2,3,3,2,4,0,2,0,0,2,1,1,1
6713,6,286,11,6,10,0,0,1,11,2,4,2,4,6,6,10,15,1,15,0,0,2,1,1,1
6714,391,8407,72,33,56,0,4,12,72,1,1,1,1,2,2,0,2,0,1,0,0,2,4,0,1
6715,391,8407,1454,835,1044,76,110,219,1530,17,275,158,296,292,454,2297,3718,9,34017,1889,1,2,4,0,1
6716,6,286,42,7,35,4,0,5,46,1,2,1,2,3,3,2,4,0,2,0,0,2,1,1,1
6717,6,286,11,6,10,0,0,1,11,2,4,2,4,6,6,10,15,1,15,0,0,2,1,1,1
6718,18,294,424,94,331,4,0,89,428,1,5,5,5,6,10,11,25,0,12,0,0,2,1,1,1
6719,18,294,38,23,23,6,0,8,44,3,11,7,11,14,18,42,68,1,102,5,0,2,1,1,1
6720,6,286,42,7,35,4,0,5,46,1,2,1,2,3,3,2,4,0,2,0,0,2,1,1,1
6721,6,286,11,6,10,0,0,1,11,2,4,2,4,6,6,10,15,1,15,0,0,2,1,1,1
6722,12,389,424,94,331,4,0,89,428,1,5,5,5,6,10,11,25,0,12,0,0,2,11,0,1
6723,42,1116,74,35,59,1,0,14,75,3,14,7,14,17,21,58,85,1,128,7,0,2,2,0,1
6724,42,1116,245,125,200,5,7,34,250,7,30,17,34,37,51,166,265,3,1053,58,0,2,2,0,1
6725,11,343,74,35,59,1,0,14,75,3,14,7,14,17,21,58,85,1,128,7,0,2,7,5,1
6726,52,1050,1098,241,925,5,10,155,1103,7,46,25,49,53,74,273,423,3,1580,87,0,2,3,0,1
6727,52,1050,282,202,222,14,2,44,296,8,42,24,43,50,67,250,378,4,1548,86,0,2,3,0,1
6728,27,1019,1098,241,925,5,10,155,1103,7,46,25,49,53,74,273,423,3,1580,87,0,2,11,0,1
6729,52,1050,1098,241,925,5,10,155,1103,7,46,25,49,53,74,273,423,3,1580,87,0,2,3,0,0
6730,52,1050,282,202,222,14,2,44,296,8,42,24,43,50,67,250,378,4,1548,86,0,2,3,0,0
6731,27,1019,1098,241,925,5,10,155,1103,7,46,25,49,53,74,273,423,3,1580,87,0,2,11,0,0
6732,391,8407,72,33,56,0,4,12,72,1,1,1,1,2,2,0,2,0,1,0,0,2,1,1,1
6733,391,8407,1454,835,1044,76,110,219,1530,17,275,158,296,292,454,2297,3718,9,34017,1889,1,2,1,1,1
6734,156,3510,77,34,69,0,0,8,77,3,24,16,29,27,45,114,213,1,387,21,0,2,0,22,0
6735,156,3510,712,438,573,51,9,84,763,14,102,71,128,116,199,733,1364,8,11988,666,0,2,0,22,0
6736,392,8417,72,33,56,0,4,12,72,1,1,1,1,2,2,0,2,0,1,0,0,2,5,1,0
6737,392,8417,1454,835,1044,76,110,219,1530,17,275,158,296,292,454,2297,3718,9,34017,1889,1,2,5,1,0
6738,96,2185,1043,504,840,53,9,147,1096,9,180,112,198,189,310,1377,2344,4,11604,644,0,2,1,1,0
6739,96,2185,383,288,292,26,6,62,409,11,65,38,67,76,105,429,656,5,3719,206,0,2,1,1,0
6740,162,3649,77,34,69,0,0,8,77,3,24,16,29,27,45,114,213,1,387,21,0,2,22,0,1
6741,162,3649,712,438,573,51,9,84,763,14,102,71,128,116,199,733,1364,8,11988,666,0,2,22,0,1
6742,391,8407,72,33,56,0,4,12,72,1,1,1,1,2,2,0,2,0,1,0,0,2,1,5,1
6743,391,8407,1454,835,1044,76,110,219,1530,17,275,158,296,292,454,2297,3718,9,34017,1889,1,2,1,5,1
6744,96,2178,1043,504,840,53,9,147,1096,9,180,112,198,189,310,1377,2344,4,11604,644,0,2,1,1,1
6745,96,2178,383,288,292,26,6,62,409,11,65,38,67,76,105,429,656,5,3719,206,0,2,1,1,1
6746,398,8516,72,33,56,0,4,12,72,1,1,1,1,2,2,0,2,0,1,0,0,2,68,38,1
6747,398,8516,1454,835,1044,76,110,219,1530,17,275,158,296,292,454,2297,3718,9,34017,1889,1,2,68,38,1
6748,398,8529,72,33,56,0,4,12,72,1,1,1,1,2,2,0,2,0,1,0,0,2,8,3,1
6749,398,8529,1454,835,1044,76,110,219,1530,17,275,158,296,292,454,2297,3718,9,34017,1889,1,2,8,3,1
6750,398,8516,72,33,56,0,4,12,72,1,1,1,1,2,2,0,2,0,1,0,0,2,3,8,1
6751,398,8516,1454,835,1044,76,110,219,1530,17,275,158,296,292,454,2297,3718,9,34017,1889,1,2,3,8,1
6752,30,618,447,308,343,6,5,95,453,7,96,59,111,103,170,651,1136,4,4600,255,0,2,5,1,1
6753,30,618,322,174,179,16,74,51,338,10,41,26,46,51,72,252,408,5,2291,127,0,2,5,1,1
6754,26,1272,447,308,343,6,5,95,453,7,96,59,111,103,170,651,1136,4,4600,255,0,2,35,0,1
6755,399,8544,72,33,56,0,4,12,72,1,1,1,1,2,2,0,2,0,1,0,0,2,3,0,1
6756,399,8544,1454,835,1044,76,110,219,1530,17,275,158,296,292,454,2297,3718,9,34017,1889,1,2,3,0,1
6757,6,286,42,7,35,4,0,5,46,1,2,1,2,3,3,2,4,0,2,0,0,2,1,1,1
6758,6,286,11,6,10,0,0,1,11,2,4,2,4,6,6,10,15,1,15,0,0,2,1,1,1
6759,162,3651,77,34,69,0,0,8,77,3,24,16,29,27,45,114,213,1,387,21,0,2,12,13,0
6760,162,3651,712,438,573,51,9,84,763,14,102,71,128,116,199,733,1364,8,11988,666,0,2,12,13,0
6761,398,8516,72,33,56,0,4,12,72,1,1,1,1,2,2,0,2,0,1,0,0,2,1,3,0
6762,398,8516,1454,835,1044,76,110,219,1530,17,275,158,296,292,454,2297,3718,9,34017,1889,1,2,1,3,0
6763,397,8484,72,33,56,0,4,12,72,1,1,1,1,2,2,0,2,0,1,0,0,2,12,23,1
6764,397,8484,1454,835,1044,76,110,219,1530,17,275,158,296,292,454,2297,3718,9,34017,1889,1,2,12,23,1
6765,399,8494,72,33,56,0,4,12,72,1,1,1,1,2,2,0,2,0,1,0,0,2,5,4,1
6766,399,8494,1454,835,1044,76,110,219,1530,17,275,158,296,292,454,2297,3718,9,34017,1889,1,2,5,4,1
6767,154,3088,1943,715,1694,26,18,214,1969,12,185,120,237,197,357,1436,2721,7,20915,1161,0,2,1,1,1
6768,154,3088,1168,838,957,57,25,144,1225,19,348,224,416,367,640,3018,5452,11,61921,3440,1,2,1,1,1
6769,59,2468,1289,550,1043,56,32,155,1345,10,167,93,185,177,278,1266,2075,5,11498,638,0,2,3,3,1
6770,6,286,42,7,35,4,0,5,46,1,2,1,2,3,3,2,4,0,2,0,0,2,2,2,1
6771,6,286,11,6,10,0,0,1,11,2,4,2,4,6,6,10,15,1,15,0,0,2,2,2,1
6772,40,1699,1513,682,1277,25,13,200,1538,11,199,116,219,210,335,1557,2584,6,15641,868,0,2,8,8,0
6773,1,197,382,65,130,157,2,92,539,4,10,5,10,14,15,41,57,2,114,6,0,2,5,1,1
6774,399,8494,72,33,56,0,4,12,72,1,1,1,1,2,2,0,2,0,1,0,0,2,25,11,1
6775,399,8494,1454,835,1044,76,110,219,1530,17,275,158,296,292,454,2297,3718,9,34017,1889,1,2,25,11,1
6776,3,66,127,75,83,2,11,30,129,4,14,7,14,18,21,61,87,2,175,9,0,2,1,1,1
6777,3,66,652,304,544,16,6,88,668,6,89,51,101,95,152,591,998,3,3399,188,0,2,1,1,1
6778,3,66,2,2,2,0,0,0,2,0,0,0,0,0,0,0,0,0,0,0,0,2,1,1,1
6779,3,66,8,5,5,0,0,3,8,0,0,0,0,0,0,0,0,0,0,0,0,2,1,1,1
6780,3,66,2,2,2,0,0,0,2,0,0,0,0,0,0,0,0,0,0,0,0,2,1,1,1
6781,3,66,14,8,8,0,0,6,14,0,0,0,0,0,0,0,0,0,0,0,0,2,1,1,1
6782,3,66,6,4,4,0,0,2,6,0,0,0,0,0,0,0,0,0,0,0,0,2,1,1,1
6783,3,66,6,4,4,0,0,2,6,1,2,1,2,3,3,2,4,0,2,0,0,2,1,1,1
6784,3,66,6,4,4,0,0,2,6,0,0,0,0,0,0,0,0,0,0,0,0,2,1,1,1
6785,3,66,7,5,5,0,0,2,7,0,0,0,0,0,0,0,0,0,0,0,0,2,1,1,1
6786,3,66,6,4,4,0,0,2,6,0,0,0,0,0,0,0,0,0,0,0,0,2,1,1,1
6787,3,66,10,6,6,0,0,4,10,0,0,0,0,0,0,0,0,0,0,0,0,2,1,1,1
6788,3,66,1,1,1,0,0,0,1,0,0,0,0,0,0,0,0,0,0,0,0,2,1,1,1
6789,3,66,1,1,1,0,0,0,1,0,0,0,0,0,0,0,0,0,0,0,0,2,1,1,1
6790,3,66,14,10,10,0,0,4,14,1,1,1,1,2,2,0,2,0,1,0,0,2,1,1,1
6791,3,66,46,26,30,3,0,12,49,3,6,3,6,9,9,20,28,1,42,2,0,2,1,1,1
6792,7,298,72,33,56,0,4,12,72,1,1,1,1,2,2,0,2,0,1,0,0,2,2,2,1
6793,18,294,424,94,331,4,0,89,428,1,5,5,5,6,10,11,25,0,12,0,0,2,1,1,1
6794,18,294,38,23,23,6,0,8,44,3,11,7,11,14,18,42,68,1,102,5,0,2,1,1,1
6795,386,8241,72,33,56,0,4,12,72,1,1,1,1,2,2,0,2,0,1,0,0,2,103,146,1
6796,386,8241,1454,835,1044,76,110,219,1530,17,275,158,296,292,454,2297,3718,9,34017,1889,1,2,103,146,1
6797,53,1067,1098,241,925,5,10,155,1103,7,46,25,49,53,74,273,423,3,1580,87,0,2,4,1,1
6798,53,1067,282,202,222,14,2,44,296,8,42,24,43,50,67,250,378,4,1548,86,0,2,4,1,1
6799,68,1223,1513,682,1277,25,13,200,1538,11,199,116,219,210,335,1557,2584,6,15641,868,0,2,3,3,1
6800,68,1223,819,519,539,24,98,155,843,15,96,57,106,111,163,690,1107,8,9171,509,0,2,3,3,1
6801,42,1116,74,35,59,1,0,14,75,3,14,7,14,17,21,58,85,1,128,7,0,2,1,1,1
6802,42,1116,245,125,200,5,7,34,250,7,30,17,34,37,51,166,265,3,1053,58,0,2,1,1,1
6803,162,3651,77,34,69,0,0,8,77,3,24,16,29,27,45,114,213,1,387,21,0,2,3,3,1
6804,162,3651,712,438,573,51,9,84,763,14,102,71,128,116,199,733,1364,8,11988,666,0,2,3,3,1
6805,387,8271,72,33,56,0,4,12,72,1,1,1,1,2,2,0,2,0,1,0,0,2,162,159,1
6806,387,8271,1454,835,1044,76,110,219,1530,17,275,158,296,292,454,2297,3718,9,34017,1889,1,2,162,159,1
6807,53,1067,1098,241,925,5,10,155,1103,7,46,25,49,53,74,273,423,3,1580,87,0,2,4,4,1
6808,53,1067,282,202,222,14,2,44,296,8,42,24,43,50,67,250,378,4,1548,86,0,2,4,4,1
6809,56,977,282,196,195,3,0,86,285,8,130,71,141,138,212,936,1507,4,6538,363,0,2,1,1,1
6810,56,977,282,196,195,3,0,86,285,8,130,71,141,138,212,936,1507,4,6538,363,0,2,1,1,1
6811,10,326,72,33,56,0,4,12,72,1,1,1,1,2,2,0,2,0,1,0,0,2,1,1,1
6812,35,628,127,75,83,2,11,30,129,4,14,7,14,18,21,61,87,2,175,9,0,2,1,1,1
6813,35,628,652,304,544,16,6,88,668,6,89,51,101,95,152,591,998,3,3399,188,0,2,1,1,1
6814,35,628,2,2,2,0,0,0,2,0,0,0,0,0,0,0,0,0,0,0,0,2,1,1,1
6815,35,628,8,5,5,0,0,3,8,0,0,0,0,0,0,0,0,0,0,0,0,2,1,1,1
6816,35,628,2,2,2,0,0,0,2,0,0,0,0,0,0,0,0,0,0,0,0,2,1,1,1
6817,35,628,14,8,8,0,0,6,14,0,0,0,0,0,0,0,0,0,0,0,0,2,1,1,1
6818,35,628,6,4,4,0,0,2,6,0,0,0,0,0,0,0,0,0,0,0,0,2,1,1,1
6819,35,628,6,4,4,0,0,2,6,1,2,1,2,3,3,2,4,0,2,0,0,2,1,1,1
6820,35,628,6,4,4,0,0,2,6,0,0,0,0,0,0,0,0,0,0,0,0,2,1,1,1
6821,35,628,7,5,5,0,0,2,7,0,0,0,0,0,0,0,0,0,0,0,0,2,1,1,1
6822,35,628,6,4,4,0,0,2,6,0,0,0,0,0,0,0,0,0,0,0,0,2,1,1,1
6823,35,628,10,6,6,0,0,4,10,0,0,0,0,0,0,0,0,0,0,0,0,2,1,1,1
6824,35,628,1,1,1,0,0,0,1,0,0,0,0,0,0,0,0,0,0,0,0,2,1,1,1
6825,35,628,1,1,1,0,0,0,1,0,0,0,0,0,0,0,0,0,0,0,0,2,1,1,1
6826,35,628,14,10,10,0,0,4,14,1,1,1,1,2,2,0,2,0,1,0,0,2,1,1,1
6827,35,628,46,26,30,3,0,12,49,3,6,3,6,9,9,20,28,1,42,2,0,2,1,1,1
6828,40,1699,1513,682,1277,25,13,200,1538,11,199,116,219,210,335,1557,2584,6,15641,868,0,2,1,1,1
6829,27,1295,652,304,544,16,6,88,668,6,89,51,101,95,152,591,998,3,3399,188,0,2,1,1,1
6830,11,343,74,35,59,1,0,14,75,3,14,7,14,17,21,58,85,1,128,7,0,2,1,1,1
6831,56,2548,1943,715,1694,26,18,214,1969,12,185,120,237,197,357,1436,2721,7,20915,1161,0,2,1,1,1
6832,159,3571,77,34,69,0,0,8,77,3,24,16,29,27,45,114,213,1,387,21,0,2,1,10,1
6833,159,3571,712,438,573,51,9,84,763,14,102,71,128,116,199,733,1364,8,11988,666,0,2,1,10,1
6834,387,8323,72,33,56,0,4,12,72,1,1,1,1,2,2,0,2,0,1,0,0,2,46,41,1
6835,387,8323,1454,835,1044,76,110,219,1530,17,275,158,296,292,454,2297,3718,9,34017,1889,1,2,46,41,1
6836,6,286,42,7,35,4,0,5,46,1,2,1,2,3,3,2,4,0,2,0,0,2,1,1,1
6837,6,286,11,6,10,0,0,1,11,2,4,2,4,6,6,10,15,1,15,0,0,2,1,1,1
6838,390,8430,72,33,56,0,4,12,72,1,1,1,1,2,2,0,2,0,1,0,0,2,30,9,1
6839,390,8430,1454,835,1044,76,110,219,1530,17,275,158,296,292,454,2297,3718,9,34017,1889,1,2,30,9,1
6840,53,1059,1098,241,925,5,10,155,1103,7,46,25,49,53,74,273,423,3,1580,87,0,2,1,1,1
6841,53,1059,282,202,222,14,2,44,296,8,42,24,43,50,67,250,378,4,1548,86,0,2,1,1,1
6842,1,197,382,65,130,157,2,92,539,4,10,5,10,14,15,41,57,2,114,6,0,2,1,1,1
6843,393,8487,72,33,56,0,4,12,72,1,1,1,1,2,2,0,2,0,1,0,0,2,28,14,1
6844,393,8487,1454,835,1044,76,110,219,1530,17,275,158,296,292,454,2297,3718,9,34017,1889,1,2,28,14,1
6845,395,8521,72,33,56,0,4,12,72,1,1,1,1,2,2,0,2,0,1,0,0,2,25,12,1
6846,395,8521,1454,835,1044,76,110,219,1530,17,275,158,296,292,454,2297,3718,9,34017,1889,1,2,25,12,1
6847,398,8551,72,33,56,0,4,12,72,1,1,1,1,2,2,0,2,0,1,0,0,2,14,6,1
6848,398,8551,1454,835,1044,76,110,219,1530,17,275,158,296,292,454,2297,3718,9,34017,1889,1,2,14,6,1
6849,6,286,42,7,35,4,0,5,46,1,2,1,2,3,3,2,4,0,2,0,0,2,1,1,1
6850,6,286,11,6,10,0,0,1,11,2,4,2,4,6,6,10,15,1,15,0,0,2,1,1,1
6851,398,8551,72,33,56,0,4,12,72,1,1,1,1,2,2,0,2,0,1,0,0,2,16,14,1
6852,398,8551,1454,835,1044,76,110,219,1530,17,275,158,296,292,454,2297,3718,9,34017,1889,1,2,16,14,1
6853,156,3098,1943,715,1694,26,18,214,1969,12,185,120,237,197,357,1436,2721,7,20915,1161,0,2,6,3,1
6854,156,3098,1168,838,957,57,25,144,1225,19,348,224,416,367,640,3018,5452,11,61921,3440,1,2,6,3,1
6855,1,191,382,65,130,157,2,92,539,4,10,5,10,14,15,41,57,2,114,6,0,2,3,2,1
6856,397,8525,72,33,56,0,4,12,72,1,1,1,1,2,2,0,2,0,1,0,0,2,3,9,1
6857,397,8525,1454,835,1044,76,110,219,1530,17,275,158,296,292,454,2297,3718,9,34017,1889,1,2,3,9,1
6858,6,286,42,7,35,4,0,5,46,1,2,1,2,3,3,2,4,0,2,0,0,2,1,1,1
6859,6,286,11,6,10,0,0,1,11,2,4,2,4,6,6,10,15,1,15,0,0,2,1,1,1
6860,12,392,424,94,331,4,0,89,428,1,5,5,5,6,10,11,25,0,12,0,0,2,1,1,1
6861,27,1019,1098,241,925,5,10,155,1103,7,46,25,49,53,74,273,423,3,1580,87,0,2,2,2,1
6862,397,8524,72,33,56,0,4,12,72,1,1,1,1,2,2,0,2,0,1,0,0,2,5,5,1
6863,397,8524,1454,835,1044,76,110,219,1530,17,275,158,296,292,454,2297,3718,9,34017,1889,1,2,5,5,1
6864,32,1987,1523,757,1297,19,12,193,1542,12,193,117,230,205,347,1508,2664,7,19053,1058,0,2,5,3,0
6865,397,8526,72,33,56,0,4,12,72,1,1,1,1,2,2,0,2,0,1,0,0,2,28,33,1
6866,397,8526,1454,835,1044,76,110,219,1530,17,275,158,296,292,454,2297,3718,9,34017,1889,1,2,28,33,1
6867,96,2178,1043,504,840,53,9,147,1096,9,180,112,198,189,310,1377,2344,4,11604,644,0,2,3,1,1
6868,96,2178,383,288,292,26,6,62,409,11,65,38,67,76,105,429,656,5,3719,206,0,2,3,1,1
6869,1,199,382,65,130,157,2,92,539,4,10,5,10,14,15,41,57,2,114,6,0,2,6,2,1
6870,394,8574,72,33,56,0,4,12,72,1,1,1,1,2,2,0,2,0,1,0,0,2,35,27,1
6871,394,8574,1454,835,1044,76,110,219,1530,17,275,158,296,292,454,2297,3718,9,34017,1889,1,2,35,27,1
6872,6,286,42,7,35,4,0,5,46,1,2,1,2,3,3,2,4,0,2,0,0,2,1,1,1
6873,6,286,11,6,10,0,0,1,11,2,4,2,4,6,6,10,15,1,15,0,0,2,1,1,1
6874,11,351,442,244,305,14,16,103,456,11,68,45,75,79,120,452,756,6,4588,254,0,2,1,1,1
6875,11,351,182,102,99,11,40,35,193,3,11,6,11,14,17,42,64,1,97,5,0,2,1,1,1
6876,6,286,42,7,35,4,0,5,46,1,2,1,2,3,3,2,4,0,2,0,0,2,1,1,1
6877,6,286,11,6,10,0,0,1,11,2,4,2,4,6,6,10,15,1,15,0,0,2,1,1,1
6878,6,484,442,244,305,14,16,103,456,11,68,45,75,79,120,452,756,6,4588,254,0,2,9,2,1
6879,19,299,424,94,331,4,0,89,428,1,5,5,5,6,10,11,25,0,12,0,0,2,1,1,1
6880,19,299,38,23,23,6,0,8,44,3,11,7,11,14,18,42,68,1,102,5,0,2,1,1,1
6881,394,8574,72,33,56,0,4,12,72,1,1,1,1,2,2,0,2,0,1,0,0,2,8,8,1
6882,394,8574,1454,835,1044,76,110,219,1530,17,275,158,296,292,454,2297,3718,9,34017,1889,1,2,8,8,1
6883,1,199,382,65,130,157,2,92,539,4,10,5,10,14,15,41,57,2,114,6,0,2,1,1,1
6884,6,286,42,7,35,4,0,5,46,1,2,1,2,3,3,2,4,0,2,0,0,2,1,1,1
6885,6,286,11,6,10,0,0,1,11,2,4,2,4,6,6,10,15,1,15,0,0,2,1,1,1
6886,12,392,424,94,331,4,0,89,428,1,5,5,5,6,10,11,25,0,12,0,0,2,1,1,1
6887,27,1019,1098,241,925,5,10,155,1103,7,46,25,49,53,74,273,423,3,1580,87,0,2,2,2,1
6888,395,8545,72,33,56,0,4,12,72,1,1,1,1,2,2,0,2,0,1,0,0,2,7,10,1
6889,395,8545,1454,835,1044,76,110,219,1530,17,275,158,296,292,454,2297,3718,9,34017,1889,1,2,7,10,1
6890,400,8685,72,33,56,0,4,12,72,1,1,1,1,2,2,0,2,0,1,0,0,2,43,20,1
6891,400,8685,1454,835,1044,76,110,219,1530,17,275,158,296,292,454,2297,3718,9,34017,1889,1,2,43,20,1
6892,53,1059,1098,241,925,5,10,155,1103,7,46,25,49,53,74,273,423,3,1580,87,0,2,1,1,1
6893,53,1059,282,202,222,14,2,44,296,8,42,24,43,50,67,250,378,4,1548,86,0,2,1,1,1
6894,404,8730,72,33,56,0,4,12,72,1,1,1,1,2,2,0,2,0,1,0,0,2,22,14,1
6895,404,8730,1454,835,1044,76,110,219,1530,17,275,158,296,292,454,2297,3718,9,34017,1889,1,2,22,14,1
6896,52,1050,1098,241,925,5,10,155,1103,7,46,25,49,53,74,273,423,3,1580,87,0,2,1,3,1
6897,52,1050,282,202,222,14,2,44,296,8,42,24,43,50,67,250,378,4,1548,86,0,2,1,3,1
6898,407,8793,72,33,56,0,4,12,72,1,1,1,1,2,2,0,2,0,1,0,0,2,28,17,1
6899,407,8793,1454,835,1044,76,110,219,1530,17,275,158,296,292,454,2297,3718,9,34017,1889,1,2,28,17,1
6900,405,8783,72,33,56,0,4,12,72,1,1,1,1,2,2,0,2,0,1,0,0,2,43,48,1
6901,405,8783,1454,835,1044,76,110,219,1530,17,275,158,296,292,454,2297,3718,9,34017,1889,1,2,43,48,1
6902,400,8717,72,33,56,0,4,12,72,1,1,1,1,2,2,0,2,0,1,0,0,2,12,25,1
6903,400,8717,1454,835,1044,76,110,219,1530,17,275,158,296,292,454,2297,3718,9,34017,1889,1,2,12,25,1
6904,405,8765,72,33,56,0,4,12,72,1,1,1,1,2,2,0,2,0,1,0,0,2,36,30,1
6905,405,8765,1454,835,1044,76,110,219,1530,17,275,158,296,292,454,2297,3718,9,34017,1889,1,2,36,30,1
6906,52,1044,1098,241,925,5,10,155,1103,7,46,25,49,53,74,273,423,3,1580,87,0,2,1,2,1
6907,52,1044,282,202,222,14,2,44,296,8,42,24,43,50,67,250,378,4,1548,86,0,2,1,2,1
6908,6,286,42,7,35,4,0,5,46,1,2,1,2,3,3,2,4,0,2,0,0,2,1,1,1
6909,6,286,11,6,10,0,0,1,11,2,4,2,4,6,6,10,15,1,15,0,0,2,1,1,1
6910,405,8766,72,33,56,0,4,12,72,1,1,1,1,2,2,0,2,0,1,0,0,2,32,0,1
6911,405,8766,1454,835,1044,76,110,219,1530,17,275,158,296,292,454,2297,3718,9,34017,1889,1,2,32,0,1
6912,405,8764,72,33,56,0,4,12,72,1,1,1,1,2,2,0,2,0,1,0,0,2,3,3,1
6913,405,8764,1454,835,1044,76,110,219,1530,17,275,158,296,292,454,2297,3718,9,34017,1889,1,2,3,3,1
6914,12,392,424,94,331,4,0,89,428,1,5,5,5,6,10,11,25,0,12,0,0,2,1,1,1
6915,401,8727,72,33,56,0,4,12,72,1,1,1,1,2,2,0,2,0,1,0,0,2,78,78,1
6916,401,8727,1454,835,1044,76,110,219,1530,17,275,158,296,292,454,2297,3718,9,34017,1889,1,2,78,78,1
6917,52,1047,1098,241,925,5,10,155,1103,7,46,25,49,53,74,273,423,3,1580,87,0,2,2,0,1
6918,52,1047,282,202,222,14,2,44,296,8,42,24,43,50,67,250,378,4,1548,86,0,2,2,0,1
6919,6,286,42,7,35,4,0,5,46,1,2,1,2,3,3,2,4,0,2,0,0,2,1,1,1
6920,6,286,11,6,10,0,0,1,11,2,4,2,4,6,6,10,15,1,15,0,0,2,1,1,1
6921,397,8658,72,33,56,0,4,12,72,1,1,1,1,2,2,0,2,0,1,0,0,2,0,15,0
6922,397,8658,1454,835,1044,76,110,219,1530,17,275,158,296,292,454,2297,3718,9,34017,1889,1,2,0,15,0
6923,401,8717,72,33,56,0,4,12,72,1,1,1,1,2,2,0,2,0,1,0,0,2,13,4,1
6924,401,8717,1454,835,1044,76,110,219,1530,17,275,158,296,292,454,2297,3718,9,34017,1889,1,2,13,4,1
6925,6,286,42,7,35,4,0,5,46,1,2,1,2,3,3,2,4,0,2,0,0,2,1,1,1
6926,6,286,11,6,10,0,0,1,11,2,4,2,4,6,6,10,15,1,15,0,0,2,1,1,1
6927,401,8717,72,33,56,0,4,12,72,1,1,1,1,2,2,0,2,0,1,0,0,2,1,1,1
6928,401,8717,1454,835,1044,76,110,219,1530,17,275,158,296,292,454,2297,3718,9,34017,1889,1,2,1,1,1
6929,402,8746,72,33,56,0,4,12,72,1,1,1,1,2,2,0,2,0,1,0,0,2,3,0,1
6930,402,8746,1454,835,1044,76,110,219,1530,17,275,158,296,292,454,2297,3718,9,34017,1889,1,2,3,0,1
6931,6,286,42,7,35,4,0,5,46,1,2,1,2,3,3,2,4,0,2,0,0,2,1,1,1
6932,6,286,11,6,10,0,0,1,11,2,4,2,4,6,6,10,15,1,15,0,0,2,1,1,1
6933,402,8748,72,33,56,0,4,12,72,1,1,1,1,2,2,0,2,0,1,0,0,2,1,1,1
6934,402,8748,1454,835,1044,76,110,219,1530,17,275,158,296,292,454,2297,3718,9,34017,1889,1,2,1,1,1
6935,1,199,382,65,130,157,2,92,539,4,10,5,10,14,15,41,57,2,114,6,0,2,1,1,1
6936,164,3666,77,34,69,0,0,8,77,3,24,16,29,27,45,114,213,1,387,21,0,2,32,21,1
6937,164,3666,712,438,573,51,9,84,763,14,102,71,128,116,199,733,1364,8,11988,666,0,2,32,21,1
6938,56,1056,1020,354,843,12,15,144,1032,8,134,77,144,142,221,970,1580,4,6792,377,0,2,1,9,1
6939,403,8758,72,33,56,0,4,12,72,1,1,1,1,2,2,0,2,0,1,0,0,2,7,4,1
6940,403,8758,1454,835,1044,76,110,219,1530,17,275,158,296,292,454,2297,3718,9,34017,1889,1,2,7,4,1
6941,1,199,382,65,130,157,2,92,539,4,10,5,10,14,15,41,57,2,114,6,0,2,1,1,1
6942,6,286,42,7,35,4,0,5,46,1,2,1,2,3,3,2,4,0,2,0,0,2,1,1,1
6943,6,286,11,6,10,0,0,1,11,2,4,2,4,6,6,10,15,1,15,0,0,2,1,1,1
6944,35,1533,1020,354,843,12,15,144,1032,8,134,77,144,142,221,970,1580,4,6792,377,0,2,13,12,1
6945,403,8760,72,33,56,0,4,12,72,1,1,1,1,2,2,0,2,0,1,0,0,2,2,2,1
6946,403,8760,1454,835,1044,76,110,219,1530,17,275,158,296,292,454,2297,3718,9,34017,1889,1,2,2,2,1
6947,6,286,42,7,35,4,0,5,46,1,2,1,2,3,3,2,4,0,2,0,0,2,1,1,1
6948,6,286,11,6,10,0,0,1,11,2,4,2,4,6,6,10,15,1,15,0,0,2,1,1,1
6949,36,1564,1020,354,843,12,15,144,1032,8,134,77,144,142,221,970,1580,4,6792,377,0,2,19,0,1
6950,403,8762,72,33,56,0,4,12,72,1,1,1,1,2,2,0,2,0,1,0,0,2,1,1,1
6951,403,8762,1454,835,1044,76,110,219,1530,17,275,158,296,292,454,2297,3718,9,34017,1889,1,2,1,1,1
6952,6,286,42,7,35,4,0,5,46,1,2,1,2,3,3,2,4,0,2,0,0,2,1,1,1
6953,6,286,11,6,10,0,0,1,11,2,4,2,4,6,6,10,15,1,15,0,0,2,1,1,1
6954,27,1019,1098,241,925,5,10,155,1103,7,46,25,49,53,74,273,423,3,1580,87,0,2,1,1,1
6955,403,8761,72,33,56,0,4,12,72,1,1,1,1,2,2,0,2,0,1,0,0,2,4,2,1
6956,403,8761,1454,835,1044,76,110,219,1530,17,275,158,296,292,454,2297,3718,9,34017,1889,1,2,4,2,1
6957,1,199,382,65,130,157,2,92,539,4,10,5,10,14,15,41,57,2,114,6,0,2,1,1,1
6958,6,286,42,7,35,4,0,5,46,1,2,1,2,3,3,2,4,0,2,0,0,2,1,1,1
6959,6,286,11,6,10,0,0,1,11,2,4,2,4,6,6,10,15,1,15,0,0,2,1,1,1
6960,403,8767,72,33,56,0,4,12,72,1,1,1,1,2,2,0,2,0,1,0,0,2,12,14,1
6961,403,8767,1454,835,1044,76,110,219,1530,17,275,158,296,292,454,2297,3718,9,34017,1889,1,2,12,14,1
6962,6,286,42,7,35,4,0,5,46,1,2,1,2,3,3,2,4,0,2,0,0,2,1,1,1
6963,6,286,11,6,10,0,0,1,11,2,4,2,4,6,6,10,15,1,15,0,0,2,1,1,1
6964,403,8776,72,33,56,0,4,12,72,1,1,1,1,2,2,0,2,0,1,0,0,2,4,0,1
6965,403,8776,1454,835,1044,76,110,219,1530,17,275,158,296,292,454,2297,3718,9,34017,1889,1,2,4,0,1
6966,6,286,42,7,35,4,0,5,46,1,2,1,2,3,3,2,4,0,2,0,0,2,1,1,1
6967,6,286,11,6,10,0,0,1,11,2,4,2,4,6,6,10,15,1,15,0,0,2,1,1,1
6968,6,286,42,7,35,4,0,5,46,1,2,1,2,3,3,2,4,0,2,0,0,2,2,2,1
6969,6,286,11,6,10,0,0,1,11,2,4,2,4,6,6,10,15,1,15,0,0,2,2,2,1
6970,32,1987,1523,757,1297,19,12,193,1542,12,193,117,230,205,347,1508,2664,7,19053,1058,0,2,2,2,1
6971,1,199,382,65,130,157,2,92,539,4,10,5,10,14,15,41,57,2,114,6,0,2,1,1,1
6972,188,4439,722,423,573,19,0,135,741,12,172,101,199,184,300,1320,2257,6,15668,870,0,2,2,0,0
6973,188,4439,1508,847,911,44,250,301,1552,14,148,88,169,162,257,1120,1886,7,15077,837,0,2,2,0,0
6974,6,286,42,7,35,4,0,5,46,1,2,1,2,3,3,2,4,0,2,0,0,2,1,1,0
6975,6,286,11,6,10,0,0,1,11,2,4,2,4,6,6,10,15,1,15,0,0,2,1,1,0
6976,6,286,42,7,35,4,0,5,46,1,2,1,2,3,3,2,4,0,2,0,0,2,1,1,1
6977,6,286,11,6,10,0,0,1,11,2,4,2,4,6,6,10,15,1,15,0,0,2,1,1,1
6978,1,199,382,65,130,157,2,92,539,4,10,5,10,14,15,41,57,2,114,6,0,2,1,1,1
6979,409,8844,72,33,56,0,4,12,72,1,1,1,1,2,2,0,2,0,1,0,0,2,23,1,1
6980,409,8844,1454,835,1044,76,110,219,1530,17,275,158,296,292,454,2297,3718,9,34017,1889,1,2,23,1,1
6981,6,286,42,7,35,4,0,5,46,1,2,1,2,3,3,2,4,0,2,0,0,2,1,1,1
6982,6,286,11,6,10,0,0,1,11,2,4,2,4,6,6,10,15,1,15,0,0,2,1,1,1
6983,409,8846,72,33,56,0,4,12,72,1,1,1,1,2,2,0,2,0,1,0,0,2,3,1,1
6984,409,8846,1454,835,1044,76,110,219,1530,17,275,158,296,292,454,2297,3718,9,34017,1889,1,2,3,1,1
6985,83,1453,1178,367,1042,6,15,115,1184,9,94,51,95,103,146,644,976,4,4439,246,0,2,3,1,1
6986,83,1453,177,108,140,8,0,27,185,6,30,16,32,36,48,162,248,3,794,44,0,2,3,1,1
6987,83,1452,1178,367,1042,6,15,115,1184,9,94,51,95,103,146,644,976,4,4439,246,0,2,7,8,1
6988,83,1452,177,108,140,8,0,27,185,6,30,16,32,36,48,162,248,3,794,44,0,2,7,8,1
6989,1,199,382,65,130,157,2,92,539,4,10,5,10,14,15,41,57,2,114,6,0,2,1,1,1
6990,6,286,42,7,35,4,0,5,46,1,2,1,2,3,3,2,4,0,2,0,0,2,1,1,1
6991,6,286,11,6,10,0,0,1,11,2,4,2,4,6,6,10,15,1,15,0,0,2,1,1,1
6992,38,1723,1178,367,1042,6,15,115,1184,9,94,51,95,103,146,644,976,4,4439,246,0,2,2,2,1
6993,6,286,42,7,35,4,0,5,46,1,2,1,2,3,3,2,4,0,2,0,0,2,1,1,1
6994,6,286,11,6,10,0,0,1,11,2,4,2,4,6,6,10,15,1,15,0,0,2,1,1,1
6995,9,372,42,7,35,4,0,5,46,1,2,1,2,3,3,2,4,0,2,0,0,2,17,3,1
6996,9,372,11,6,10,0,0,1,11,2,4,2,4,6,6,10,15,1,15,0,0,2,17,3,1
6997,11,401,42,7,35,4,0,5,46,1,2,1,2,3,3,2,4,0,2,0,0,2,4,2,1
6998,11,401,11,6,10,0,0,1,11,2,4,2,4,6,6,10,15,1,15,0,0,2,4,2,1
6999,409,8854,72,33,56,0,4,12,72,1,1,1,1,2,2,0,2,0,1,0,0,2,2,2,1
7000,409,8854,1454,835,1044,76,110,219,1530,17,275,158,296,292,454,2297,3718,9,34017,1889,1,2,2,2,1
7001,11,401,42,7,35,4,0,5,46,1,2,1,2,3,3,2,4,0,2,0,0,2,1,1,1
7002,11,401,11,6,10,0,0,1,11,2,4,2,4,6,6,10,15,1,15,0,0,2,1,1,1
7003,12,392,424,94,331,4,0,89,428,1,5,5,5,6,10,11,25,0,12,0,0,2,1,1,1
7004,11,401,42,7,35,4,0,5,46,1,2,1,2,3,3,2,4,0,2,0,0,2,1,1,1
7005,11,401,11,6,10,0,0,1,11,2,4,2,4,6,6,10,15,1,15,0,0,2,1,1,1
7006,100,2275,1660,832,1314,41,38,274,1701,20,312,209,395,332,604,2671,5058,12,64042,3557,1,2,7,4,1
7007,409,8857,72,33,56,0,4,12,72,1,1,1,1,2,2,0,2,0,1,0,0,2,1,1,1
7008,409,8857,1454,835,1044,76,110,219,1530,17,275,158,296,292,454,2297,3718,9,34017,1889,1,2,1,1,1
7009,11,401,42,7,35,4,0,5,46,1,2,1,2,3,3,2,4,0,2,0,0,2,1,1,1
7010,11,401,11,6,10,0,0,1,11,2,4,2,4,6,6,10,15,1,15,0,0,2,1,1,1
7011,165,3672,77,34,69,0,0,8,77,3,24,16,29,27,45,114,213,1,387,21,0,2,5,3,1
7012,165,3672,712,438,573,51,9,84,763,14,102,71,128,116,199,733,1364,8,11988,666,0,2,5,3,1
7013,409,8857,72,33,56,0,4,12,72,1,1,1,1,2,2,0,2,0,1,0,0,2,1,0,1
7014,409,8857,1454,835,1044,76,110,219,1530,17,275,158,296,292,454,2297,3718,9,34017,1889,1,2,1,0,1
7015,11,401,42,7,35,4,0,5,46,1,2,1,2,3,3,2,4,0,2,0,0,2,1,1,1
7016,11,401,11,6,10,0,0,1,11,2,4,2,4,6,6,10,15,1,15,0,0,2,1,1,1
7017,53,1057,1098,241,925,5,10,155,1103,7,46,25,49,53,74,273,423,3,1580,87,0,2,5,2,1
7018,53,1057,282,202,222,14,2,44,296,8,42,24,43,50,67,250,378,4,1548,86,0,2,5,2,1
7019,11,401,42,7,35,4,0,5,46,1,2,1,2,3,3,2,4,0,2,0,0,2,1,1,1
7020,11,401,11,6,10,0,0,1,11,2,4,2,4,6,6,10,15,1,15,0,0,2,1,1,1
7021,27,1018,1098,241,925,5,10,155,1103,7,46,25,49,53,74,273,423,3,1580,87,0,2,12,3,1
7022,55,1085,1098,241,925,5,10,155,1103,7,46,25,49,53,74,273,423,3,1580,87,0,2,5,2,1
7023,55,1085,282,202,222,14,2,44,296,8,42,24,43,50,67,250,378,4,1548,86,0,2,5,2,1
7024,11,401,42,7,35,4,0,5,46,1,2,1,2,3,3,2,4,0,2,0,0,2,1,1,1
7025,11,401,11,6,10,0,0,1,11,2,4,2,4,6,6,10,15,1,15,0,0,2,1,1,1
7026,28,1072,1098,241,925,5,10,155,1103,7,46,25,49,53,74,273,423,3,1580,87,0,2,22,2,1
7027,139,2729,1457,730,1242,11,6,188,1468,10,292,166,329,302,495,2424,4078,5,22973,1276,1,2,32,6,1
7028,139,2729,74,35,59,1,0,14,75,3,14,7,14,17,21,58,85,1,128,7,0,2,32,6,1
7029,139,2729,245,125,200,5,7,34,250,7,30,17,34,37,51,166,265,3,1053,58,0,2,32,6,1
7030,43,415,647,139,84,35,284,233,682,0,0,0,0,0,0,0,0,0,0,0,0,2,4,2,1
7031,1,199,382,65,130,157,2,92,539,4,10,5,10,14,15,41,57,2,114,6,0,2,1,1,1
7032,11,401,42,7,35,4,0,5,46,1,2,1,2,3,3,2,4,0,2,0,0,2,1,1,1
7033,11,401,11,6,10,0,0,1,11,2,4,2,4,6,6,10,15,1,15,0,0,2,1,1,1
7034,1,199,382,65,130,157,2,92,539,4,10,5,10,14,15,41,57,2,114,6,0,2,4,4,1
7035,11,401,42,7,35,4,0,5,46,1,2,1,2,3,3,2,4,0,2,0,0,2,2,2,1
7036,11,401,11,6,10,0,0,1,11,2,4,2,4,6,6,10,15,1,15,0,0,2,2,2,1
7037,135,2675,1457,730,1242,11,6,188,1468,10,292,166,329,302,495,2424,4078,5,22973,1276,1,2,0,11,0
7038,135,2675,74,35,59,1,0,14,75,3,14,7,14,17,21,58,85,1,128,7,0,2,0,11,0
7039,135,2675,245,125,200,5,7,34,250,7,30,17,34,37,51,166,265,3,1053,58,0,2,0,11,0
7040,1,199,382,65,130,157,2,92,539,4,10,5,10,14,15,41,57,2,114,6,0,2,1,1,0
7041,409,8857,72,33,56,0,4,12,72,1,1,1,1,2,2,0,2,0,1,0,0,2,1,1,1
7042,409,8857,1454,835,1044,76,110,219,1530,17,275,158,296,292,454,2297,3718,9,34017,1889,1,2,1,1,1
7043,410,8865,72,33,56,0,4,12,72,1,1,1,1,2,2,0,2,0,1,0,0,2,9,1,1
7044,410,8865,1454,835,1044,76,110,219,1530,17,275,158,296,292,454,2297,3718,9,34017,1889,1,2,9,1,1
7045,410,8865,72,33,56,0,4,12,72,1,1,1,1,2,2,0,2,0,1,0,0,2,9,1,0
7046,410,8865,1454,835,1044,76,110,219,1530,17,275,158,296,292,454,2297,3718,9,34017,1889,1,2,9,1,0
7047,411,8864,72,33,56,0,4,12,72,1,1,1,1,2,2,0,2,0,1,0,0,2,6,6,1
7048,411,8864,1454,835,1044,76,110,219,1530,17,275,158,296,292,454,2297,3718,9,34017,1889,1,2,6,6,1
7049,12,222,127,75,83,2,11,30,129,4,14,7,14,18,21,61,87,2,175,9,0,2,3,3,1
7050,12,222,652,304,544,16,6,88,668,6,89,51,101,95,152,591,998,3,3399,188,0,2,3,3,1
7051,12,222,2,2,2,0,0,0,2,0,0,0,0,0,0,0,0,0,0,0,0,2,3,3,1
7052,12,222,8,5,5,0,0,3,8,0,0,0,0,0,0,0,0,0,0,0,0,2,3,3,1
7053,12,222,2,2,2,0,0,0,2,0,0,0,0,0,0,0,0,0,0,0,0,2,3,3,1
7054,12,222,14,8,8,0,0,6,14,0,0,0,0,0,0,0,0,0,0,0,0,2,3,3,1
7055,12,222,6,4,4,0,0,2,6,0,0,0,0,0,0,0,0,0,0,0,0,2,3,3,1
7056,12,222,6,4,4,0,0,2,6,1,2,1,2,3,3,2,4,0,2,0,0,2,3,3,1
7057,12,222,6,4,4,0,0,2,6,0,0,0,0,0,0,0,0,0,0,0,0,2,3,3,1
7058,12,222,7,5,5,0,0,2,7,0,0,0,0,0,0,0,0,0,0,0,0,2,3,3,1
7059,12,222,6,4,4,0,0,2,6,0,0,0,0,0,0,0,0,0,0,0,0,2,3,3,1
7060,12,222,10,6,6,0,0,4,10,0,0,0,0,0,0,0,0,0,0,0,0,2,3,3,1
7061,12,222,1,1,1,0,0,0,1,0,0,0,0,0,0,0,0,0,0,0,0,2,3,3,1
7062,12,222,1,1,1,0,0,0,1,0,0,0,0,0,0,0,0,0,0,0,0,2,3,3,1
7063,12,222,14,10,10,0,0,4,14,1,1,1,1,2,2,0,2,0,1,0,0,2,3,3,1
7064,12,222,46,26,30,3,0,12,49,3,6,3,6,9,9,20,28,1,42,2,0,2,3,3,1
7065,11,401,42,7,35,4,0,5,46,1,2,1,2,3,3,2,4,0,2,0,0,2,1,1,1
7066,11,401,11,6,10,0,0,1,11,2,4,2,4,6,6,10,15,1,15,0,0,2,1,1,1
7067,409,8836,72,33,56,0,4,12,72,1,1,1,1,2,2,0,2,0,1,0,0,2,0,6,0
7068,409,8836,1454,835,1044,76,110,219,1530,17,275,158,296,292,454,2297,3718,9,34017,1889,1,2,0,6,0
7069,51,2762,1338,495,1086,10,64,173,1348,11,122,82,157,133,239,883,1686,7,11934,663,0,0,721,0,1
7070,97,4106,139,89,101,2,0,35,141,7,54,34,62,61,96,330,569,4,2287,127,0,3,248,1616,1
7071,97,4106,7,5,5,0,0,2,7,1,2,1,2,3,3,2,4,0,2,0,0,3,248,1616,1
7072,39,2430,1782,648,1425,9,47,279,1791,8,171,97,189,179,286,1292,2140,4,9462,525,0,0,575,0,1
7073,9,192,256,139,192,9,7,47,265,4,23,12,24,27,36,112,171,2,357,19,0,0,64,0,1
7074,57,1111,1098,241,925,5,10,155,1103,7,46,25,49,53,74,273,423,3,1580,87,0,2,4,0,1
7075,57,1111,282,202,222,14,2,44,296,8,42,24,43,50,67,250,378,4,1548,86,0,2,4,0,1
7076,29,1111,1098,241,925,5,10,155,1103,7,46,25,49,53,74,273,423,3,1580,87,0,2,19,0,1
7077,11,401,42,7,35,4,0,5,46,1,2,1,2,3,3,2,4,0,2,0,0,2,1,1,0
7078,11,401,11,6,10,0,0,1,11,2,4,2,4,6,6,10,15,1,15,0,0,2,1,1,0
7079,13,417,424,94,331,4,0,89,428,1,5,5,5,6,10,11,25,0,12,0,0,2,6,0,1
7080,19,299,424,94,331,4,0,89,428,1,5,5,5,6,10,11,25,0,12,0,0,2,1,1,0
7081,19,299,38,23,23,6,0,8,44,3,11,7,11,14,18,42,68,1,102,5,0,2,1,1,0
7082,13,417,424,94,331,4,0,89,428,1,5,5,5,6,10,11,25,0,12,0,0,2,6,0,0
7083,38,1618,1020,354,843,12,15,144,1032,8,134,77,144,142,221,970,1580,4,6792,377,0,2,19,0,1
7084,118,3822,1660,832,1314,41,38,274,1701,20,312,209,395,332,604,2671,5058,12,64042,3557,1,2,1,1,0
7085,118,3822,1057,646,719,113,100,145,1170,18,215,134,248,233,382,1740,3004,10,31186,1732,1,2,1,1,0
7086,11,401,42,7,35,4,0,5,46,1,2,1,2,3,3,2,4,0,2,0,0,2,1,1,0
7087,11,401,11,6,10,0,0,1,11,2,4,2,4,6,6,10,15,1,15,0,0,2,1,1,0
7088,12,417,42,7,35,4,0,5,46,1,2,1,2,3,3,2,4,0,2,0,0,2,4,2,0
7089,12,417,11,6,10,0,0,1,11,2,4,2,4,6,6,10,15,1,15,0,0,2,4,2,0
7090,12,417,42,7,35,4,0,5,46,1,2,1,2,3,3,2,4,0,2,0,0,2,2,2,1
7091,12,417,11,6,10,0,0,1,11,2,4,2,4,6,6,10,15,1,15,0,0,2,2,2,1
7092,411,8874,72,33,56,0,4,12,72,1,1,1,1,2,2,0,2,0,1,0,0,2,6,0,1
7093,411,8874,1454,835,1044,76,110,219,1530,17,275,158,296,292,454,2297,3718,9,34017,1889,1,2,6,0,1
7094,12,417,42,7,35,4,0,5,46,1,2,1,2,3,3,2,4,0,2,0,0,2,1,1,1
7095,12,417,11,6,10,0,0,1,11,2,4,2,4,6,6,10,15,1,15,0,0,2,1,1,1
7096,95,3966,139,89,101,2,0,35,141,7,54,34,62,61,96,330,569,4,2287,127,0,2,0,53,1
7097,95,3966,7,5,5,0,0,2,7,1,2,1,2,3,3,2,4,0,2,0,0,2,0,53,1
7098,12,339,465,148,393,5,8,60,470,4,31,20,31,35,51,161,261,2,523,29,0,0,119,0,1
7099,12,339,16,12,9,0,0,6,16,1,2,1,2,3,3,2,4,0,2,0,0,0,119,0,1
7100,38,1620,1020,354,843,12,15,144,1032,8,134,77,144,142,221,970,1580,4,6792,377,0,2,1,1,1
7101,13,410,424,94,331,4,0,89,428,1,5,5,5,6,10,11,25,0,12,0,0,2,3,11,1
7102,138,2747,1457,730,1242,11,6,188,1468,10,292,166,329,302,495,2424,4078,5,22973,1276,1,2,24,6,1
7103,138,2747,74,35,59,1,0,14,75,3,14,7,14,17,21,58,85,1,128,7,0,2,24,6,1
7104,138,2747,245,125,200,5,7,34,250,7,30,17,34,37,51,166,265,3,1053,58,0,2,24,6,1
7105,43,415,647,139,84,35,284,233,682,0,0,0,0,0,0,0,0,0,0,0,0,2,23,5,1
7106,12,417,42,7,35,4,0,5,46,1,2,1,2,3,3,2,4,0,2,0,0,2,1,1,1
7107,12,417,11,6,10,0,0,1,11,2,4,2,4,6,6,10,15,1,15,0,0,2,1,1,1
7108,33,1692,1457,730,1242,11,6,188,1468,10,292,166,329,302,495,2424,4078,5,22973,1276,1,2,11,0,1
7109,1,199,382,65,130,157,2,92,539,4,10,5,10,14,15,41,57,2,114,6,0,2,1,1,1
7110,12,417,42,7,35,4,0,5,46,1,2,1,2,3,3,2,4,0,2,0,0,2,2,2,1
7111,12,417,11,6,10,0,0,1,11,2,4,2,4,6,6,10,15,1,15,0,0,2,2,2,1
7112,19,303,424,94,331,4,0,89,428,1,5,5,5,6,10,11,25,0,12,0,0,2,1,1,1
7113,19,303,38,23,23,6,0,8,44,3,11,7,11,14,18,42,68,1,102,5,0,2,1,1,1
7114,12,417,42,7,35,4,0,5,46,1,2,1,2,3,3,2,4,0,2,0,0,2,29,5,1
7115,12,417,11,6,10,0,0,1,11,2,4,2,4,6,6,10,15,1,15,0,0,2,29,5,1
7116,12,417,42,7,35,4,0,5,46,1,2,1,2,3,3,2,4,0,2,0,0,2,1,1,0
7117,12,417,11,6,10,0,0,1,11,2,4,2,4,6,6,10,15,1,15,0,0,2,1,1,0
7118,12,417,42,7,35,4,0,5,46,1,2,1,2,3,3,2,4,0,2,0,0,2,1,1,0
7119,12,417,11,6,10,0,0,1,11,2,4,2,4,6,6,10,15,1,15,0,0,2,1,1,0
7120,1,199,382,65,130,157,2,92,539,4,10,5,10,14,15,41,57,2,114,6,0,2,1,1,1
7121,1,199,382,65,130,157,2,92,539,4,10,5,10,14,15,41,57,2,114,6,0,2,1,1,0
7122,1,199,382,65,130,157,2,92,539,4,10,5,10,14,15,41,57,2,114,6,0,2,1,1,1
7123,56,1054,1020,354,843,12,15,144,1032,8,134,77,144,142,221,970,1580,4,6792,377,0,2,1,1,1
7124,12,417,42,7,35,4,0,5,46,1,2,1,2,3,3,2,4,0,2,0,0,2,1,1,1
7125,12,417,11,6,10,0,0,1,11,2,4,2,4,6,6,10,15,1,15,0,0,2,1,1,1
7126,40,1736,1020,354,843,12,15,144,1032,8,134,77,144,142,221,970,1580,4,6792,377,0,2,24,1,1
7127,52,1026,1020,354,843,12,15,144,1032,8,134,77,144,142,221,970,1580,4,6792,377,0,2,14,25,1
7128,12,417,42,7,35,4,0,5,46,1,2,1,2,3,3,2,4,0,2,0,0,2,1,1,1
7129,12,417,11,6,10,0,0,1,11,2,4,2,4,6,6,10,15,1,15,0,0,2,1,1,1
7130,42,1846,1020,354,843,12,15,144,1032,8,134,77,144,142,221,970,1580,4,6792,377,0,2,21,3,1
7131,140,2768,1457,730,1242,11,6,188,1468,10,292,166,329,302,495,2424,4078,5,22973,1276,1,2,7,2,1
7132,140,2768,74,35,59,1,0,14,75,3,14,7,14,17,21,58,85,1,128,7,0,2,7,2,1
7133,140,2768,245,125,200,5,7,34,250,7,30,17,34,37,51,166,265,3,1053,58,0,2,7,2,1
7134,12,417,42,7,35,4,0,5,46,1,2,1,2,3,3,2,4,0,2,0,0,2,1,1,1
7135,12,417,11,6,10,0,0,1,11,2,4,2,4,6,6,10,15,1,15,0,0,2,1,1,1
7136,34,1716,1457,730,1242,11,6,188,1468,10,292,166,329,302,495,2424,4078,5,22973,1276,1,2,4,0,1
7137,411,8874,72,33,56,0,4,12,72,1,1,1,1,2,2,0,2,0,1,0,0,2,2,2,1
7138,411,8874,1454,835,1044,76,110,219,1530,17,275,158,296,292,454,2297,3718,9,34017,1889,1,2,2,2,1
7139,411,8876,72,33,56,0,4,12,72,1,1,1,1,2,2,0,2,0,1,0,0,2,10,4,1
7140,411,8876,1454,835,1044,76,110,219,1530,17,275,158,296,292,454,2297,3718,9,34017,1889,1,2,10,4,1
7141,12,417,42,7,35,4,0,5,46,1,2,1,2,3,3,2,4,0,2,0,0,2,1,1,1
7142,12,417,11,6,10,0,0,1,11,2,4,2,4,6,6,10,15,1,15,0,0,2,1,1,1
7143,96,4040,139,89,101,2,0,35,141,7,54,34,62,61,96,330,569,4,2287,127,0,2,25,1,1
7144,96,4040,7,5,5,0,0,2,7,1,2,1,2,3,3,2,4,0,2,0,0,2,25,1,1
7145,412,8880,72,33,56,0,4,12,72,1,1,1,1,2,2,0,2,0,1,0,0,2,9,6,1
7146,412,8880,1454,835,1044,76,110,219,1530,17,275,158,296,292,454,2297,3718,9,34017,1889,1,2,9,6,1
7147,11,355,442,244,305,14,16,103,456,11,68,45,75,79,120,452,756,6,4588,254,0,2,3,3,1
7148,11,355,182,102,99,11,40,35,193,3,11,6,11,14,17,42,64,1,97,5,0,2,3,3,1
7149,6,488,442,244,305,14,16,103,456,11,68,45,75,79,120,452,756,6,4588,254,0,2,3,3,1
7150,412,8878,72,33,56,0,4,12,72,1,1,1,1,2,2,0,2,0,1,0,0,2,1,1,1
7151,412,8878,1454,835,1044,76,110,219,1530,17,275,158,296,292,454,2297,3718,9,34017,1889,1,2,1,1,1
7152,12,417,42,7,35,4,0,5,46,1,2,1,2,3,3,2,4,0,2,0,0,2,1,1,1
7153,12,417,11,6,10,0,0,1,11,2,4,2,4,6,6,10,15,1,15,0,0,2,1,1,1
7154,97,4113,139,89,101,2,0,35,141,7,54,34,62,61,96,330,569,4,2287,127,0,2,19,0,1
7155,97,4113,7,5,5,0,0,2,7,1,2,1,2,3,3,2,4,0,2,0,0,2,19,0,1
7156,414,8900,72,33,56,0,4,12,72,1,1,1,1,2,2,0,2,0,1,0,0,2,10,8,1
7157,414,8900,1454,835,1044,76,110,219,1530,17,275,158,296,292,454,2297,3718,9,34017,1889,1,2,10,8,1
7158,98,4142,139,89,101,2,0,35,141,7,54,34,62,61,96,330,569,4,2287,127,0,2,18,0,1
7159,98,4142,7,5,5,0,0,2,7,1,2,1,2,3,3,2,4,0,2,0,0,2,18,0,1
7160,34,1725,1457,730,1242,11,6,188,1468,10,292,166,329,302,495,2424,4078,5,22973,1276,1,2,1,0,0
7161,1,199,382,65,130,157,2,92,539,4,10,5,10,14,15,41,57,2,114,6,0,2,1,1,1
7162,12,417,42,7,35,4,0,5,46,1,2,1,2,3,3,2,4,0,2,0,0,2,1,1,1
7163,12,417,11,6,10,0,0,1,11,2,4,2,4,6,6,10,15,1,15,0,0,2,1,1,1
7164,12,417,42,7,35,4,0,5,46,1,2,1,2,3,3,2,4,0,2,0,0,2,1,1,1
7165,12,417,11,6,10,0,0,1,11,2,4,2,4,6,6,10,15,1,15,0,0,2,1,1,1
7166,52,1027,1020,354,843,12,15,144,1032,8,134,77,144,142,221,970,1580,4,6792,377,0,2,6,5,1
7167,12,417,42,7,35,4,0,5,46,1,2,1,2,3,3,2,4,0,2,0,0,2,1,1,1
7168,12,417,11,6,10,0,0,1,11,2,4,2,4,6,6,10,15,1,15,0,0,2,1,1,1
7169,12,424,42,7,35,4,0,5,46,1,2,1,2,3,3,2,4,0,2,0,0,2,1,37,0
7170,12,424,11,6,10,0,0,1,11,2,4,2,4,6,6,10,15,1,15,0,0,2,1,37,0
7171,12,424,42,7,35,4,0,5,46,1,2,1,2,3,3,2,4,0,2,0,0,2,1,1,1
7172,12,424,11,6,10,0,0,1,11,2,4,2,4,6,6,10,15,1,15,0,0,2,1,1,1
7173,414,8900,72,33,56,0,4,12,72,1,1,1,1,2,2,0,2,0,1,0,0,2,5,2,1
7174,414,8900,1454,835,1044,76,110,219,1530,17,275,158,296,292,454,2297,3718,9,34017,1889,1,2,5,2,1
7175,69,1236,1513,682,1277,25,13,200,1538,11,199,116,219,210,335,1557,2584,6,15641,868,0,2,5,2,1
7176,69,1236,819,519,539,24,98,155,843,15,96,57,106,111,163,690,1107,8,9171,509,0,2,5,2,1
7177,12,424,42,7,35,4,0,5,46,1,2,1,2,3,3,2,4,0,2,0,0,2,1,1,1
7178,12,424,11,6,10,0,0,1,11,2,4,2,4,6,6,10,15,1,15,0,0,2,1,1,1
7179,21,825,1293,570,1093,25,15,163,1318,10,195,123,241,205,364,1516,2795,6,17273,959,0,2,16,0,1
7180,413,8892,72,33,56,0,4,12,72,1,1,1,1,2,2,0,2,0,1,0,0,2,6,7,1
7181,413,8892,1454,835,1044,76,110,219,1530,17,275,158,296,292,454,2297,3718,9,34017,1889,1,2,6,7,1
7182,52,2827,1338,495,1086,10,64,173,1348,11,122,82,157,133,239,883,1686,7,11934,663,0,2,22,0,1
7183,12,424,42,7,35,4,0,5,46,1,2,1,2,3,3,2,4,0,2,0,0,2,1,1,1
7184,12,424,11,6,10,0,0,1,11,2,4,2,4,6,6,10,15,1,15,0,0,2,1,1,1
7185,29,603,2,2,2,0,0,0,2,0,0,0,0,0,0,0,0,0,0,0,0,2,1,1,1
7186,29,603,99,48,90,1,3,5,100,0,0,0,0,0,0,0,0,0,0,0,0,2,1,1,1
7187,29,603,8,5,5,2,0,1,10,0,0,0,0,0,0,0,0,0,0,0,0,2,1,1,1
7188,29,603,1217,716,841,84,126,174,1301,14,185,118,215,199,333,1446,2542,8,20687,1149,0,2,1,1,1
7189,29,603,160,89,115,0,13,31,160,7,15,11,17,22,28,78,124,3,495,27,0,2,1,1,1
7190,29,603,10,10,9,9,0,0,19,0,0,0,0,0,0,0,0,0,0,0,0,2,1,1,1
7191,29,603,173,84,99,8,29,36,181,5,12,7,13,17,20,54,81,2,221,12,0,2,1,1,1
7192,29,603,3,1,1,3,0,0,6,0,0,0,0,0,0,0,0,0,0,0,0,2,1,1,1
7193,29,1172,1450,624,1228,12,26,181,1462,14,306,186,354,320,540,2580,4493,8,36391,2021,1,2,1,1,1
7194,11,345,74,35,59,1,0,14,75,3,14,7,14,17,21,58,85,1,128,7,0,2,2,1,0
7195,12,424,42,7,35,4,0,5,46,1,2,1,2,3,3,2,4,0,2,0,0,2,1,1,1
7196,12,424,11,6,10,0,0,1,11,2,4,2,4,6,6,10,15,1,15,0,0,2,1,1,1
7197,120,3840,1660,832,1314,41,38,274,1701,20,312,209,395,332,604,2671,5058,12,64042,3557,1,2,8,4,1
7198,120,3840,1057,646,719,113,100,145,1170,18,215,134,248,233,382,1740,3004,10,31186,1732,1,2,8,4,1
7199,102,2320,1660,832,1314,41,38,274,1701,20,312,209,395,332,604,2671,5058,12,64042,3557,1,2,10,2,1
7200,1,199,382,65,130,157,2,92,539,4,10,5,10,14,15,41,57,2,114,6,0,2,1,1,0
7201,96,2189,1043,504,840,53,9,147,1096,9,180,112,198,189,310,1377,2344,4,11604,644,0,2,1,0,1
7202,96,2189,383,288,292,26,6,62,409,11,65,38,67,76,105,429,656,5,3719,206,0,2,1,0,1
7203,45,1829,1043,504,840,53,9,147,1096,9,180,112,198,189,310,1377,2344,4,11604,644,0,2,4,0,1
7204,1,199,382,65,130,157,2,92,539,4,10,5,10,14,15,41,57,2,114,6,0,2,1,1,0
7205,18,678,1455,414,1257,16,76,112,1471,5,41,23,46,46,69,231,381,2,1069,59,0,2,7,0,1
7206,18,678,669,365,481,22,61,110,691,15,103,63,122,118,185,747,1273,8,11311,628,0,2,7,0,1
7207,188,4434,722,423,573,19,0,135,741,12,172,101,199,184,300,1320,2257,6,15668,870,0,2,3,5,1
7208,188,4434,1508,847,911,44,250,301,1552,14,148,88,169,162,257,1120,1886,7,15077,837,0,2,3,5,1
7209,45,1832,1043,504,840,53,9,147,1096,9,180,112,198,189,310,1377,2344,4,11604,644,0,2,1,1,1
7210,98,4158,139,89,101,2,0,35,141,7,54,34,62,61,96,330,569,4,2287,127,0,2,2,2,1
7211,98,4158,7,5,5,0,0,2,7,1,2,1,2,3,3,2,4,0,2,0,0,2,2,2,1
7212,19,306,424,94,331,4,0,89,428,1,5,5,5,6,10,11,25,0,12,0,0,2,2,1,1
7213,19,306,38,23,23,6,0,8,44,3,11,7,11,14,18,42,68,1,102,5,0,2,2,1,1
7214,21,326,424,94,331,4,0,89,428,1,5,5,5,6,10,11,25,0,12,0,0,2,12,2,1
7215,21,326,38,23,23,6,0,8,44,3,11,7,11,14,18,42,68,1,102,5,0,2,12,2,1
7216,14,437,424,94,331,4,0,89,428,1,5,5,5,6,10,11,25,0,12,0,0,2,25,0,1
7217,21,326,424,94,331,4,0,89,428,1,5,5,5,6,10,11,25,0,12,0,0,2,14,3,0
7218,21,326,38,23,23,6,0,8,44,3,11,7,11,14,18,42,68,1,102,5,0,2,14,3,0
7219,14,437,424,94,331,4,0,89,428,1,5,5,5,6,10,11,25,0,12,0,0,2,25,0,0
7220,12,424,42,7,35,4,0,5,46,1,2,1,2,3,3,2,4,0,2,0,0,2,2,2,1
7221,12,424,11,6,10,0,0,1,11,2,4,2,4,6,6,10,15,1,15,0,0,2,2,2,1
7222,30,1205,1450,624,1228,12,26,181,1462,14,306,186,354,320,540,2580,4493,8,36391,2021,1,2,13,0,1
7223,35,630,127,75,83,2,11,30,129,4,14,7,14,18,21,61,87,2,175,9,0,2,2,1,0
7224,35,630,652,304,544,16,6,88,668,6,89,51,101,95,152,591,998,3,3399,188,0,2,2,1,0
7225,35,630,2,2,2,0,0,0,2,0,0,0,0,0,0,0,0,0,0,0,0,2,2,1,0
7226,35,630,8,5,5,0,0,3,8,0,0,0,0,0,0,0,0,0,0,0,0,2,2,1,0
7227,35,630,2,2,2,0,0,0,2,0,0,0,0,0,0,0,0,0,0,0,0,2,2,1,0
7228,35,630,14,8,8,0,0,6,14,0,0,0,0,0,0,0,0,0,0,0,0,2,2,1,0
7229,35,630,6,4,4,0,0,2,6,0,0,0,0,0,0,0,0,0,0,0,0,2,2,1,0
7230,35,630,6,4,4,0,0,2,6,1,2,1,2,3,3,2,4,0,2,0,0,2,2,1,0
7231,35,630,6,4,4,0,0,2,6,0,0,0,0,0,0,0,0,0,0,0,0,2,2,1,0
7232,35,630,7,5,5,0,0,2,7,0,0,0,0,0,0,0,0,0,0,0,0,2,2,1,0
7233,35,630,6,4,4,0,0,2,6,0,0,0,0,0,0,0,0,0,0,0,0,2,2,1,0
7234,35,630,10,6,6,0,0,4,10,0,0,0,0,0,0,0,0,0,0,0,0,2,2,1,0
7235,35,630,1,1,1,0,0,0,1,0,0,0,0,0,0,0,0,0,0,0,0,2,2,1,0
7236,35,630,1,1,1,0,0,0,1,0,0,0,0,0,0,0,0,0,0,0,0,2,2,1,0
7237,35,630,14,10,10,0,0,4,14,1,1,1,1,2,2,0,2,0,1,0,0,2,2,1,0
7238,35,630,46,26,30,3,0,12,49,3,6,3,6,9,9,20,28,1,42,2,0,2,2,1,0
7239,413,8895,72,33,56,0,4,12,72,1,1,1,1,2,2,0,2,0,1,0,0,2,1,1,1
7240,413,8895,1454,835,1044,76,110,219,1530,17,275,158,296,292,454,2297,3718,9,34017,1889,1,2,1,1,1
7241,39,2462,1782,648,1425,9,47,279,1791,8,171,97,189,179,286,1292,2140,4,9462,525,0,2,5,0,1
7242,12,424,42,7,35,4,0,5,46,1,2,1,2,3,3,2,4,0,2,0,0,2,1,1,0
7243,12,424,11,6,10,0,0,1,11,2,4,2,4,6,6,10,15,1,15,0,0,2,1,1,0
7244,39,2468,1782,648,1425,9,47,279,1791,8,171,97,189,179,286,1292,2140,4,9462,525,0,2,1,1,0
7245,162,3661,77,34,69,0,0,8,77,3,24,16,29,27,45,114,213,1,387,21,0,2,6,4,0
7246,162,3661,712,438,573,51,9,84,763,14,102,71,128,116,199,733,1364,8,11988,666,0,2,6,4,0
7247,156,3100,1943,715,1694,26,18,214,1969,12,185,120,237,197,357,1436,2721,7,20915,1161,0,2,1,1,1
7248,156,3100,1168,838,957,57,25,144,1225,19,348,224,416,367,640,3018,5452,11,61921,3440,1,2,1,1,1
7249,61,2541,1289,550,1043,56,32,155,1345,10,167,93,185,177,278,1266,2075,5,11498,638,0,2,15,0,1
7250,413,8917,72,33,56,0,4,12,72,1,1,1,1,2,2,0,2,0,1,0,0,2,7,3,0
7251,413,8917,1454,835,1044,76,110,219,1530,17,275,158,296,292,454,2297,3718,9,34017,1889,1,2,7,3,0
7252,53,2846,1338,495,1086,10,64,173,1348,11,122,82,157,133,239,883,1686,7,11934,663,0,2,5,2,0
7253,83,1463,1178,367,1042,6,15,115,1184,9,94,51,95,103,146,644,976,4,4439,246,0,2,7,1,0
7254,83,1463,177,108,140,8,0,27,185,6,30,16,32,36,48,162,248,3,794,44,0,2,7,1,0
7255,39,1775,1178,367,1042,6,15,115,1184,9,94,51,95,103,146,644,976,4,4439,246,0,2,14,0,0
7256,83,1456,1178,367,1042,6,15,115,1184,9,94,51,95,103,146,644,976,4,4439,246,0,2,1,7,0
7257,83,1456,177,108,140,8,0,27,185,6,30,16,32,36,48,162,248,3,794,44,0,2,1,7,0
7258,125,3938,1660,832,1314,41,38,274,1701,20,312,209,395,332,604,2671,5058,12,64042,3557,1,2,27,0,1
7259,125,3938,1057,646,719,113,100,145,1170,18,215,134,248,233,382,1740,3004,10,31186,1732,1,2,27,0,1
7260,103,2378,1660,832,1314,41,38,274,1701,20,312,209,395,332,604,2671,5058,12,64042,3557,1,2,8,0,1
7261,1,224,382,65,130,157,2,92,539,4,10,5,10,14,15,41,57,2,114,6,0,2,13,0,1
7262,1,200,382,65,130,157,2,92,539,4,10,5,10,14,15,41,57,2,114,6,0,2,13,0,1
7263,165,3711,77,34,69,0,0,8,77,3,24,16,29,27,45,114,213,1,387,21,0,2,12,0,0
7264,165,3711,712,438,573,51,9,84,763,14,102,71,128,116,199,733,1364,8,11988,666,0,2,12,0,0
7265,21,343,424,94,331,4,0,89,428,1,5,5,5,6,10,11,25,0,12,0,0,2,2,0,0
7266,21,343,38,23,23,6,0,8,44,3,11,7,11,14,18,42,68,1,102,5,0,2,2,0,0
7267,96,2185,1043,504,840,53,9,147,1096,9,180,112,198,189,310,1377,2344,4,11604,644,0,2,1,1,0
7268,96,2185,383,288,292,26,6,62,409,11,65,38,67,76,105,429,656,5,3719,206,0,2,1,1,0
7269,15,464,424,94,331,4,0,89,428,1,5,5,5,6,10,11,25,0,12,0,0,2,9,0,0
7270,162,3675,77,34,69,0,0,8,77,3,24,16,29,27,45,114,213,1,387,21,0,2,4,10,1
7271,162,3675,712,438,573,51,9,84,763,14,102,71,128,116,199,733,1364,8,11988,666,0,2,4,10,1
7272,96,2186,1043,504,840,53,9,147,1096,9,180,112,198,189,310,1377,2344,4,11604,644,0,2,1,1,1
7273,96,2186,383,288,292,26,6,62,409,11,65,38,67,76,105,429,656,5,3719,206,0,2,1,1,1
7274,18,674,1455,414,1257,16,76,112,1471,5,41,23,46,46,69,231,381,2,1069,59,0,2,1,2,1
7275,18,674,669,365,481,22,61,110,691,15,103,63,122,118,185,747,1273,8,11311,628,0,2,1,2,1
7276,12,510,1455,414,1257,16,76,112,1471,5,41,23,46,46,69,231,381,2,1069,59,0,2,9,0,1
7277,18,712,1455,414,1257,16,76,112,1471,5,41,23,46,46,69,231,381,2,1069,59,0,2,5,0,1
7278,18,712,669,365,481,22,61,110,691,15,103,63,122,118,185,747,1273,8,11311,628,0,2,5,0,1
7279,13,546,1455,414,1257,16,76,112,1471,5,41,23,46,46,69,231,381,2,1069,59,0,2,11,0,1
7280,13,542,1455,414,1257,16,76,112,1471,5,41,23,46,46,69,231,381,2,1069,59,0,2,2,2,0
7281,18,712,1455,414,1257,16,76,112,1471,5,41,23,46,46,69,231,381,2,1069,59,0,2,2,2,1
7282,18,712,669,365,481,22,61,110,691,15,103,63,122,118,185,747,1273,8,11311,628,0,2,2,2,1
7283,13,542,1455,414,1257,16,76,112,1471,5,41,23,46,46,69,231,381,2,1069,59,0,2,2,2,1
7284,18,712,1455,414,1257,16,76,112,1471,5,41,23,46,46,69,231,381,2,1069,59,0,2,11,0,0
7285,18,712,669,365,481,22,61,110,691,15,103,63,122,118,185,747,1273,8,11311,628,0,2,11,0,0
7286,13,542,1455,414,1257,16,76,112,1471,5,41,23,46,46,69,231,381,2,1069,59,0,2,20,0,0
7287,30,621,2,2,2,0,0,0,2,0,0,0,0,0,0,0,0,0,0,0,0,2,4,1,1
7288,30,621,99,48,90,1,3,5,100,0,0,0,0,0,0,0,0,0,0,0,0,2,4,1,1
7289,30,621,8,5,5,2,0,1,10,0,0,0,0,0,0,0,0,0,0,0,0,2,4,1,1
7290,30,621,1217,716,841,84,126,174,1301,14,185,118,215,199,333,1446,2542,8,20687,1149,0,2,4,1,1
7291,30,621,160,89,115,0,13,31,160,7,15,11,17,22,28,78,124,3,495,27,0,2,4,1,1
7292,30,621,10,10,9,9,0,0,19,0,0,0,0,0,0,0,0,0,0,0,0,2,4,1,1
7293,30,621,173,84,99,8,29,36,181,5,12,7,13,17,20,54,81,2,221,12,0,2,4,1,1
7294,30,621,3,1,1,3,0,0,6,0,0,0,0,0,0,0,0,0,0,0,0,2,4,1,1
7295,21,767,1455,414,1257,16,76,112,1471,5,41,23,46,46,69,231,381,2,1069,59,0,2,15,5,1
7296,21,767,669,365,481,22,61,110,691,15,103,63,122,118,185,747,1273,8,11311,628,0,2,15,5,1
7297,14,597,1455,414,1257,16,76,112,1471,5,41,23,46,46,69,231,381,2,1069,59,0,2,20,0,1
7298,41,1286,1523,757,1297,19,12,193,1542,12,193,117,230,205,347,1508,2664,7,19053,1058,0,2,2,1,1
7299,41,1286,701,378,504,33,58,109,734,13,110,68,126,123,194,794,1346,7,10027,557,0,2,2,1,1
7300,34,2075,1523,757,1297,19,12,193,1542,12,193,117,230,205,347,1508,2664,7,19053,1058,0,2,19,0,1
7301,41,1749,1513,682,1277,25,13,200,1538,11,199,116,219,210,335,1557,2584,6,15641,868,0,2,12,0,1
7302,21,345,424,94,331,4,0,89,428,1,5,5,5,6,10,11,25,0,12,0,0,2,3,1,1
7303,21,345,38,23,23,6,0,8,44,3,11,7,11,14,18,42,68,1,102,5,0,2,3,1,1
7304,15,464,424,94,331,4,0,89,428,1,5,5,5,6,10,11,25,0,12,0,0,2,23,0,1
7305,72,1496,477,336,357,30,23,73,507,16,194,134,250,210,384,1538,2962,10,30538,1696,0,2,63,34,1
7306,56,985,282,196,195,3,0,86,285,8,130,71,141,138,212,936,1507,4,6538,363,0,2,1,1,1
7307,36,1357,1450,624,1228,12,26,181,1462,14,306,186,354,320,540,2580,4493,8,36391,2021,1,2,31,4,1
7308,12,424,42,7,35,4,0,5,46,1,2,1,2,3,3,2,4,0,2,0,0,2,1,1,1
7309,12,424,11,6,10,0,0,1,11,2,4,2,4,6,6,10,15,1,15,0,0,2,1,1,1
7310,61,2541,1289,550,1043,56,32,155,1345,10,167,93,185,177,278,1266,2075,5,11498,638,0,2,2,0,1
7311,68,1230,1513,682,1277,25,13,200,1538,11,199,116,219,210,335,1557,2584,6,15641,868,0,2,1,2,1
7312,68,1230,819,519,539,24,98,155,843,15,96,57,106,111,163,690,1107,8,9171,509,0,2,1,2,1
7313,42,1312,1523,757,1297,19,12,193,1542,12,193,117,230,205,347,1508,2664,7,19053,1058,0,2,11,6,1
7314,42,1312,701,378,504,33,58,109,734,13,110,68,126,123,194,794,1346,7,10027,557,0,2,11,6,1
7315,36,2201,1523,757,1297,19,12,193,1542,12,193,117,230,205,347,1508,2664,7,19053,1058,0,2,23,1,1
7316,24,565,1293,570,1093,25,15,163,1318,10,195,123,241,205,364,1516,2795,6,17273,959,0,2,11,6,0
7317,68,1230,1513,682,1277,25,13,200,1538,11,199,116,219,210,335,1557,2584,6,15641,868,0,2,1,2,0
7318,68,1230,819,519,539,24,98,155,843,15,96,57,106,111,163,690,1107,8,9171,509,0,2,1,2,0
7319,42,1312,1523,757,1297,19,12,193,1542,12,193,117,230,205,347,1508,2664,7,19053,1058,0,2,11,6,0
7320,42,1312,701,378,504,33,58,109,734,13,110,68,126,123,194,794,1346,7,10027,557,0,2,11,6,0
7321,36,2201,1523,757,1297,19,12,193,1542,12,193,117,230,205,347,1508,2664,7,19053,1058,0,2,23,1,0
7322,52,1027,1020,354,843,12,15,144,1032,8,134,77,144,142,221,970,1580,4,6792,377,0,2,2,2,1
7323,15,473,424,94,331,4,0,89,428,1,5,5,5,6,10,11,25,0,12,0,0,2,4,2,1
7324,68,1230,1513,682,1277,25,13,200,1538,11,199,116,219,210,335,1557,2584,6,15641,868,0,2,1,2,0
7325,68,1230,819,519,539,24,98,155,843,15,96,57,106,111,163,690,1107,8,9171,509,0,2,1,2,0
7326,42,1312,1523,757,1297,19,12,193,1542,12,193,117,230,205,347,1508,2664,7,19053,1058,0,2,11,6,0
7327,42,1312,701,378,504,33,58,109,734,13,110,68,126,123,194,794,1346,7,10027,557,0,2,11,6,0
7328,24,565,1293,570,1093,25,15,163,1318,10,195,123,241,205,364,1516,2795,6,17273,959,0,2,11,6,0
7329,36,2201,1523,757,1297,19,12,193,1542,12,193,117,230,205,347,1508,2664,7,19053,1058,0,2,23,1,0
7330,24,561,1293,570,1093,25,15,163,1318,10,195,123,241,205,364,1516,2795,6,17273,959,0,2,10,9,0
7331,25,575,1293,570,1093,25,15,163,1318,10,195,123,241,205,364,1516,2795,6,17273,959,0,2,8,3,0
7332,26,594,1293,570,1093,25,15,163,1318,10,195,123,241,205,364,1516,2795,6,17273,959,0,2,20,14,1
7333,139,2741,1457,730,1242,11,6,188,1468,10,292,166,329,302,495,2424,4078,5,22973,1276,1,2,8,15,1
7334,139,2741,74,35,59,1,0,14,75,3,14,7,14,17,21,58,85,1,128,7,0,2,8,15,1
7335,139,2741,245,125,200,5,7,34,250,7,30,17,34,37,51,166,265,3,1053,58,0,2,8,15,1
7336,101,4362,139,89,101,2,0,35,141,7,54,34,62,61,96,330,569,4,2287,127,0,2,71,0,1
7337,101,4362,7,5,5,0,0,2,7,1,2,1,2,3,3,2,4,0,2,0,0,2,71,0,1
7338,29,1371,652,304,544,16,6,88,668,6,89,51,101,95,152,591,998,3,3399,188,0,2,12,0,1
7339,56,2548,1943,715,1694,26,18,214,1969,12,185,120,237,197,357,1436,2721,7,20915,1161,0,2,1,1,1
7340,417,8949,72,33,56,0,4,12,72,1,1,1,1,2,2,0,2,0,1,0,0,2,11,6,1
7341,417,8949,1454,835,1044,76,110,219,1530,17,275,158,296,292,454,2297,3718,9,34017,1889,1,2,11,6,1
7342,99,2220,1043,504,840,53,9,147,1096,9,180,112,198,189,310,1377,2344,4,11604,644,0,2,8,0,1
7343,99,2220,383,288,292,26,6,62,409,11,65,38,67,76,105,429,656,5,3719,206,0,2,8,0,1
7344,12,424,42,7,35,4,0,5,46,1,2,1,2,3,3,2,4,0,2,0,0,2,1,1,1
7345,12,424,11,6,10,0,0,1,11,2,4,2,4,6,6,10,15,1,15,0,0,2,1,1,1
7346,13,386,465,148,393,5,8,60,470,4,31,20,31,35,51,161,261,2,523,29,0,2,32,0,1
7347,13,386,16,12,9,0,0,6,16,1,2,1,2,3,3,2,4,0,2,0,0,2,32,0,1
7348,6,493,442,244,305,14,16,103,456,11,68,45,75,79,120,452,756,6,4588,254,0,2,1,0,1
7349,72,1494,477,336,357,30,23,73,507,16,194,134,250,210,384,1538,2962,10,30538,1696,0,2,16,13,1
7350,72,1498,477,336,357,30,23,73,507,16,194,134,250,210,384,1538,2962,10,30538,1696,0,2,1,1,1
7351,37,1394,1450,624,1228,12,26,181,1462,14,306,186,354,320,540,2580,4493,8,36391,2021,1,2,5,0,1
7352,418,8966,72,33,56,0,4,12,72,1,1,1,1,2,2,0,2,0,1,0,0,2,18,13,1
7353,418,8966,1454,835,1044,76,110,219,1530,17,275,158,296,292,454,2297,3718,9,34017,1889,1,2,18,13,1
7354,99,4187,139,89,101,2,0,35,141,7,54,34,62,61,96,330,569,4,2287,127,0,2,14,0,1
7355,99,4187,7,5,5,0,0,2,7,1,2,1,2,3,3,2,4,0,2,0,0,2,14,0,1
7356,37,1396,1450,624,1228,12,26,181,1462,14,306,186,354,320,540,2580,4493,8,36391,2021,1,2,1,1,1
7357,127,3961,1660,832,1314,41,38,274,1701,20,312,209,395,332,604,2671,5058,12,64042,3557,1,2,10,4,0
7358,127,3961,1057,646,719,113,100,145,1170,18,215,134,248,233,382,1740,3004,10,31186,1732,1,2,10,4,0
7359,38,1430,1450,624,1228,12,26,181,1462,14,306,186,354,320,540,2580,4493,8,36391,2021,1,2,14,0,0
7360,12,424,42,7,35,4,0,5,46,1,2,1,2,3,3,2,4,0,2,0,0,2,1,1,1
7361,12,424,11,6,10,0,0,1,11,2,4,2,4,6,6,10,15,1,15,0,0,2,1,1,1
7362,1,224,382,65,130,157,2,92,539,4,10,5,10,14,15,41,57,2,114,6,0,2,1,1,0
7363,12,424,42,7,35,4,0,5,46,1,2,1,2,3,3,2,4,0,2,0,0,2,1,1,1
7364,12,424,11,6,10,0,0,1,11,2,4,2,4,6,6,10,15,1,15,0,0,2,1,1,1
7365,423,9090,72,33,56,0,4,12,72,1,1,1,1,2,2,0,2,0,1,0,0,2,24,1,1
7366,423,9090,1454,835,1044,76,110,219,1530,17,275,158,296,292,454,2297,3718,9,34017,1889,1,2,24,1,1
7367,12,424,42,7,35,4,0,5,46,1,2,1,2,3,3,2,4,0,2,0,0,2,1,1,1
7368,12,424,11,6,10,0,0,1,11,2,4,2,4,6,6,10,15,1,15,0,0,2,1,1,1
7369,104,4340,139,89,101,2,0,35,141,7,54,34,62,61,96,330,569,4,2287,127,0,2,98,0,1
7370,104,4340,7,5,5,0,0,2,7,1,2,1,2,3,3,2,4,0,2,0,0,2,98,0,1
7371,99,2230,1043,504,840,53,9,147,1096,9,180,112,198,189,310,1377,2344,4,11604,644,0,2,1,1,0
7372,99,2230,383,288,292,26,6,62,409,11,65,38,67,76,105,429,656,5,3719,206,0,2,1,1,0
7373,12,424,42,7,35,4,0,5,46,1,2,1,2,3,3,2,4,0,2,0,0,2,1,1,0
7374,12,424,11,6,10,0,0,1,11,2,4,2,4,6,6,10,15,1,15,0,0,2,1,1,0
7375,12,424,42,7,35,4,0,5,46,1,2,1,2,3,3,2,4,0,2,0,0,2,1,1,0
7376,12,424,11,6,10,0,0,1,11,2,4,2,4,6,6,10,15,1,15,0,0,2,1,1,0
7377,84,1473,1178,367,1042,6,15,115,1184,9,94,51,95,103,146,644,976,4,4439,246,0,2,5,1,1
7378,84,1473,177,108,140,8,0,27,185,6,30,16,32,36,48,162,248,3,794,44,0,2,5,1,1
7379,12,424,42,7,35,4,0,5,46,1,2,1,2,3,3,2,4,0,2,0,0,2,1,1,1
7380,12,424,11,6,10,0,0,1,11,2,4,2,4,6,6,10,15,1,15,0,0,2,1,1,1
7381,42,1867,1178,367,1042,6,15,115,1184,9,94,51,95,103,146,644,976,4,4439,246,0,2,41,1,1
7382,12,424,42,7,35,4,0,5,46,1,2,1,2,3,3,2,4,0,2,0,0,2,1,1,0
7383,12,424,11,6,10,0,0,1,11,2,4,2,4,6,6,10,15,1,15,0,0,2,1,1,0
7384,42,1321,1523,757,1297,19,12,193,1542,12,193,117,230,205,347,1508,2664,7,19053,1058,0,2,3,2,1
7385,42,1321,701,378,504,33,58,109,734,13,110,68,126,123,194,794,1346,7,10027,557,0,2,3,2,1
7386,99,2230,1043,504,840,53,9,147,1096,9,180,112,198,189,310,1377,2344,4,11604,644,0,2,2,1,1
7387,99,2230,383,288,292,26,6,62,409,11,65,38,67,76,105,429,656,5,3719,206,0,2,2,1,1
7388,57,2580,1943,715,1694,26,18,214,1969,12,185,120,237,197,357,1436,2721,7,20915,1161,0,2,16,0,1
7389,99,2230,1043,504,840,53,9,147,1096,9,180,112,198,189,310,1377,2344,4,11604,644,0,2,2,1,0
7390,99,2230,383,288,292,26,6,62,409,11,65,38,67,76,105,429,656,5,3719,206,0,2,2,1,0
7391,57,2580,1943,715,1694,26,18,214,1969,12,185,120,237,197,357,1436,2721,7,20915,1161,0,2,16,0,0
7392,37,2246,1523,757,1297,19,12,193,1542,12,193,117,230,205,347,1508,2664,7,19053,1058,0,2,13,0,1
7393,42,1321,1523,757,1297,19,12,193,1542,12,193,117,230,205,347,1508,2664,7,19053,1058,0,2,3,2,0
7394,42,1321,701,378,504,33,58,109,734,13,110,68,126,123,194,794,1346,7,10027,557,0,2,3,2,0
7395,37,2246,1523,757,1297,19,12,193,1542,12,193,117,230,205,347,1508,2664,7,19053,1058,0,2,13,0,0
7396,42,1321,1523,757,1297,19,12,193,1542,12,193,117,230,205,347,1508,2664,7,19053,1058,0,2,3,2,0
7397,42,1321,701,378,504,33,58,109,734,13,110,68,126,123,194,794,1346,7,10027,557,0,2,3,2,0
7398,37,2246,1523,757,1297,19,12,193,1542,12,193,117,230,205,347,1508,2664,7,19053,1058,0,2,13,0,0
7399,12,222,127,75,83,2,11,30,129,4,14,7,14,18,21,61,87,2,175,9,0,2,1,1,0
7400,12,222,652,304,544,16,6,88,668,6,89,51,101,95,152,591,998,3,3399,188,0,2,1,1,0
7401,12,222,2,2,2,0,0,0,2,0,0,0,0,0,0,0,0,0,0,0,0,2,1,1,0
7402,12,222,8,5,5,0,0,3,8,0,0,0,0,0,0,0,0,0,0,0,0,2,1,1,0
7403,12,222,2,2,2,0,0,0,2,0,0,0,0,0,0,0,0,0,0,0,0,2,1,1,0
7404,12,222,14,8,8,0,0,6,14,0,0,0,0,0,0,0,0,0,0,0,0,2,1,1,0
7405,12,222,6,4,4,0,0,2,6,0,0,0,0,0,0,0,0,0,0,0,0,2,1,1,0
7406,12,222,6,4,4,0,0,2,6,1,2,1,2,3,3,2,4,0,2,0,0,2,1,1,0
7407,12,222,6,4,4,0,0,2,6,0,0,0,0,0,0,0,0,0,0,0,0,2,1,1,0
7408,12,222,7,5,5,0,0,2,7,0,0,0,0,0,0,0,0,0,0,0,0,2,1,1,0
7409,12,222,6,4,4,0,0,2,6,0,0,0,0,0,0,0,0,0,0,0,0,2,1,1,0
7410,12,222,10,6,6,0,0,4,10,0,0,0,0,0,0,0,0,0,0,0,0,2,1,1,0
7411,12,222,1,1,1,0,0,0,1,0,0,0,0,0,0,0,0,0,0,0,0,2,1,1,0
7412,12,222,1,1,1,0,0,0,1,0,0,0,0,0,0,0,0,0,0,0,0,2,1,1,0
7413,12,222,14,10,10,0,0,4,14,1,1,1,1,2,2,0,2,0,1,0,0,2,1,1,0
7414,12,222,46,26,30,3,0,12,49,3,6,3,6,9,9,20,28,1,42,2,0,2,1,1,0
7415,427,9239,72,33,56,0,4,12,72,1,1,1,1,2,2,0,2,0,1,0,0,2,21,2,1
7416,427,9239,1454,835,1044,76,110,219,1530,17,275,158,296,292,454,2297,3718,9,34017,1889,1,2,21,2,1
7417,51,2975,1782,648,1425,9,47,279,1791,8,171,97,189,179,286,1292,2140,4,9462,525,0,2,171,0,1
7418,12,222,127,75,83,2,11,30,129,4,14,7,14,18,21,61,87,2,175,9,0,2,1,1,0
7419,12,222,652,304,544,16,6,88,668,6,89,51,101,95,152,591,998,3,3399,188,0,2,1,1,0
7420,12,222,2,2,2,0,0,0,2,0,0,0,0,0,0,0,0,0,0,0,0,2,1,1,0
7421,12,222,8,5,5,0,0,3,8,0,0,0,0,0,0,0,0,0,0,0,0,2,1,1,0
7422,12,222,2,2,2,0,0,0,2,0,0,0,0,0,0,0,0,0,0,0,0,2,1,1,0
7423,12,222,14,8,8,0,0,6,14,0,0,0,0,0,0,0,0,0,0,0,0,2,1,1,0
7424,12,222,6,4,4,0,0,2,6,0,0,0,0,0,0,0,0,0,0,0,0,2,1,1,0
7425,12,222,6,4,4,0,0,2,6,1,2,1,2,3,3,2,4,0,2,0,0,2,1,1,0
7426,12,222,6,4,4,0,0,2,6,0,0,0,0,0,0,0,0,0,0,0,0,2,1,1,0
7427,12,222,7,5,5,0,0,2,7,0,0,0,0,0,0,0,0,0,0,0,0,2,1,1,0
7428,12,222,6,4,4,0,0,2,6,0,0,0,0,0,0,0,0,0,0,0,0,2,1,1,0
7429,12,222,10,6,6,0,0,4,10,0,0,0,0,0,0,0,0,0,0,0,0,2,1,1,0
7430,12,222,1,1,1,0,0,0,1,0,0,0,0,0,0,0,0,0,0,0,0,2,1,1,0
7431,12,222,1,1,1,0,0,0,1,0,0,0,0,0,0,0,0,0,0,0,0,2,1,1,0
7432,12,222,14,10,10,0,0,4,14,1,1,1,1,2,2,0,2,0,1,0,0,2,1,1,0
7433,12,222,46,26,30,3,0,12,49,3,6,3,6,9,9,20,28,1,42,2,0,2,1,1,0
7434,25,860,1455,414,1257,16,76,112,1471,5,41,23,46,46,69,231,381,2,1069,59,0,2,19,7,1
7435,25,860,669,365,481,22,61,110,691,15,103,63,122,118,185,747,1273,8,11311,628,0,2,19,7,1
7436,22,919,1455,414,1257,16,76,112,1471,5,41,23,46,46,69,231,381,2,1069,59,0,2,95,3,1
7437,425,9242,72,33,56,0,4,12,72,1,1,1,1,2,2,0,2,0,1,0,0,2,13,10,1
7438,425,9242,1454,835,1044,76,110,219,1530,17,275,158,296,292,454,2297,3718,9,34017,1889,1,2,13,10,1
7439,51,2929,1782,648,1425,9,47,279,1791,8,171,97,189,179,286,1292,2140,4,9462,525,0,2,72,60,1
7440,12,222,127,75,83,2,11,30,129,4,14,7,14,18,21,61,87,2,175,9,0,2,1,1,0
7441,12,222,652,304,544,16,6,88,668,6,89,51,101,95,152,591,998,3,3399,188,0,2,1,1,0
7442,12,222,2,2,2,0,0,0,2,0,0,0,0,0,0,0,0,0,0,0,0,2,1,1,0
7443,12,222,8,5,5,0,0,3,8,0,0,0,0,0,0,0,0,0,0,0,0,2,1,1,0
7444,12,222,2,2,2,0,0,0,2,0,0,0,0,0,0,0,0,0,0,0,0,2,1,1,0
7445,12,222,14,8,8,0,0,6,14,0,0,0,0,0,0,0,0,0,0,0,0,2,1,1,0
7446,12,222,6,4,4,0,0,2,6,0,0,0,0,0,0,0,0,0,0,0,0,2,1,1,0
7447,12,222,6,4,4,0,0,2,6,1,2,1,2,3,3,2,4,0,2,0,0,2,1,1,0
7448,12,222,6,4,4,0,0,2,6,0,0,0,0,0,0,0,0,0,0,0,0,2,1,1,0
7449,12,222,7,5,5,0,0,2,7,0,0,0,0,0,0,0,0,0,0,0,0,2,1,1,0
7450,12,222,6,4,4,0,0,2,6,0,0,0,0,0,0,0,0,0,0,0,0,2,1,1,0
7451,12,222,10,6,6,0,0,4,10,0,0,0,0,0,0,0,0,0,0,0,0,2,1,1,0
7452,12,222,1,1,1,0,0,0,1,0,0,0,0,0,0,0,0,0,0,0,0,2,1,1,0
7453,12,222,1,1,1,0,0,0,1,0,0,0,0,0,0,0,0,0,0,0,0,2,1,1,0
7454,12,222,14,10,10,0,0,4,14,1,1,1,1,2,2,0,2,0,1,0,0,2,1,1,0
7455,12,222,46,26,30,3,0,12,49,3,6,3,6,9,9,20,28,1,42,2,0,2,1,1,0
7456,164,3702,77,34,69,0,0,8,77,3,24,16,29,27,45,114,213,1,387,21,0,2,12,0,1
7457,164,3702,712,438,573,51,9,84,763,14,102,71,128,116,199,733,1364,8,11988,666,0,2,12,0,1
7458,60,1138,1020,354,843,12,15,144,1032,8,134,77,144,142,221,970,1580,4,6792,377,0,2,92,32,1
7459,42,1846,1020,354,843,12,15,144,1032,8,134,77,144,142,221,970,1580,4,6792,377,0,2,1,2,1
7460,25,860,1455,414,1257,16,76,112,1471,5,41,23,46,46,69,231,381,2,1069,59,0,2,19,7,0
7461,25,860,669,365,481,22,61,110,691,15,103,63,122,118,185,747,1273,8,11311,628,0,2,19,7,0
7462,22,919,1455,414,1257,16,76,112,1471,5,41,23,46,46,69,231,381,2,1069,59,0,2,95,3,0
7463,60,1138,1020,354,843,12,15,144,1032,8,134,77,144,142,221,970,1580,4,6792,377,0,2,1,1,1
7464,425,9242,72,33,56,0,4,12,72,1,1,1,1,2,2,0,2,0,1,0,0,2,24,2,0
7465,425,9242,1454,835,1044,76,110,219,1530,17,275,158,296,292,454,2297,3718,9,34017,1889,1,2,24,2,0
7466,51,2929,1782,648,1425,9,47,279,1791,8,171,97,189,179,286,1292,2140,4,9462,525,0,2,183,0,0
7467,425,9235,72,33,56,0,4,12,72,1,1,1,1,2,2,0,2,0,1,0,0,2,17,16,1
7468,425,9235,1454,835,1044,76,110,219,1530,17,275,158,296,292,454,2297,3718,9,34017,1889,1,2,17,16,1
7469,51,2930,1782,648,1425,9,47,279,1791,8,171,97,189,179,286,1292,2140,4,9462,525,0,2,3,3,1
7470,44,1923,1020,354,843,12,15,144,1032,8,134,77,144,142,221,970,1580,4,6792,377,0,2,18,0,0
7471,45,2010,1020,354,843,12,15,144,1032,8,134,77,144,142,221,970,1580,4,6792,377,0,2,20,1,0
7472,59,1130,1020,354,843,12,15,144,1032,8,134,77,144,142,221,970,1580,4,6792,377,0,2,1,1,1
7473,164,3702,77,34,69,0,0,8,77,3,24,16,29,27,45,114,213,1,387,21,0,2,5,6,1
7474,164,3702,712,438,573,51,9,84,763,14,102,71,128,116,199,733,1364,8,11988,666,0,2,5,6,1
7475,59,1132,1020,354,843,12,15,144,1032,8,134,77,144,142,221,970,1580,4,6792,377,0,2,8,8,1
7476,45,2010,1020,354,843,12,15,144,1032,8,134,77,144,142,221,970,1580,4,6792,377,0,2,1,1,1
7477,164,3702,77,34,69,0,0,8,77,3,24,16,29,27,45,114,213,1,387,21,0,2,11,0,0
7478,164,3702,712,438,573,51,9,84,763,14,102,71,128,116,199,733,1364,8,11988,666,0,2,11,0,0
7479,59,1132,1020,354,843,12,15,144,1032,8,134,77,144,142,221,970,1580,4,6792,377,0,2,91,31,0
7480,45,2010,1020,354,843,12,15,144,1032,8,134,77,144,142,221,970,1580,4,6792,377,0,2,38,2,0
7481,59,1132,1020,354,843,12,15,144,1032,8,134,77,144,142,221,970,1580,4,6792,377,0,2,1,1,0
7482,428,9261,72,33,56,0,4,12,72,1,1,1,1,2,2,0,2,0,1,0,0,2,4,2,1
7483,428,9261,1454,835,1044,76,110,219,1530,17,275,158,296,292,454,2297,3718,9,34017,1889,1,2,4,2,1
7484,12,424,42,7,35,4,0,5,46,1,2,1,2,3,3,2,4,0,2,0,0,2,1,1,1
7485,12,424,11,6,10,0,0,1,11,2,4,2,4,6,6,10,15,1,15,0,0,2,1,1,1
7486,52,2959,1782,648,1425,9,47,279,1791,8,171,97,189,179,286,1292,2140,4,9462,525,0,2,10,0,1
7487,128,3970,1660,832,1314,41,38,274,1701,20,312,209,395,332,604,2671,5058,12,64042,3557,1,2,4,0,1
7488,128,3970,1057,646,719,113,100,145,1170,18,215,134,248,233,382,1740,3004,10,31186,1732,1,2,4,0,1
7489,106,2462,1660,832,1314,41,38,274,1701,20,312,209,395,332,604,2671,5058,12,64042,3557,1,2,18,1,1
7490,430,9299,72,33,56,0,4,12,72,1,1,1,1,2,2,0,2,0,1,0,0,2,5,1,1
7491,430,9299,1454,835,1044,76,110,219,1530,17,275,158,296,292,454,2297,3718,9,34017,1889,1,2,5,1,1
7492,55,3168,1782,648,1425,9,47,279,1791,8,171,97,189,179,286,1292,2140,4,9462,525,0,2,30,2,1
7493,106,2462,1660,832,1314,41,38,274,1701,20,312,209,395,332,604,2671,5058,12,64042,3557,1,2,13,13,0
7494,128,3970,1660,832,1314,41,38,274,1701,20,312,209,395,332,604,2671,5058,12,64042,3557,1,2,4,0,0
7495,128,3970,1057,646,719,113,100,145,1170,18,215,134,248,233,382,1740,3004,10,31186,1732,1,2,4,0,0
7496,106,2462,1660,832,1314,41,38,274,1701,20,312,209,395,332,604,2671,5058,12,64042,3557,1,2,29,12,0
7497,164,3720,77,34,69,0,0,8,77,3,24,16,29,27,45,114,213,1,387,21,0,2,2,0,1
7498,164,3720,712,438,573,51,9,84,763,14,102,71,128,116,199,733,1364,8,11988,666,0,2,2,0,1
7499,24,972,373,158,315,8,0,51,381,5,76,44,79,81,123,486,779,2,2026,112,0,2,14,0,1
7500,430,9291,72,33,56,0,4,12,72,1,1,1,1,2,2,0,2,0,1,0,0,2,6,2,1
7501,430,9291,1454,835,1044,76,110,219,1530,17,275,158,296,292,454,2297,3718,9,34017,1889,1,2,6,2,1
7502,30,1144,1098,241,925,5,10,155,1103,7,46,25,49,53,74,273,423,3,1580,87,0,2,22,0,1
7503,30,1144,1098,241,925,5,10,155,1103,7,46,25,49,53,74,273,423,3,1580,87,0,2,2,2,0
7504,12,424,42,7,35,4,0,5,46,1,2,1,2,3,3,2,4,0,2,0,0,2,1,1,1
7505,12,424,11,6,10,0,0,1,11,2,4,2,4,6,6,10,15,1,15,0,0,2,1,1,1
7506,430,9291,72,33,56,0,4,12,72,1,1,1,1,2,2,0,2,0,1,0,0,2,15,13,1
7507,430,9291,1454,835,1044,76,110,219,1530,17,275,158,296,292,454,2297,3718,9,34017,1889,1,2,15,13,1
7508,430,9303,72,33,56,0,4,12,72,1,1,1,1,2,2,0,2,0,1,0,0,2,9,1,1
7509,430,9303,1454,835,1044,76,110,219,1530,17,275,158,296,292,454,2297,3718,9,34017,1889,1,2,9,1,1
7510,12,424,42,7,35,4,0,5,46,1,2,1,2,3,3,2,4,0,2,0,0,2,1,1,1
7511,12,424,11,6,10,0,0,1,11,2,4,2,4,6,6,10,15,1,15,0,0,2,1,1,1
7512,53,2989,1782,648,1425,9,47,279,1791,8,171,97,189,179,286,1292,2140,4,9462,525,0,2,14,0,1
7513,157,3128,1943,715,1694,26,18,214,1969,12,185,120,237,197,357,1436,2721,7,20915,1161,0,2,6,2,0
7514,157,3128,1168,838,957,57,25,144,1225,19,348,224,416,367,640,3018,5452,11,61921,3440,1,2,6,2,0
7515,128,3970,1660,832,1314,41,38,274,1701,20,312,209,395,332,604,2671,5058,12,64042,3557,1,2,14,4,0
7516,128,3970,1057,646,719,113,100,145,1170,18,215,134,248,233,382,1740,3004,10,31186,1732,1,2,14,4,0
7517,72,1498,477,336,357,30,23,73,507,16,194,134,250,210,384,1538,2962,10,30538,1696,0,2,17,14,0
7518,25,860,1455,414,1257,16,76,112,1471,5,41,23,46,46,69,231,381,2,1069,59,0,2,19,7,0
7519,25,860,669,365,481,22,61,110,691,15,103,63,122,118,185,747,1273,8,11311,628,0,2,19,7,0
7520,42,1321,1523,757,1297,19,12,193,1542,12,193,117,230,205,347,1508,2664,7,19053,1058,0,2,3,2,0
7521,42,1321,701,378,504,33,58,109,734,13,110,68,126,123,194,794,1346,7,10027,557,0,2,3,2,0
7522,164,3720,77,34,69,0,0,8,77,3,24,16,29,27,45,114,213,1,387,21,0,2,13,0,0
7523,164,3720,712,438,573,51,9,84,763,14,102,71,128,116,199,733,1364,8,11988,666,0,2,13,0,0
7524,59,1132,1020,354,843,12,15,144,1032,8,134,77,144,142,221,970,1580,4,6792,377,0,2,91,31,0
7525,430,9303,72,33,56,0,4,12,72,1,1,1,1,2,2,0,2,0,1,0,0,2,116,44,0
7526,430,9303,1454,835,1044,76,110,219,1530,17,275,158,296,292,454,2297,3718,9,34017,1889,1,2,116,44,0
7527,99,2230,1043,504,840,53,9,147,1096,9,180,112,198,189,310,1377,2344,4,11604,644,0,2,10,1,0
7528,99,2230,383,288,292,26,6,62,409,11,65,38,67,76,105,429,656,5,3719,206,0,2,10,1,0
7529,84,1473,1178,367,1042,6,15,115,1184,9,94,51,95,103,146,644,976,4,4439,246,0,2,5,1,0
7530,84,1473,177,108,140,8,0,27,185,6,30,16,32,36,48,162,248,3,794,44,0,2,5,1,0
7531,157,3128,1943,715,1694,26,18,214,1969,12,185,120,237,197,357,1436,2721,7,20915,1161,0,2,6,2,0
7532,157,3128,1168,838,957,57,25,144,1225,19,348,224,416,367,640,3018,5452,11,61921,3440,1,2,6,2,0
7533,1,224,382,65,130,157,2,92,539,4,10,5,10,14,15,41,57,2,114,6,0,2,1,1,0
7534,12,222,127,75,83,2,11,30,129,4,14,7,14,18,21,61,87,2,175,9,0,2,1,1,0
7535,12,222,652,304,544,16,6,88,668,6,89,51,101,95,152,591,998,3,3399,188,0,2,1,1,0
7536,12,222,2,2,2,0,0,0,2,0,0,0,0,0,0,0,0,0,0,0,0,2,1,1,0
7537,12,222,8,5,5,0,0,3,8,0,0,0,0,0,0,0,0,0,0,0,0,2,1,1,0
7538,12,222,2,2,2,0,0,0,2,0,0,0,0,0,0,0,0,0,0,0,0,2,1,1,0
7539,12,222,14,8,8,0,0,6,14,0,0,0,0,0,0,0,0,0,0,0,0,2,1,1,0
7540,12,222,6,4,4,0,0,2,6,0,0,0,0,0,0,0,0,0,0,0,0,2,1,1,0
7541,12,222,6,4,4,0,0,2,6,1,2,1,2,3,3,2,4,0,2,0,0,2,1,1,0
7542,12,222,6,4,4,0,0,2,6,0,0,0,0,0,0,0,0,0,0,0,0,2,1,1,0
7543,12,222,7,5,5,0,0,2,7,0,0,0,0,0,0,0,0,0,0,0,0,2,1,1,0
7544,12,222,6,4,4,0,0,2,6,0,0,0,0,0,0,0,0,0,0,0,0,2,1,1,0
7545,12,222,10,6,6,0,0,4,10,0,0,0,0,0,0,0,0,0,0,0,0,2,1,1,0
7546,12,222,1,1,1,0,0,0,1,0,0,0,0,0,0,0,0,0,0,0,0,2,1,1,0
7547,12,222,1,1,1,0,0,0,1,0,0,0,0,0,0,0,0,0,0,0,0,2,1,1,0
7548,12,222,14,10,10,0,0,4,14,1,1,1,1,2,2,0,2,0,1,0,0,2,1,1,0
7549,12,222,46,26,30,3,0,12,49,3,6,3,6,9,9,20,28,1,42,2,0,2,1,1,0
7550,12,424,42,7,35,4,0,5,46,1,2,1,2,3,3,2,4,0,2,0,0,2,2,2,0
7551,12,424,11,6,10,0,0,1,11,2,4,2,4,6,6,10,15,1,15,0,0,2,2,2,0
7552,107,4544,139,89,101,2,0,35,141,7,54,34,62,61,96,330,569,4,2287,127,0,2,112,0,0
7553,107,4544,7,5,5,0,0,2,7,1,2,1,2,3,3,2,4,0,2,0,0,2,112,0,0
7554,13,386,465,148,393,5,8,60,470,4,31,20,31,35,51,161,261,2,523,29,0,2,32,0,0
7555,13,386,16,12,9,0,0,6,16,1,2,1,2,3,3,2,4,0,2,0,0,2,32,0,0
7556,53,2989,1782,648,1425,9,47,279,1791,8,171,97,189,179,286,1292,2140,4,9462,525,0,2,207,0,0
7557,38,1430,1450,624,1228,12,26,181,1462,14,306,186,354,320,540,2580,4493,8,36391,2021,1,2,19,0,0
7558,106,2462,1660,832,1314,41,38,274,1701,20,312,209,395,332,604,2671,5058,12,64042,3557,1,2,29,12,0
7559,22,919,1455,414,1257,16,76,112,1471,5,41,23,46,46,69,231,381,2,1069,59,0,2,95,3,0
7560,37,2246,1523,757,1297,19,12,193,1542,12,193,117,230,205,347,1508,2664,7,19053,1058,0,2,13,0,0
7561,45,2010,1020,354,843,12,15,144,1032,8,134,77,144,142,221,970,1580,4,6792,377,0,2,38,2,0
7562,24,972,373,158,315,8,0,51,381,5,76,44,79,81,123,486,779,2,2026,112,0,2,14,0,0
7563,42,1867,1178,367,1042,6,15,115,1184,9,94,51,95,103,146,644,976,4,4439,246,0,2,41,1,0
7564,57,2580,1943,715,1694,26,18,214,1969,12,185,120,237,197,357,1436,2721,7,20915,1161,0,2,16,0,0
7565,6,493,442,244,305,14,16,103,456,11,68,45,75,79,120,452,756,6,4588,254,0,2,1,0,0
7566,30,1144,1098,241,925,5,10,155,1103,7,46,25,49,53,74,273,423,3,1580,87,0,2,22,0,0
7567,29,1369,652,304,544,16,6,88,668,6,89,51,101,95,152,591,998,3,3399,188,0,2,0,1,0
7568,1,224,382,65,130,157,2,92,539,4,10,5,10,14,15,41,57,2,114,6,0,2,1,1,0
7569,159,3155,1943,715,1694,26,18,214,1969,12,185,120,237,197,357,1436,2721,7,20915,1161,0,2,13,9,1
7570,159,3155,1168,838,957,57,25,144,1225,19,348,224,416,367,640,3018,5452,11,61921,3440,1,2,13,9,1
7571,58,2641,1943,715,1694,26,18,214,1969,12,185,120,237,197,357,1436,2721,7,20915,1161,0,2,16,5,1
7572,139,2741,1457,730,1242,11,6,188,1468,10,292,166,329,302,495,2424,4078,5,22973,1276,1,2,8,15,0
7573,139,2741,74,35,59,1,0,14,75,3,14,7,14,17,21,58,85,1,128,7,0,2,8,15,0
7574,139,2741,245,125,200,5,7,34,250,7,30,17,34,37,51,166,265,3,1053,58,0,2,8,15,0
7575,107,4544,139,89,101,2,0,35,141,7,54,34,62,61,96,330,569,4,2287,127,0,2,71,0,0
7576,107,4544,7,5,5,0,0,2,7,1,2,1,2,3,3,2,4,0,2,0,0,2,71,0,0
7577,29,1369,652,304,544,16,6,88,668,6,89,51,101,95,152,591,998,3,3399,188,0,2,11,0,0
7578,58,2641,1943,715,1694,26,18,214,1969,12,185,120,237,197,357,1436,2721,7,20915,1161,0,2,1,1,0
7579,159,3155,1943,715,1694,26,18,214,1969,12,185,120,237,197,357,1436,2721,7,20915,1161,0,2,13,9,0
7580,159,3155,1168,838,957,57,25,144,1225,19,348,224,416,367,640,3018,5452,11,61921,3440,1,2,13,9,0
7581,58,2641,1943,715,1694,26,18,214,1969,12,185,120,237,197,357,1436,2721,7,20915,1161,0,2,16,5,0
7582,159,3155,1943,715,1694,26,18,214,1969,12,185,120,237,197,357,1436,2721,7,20915,1161,0,2,13,9,0
7583,159,3155,1168,838,957,57,25,144,1225,19,348,224,416,367,640,3018,5452,11,61921,3440,1,2,13,9,0
7584,58,2641,1943,715,1694,26,18,214,1969,12,185,120,237,197,357,1436,2721,7,20915,1161,0,2,16,5,0
7585,432,9349,72,33,56,0,4,12,72,1,1,1,1,2,2,0,2,0,1,0,0,2,16,7,1
7586,432,9349,1454,835,1044,76,110,219,1530,17,275,158,296,292,454,2297,3718,9,34017,1889,1,2,16,7,1
7587,108,4591,139,89,101,2,0,35,141,7,54,34,62,61,96,330,569,4,2287,127,0,2,25,0,1
7588,108,4591,7,5,5,0,0,2,7,1,2,1,2,3,3,2,4,0,2,0,0,2,25,0,1
7589,128,3964,1660,832,1314,41,38,274,1701,20,312,209,395,332,604,2671,5058,12,64042,3557,1,2,2,8,1
7590,128,3964,1057,646,719,113,100,145,1170,18,215,134,248,233,382,1740,3004,10,31186,1732,1,2,2,8,1
7591,43,1919,1178,367,1042,6,15,115,1184,9,94,51,95,103,146,644,976,4,4439,246,0,2,12,0,1
7592,43,1919,1178,367,1042,6,15,115,1184,9,94,51,95,103,146,644,976,4,4439,246,0,2,12,0,0
7593,432,9350,72,33,56,0,4,12,72,1,1,1,1,2,2,0,2,0,1,0,0,2,2,1,1
7594,432,9350,1454,835,1044,76,110,219,1530,17,275,158,296,292,454,2297,3718,9,34017,1889,1,2,2,1,1
7595,108,4591,139,89,101,2,0,35,141,7,54,34,62,61,96,330,569,4,2287,127,0,2,3,3,1
7596,108,4591,7,5,5,0,0,2,7,1,2,1,2,3,3,2,4,0,2,0,0,2,3,3,1
7597,432,9350,72,33,56,0,4,12,72,1,1,1,1,2,2,0,2,0,1,0,0,2,2,1,0
7598,432,9350,1454,835,1044,76,110,219,1530,17,275,158,296,292,454,2297,3718,9,34017,1889,1,2,2,1,0
7599,108,4591,139,89,101,2,0,35,141,7,54,34,62,61,96,330,569,4,2287,127,0,2,3,3,0
7600,108,4591,7,5,5,0,0,2,7,1,2,1,2,3,3,2,4,0,2,0,0,2,3,3,0
7601,43,1913,1178,367,1042,6,15,115,1184,9,94,51,95,103,146,644,976,4,4439,246,0,2,1,2,1
7602,43,1913,1178,367,1042,6,15,115,1184,9,94,51,95,103,146,644,976,4,4439,246,0,2,1,2,0
7603,434,9388,72,33,56,0,4,12,72,1,1,1,1,2,2,0,2,0,1,0,0,2,5,1,0
7604,434,9388,1454,835,1044,76,110,219,1530,17,275,158,296,292,454,2297,3718,9,34017,1889,1,2,5,1,0
7605,56,3198,1782,648,1425,9,47,279,1791,8,171,97,189,179,286,1292,2140,4,9462,525,0,2,30,2,0
7606,434,9388,72,33,56,0,4,12,72,1,1,1,1,2,2,0,2,0,1,0,0,2,5,1,0
7607,434,9388,1454,835,1044,76,110,219,1530,17,275,158,296,292,454,2297,3718,9,34017,1889,1,2,5,1,0
7608,56,3198,1782,648,1425,9,47,279,1791,8,171,97,189,179,286,1292,2140,4,9462,525,0,2,30,2,0
7609,434,9390,72,33,56,0,4,12,72,1,1,1,1,2,2,0,2,0,1,0,0,2,2,1,1
7610,434,9390,1454,835,1044,76,110,219,1530,17,275,158,296,292,454,2297,3718,9,34017,1889,1,2,2,1,1
7611,12,424,42,7,35,4,0,5,46,1,2,1,2,3,3,2,4,0,2,0,0,2,1,1,1
7612,12,424,11,6,10,0,0,1,11,2,4,2,4,6,6,10,15,1,15,0,0,2,1,1,1
7613,56,3203,1782,648,1425,9,47,279,1791,8,171,97,189,179,286,1292,2140,4,9462,525,0,2,5,5,1
7614,160,3161,1943,715,1694,26,18,214,1969,12,185,120,237,197,357,1436,2721,7,20915,1161,0,2,1,1,0
7615,160,3161,1168,838,957,57,25,144,1225,19,348,224,416,367,640,3018,5452,11,61921,3440,1,2,1,1,0
7616,435,9394,72,33,56,0,4,12,72,1,1,1,1,2,2,0,2,0,1,0,0,2,15,9,1
7617,435,9394,1454,835,1044,76,110,219,1530,17,275,158,296,292,454,2297,3718,9,34017,1889,1,2,15,9,1
7618,12,424,42,7,35,4,0,5,46,1,2,1,2,3,3,2,4,0,2,0,0,2,1,1,1
7619,12,424,11,6,10,0,0,1,11,2,4,2,4,6,6,10,15,1,15,0,0,2,1,1,1
7620,110,4667,139,89,101,2,0,35,141,7,54,34,62,61,96,330,569,4,2287,127,0,2,33,0,1
7621,110,4667,7,5,5,0,0,2,7,1,2,1,2,3,3,2,4,0,2,0,0,2,33,0,1
7622,12,424,42,7,35,4,0,5,46,1,2,1,2,3,3,2,4,0,2,0,0,2,1,1,1
7623,12,424,11,6,10,0,0,1,11,2,4,2,4,6,6,10,15,1,15,0,0,2,1,1,1
7624,68,1226,1513,682,1277,25,13,200,1538,11,199,116,219,210,335,1557,2584,6,15641,868,0,2,1,1,1
7625,68,1226,819,519,539,24,98,155,843,15,96,57,106,111,163,690,1107,8,9171,509,0,2,1,1,1
7626,172,3366,1457,730,1242,11,6,188,1468,10,292,166,329,302,495,2424,4078,5,22973,1276,1,2,144,11,1
7627,172,3366,74,35,59,1,0,14,75,3,14,7,14,17,21,58,85,1,128,7,0,2,144,11,1
7628,172,3366,245,125,200,5,7,34,250,7,30,17,34,37,51,166,265,3,1053,58,0,2,144,11,1
7629,42,1131,74,35,59,1,0,14,75,3,14,7,14,17,21,58,85,1,128,7,0,2,1,0,1
7630,42,1131,245,125,200,5,7,34,250,7,30,17,34,37,51,166,265,3,1053,58,0,2,1,0,1
7631,43,415,647,139,84,35,284,233,682,0,0,0,0,0,0,0,0,0,0,0,0,2,1,1,1
7632,164,3720,77,34,69,0,0,8,77,3,24,16,29,27,45,114,213,1,387,21,0,2,1,1,1
7633,164,3720,712,438,573,51,9,84,763,14,102,71,128,116,199,733,1364,8,11988,666,0,2,1,1,1
7634,14,453,184,100,137,2,15,30,186,6,38,20,39,44,59,214,322,3,991,55,0,2,1,1,1
7635,14,453,103,65,74,8,5,16,111,7,17,9,17,24,26,89,119,3,417,23,0,2,1,1,1
7636,99,2230,1043,504,840,53,9,147,1096,9,180,112,198,189,310,1377,2344,4,11604,644,0,2,1,1,1
7637,99,2230,383,288,292,26,6,62,409,11,65,38,67,76,105,429,656,5,3719,206,0,2,1,1,1
7638,160,3157,1943,715,1694,26,18,214,1969,12,185,120,237,197,357,1436,2721,7,20915,1161,0,2,1,1,1
7639,160,3157,1168,838,957,57,25,144,1225,19,348,224,416,367,640,3018,5452,11,61921,3440,1,2,1,1,1
7640,46,2032,1020,354,843,12,15,144,1032,8,134,77,144,142,221,970,1580,4,6792,377,0,2,13,3,1
7641,22,1115,334,251,279,10,4,40,344,5,127,74,143,132,217,899,1528,2,4303,239,0,2,59,14,1
7642,178,3490,1457,730,1242,11,6,188,1468,10,292,166,329,302,495,2424,4078,5,22973,1276,1,2,38,1,1
7643,178,3490,74,35,59,1,0,14,75,3,14,7,14,17,21,58,85,1,128,7,0,2,38,1,1
7644,178,3490,245,125,200,5,7,34,250,7,30,17,34,37,51,166,265,3,1053,58,0,2,38,1,1
7645,68,1226,1513,682,1277,25,13,200,1538,11,199,116,219,210,335,1557,2584,6,15641,868,0,2,1,1,0
7646,68,1226,819,519,539,24,98,155,843,15,96,57,106,111,163,690,1107,8,9171,509,0,2,1,1,0
7647,178,3490,1457,730,1242,11,6,188,1468,10,292,166,329,302,495,2424,4078,5,22973,1276,1,2,181,11,0
7648,178,3490,74,35,59,1,0,14,75,3,14,7,14,17,21,58,85,1,128,7,0,2,181,11,0
7649,178,3490,245,125,200,5,7,34,250,7,30,17,34,37,51,166,265,3,1053,58,0,2,181,11,0
7650,42,1131,74,35,59,1,0,14,75,3,14,7,14,17,21,58,85,1,128,7,0,2,1,0,0
7651,42,1131,245,125,200,5,7,34,250,7,30,17,34,37,51,166,265,3,1053,58,0,2,1,0,0
7652,43,415,647,139,84,35,284,233,682,0,0,0,0,0,0,0,0,0,0,0,0,2,1,1,0
7653,164,3720,77,34,69,0,0,8,77,3,24,16,29,27,45,114,213,1,387,21,0,2,1,1,0
7654,164,3720,712,438,573,51,9,84,763,14,102,71,128,116,199,733,1364,8,11988,666,0,2,1,1,0
7655,14,453,184,100,137,2,15,30,186,6,38,20,39,44,59,214,322,3,991,55,0,2,1,1,0
7656,14,453,103,65,74,8,5,16,111,7,17,9,17,24,26,89,119,3,417,23,0,2,1,1,0
7657,99,2230,1043,504,840,53,9,147,1096,9,180,112,198,189,310,1377,2344,4,11604,644,0,2,1,1,0
7658,99,2230,383,288,292,26,6,62,409,11,65,38,67,76,105,429,656,5,3719,206,0,2,1,1,0
7659,160,3157,1943,715,1694,26,18,214,1969,12,185,120,237,197,357,1436,2721,7,20915,1161,0,2,1,1,0
7660,160,3157,1168,838,957,57,25,144,1225,19,348,224,416,367,640,3018,5452,11,61921,3440,1,2,1,1,0
7661,46,2032,1020,354,843,12,15,144,1032,8,134,77,144,142,221,970,1580,4,6792,377,0,2,13,3,0
7662,22,1115,334,251,279,10,4,40,344,5,127,74,143,132,217,899,1528,2,4303,239,0,2,59,14,0
7663,13,444,42,7,35,4,0,5,46,1,2,1,2,3,3,2,4,0,2,0,0,2,5,1,1
7664,13,444,11,6,10,0,0,1,11,2,4,2,4,6,6,10,15,1,15,0,0,2,5,1,1
7665,35,645,127,75,83,2,11,30,129,4,14,7,14,18,21,61,87,2,175,9,0,2,3,0,1
7666,35,645,652,304,544,16,6,88,668,6,89,51,101,95,152,591,998,3,3399,188,0,2,3,0,1
7667,35,645,2,2,2,0,0,0,2,0,0,0,0,0,0,0,0,0,0,0,0,2,3,0,1
7668,35,645,8,5,5,0,0,3,8,0,0,0,0,0,0,0,0,0,0,0,0,2,3,0,1
7669,35,645,2,2,2,0,0,0,2,0,0,0,0,0,0,0,0,0,0,0,0,2,3,0,1
7670,35,645,14,8,8,0,0,6,14,0,0,0,0,0,0,0,0,0,0,0,0,2,3,0,1
7671,35,645,6,4,4,0,0,2,6,0,0,0,0,0,0,0,0,0,0,0,0,2,3,0,1
7672,35,645,6,4,4,0,0,2,6,1,2,1,2,3,3,2,4,0,2,0,0,2,3,0,1
7673,35,645,6,4,4,0,0,2,6,0,0,0,0,0,0,0,0,0,0,0,0,2,3,0,1
7674,35,645,7,5,5,0,0,2,7,0,0,0,0,0,0,0,0,0,0,0,0,2,3,0,1
7675,35,645,6,4,4,0,0,2,6,0,0,0,0,0,0,0,0,0,0,0,0,2,3,0,1
7676,35,645,10,6,6,0,0,4,10,0,0,0,0,0,0,0,0,0,0,0,0,2,3,0,1
7677,35,645,1,1,1,0,0,0,1,0,0,0,0,0,0,0,0,0,0,0,0,2,3,0,1
7678,35,645,1,1,1,0,0,0,1,0,0,0,0,0,0,0,0,0,0,0,0,2,3,0,1
7679,35,645,14,10,10,0,0,4,14,1,1,1,1,2,2,0,2,0,1,0,0,2,3,0,1
7680,35,645,46,26,30,3,0,12,49,3,6,3,6,9,9,20,28,1,42,2,0,2,3,0,1
7681,22,1119,334,251,279,10,4,40,344,5,127,74,143,132,217,899,1528,2,4303,239,0,2,3,2,1
7682,35,645,127,75,83,2,11,30,129,4,14,7,14,18,21,61,87,2,175,9,0,2,1,1,0
7683,35,645,652,304,544,16,6,88,668,6,89,51,101,95,152,591,998,3,3399,188,0,2,1,1,0
7684,35,645,2,2,2,0,0,0,2,0,0,0,0,0,0,0,0,0,0,0,0,2,1,1,0
7685,35,645,8,5,5,0,0,3,8,0,0,0,0,0,0,0,0,0,0,0,0,2,1,1,0
7686,35,645,2,2,2,0,0,0,2,0,0,0,0,0,0,0,0,0,0,0,0,2,1,1,0
7687,35,645,14,8,8,0,0,6,14,0,0,0,0,0,0,0,0,0,0,0,0,2,1,1,0
7688,35,645,6,4,4,0,0,2,6,0,0,0,0,0,0,0,0,0,0,0,0,2,1,1,0
7689,35,645,6,4,4,0,0,2,6,1,2,1,2,3,3,2,4,0,2,0,0,2,1,1,0
7690,35,645,6,4,4,0,0,2,6,0,0,0,0,0,0,0,0,0,0,0,0,2,1,1,0
7691,35,645,7,5,5,0,0,2,7,0,0,0,0,0,0,0,0,0,0,0,0,2,1,1,0
7692,35,645,6,4,4,0,0,2,6,0,0,0,0,0,0,0,0,0,0,0,0,2,1,1,0
7693,35,645,10,6,6,0,0,4,10,0,0,0,0,0,0,0,0,0,0,0,0,2,1,1,0
7694,35,645,1,1,1,0,0,0,1,0,0,0,0,0,0,0,0,0,0,0,0,2,1,1,0
7695,35,645,1,1,1,0,0,0,1,0,0,0,0,0,0,0,0,0,0,0,0,2,1,1,0
7696,35,645,14,10,10,0,0,4,14,1,1,1,1,2,2,0,2,0,1,0,0,2,1,1,0
7697,35,645,46,26,30,3,0,12,49,3,6,3,6,9,9,20,28,1,42,2,0,2,1,1,0
7698,1,87,19,8,11,5,0,4,24,2,5,3,6,7,9,13,25,1,30,1,0,0,68,0,1
7699,1,87,102,59,69,5,3,24,107,6,22,15,28,28,43,113,206,3,789,43,0,0,68,0,1
7700,1,87,106,40,36,3,49,17,109,8,17,13,23,25,36,93,167,5,904,50,0,0,68,0,1
7701,181,3563,1457,730,1242,11,6,188,1468,10,292,166,329,302,495,2424,4078,5,22973,1276,1,2,17,8,1
7702,181,3563,74,35,59,1,0,14,75,3,14,7,14,17,21,58,85,1,128,7,0,2,17,8,1
7703,181,3563,245,125,200,5,7,34,250,7,30,17,34,37,51,166,265,3,1053,58,0,2,17,8,1
7704,25,1433,334,251,279,10,4,40,344,5,127,74,143,132,217,899,1528,2,4303,239,0,2,40,0,1
7705,1,85,19,8,11,5,0,4,24,2,5,3,6,7,9,13,25,1,30,1,0,2,0,1,1
7706,1,85,102,59,69,5,3,24,107,6,22,15,28,28,43,113,206,3,789,43,0,2,0,1,1
7707,1,85,106,40,36,3,49,17,109,8,17,13,23,25,36,93,167,5,904,50,0,2,0,1,1
7708,26,1521,334,251,279,10,4,40,344,5,127,74,143,132,217,899,1528,2,4303,239,0,2,15,7,1
7709,1,85,19,8,11,5,0,4,24,2,5,3,6,7,9,13,25,1,30,1,0,0,67,0,0
7710,1,85,102,59,69,5,3,24,107,6,22,15,28,28,43,113,206,3,789,43,0,0,67,0,0
7711,1,85,106,40,36,3,49,17,109,8,17,13,23,25,36,93,167,5,904,50,0,0,67,0,0
7712,181,3563,1457,730,1242,11,6,188,1468,10,292,166,329,302,495,2424,4078,5,22973,1276,1,2,17,8,0
7713,181,3563,74,35,59,1,0,14,75,3,14,7,14,17,21,58,85,1,128,7,0,2,17,8,0
7714,181,3563,245,125,200,5,7,34,250,7,30,17,34,37,51,166,265,3,1053,58,0,2,17,8,0
7715,26,1521,334,251,279,10,4,40,344,5,127,74,143,132,217,899,1528,2,4303,239,0,2,48,0,0
7716,26,1539,334,251,279,10,4,40,344,5,127,74,143,132,217,899,1528,2,4303,239,0,2,7,1,0
7717,26,1517,334,251,279,10,4,40,344,5,127,74,143,132,217,899,1528,2,4303,239,0,2,8,10,1
7718,13,426,42,7,35,4,0,5,46,1,2,1,2,3,3,2,4,0,2,0,0,2,1,6,0
7719,13,426,11,6,10,0,0,1,11,2,4,2,4,6,6,10,15,1,15,0,0,2,1,6,0
7720,26,1517,334,251,279,10,4,40,344,5,127,74,143,132,217,899,1528,2,4303,239,0,2,13,9,0
7721,26,1517,334,251,279,10,4,40,344,5,127,74,143,132,217,899,1528,2,4303,239,0,2,13,9,0
7722,435,9394,72,33,56,0,4,12,72,1,1,1,1,2,2,0,2,0,1,0,0,2,2,0,0
7723,435,9394,1454,835,1044,76,110,219,1530,17,275,158,296,292,454,2297,3718,9,34017,1889,1,2,2,0,0
7724,26,1517,334,251,279,10,4,40,344,5,127,74,143,132,217,899,1528,2,4303,239,0,2,13,9,0
7725,181,3565,1457,730,1242,11,6,188,1468,10,292,166,329,302,495,2424,4078,5,22973,1276,1,2,8,8,0
7726,181,3565,74,35,59,1,0,14,75,3,14,7,14,17,21,58,85,1,128,7,0,2,8,8,0
7727,181,3565,245,125,200,5,7,34,250,7,30,17,34,37,51,166,265,3,1053,58,0,2,8,8,0
7728,26,1508,334,251,279,10,4,40,344,5,127,74,143,132,217,899,1528,2,4303,239,0,2,1,1,0
7729,181,3565,1457,730,1242,11,6,188,1468,10,292,166,329,302,495,2424,4078,5,22973,1276,1,2,8,8,0
7730,181,3565,74,35,59,1,0,14,75,3,14,7,14,17,21,58,85,1,128,7,0,2,8,8,0
7731,181,3565,245,125,200,5,7,34,250,7,30,17,34,37,51,166,265,3,1053,58,0,2,8,8,0
7732,26,1508,334,251,279,10,4,40,344,5,127,74,143,132,217,899,1528,2,4303,239,0,2,1,1,0
7733,73,1525,477,336,357,30,23,73,507,16,194,134,250,210,384,1538,2962,10,30538,1696,0,2,7,2,1
7734,48,1675,1450,624,1228,12,26,181,1462,14,306,186,354,320,540,2580,4493,8,36391,2021,1,2,41,1,1
7735,73,1533,477,336,357,30,23,73,507,16,194,134,250,210,384,1538,2962,10,30538,1696,0,2,5,1,1
7736,35,643,127,75,83,2,11,30,129,4,14,7,14,18,21,61,87,2,175,9,0,2,1,1,1
7737,35,643,652,304,544,16,6,88,668,6,89,51,101,95,152,591,998,3,3399,188,0,2,1,1,1
7738,35,643,2,2,2,0,0,0,2,0,0,0,0,0,0,0,0,0,0,0,0,2,1,1,1
7739,35,643,8,5,5,0,0,3,8,0,0,0,0,0,0,0,0,0,0,0,0,2,1,1,1
7740,35,643,2,2,2,0,0,0,2,0,0,0,0,0,0,0,0,0,0,0,0,2,1,1,1
7741,35,643,14,8,8,0,0,6,14,0,0,0,0,0,0,0,0,0,0,0,0,2,1,1,1
7742,35,643,6,4,4,0,0,2,6,0,0,0,0,0,0,0,0,0,0,0,0,2,1,1,1
7743,35,643,6,4,4,0,0,2,6,1,2,1,2,3,3,2,4,0,2,0,0,2,1,1,1
7744,35,643,6,4,4,0,0,2,6,0,0,0,0,0,0,0,0,0,0,0,0,2,1,1,1
7745,35,643,7,5,5,0,0,2,7,0,0,0,0,0,0,0,0,0,0,0,0,2,1,1,1
7746,35,643,6,4,4,0,0,2,6,0,0,0,0,0,0,0,0,0,0,0,0,2,1,1,1
7747,35,643,10,6,6,0,0,4,10,0,0,0,0,0,0,0,0,0,0,0,0,2,1,1,1
7748,35,643,1,1,1,0,0,0,1,0,0,0,0,0,0,0,0,0,0,0,0,2,1,1,1
7749,35,643,1,1,1,0,0,0,1,0,0,0,0,0,0,0,0,0,0,0,0,2,1,1,1
7750,35,643,14,10,10,0,0,4,14,1,1,1,1,2,2,0,2,0,1,0,0,2,1,1,1
7751,35,643,46,26,30,3,0,12,49,3,6,3,6,9,9,20,28,1,42,2,0,2,1,1,1
7752,49,1694,1450,624,1228,12,26,181,1462,14,306,186,354,320,540,2580,4493,8,36391,2021,1,2,8,6,1
7753,126,3959,1660,832,1314,41,38,274,1701,20,312,209,395,332,604,2671,5058,12,64042,3557,1,2,8,12,1
7754,126,3959,1057,646,719,113,100,145,1170,18,215,134,248,233,382,1740,3004,10,31186,1732,1,2,8,12,1
7755,109,2592,1660,832,1314,41,38,274,1701,20,312,209,395,332,604,2671,5058,12,64042,3557,1,2,20,0,1
7756,200,3870,1457,730,1242,11,6,188,1468,10,292,166,329,302,495,2424,4078,5,22973,1276,1,2,69,2,1
7757,200,3870,74,35,59,1,0,14,75,3,14,7,14,17,21,58,85,1,128,7,0,2,69,2,1
7758,200,3870,245,125,200,5,7,34,250,7,30,17,34,37,51,166,265,3,1053,58,0,2,69,2,1
7759,35,2151,334,251,279,10,4,40,344,5,127,74,143,132,217,899,1528,2,4303,239,0,2,101,29,1
7760,35,2147,334,251,279,10,4,40,344,5,127,74,143,132,217,899,1528,2,4303,239,0,2,2,2,0
7761,200,3870,1457,730,1242,11,6,188,1468,10,292,166,329,302,495,2424,4078,5,22973,1276,1,2,69,2,0
7762,200,3870,74,35,59,1,0,14,75,3,14,7,14,17,21,58,85,1,128,7,0,2,69,2,0
7763,200,3870,245,125,200,5,7,34,250,7,30,17,34,37,51,166,265,3,1053,58,0,2,69,2,0
7764,35,2147,334,251,279,10,4,40,344,5,127,74,143,132,217,899,1528,2,4303,239,0,2,99,27,0
7765,30,619,2,2,2,0,0,0,2,0,0,0,0,0,0,0,0,0,0,0,0,2,2,2,1
7766,30,619,99,48,90,1,3,5,100,0,0,0,0,0,0,0,0,0,0,0,0,2,2,2,1
7767,30,619,8,5,5,2,0,1,10,0,0,0,0,0,0,0,0,0,0,0,0,2,2,2,1
7768,30,619,1217,716,841,84,126,174,1301,14,185,118,215,199,333,1446,2542,8,20687,1149,0,2,2,2,1
7769,30,619,160,89,115,0,13,31,160,7,15,11,17,22,28,78,124,3,495,27,0,2,2,2,1
7770,30,619,10,10,9,9,0,0,19,0,0,0,0,0,0,0,0,0,0,0,0,2,2,2,1
7771,30,619,173,84,99,8,29,36,181,5,12,7,13,17,20,54,81,2,221,12,0,2,2,2,1
7772,30,619,3,1,1,3,0,0,6,0,0,0,0,0,0,0,0,0,0,0,0,2,2,2,1
7773,42,1129,74,35,59,1,0,14,75,3,14,7,14,17,21,58,85,1,128,7,0,2,2,2,1
7774,42,1129,245,125,200,5,7,34,250,7,30,17,34,37,51,166,265,3,1053,58,0,2,2,2,1
7775,42,1321,1523,757,1297,19,12,193,1542,12,193,117,230,205,347,1508,2664,7,19053,1058,0,2,3,3,1
7776,42,1321,701,378,504,33,58,109,734,13,110,68,126,123,194,794,1346,7,10027,557,0,2,3,3,1
7777,164,3718,77,34,69,0,0,8,77,3,24,16,29,27,45,114,213,1,387,21,0,2,3,2,1
7778,164,3718,712,438,573,51,9,84,763,14,102,71,128,116,199,733,1364,8,11988,666,0,2,3,2,1
7779,29,601,215,129,180,6,0,29,221,8,65,43,72,73,115,415,711,4,3153,175,0,2,1,1,1
7780,29,601,97,69,77,3,3,16,100,6,22,13,23,28,36,113,173,3,542,30,0,2,1,1,1
7781,160,3155,1943,715,1694,26,18,214,1969,12,185,120,237,197,357,1436,2721,7,20915,1161,0,2,2,2,1
7782,160,3155,1168,838,957,57,25,144,1225,19,348,224,416,367,640,3018,5452,11,61921,3440,1,2,2,2,1
7783,35,2147,334,251,279,10,4,40,344,5,127,74,143,132,217,899,1528,2,4303,239,0,2,0,1,1
7784,30,619,2,2,2,0,0,0,2,0,0,0,0,0,0,0,0,0,0,0,0,2,2,2,0
7785,30,619,99,48,90,1,3,5,100,0,0,0,0,0,0,0,0,0,0,0,0,2,2,2,0
7786,30,619,8,5,5,2,0,1,10,0,0,0,0,0,0,0,0,0,0,0,0,2,2,2,0
7787,30,619,1217,716,841,84,126,174,1301,14,185,118,215,199,333,1446,2542,8,20687,1149,0,2,2,2,0
7788,30,619,160,89,115,0,13,31,160,7,15,11,17,22,28,78,124,3,495,27,0,2,2,2,0
7789,30,619,10,10,9,9,0,0,19,0,0,0,0,0,0,0,0,0,0,0,0,2,2,2,0
7790,30,619,173,84,99,8,29,36,181,5,12,7,13,17,20,54,81,2,221,12,0,2,2,2,0
7791,30,619,3,1,1,3,0,0,6,0,0,0,0,0,0,0,0,0,0,0,0,2,2,2,0
7792,42,1129,74,35,59,1,0,14,75,3,14,7,14,17,21,58,85,1,128,7,0,2,2,2,0
7793,42,1129,245,125,200,5,7,34,250,7,30,17,34,37,51,166,265,3,1053,58,0,2,2,2,0
7794,42,1321,1523,757,1297,19,12,193,1542,12,193,117,230,205,347,1508,2664,7,19053,1058,0,2,3,3,0
7795,42,1321,701,378,504,33,58,109,734,13,110,68,126,123,194,794,1346,7,10027,557,0,2,3,3,0
7796,164,3718,77,34,69,0,0,8,77,3,24,16,29,27,45,114,213,1,387,21,0,2,3,2,0
7797,164,3718,712,438,573,51,9,84,763,14,102,71,128,116,199,733,1364,8,11988,666,0,2,3,2,0
7798,29,601,215,129,180,6,0,29,221,8,65,43,72,73,115,415,711,4,3153,175,0,2,1,1,0
7799,29,601,97,69,77,3,3,16,100,6,22,13,23,28,36,113,173,3,542,30,0,2,1,1,0
7800,160,3155,1943,715,1694,26,18,214,1969,12,185,120,237,197,357,1436,2721,7,20915,1161,0,2,2,2,0
7801,160,3155,1168,838,957,57,25,144,1225,19,348,224,416,367,640,3018,5452,11,61921,3440,1,2,2,2,0
7802,35,2147,334,251,279,10,4,40,344,5,127,74,143,132,217,899,1528,2,4303,239,0,2,0,1,0
7803,3,23,14,7,7,2,0,5,16,0,0,0,0,0,0,0,0,0,0,0,0,2,1,1,1
7804,3,23,14,7,7,2,0,5,16,0,0,0,0,0,0,0,0,0,0,0,0,2,1,1,1
7805,61,2541,1289,550,1043,56,32,155,1345,10,167,93,185,177,278,1266,2075,5,11498,638,0,2,1,1,1
7806,53,2846,1338,495,1086,10,64,173,1348,11,122,82,157,133,239,883,1686,7,11934,663,0,2,5,5,1
7807,110,4667,139,89,101,2,0,35,141,7,54,34,62,61,96,330,569,4,2287,127,0,2,1,1,1
7808,110,4667,7,5,5,0,0,2,7,1,2,1,2,3,3,2,4,0,2,0,0,2,1,1,1
7809,56,3203,1782,648,1425,9,47,279,1791,8,171,97,189,179,286,1292,2140,4,9462,525,0,2,1,1,1
7810,49,1694,1450,624,1228,12,26,181,1462,14,306,186,354,320,540,2580,4493,8,36391,2021,1,2,1,1,1
7811,42,2708,1296,573,1062,40,33,157,1336,8,201,118,231,209,349,1561,2689,4,12365,686,0,2,3,3,1
7812,24,972,373,158,315,8,0,51,381,5,76,44,79,81,123,486,779,2,2026,112,0,2,2,2,1
7813,58,2641,1943,715,1694,26,18,214,1969,12,185,120,237,197,357,1436,2721,7,20915,1161,0,2,9,9,1
7814,438,9405,72,33,56,0,4,12,72,1,1,1,1,2,2,0,2,0,1,0,0,2,6,6,1
7815,438,9405,1454,835,1044,76,110,219,1530,17,275,158,296,292,454,2297,3718,9,34017,1889,1,2,6,6,1
7816,112,4755,139,89,101,2,0,35,141,7,54,34,62,61,96,330,569,4,2287,127,0,2,47,1,1
7817,112,4755,7,5,5,0,0,2,7,1,2,1,2,3,3,2,4,0,2,0,0,2,47,1,1
7818,129,4014,1660,832,1314,41,38,274,1701,20,312,209,395,332,604,2671,5058,12,64042,3557,1,2,13,0,1
7819,129,4014,1057,646,719,113,100,145,1170,18,215,134,248,233,382,1740,3004,10,31186,1732,1,2,13,0,1
7820,111,2674,1660,832,1314,41,38,274,1701,20,312,209,395,332,604,2671,5058,12,64042,3557,1,2,30,0,1
7821,438,9405,72,33,56,0,4,12,72,1,1,1,1,2,2,0,2,0,1,0,0,2,6,6,0
7822,438,9405,1454,835,1044,76,110,219,1530,17,275,158,296,292,454,2297,3718,9,34017,1889,1,2,6,6,0
7823,112,4755,139,89,101,2,0,35,141,7,54,34,62,61,96,330,569,4,2287,127,0,2,47,1,0
7824,112,4755,7,5,5,0,0,2,7,1,2,1,2,3,3,2,4,0,2,0,0,2,47,1,0
7825,191,4456,722,423,573,19,0,135,741,12,172,101,199,184,300,1320,2257,6,15668,870,0,2,6,0,1
7826,191,4456,1508,847,911,44,250,301,1552,14,148,88,169,162,257,1120,1886,7,15077,837,0,2,6,0,1
7827,56,1100,1098,241,925,5,10,155,1103,7,46,25,49,53,74,273,423,3,1580,87,0,2,27,22,1
7828,56,1100,282,202,222,14,2,44,296,8,42,24,43,50,67,250,378,4,1548,86,0,2,27,22,1
7829,112,4779,139,89,101,2,0,35,141,7,54,34,62,61,96,330,569,4,2287,127,0,2,10,4,1
7830,112,4779,7,5,5,0,0,2,7,1,2,1,2,3,3,2,4,0,2,0,0,2,10,4,1
7831,32,1208,1098,241,925,5,10,155,1103,7,46,25,49,53,74,273,423,3,1580,87,0,2,51,1,1
7832,57,1106,1098,241,925,5,10,155,1103,7,46,25,49,53,74,273,423,3,1580,87,0,2,2,1,1
7833,57,1106,282,202,222,14,2,44,296,8,42,24,43,50,67,250,378,4,1548,86,0,2,2,1,1
7834,165,3739,77,34,69,0,0,8,77,3,24,16,29,27,45,114,213,1,387,21,0,2,9,1,1
7835,165,3739,712,438,573,51,9,84,763,14,102,71,128,116,199,733,1364,8,11988,666,0,2,9,1,1
7836,434,9399,72,33,56,0,4,12,72,1,1,1,1,2,2,0,2,0,1,0,0,2,22,29,1
7837,434,9399,1454,835,1044,76,110,219,1530,17,275,158,296,292,454,2297,3718,9,34017,1889,1,2,22,29,1
7838,56,1091,1098,241,925,5,10,155,1103,7,46,25,49,53,74,273,423,3,1580,87,0,2,12,15,1
7839,56,1091,282,202,222,14,2,44,296,8,42,24,43,50,67,250,378,4,1548,86,0,2,12,15,1
7840,13,426,42,7,35,4,0,5,46,1,2,1,2,3,3,2,4,0,2,0,0,2,1,1,1
7841,13,426,11,6,10,0,0,1,11,2,4,2,4,6,6,10,15,1,15,0,0,2,1,1,1
7842,112,4767,139,89,101,2,0,35,141,7,54,34,62,61,96,330,569,4,2287,127,0,2,0,2,1
7843,112,4767,7,5,5,0,0,2,7,1,2,1,2,3,3,2,4,0,2,0,0,2,0,2,1
7844,13,413,295,56,236,0,4,54,295,2,9,5,10,11,15,30,51,1,57,3,0,2,74,34,1
7845,33,1262,1098,241,925,5,10,155,1103,7,46,25,49,53,74,273,423,3,1580,87,0,2,19,1,1
7846,159,3154,1943,715,1694,26,18,214,1969,12,185,120,237,197,357,1436,2721,7,20915,1161,0,2,8,10,0
7847,159,3154,1168,838,957,57,25,144,1225,19,348,224,416,367,640,3018,5452,11,61921,3440,1,2,8,10,0
7848,8,207,19,8,11,5,0,4,24,2,5,3,6,7,9,13,25,1,30,1,0,2,36,2,1
7849,8,207,102,59,69,5,3,24,107,6,22,15,28,28,43,113,206,3,789,43,0,2,36,2,1
7850,8,207,106,40,36,3,49,17,109,8,17,13,23,25,36,93,167,5,904,50,0,2,36,2,1
7851,23,594,102,59,69,5,3,24,107,6,22,15,28,28,43,113,206,3,789,43,0,0,92,0,1
7852,159,3154,1943,715,1694,26,18,214,1969,12,185,120,237,197,357,1436,2721,7,20915,1161,0,2,8,10,0
7853,159,3154,1168,838,957,57,25,144,1225,19,348,224,416,367,640,3018,5452,11,61921,3440,1,2,8,10,0
7854,8,207,19,8,11,5,0,4,24,2,5,3,6,7,9,13,25,1,30,1,0,2,36,2,0
7855,8,207,102,59,69,5,3,24,107,6,22,15,28,28,43,113,206,3,789,43,0,2,36,2,0
7856,8,207,106,40,36,3,49,17,109,8,17,13,23,25,36,93,167,5,904,50,0,2,36,2,0
7857,23,594,102,59,69,5,3,24,107,6,22,15,28,28,43,113,206,3,789,43,0,0,92,0,0
7858,43,912,447,308,343,6,5,95,453,7,96,59,111,103,170,651,1136,4,4600,255,0,2,61,1,0
7859,43,912,322,174,179,16,74,51,338,10,41,26,46,51,72,252,408,5,2291,127,0,2,61,1,0
7860,33,1460,447,308,343,6,5,95,453,7,96,59,111,103,170,651,1136,4,4600,255,0,2,32,0,0
7861,38,787,447,308,343,6,5,95,453,7,96,59,111,103,170,651,1136,4,4600,255,0,2,39,56,1
7862,38,787,322,174,179,16,74,51,338,10,41,26,46,51,72,252,408,5,2291,127,0,2,39,56,1
7863,31,1414,447,308,343,6,5,95,453,7,96,59,111,103,170,651,1136,4,4600,255,0,2,12,23,1
7864,13,426,42,7,35,4,0,5,46,1,2,1,2,3,3,2,4,0,2,0,0,2,1,1,1
7865,13,426,11,6,10,0,0,1,11,2,4,2,4,6,6,10,15,1,15,0,0,2,1,1,1
7866,165,3753,77,34,69,0,0,8,77,3,24,16,29,27,45,114,213,1,387,21,0,2,6,0,1
7867,165,3753,712,438,573,51,9,84,763,14,102,71,128,116,199,733,1364,8,11988,666,0,2,6,0,1
7868,22,372,424,94,331,4,0,89,428,1,5,5,5,6,10,11,25,0,12,0,0,2,3,0,1
7869,22,372,38,23,23,6,0,8,44,3,11,7,11,14,18,42,68,1,102,5,0,2,3,0,1
7870,191,4461,722,423,573,19,0,135,741,12,172,101,199,184,300,1320,2257,6,15668,870,0,2,3,2,1
7871,191,4461,1508,847,911,44,250,301,1552,14,148,88,169,162,257,1120,1886,7,15077,837,0,2,3,2,1
7872,99,2226,1043,504,840,53,9,147,1096,9,180,112,198,189,310,1377,2344,4,11604,644,0,2,1,1,1
7873,99,2226,383,288,292,26,6,62,409,11,65,38,67,76,105,429,656,5,3719,206,0,2,1,1,1
7874,16,504,424,94,331,4,0,89,428,1,5,5,5,6,10,11,25,0,12,0,0,2,11,2,1
7875,57,3243,1782,648,1425,9,47,279,1791,8,171,97,189,179,286,1292,2140,4,9462,525,0,2,17,0,1
7876,46,1863,1043,504,840,53,9,147,1096,9,180,112,198,189,310,1377,2344,4,11604,644,0,2,11,0,1
7877,46,1863,1043,504,840,53,9,147,1096,9,180,112,198,189,310,1377,2344,4,11604,644,0,2,4,1,0
7878,36,2163,334,251,279,10,4,40,344,5,127,74,143,132,217,899,1528,2,4303,239,0,2,2,0,1
7879,165,3753,77,34,69,0,0,8,77,3,24,16,29,27,45,114,213,1,387,21,0,2,1,1,1
7880,165,3753,712,438,573,51,9,84,763,14,102,71,128,116,199,733,1364,8,11988,666,0,2,1,1,1
7881,22,950,1455,414,1257,16,76,112,1471,5,41,23,46,46,69,231,381,2,1069,59,0,2,11,0,1
7882,44,428,647,139,84,35,284,233,682,0,0,0,0,0,0,0,0,0,0,0,0,2,11,1,1
7883,165,3705,77,34,69,0,0,8,77,3,24,16,29,27,45,114,213,1,387,21,0,2,5,8,1
7884,165,3705,712,438,573,51,9,84,763,14,102,71,128,116,199,733,1364,8,11988,666,0,2,5,8,1
7885,24,583,1293,570,1093,25,15,163,1318,10,195,123,241,205,364,1516,2795,6,17273,959,0,2,10,15,1
7886,107,2375,1043,504,840,53,9,147,1096,9,180,112,198,189,310,1377,2344,4,11604,644,0,2,22,1,1
7887,107,2375,383,288,292,26,6,62,409,11,65,38,67,76,105,429,656,5,3719,206,0,2,22,1,1
7888,13,426,42,7,35,4,0,5,46,1,2,1,2,3,3,2,4,0,2,0,0,2,1,1,1
7889,13,426,11,6,10,0,0,1,11,2,4,2,4,6,6,10,15,1,15,0,0,2,1,1,1
7890,13,384,465,148,393,5,8,60,470,4,31,20,31,35,51,161,261,2,523,29,0,2,3,2,1
7891,13,384,16,12,9,0,0,6,16,1,2,1,2,3,3,2,4,0,2,0,0,2,3,2,1
7892,25,941,1293,570,1093,25,15,163,1318,10,195,123,241,205,364,1516,2795,6,17273,959,0,2,29,0,1
7893,46,1865,1043,504,840,53,9,147,1096,9,180,112,198,189,310,1377,2344,4,11604,644,0,2,3,3,1
7894,23,383,424,94,331,4,0,89,428,1,5,5,5,6,10,11,25,0,12,0,0,2,3,2,0
7895,23,383,38,23,23,6,0,8,44,3,11,7,11,14,18,42,68,1,102,5,0,2,3,2,0
7896,23,409,424,94,331,4,0,89,428,1,5,5,5,6,10,11,25,0,12,0,0,2,8,6,0
7897,23,409,38,23,23,6,0,8,44,3,11,7,11,14,18,42,68,1,102,5,0,2,8,6,0
7898,25,625,1293,570,1093,25,15,163,1318,10,195,123,241,205,364,1516,2795,6,17273,959,0,2,6,0,1
7899,27,1013,1293,570,1093,25,15,163,1318,10,195,123,241,205,364,1516,2795,6,17273,959,0,2,16,0,1
7900,54,2876,1338,495,1086,10,64,173,1348,11,122,82,157,133,239,883,1686,7,11934,663,0,2,18,0,0
7901,54,2876,1338,495,1086,10,64,173,1348,11,122,82,157,133,239,883,1686,7,11934,663,0,2,18,0,0
7902,166,3708,77,34,69,0,0,8,77,3,24,16,29,27,45,114,213,1,387,21,0,2,8,5,1
7903,166,3708,712,438,573,51,9,84,763,14,102,71,128,116,199,733,1364,8,11988,666,0,2,8,5,1
7904,62,2584,1289,550,1043,56,32,155,1345,10,167,93,185,177,278,1266,2075,5,11498,638,0,2,8,0,1
7905,57,1097,1098,241,925,5,10,155,1103,7,46,25,49,53,74,273,423,3,1580,87,0,2,4,1,1
7906,57,1097,282,202,222,14,2,44,296,8,42,24,43,50,67,250,378,4,1548,86,0,2,4,1,1
7907,34,1295,1098,241,925,5,10,155,1103,7,46,25,49,53,74,273,423,3,1580,87,0,2,18,0,1
7908,23,612,102,59,69,5,3,24,107,6,22,15,28,28,43,113,206,3,789,43,0,2,2,0,0
7909,42,1321,1523,757,1297,19,12,193,1542,12,193,117,230,205,347,1508,2664,7,19053,1058,0,2,3,3,1
7910,42,1321,701,378,504,33,58,109,734,13,110,68,126,123,194,794,1346,7,10027,557,0,2,3,3,1
7911,37,2250,1523,757,1297,19,12,193,1542,12,193,117,230,205,347,1508,2664,7,19053,1058,0,2,1,1,1
7912,436,9474,72,33,56,0,4,12,72,1,1,1,1,2,2,0,2,0,1,0,0,2,31,14,1
7913,436,9474,1454,835,1044,76,110,219,1530,17,275,158,296,292,454,2297,3718,9,34017,1889,1,2,31,14,1
7914,113,4797,139,89,101,2,0,35,141,7,54,34,62,61,96,330,569,4,2287,127,0,2,22,6,1
7915,113,4797,7,5,5,0,0,2,7,1,2,1,2,3,3,2,4,0,2,0,0,2,22,6,1
7916,160,3165,1943,715,1694,26,18,214,1969,12,185,120,237,197,357,1436,2721,7,20915,1161,0,2,3,2,1
7917,160,3165,1168,838,957,57,25,144,1225,19,348,224,416,367,640,3018,5452,11,61921,3440,1,2,3,2,1
7918,59,2688,1943,715,1694,26,18,214,1969,12,185,120,237,197,357,1436,2721,7,20915,1161,0,2,8,1,1
7919,436,9476,72,33,56,0,4,12,72,1,1,1,1,2,2,0,2,0,1,0,0,2,1,1,1
7920,436,9476,1454,835,1044,76,110,219,1530,17,275,158,296,292,454,2297,3718,9,34017,1889,1,2,1,1,1
7921,113,4797,139,89,101,2,0,35,141,7,54,34,62,61,96,330,569,4,2287,127,0,2,10,10,1
7922,113,4797,7,5,5,0,0,2,7,1,2,1,2,3,3,2,4,0,2,0,0,2,10,10,1
7923,59,2687,1943,715,1694,26,18,214,1969,12,185,120,237,197,357,1436,2721,7,20915,1161,0,2,1,1,1
7924,42,846,447,308,343,6,5,95,453,7,96,59,111,103,170,651,1136,4,4600,255,0,2,85,56,1
7925,42,846,322,174,179,16,74,51,338,10,41,26,46,51,72,252,408,5,2291,127,0,2,85,56,1
7926,32,1449,447,308,343,6,5,95,453,7,96,59,111,103,170,651,1136,4,4600,255,0,2,14,6,1
7927,13,426,42,7,35,4,0,5,46,1,2,1,2,3,3,2,4,0,2,0,0,2,1,1,1
7928,13,426,11,6,10,0,0,1,11,2,4,2,4,6,6,10,15,1,15,0,0,2,1,1,1
7929,44,428,647,139,84,35,284,233,682,0,0,0,0,0,0,0,0,0,0,0,0,2,1,1,1
7930,162,3224,1943,715,1694,26,18,214,1969,12,185,120,237,197,357,1436,2721,7,20915,1161,0,2,8,1,1
7931,162,3224,1168,838,957,57,25,144,1225,19,348,224,416,367,640,3018,5452,11,61921,3440,1,2,8,1,1
7932,46,2032,1020,354,843,12,15,144,1032,8,134,77,144,142,221,970,1580,4,6792,377,0,2,1,1,1
7933,60,2714,1943,715,1694,26,18,214,1969,12,185,120,237,197,357,1436,2721,7,20915,1161,0,2,13,0,1
7934,200,3862,1457,730,1242,11,6,188,1468,10,292,166,329,302,495,2424,4078,5,22973,1276,1,2,5,18,1
7935,200,3862,74,35,59,1,0,14,75,3,14,7,14,17,21,58,85,1,128,7,0,2,5,18,1
7936,200,3862,245,125,200,5,7,34,250,7,30,17,34,37,51,166,265,3,1053,58,0,2,5,18,1
7937,36,2153,334,251,279,10,4,40,344,5,127,74,143,132,217,899,1528,2,4303,239,0,2,5,5,1
7938,199,3859,1457,730,1242,11,6,188,1468,10,292,166,329,302,495,2424,4078,5,22973,1276,1,2,3,3,1
7939,199,3859,74,35,59,1,0,14,75,3,14,7,14,17,21,58,85,1,128,7,0,2,3,3,1
7940,199,3859,245,125,200,5,7,34,250,7,30,17,34,37,51,166,265,3,1053,58,0,2,3,3,1
7941,34,1725,1457,730,1242,11,6,188,1468,10,292,166,329,302,495,2424,4078,5,22973,1276,1,2,1,1,1
7942,6,493,442,244,305,14,16,103,456,11,68,45,75,79,120,452,756,6,4588,254,0,2,1,1,1
7943,199,3865,1457,730,1242,11,6,188,1468,10,292,166,329,302,495,2424,4078,5,22973,1276,1,2,3,1,0
7944,199,3865,74,35,59,1,0,14,75,3,14,7,14,17,21,58,85,1,128,7,0,2,3,1,0
7945,199,3865,245,125,200,5,7,34,250,7,30,17,34,37,51,166,265,3,1053,58,0,2,3,1,0
7946,43,421,647,139,84,35,284,233,682,0,0,0,0,0,0,0,0,0,0,0,0,2,1,4,0
7947,70,1248,1513,682,1277,25,13,200,1538,11,199,116,219,210,335,1557,2584,6,15641,868,0,2,8,0,1
7948,70,1248,819,519,539,24,98,155,843,15,96,57,106,111,163,690,1107,8,9171,509,0,2,8,0,1
7949,165,3712,77,34,69,0,0,8,77,3,24,16,29,27,45,114,213,1,387,21,0,2,1,0,1
7950,165,3712,712,438,573,51,9,84,763,14,102,71,128,116,199,733,1364,8,11988,666,0,2,1,0,1
7951,192,4394,722,423,573,19,0,135,741,12,172,101,199,184,300,1320,2257,6,15668,870,0,2,12,21,1
7952,192,4394,1508,847,911,44,250,301,1552,14,148,88,169,162,257,1120,1886,7,15077,837,0,2,12,21,1
7953,61,2537,1289,550,1043,56,32,155,1345,10,167,93,185,177,278,1266,2075,5,11498,638,0,2,5,5,1
7954,42,2708,1296,573,1062,40,33,157,1336,8,201,118,231,209,349,1561,2689,4,12365,686,0,2,2,2,1
7955,22,954,1455,414,1257,16,76,112,1471,5,41,23,46,46,69,231,381,2,1069,59,0,2,1,1,1
7956,36,2150,334,251,279,10,4,40,344,5,127,74,143,132,217,899,1528,2,4303,239,0,2,1,1,0
7957,199,3872,1457,730,1242,11,6,188,1468,10,292,166,329,302,495,2424,4078,5,22973,1276,1,2,9,14,1
7958,199,3872,74,35,59,1,0,14,75,3,14,7,14,17,21,58,85,1,128,7,0,2,9,14,1
7959,199,3872,245,125,200,5,7,34,250,7,30,17,34,37,51,166,265,3,1053,58,0,2,9,14,1
7960,208,4134,1457,730,1242,11,6,188,1468,10,292,166,329,302,495,2424,4078,5,22973,1276,1,2,55,16,1
7961,208,4134,74,35,59,1,0,14,75,3,14,7,14,17,21,58,85,1,128,7,0,2,55,16,1
7962,208,4134,245,125,200,5,7,34,250,7,30,17,34,37,51,166,265,3,1053,58,0,2,55,16,1
7963,42,1123,74,35,59,1,0,14,75,3,14,7,14,17,21,58,85,1,128,7,0,2,2,2,1
7964,42,1123,245,125,200,5,7,34,250,7,30,17,34,37,51,166,265,3,1053,58,0,2,2,2,1
7965,165,3706,77,34,69,0,0,8,77,3,24,16,29,27,45,114,213,1,387,21,0,2,2,2,1
7966,165,3706,712,438,573,51,9,84,763,14,102,71,128,116,199,733,1364,8,11988,666,0,2,2,2,1
7967,59,1128,1020,354,843,12,15,144,1032,8,134,77,144,142,221,970,1580,4,6792,377,0,2,5,3,1
7968,192,4388,722,423,573,19,0,135,741,12,172,101,199,184,300,1320,2257,6,15668,870,0,2,2,2,1
7969,192,4388,1508,847,911,44,250,301,1552,14,148,88,169,162,257,1120,1886,7,15077,837,0,2,2,2,1
7970,24,974,373,158,315,8,0,51,381,5,76,44,79,81,123,486,779,2,2026,112,0,2,3,2,1
7971,229,4659,1457,730,1242,11,6,188,1468,10,292,166,329,302,495,2424,4078,5,22973,1276,1,2,104,2,1
7972,229,4659,74,35,59,1,0,14,75,3,14,7,14,17,21,58,85,1,128,7,0,2,104,2,1
7973,229,4659,245,125,200,5,7,34,250,7,30,17,34,37,51,166,265,3,1053,58,0,2,104,2,1
7974,165,3704,77,34,69,0,0,8,77,3,24,16,29,27,45,114,213,1,387,21,0,2,1,1,1
7975,165,3704,712,438,573,51,9,84,763,14,102,71,128,116,199,733,1364,8,11988,666,0,2,1,1,1
7976,192,4388,722,423,573,19,0,135,741,12,172,101,199,184,300,1320,2257,6,15668,870,0,2,2,2,1
7977,192,4388,1508,847,911,44,250,301,1552,14,148,88,169,162,257,1120,1886,7,15077,837,0,2,2,2,1
7978,165,3265,1943,715,1694,26,18,214,1969,12,185,120,237,197,357,1436,2721,7,20915,1161,0,2,6,0,1
7979,165,3265,1168,838,957,57,25,144,1225,19,348,224,416,367,640,3018,5452,11,61921,3440,1,2,6,0,1
7980,36,1810,1457,730,1242,11,6,188,1468,10,292,166,329,302,495,2424,4078,5,22973,1276,1,2,15,0,1
7981,14,577,722,423,573,19,0,135,741,12,172,101,199,184,300,1320,2257,6,15668,870,0,2,1,1,1
7982,71,1306,1513,682,1277,25,13,200,1538,11,199,116,219,210,335,1557,2584,6,15641,868,0,2,20,9,1
7983,71,1306,819,519,539,24,98,155,843,15,96,57,106,111,163,690,1107,8,9171,509,0,2,20,9,1
7984,229,4666,1457,730,1242,11,6,188,1468,10,292,166,329,302,495,2424,4078,5,22973,1276,1,2,21,25,1
7985,229,4666,74,35,59,1,0,14,75,3,14,7,14,17,21,58,85,1,128,7,0,2,21,25,1
7986,229,4666,245,125,200,5,7,34,250,7,30,17,34,37,51,166,265,3,1053,58,0,2,21,25,1
7987,44,432,647,139,84,35,284,233,682,0,0,0,0,0,0,0,0,0,0,0,0,2,5,1,1
7988,42,1791,1513,682,1277,25,13,200,1538,11,199,116,219,210,335,1557,2584,6,15641,868,0,2,10,0,1
7989,38,1886,1457,730,1242,11,6,188,1468,10,292,166,329,302,495,2424,4078,5,22973,1276,1,2,15,0,1
7990,37,2204,334,251,279,10,4,40,344,5,127,74,143,132,217,899,1528,2,4303,239,0,2,6,0,1
7991,440,9534,72,33,56,0,4,12,72,1,1,1,1,2,2,0,2,0,1,0,0,2,22,8,1
7992,440,9534,1454,835,1044,76,110,219,1530,17,275,158,296,292,454,2297,3718,9,34017,1889,1,2,22,8,1
7993,113,4797,139,89,101,2,0,35,141,7,54,34,62,61,96,330,569,4,2287,127,0,2,8,9,1
7994,113,4797,7,5,5,0,0,2,7,1,2,1,2,3,3,2,4,0,2,0,0,2,8,9,1
7995,441,9550,72,33,56,0,4,12,72,1,1,1,1,2,2,0,2,0,1,0,0,2,5,0,1
7996,441,9550,1454,835,1044,76,110,219,1530,17,275,158,296,292,454,2297,3718,9,34017,1889,1,2,5,0,1
7997,114,4827,139,89,101,2,0,35,141,7,54,34,62,61,96,330,569,4,2287,127,0,2,15,0,1
7998,114,4827,7,5,5,0,0,2,7,1,2,1,2,3,3,2,4,0,2,0,0,2,15,0,1
7999,73,1336,1513,682,1277,25,13,200,1538,11,199,116,219,210,335,1557,2584,6,15641,868,0,2,5,0,1
8000,73,1336,819,519,539,24,98,155,843,15,96,57,106,111,163,690,1107,8,9171,509,0,2,5,0,1
8001,13,426,42,7,35,4,0,5,46,1,2,1,2,3,3,2,4,0,2,0,0,2,1,1,1
8002,13,426,11,6,10,0,0,1,11,2,4,2,4,6,6,10,15,1,15,0,0,2,1,1,1
8003,61,2530,1289,550,1043,56,32,155,1345,10,167,93,185,177,278,1266,2075,5,11498,638,0,2,5,5,1
8004,42,1782,1513,682,1277,25,13,200,1538,11,199,116,219,210,335,1557,2584,6,15641,868,0,2,0,1,1
8005,13,426,42,7,35,4,0,5,46,1,2,1,2,3,3,2,4,0,2,0,0,2,2,2,1
8006,13,426,11,6,10,0,0,1,11,2,4,2,4,6,6,10,15,1,15,0,0,2,2,2,1
8007,196,4437,722,423,573,19,0,135,741,12,172,101,199,184,300,1320,2257,6,15668,870,0,2,6,0,1
8008,196,4437,1508,847,911,44,250,301,1552,14,148,88,169,162,257,1120,1886,7,15077,837,0,2,6,0,1
8009,1,224,382,65,130,157,2,92,539,4,10,5,10,14,15,41,57,2,114,6,0,2,1,1,1
8010,61,2521,1289,550,1043,56,32,155,1345,10,167,93,185,177,278,1266,2075,5,11498,638,0,2,5,9,1
8011,37,2265,1523,757,1297,19,12,193,1542,12,193,117,230,205,347,1508,2664,7,19053,1058,0,2,4,4,1
8012,13,426,42,7,35,4,0,5,46,1,2,1,2,3,3,2,4,0,2,0,0,2,1,1,0
8013,13,426,11,6,10,0,0,1,11,2,4,2,4,6,6,10,15,1,15,0,0,2,1,1,0
8014,229,4670,1457,730,1242,11,6,188,1468,10,292,166,329,302,495,2424,4078,5,22973,1276,1,2,1,1,1
8015,229,4670,74,35,59,1,0,14,75,3,14,7,14,17,21,58,85,1,128,7,0,2,1,1,1
8016,229,4670,245,125,200,5,7,34,250,7,30,17,34,37,51,166,265,3,1053,58,0,2,1,1,1
8017,39,1926,1457,730,1242,11,6,188,1468,10,292,166,329,302,495,2424,4078,5,22973,1276,1,2,11,0,1
8018,9,241,19,8,11,5,0,4,24,2,5,3,6,7,9,13,25,1,30,1,0,2,5,1,1
8019,9,241,102,59,69,5,3,24,107,6,22,15,28,28,43,113,206,3,789,43,0,2,5,1,1
8020,9,241,106,40,36,3,49,17,109,8,17,13,23,25,36,93,167,5,904,50,0,2,5,1,1
8021,9,241,19,8,11,5,0,4,24,2,5,3,6,7,9,13,25,1,30,1,0,2,5,1,0
8022,9,241,102,59,69,5,3,24,107,6,22,15,28,28,43,113,206,3,789,43,0,2,5,1,0
8023,9,241,106,40,36,3,49,17,109,8,17,13,23,25,36,93,167,5,904,50,0,2,5,1,0
8024,441,9550,72,33,56,0,4,12,72,1,1,1,1,2,2,0,2,0,1,0,0,2,2,2,1
8025,441,9550,1454,835,1044,76,110,219,1530,17,275,158,296,292,454,2297,3718,9,34017,1889,1,2,2,2,1
8026,55,2905,1338,495,1086,10,64,173,1348,11,122,82,157,133,239,883,1686,7,11934,663,0,2,10,0,1
8027,1,225,382,65,130,157,2,92,539,4,10,5,10,14,15,41,57,2,114,6,0,2,2,1,1
8028,13,426,42,7,35,4,0,5,46,1,2,1,2,3,3,2,4,0,2,0,0,2,1,1,1
8029,13,426,11,6,10,0,0,1,11,2,4,2,4,6,6,10,15,1,15,0,0,2,1,1,1
8030,73,1336,1513,682,1277,25,13,200,1538,11,199,116,219,210,335,1557,2584,6,15641,868,0,2,1,1,1
8031,73,1336,819,519,539,24,98,155,843,15,96,57,106,111,163,690,1107,8,9171,509,0,2,1,1,1
8032,164,3237,1943,715,1694,26,18,214,1969,12,185,120,237,197,357,1436,2721,7,20915,1161,0,2,8,5,1
8033,164,3237,1168,838,957,57,25,144,1225,19,348,224,416,367,640,3018,5452,11,61921,3440,1,2,8,5,1
8034,13,426,42,7,35,4,0,5,46,1,2,1,2,3,3,2,4,0,2,0,0,2,1,1,1
8035,13,426,11,6,10,0,0,1,11,2,4,2,4,6,6,10,15,1,15,0,0,2,1,1,1
8036,30,617,2,2,2,0,0,0,2,0,0,0,0,0,0,0,0,0,0,0,0,2,1,2,1
8037,30,617,99,48,90,1,3,5,100,0,0,0,0,0,0,0,0,0,0,0,0,2,1,2,1
8038,30,617,8,5,5,2,0,1,10,0,0,0,0,0,0,0,0,0,0,0,0,2,1,2,1
8039,30,617,1217,716,841,84,126,174,1301,14,185,118,215,199,333,1446,2542,8,20687,1149,0,2,1,2,1
8040,30,617,160,89,115,0,13,31,160,7,15,11,17,22,28,78,124,3,495,27,0,2,1,2,1
8041,30,617,10,10,9,9,0,0,19,0,0,0,0,0,0,0,0,0,0,0,0,2,1,2,1
8042,30,617,173,84,99,8,29,36,181,5,12,7,13,17,20,54,81,2,221,12,0,2,1,2,1
8043,30,617,3,1,1,3,0,0,6,0,0,0,0,0,0,0,0,0,0,0,0,2,1,2,1
8044,165,3696,77,34,69,0,0,8,77,3,24,16,29,27,45,114,213,1,387,21,0,2,0,2,1
8045,165,3696,712,438,573,51,9,84,763,14,102,71,128,116,199,733,1364,8,11988,666,0,2,0,2,1
8046,23,407,424,94,331,4,0,89,428,1,5,5,5,6,10,11,25,0,12,0,0,2,0,1,1
8047,23,407,38,23,23,6,0,8,44,3,11,7,11,14,18,42,68,1,102,5,0,2,0,1,1
8048,196,4435,722,423,573,19,0,135,741,12,172,101,199,184,300,1320,2257,6,15668,870,0,2,0,1,1
8049,196,4435,1508,847,911,44,250,301,1552,14,148,88,169,162,257,1120,1886,7,15077,837,0,2,0,1,1
8050,18,460,386,256,301,16,9,68,402,4,59,35,69,63,104,355,621,2,1453,80,0,2,2,2,1
8051,18,460,264,131,164,11,41,46,275,6,38,22,40,44,62,214,338,3,1068,59,0,2,2,2,1
8052,57,1095,1098,241,925,5,10,155,1103,7,46,25,49,53,74,273,423,3,1580,87,0,2,1,1,1
8053,57,1095,282,202,222,14,2,44,296,8,42,24,43,50,67,250,378,4,1548,86,0,2,1,1,1
8054,60,1136,1020,354,843,12,15,144,1032,8,134,77,144,142,221,970,1580,4,6792,377,0,2,3,2,1
8055,166,3721,77,34,69,0,0,8,77,3,24,16,29,27,45,114,213,1,387,21,0,2,20,11,1
8056,166,3721,712,438,573,51,9,84,763,14,102,71,128,116,199,733,1364,8,11988,666,0,2,20,11,1
8057,45,2799,1296,573,1062,40,33,157,1336,8,201,118,231,209,349,1561,2689,4,12365,686,0,2,22,1,1
8058,12,373,442,244,305,14,16,103,456,11,68,45,75,79,120,452,756,6,4588,254,0,2,3,0,0
8059,12,373,182,102,99,11,40,35,193,3,11,6,11,14,17,42,64,1,97,5,0,2,3,0,0
8060,7,520,442,244,305,14,16,103,456,11,68,45,75,79,120,452,756,6,4588,254,0,2,9,0,0
8061,172,3827,77,34,69,0,0,8,77,3,24,16,29,27,45,114,213,1,387,21,0,2,21,0,1
8062,172,3827,712,438,573,51,9,84,763,14,102,71,128,116,199,733,1364,8,11988,666,0,2,21,0,1
8063,61,1148,1020,354,843,12,15,144,1032,8,134,77,144,142,221,970,1580,4,6792,377,0,2,14,13,1
8064,47,2070,1020,354,843,12,15,144,1032,8,134,77,144,142,221,970,1580,4,6792,377,0,2,25,1,1
8065,163,3229,1943,715,1694,26,18,214,1969,12,185,120,237,197,357,1436,2721,7,20915,1161,0,2,1,1,1
8066,163,3229,1168,838,957,57,25,144,1225,19,348,224,416,367,640,3018,5452,11,61921,3440,1,2,1,1,1
8067,60,2704,1943,715,1694,26,18,214,1969,12,185,120,237,197,357,1436,2721,7,20915,1161,0,2,11,8,1
8068,14,439,42,7,35,4,0,5,46,1,2,1,2,3,3,2,4,0,2,0,0,2,4,2,0
8069,14,439,11,6,10,0,0,1,11,2,4,2,4,6,6,10,15,1,15,0,0,2,4,2,0
8070,38,2239,334,251,279,10,4,40,344,5,127,74,143,132,217,899,1528,2,4303,239,0,2,7,3,1
8071,42,846,447,308,343,6,5,95,453,7,96,59,111,103,170,651,1136,4,4600,255,0,2,3,2,1
8072,42,846,322,174,179,16,74,51,338,10,41,26,46,51,72,252,408,5,2291,127,0,2,3,2,1
8073,164,3240,1943,715,1694,26,18,214,1969,12,185,120,237,197,357,1436,2721,7,20915,1161,0,2,2,2,1
8074,164,3240,1168,838,957,57,25,144,1225,19,348,224,416,367,640,3018,5452,11,61921,3440,1,2,2,2,1
8075,161,3179,1943,715,1694,26,18,214,1969,12,185,120,237,197,357,1436,2721,7,20915,1161,0,2,1,19,0
8076,161,3179,1168,838,957,57,25,144,1225,19,348,224,416,367,640,3018,5452,11,61921,3440,1,2,1,19,0
8077,59,2667,1943,715,1694,26,18,214,1969,12,185,120,237,197,357,1436,2721,7,20915,1161,0,2,0,11,0
8078,14,439,42,7,35,4,0,5,46,1,2,1,2,3,3,2,4,0,2,0,0,2,1,1,1
8079,14,439,11,6,10,0,0,1,11,2,4,2,4,6,6,10,15,1,15,0,0,2,1,1,1
8080,1,225,382,65,130,157,2,92,539,4,10,5,10,14,15,41,57,2,114,6,0,2,2,2,1
8081,129,4015,1660,832,1314,41,38,274,1701,20,312,209,395,332,604,2671,5058,12,64042,3557,1,2,3,3,1
8082,129,4015,1057,646,719,113,100,145,1170,18,215,134,248,233,382,1740,3004,10,31186,1732,1,2,3,3,1
8083,112,2716,1660,832,1314,41,38,274,1701,20,312,209,395,332,604,2671,5058,12,64042,3557,1,2,7,1,1
8084,129,4017,1660,832,1314,41,38,274,1701,20,312,209,395,332,604,2671,5058,12,64042,3557,1,2,1,1,1
8085,129,4017,1057,646,719,113,100,145,1170,18,215,134,248,233,382,1740,3004,10,31186,1732,1,2,1,1,1
8086,113,2758,1660,832,1314,41,38,274,1701,20,312,209,395,332,604,2671,5058,12,64042,3557,1,2,10,1,1
8087,114,2807,1660,832,1314,41,38,274,1701,20,312,209,395,332,604,2671,5058,12,64042,3557,1,2,9,0,0
8088,14,439,42,7,35,4,0,5,46,1,2,1,2,3,3,2,4,0,2,0,0,2,1,1,1
8089,14,439,11,6,10,0,0,1,11,2,4,2,4,6,6,10,15,1,15,0,0,2,1,1,1
8090,86,1526,1178,367,1042,6,15,115,1184,9,94,51,95,103,146,644,976,4,4439,246,0,2,8,0,1
8091,86,1526,177,108,140,8,0,27,185,6,30,16,32,36,48,162,248,3,794,44,0,2,8,0,1
8092,13,442,42,7,35,4,0,5,46,1,2,1,2,3,3,2,4,0,2,0,0,2,15,13,1
8093,13,442,11,6,10,0,0,1,11,2,4,2,4,6,6,10,15,1,15,0,0,2,15,13,1
8094,43,1897,1178,367,1042,6,15,115,1184,9,94,51,95,103,146,644,976,4,4439,246,0,2,8,10,1
8095,115,2872,1660,832,1314,41,38,274,1701,20,312,209,395,332,604,2671,5058,12,64042,3557,1,2,31,0,0
8096,131,4056,1660,832,1314,41,38,274,1701,20,312,209,395,332,604,2671,5058,12,64042,3557,1,2,18,0,0
8097,131,4056,1057,646,719,113,100,145,1170,18,215,134,248,233,382,1740,3004,10,31186,1732,1,2,18,0,0
8098,131,4052,1660,832,1314,41,38,274,1701,20,312,209,395,332,604,2671,5058,12,64042,3557,1,2,3,2,0
8099,131,4052,1057,646,719,113,100,145,1170,18,215,134,248,233,382,1740,3004,10,31186,1732,1,2,3,2,0
8100,115,2872,1660,832,1314,41,38,274,1701,20,312,209,395,332,604,2671,5058,12,64042,3557,1,2,1,0,0
8101,131,4052,1660,832,1314,41,38,274,1701,20,312,209,395,332,604,2671,5058,12,64042,3557,1,2,19,0,0
8102,131,4052,1057,646,719,113,100,145,1170,18,215,134,248,233,382,1740,3004,10,31186,1732,1,2,19,0,0
8103,115,2872,1660,832,1314,41,38,274,1701,20,312,209,395,332,604,2671,5058,12,64042,3557,1,2,32,0,0
8104,63,1172,1020,354,843,12,15,144,1032,8,134,77,144,142,221,970,1580,4,6792,377,0,2,5,2,1
8105,48,2097,1020,354,843,12,15,144,1032,8,134,77,144,142,221,970,1580,4,6792,377,0,2,11,0,1
8106,30,617,2,2,2,0,0,0,2,0,0,0,0,0,0,0,0,0,0,0,0,2,5,5,1
8107,30,617,99,48,90,1,3,5,100,0,0,0,0,0,0,0,0,0,0,0,0,2,5,5,1
8108,30,617,8,5,5,2,0,1,10,0,0,0,0,0,0,0,0,0,0,0,0,2,5,5,1
8109,30,617,1217,716,841,84,126,174,1301,14,185,118,215,199,333,1446,2542,8,20687,1149,0,2,5,5,1
8110,30,617,160,89,115,0,13,31,160,7,15,11,17,22,28,78,124,3,495,27,0,2,5,5,1
8111,30,617,10,10,9,9,0,0,19,0,0,0,0,0,0,0,0,0,0,0,0,2,5,5,1
8112,30,617,173,84,99,8,29,36,181,5,12,7,13,17,20,54,81,2,221,12,0,2,5,5,1
8113,30,617,3,1,1,3,0,0,6,0,0,0,0,0,0,0,0,0,0,0,0,2,5,5,1
8114,131,4052,1660,832,1314,41,38,274,1701,20,312,209,395,332,604,2671,5058,12,64042,3557,1,2,3,2,1
8115,131,4052,1057,646,719,113,100,145,1170,18,215,134,248,233,382,1740,3004,10,31186,1732,1,2,3,2,1
8116,229,4668,1457,730,1242,11,6,188,1468,10,292,166,329,302,495,2424,4078,5,22973,1276,1,2,1,1,1
8117,229,4668,74,35,59,1,0,14,75,3,14,7,14,17,21,58,85,1,128,7,0,2,1,1,1
8118,229,4668,245,125,200,5,7,34,250,7,30,17,34,37,51,166,265,3,1053,58,0,2,1,1,1
8119,42,1119,74,35,59,1,0,14,75,3,14,7,14,17,21,58,85,1,128,7,0,2,0,1,1
8120,42,1119,245,125,200,5,7,34,250,7,30,17,34,37,51,166,265,3,1053,58,0,2,0,1,1
8121,172,3822,77,34,69,0,0,8,77,3,24,16,29,27,45,114,213,1,387,21,0,2,0,1,1
8122,172,3822,712,438,573,51,9,84,763,14,102,71,128,116,199,733,1364,8,11988,666,0,2,0,1,1
8123,195,4408,722,423,573,19,0,135,741,12,172,101,199,184,300,1320,2257,6,15668,870,0,2,1,6,1
8124,195,4408,1508,847,911,44,250,301,1552,14,148,88,169,162,257,1120,1886,7,15077,837,0,2,1,6,1
8125,439,9488,72,33,56,0,4,12,72,1,1,1,1,2,2,0,2,0,1,0,0,2,4,9,1
8126,439,9488,1454,835,1044,76,110,219,1530,17,275,158,296,292,454,2297,3718,9,34017,1889,1,2,4,9,1
8127,86,1521,1178,367,1042,6,15,115,1184,9,94,51,95,103,146,644,976,4,4439,246,0,2,0,1,1
8128,86,1521,177,108,140,8,0,27,185,6,30,16,32,36,48,162,248,3,794,44,0,2,0,1,1
8129,161,3177,1943,715,1694,26,18,214,1969,12,185,120,237,197,357,1436,2721,7,20915,1161,0,2,0,1,1
8130,161,3177,1168,838,957,57,25,144,1225,19,348,224,416,367,640,3018,5452,11,61921,3440,1,2,0,1,1
8131,61,2511,1289,550,1043,56,32,155,1345,10,167,93,185,177,278,1266,2075,5,11498,638,0,2,3,4,1
8132,55,2891,1338,495,1086,10,64,173,1348,11,122,82,157,133,239,883,1686,7,11934,663,0,2,4,6,1
8133,114,4817,139,89,101,2,0,35,141,7,54,34,62,61,96,330,569,4,2287,127,0,2,6,6,1
8134,114,4817,7,5,5,0,0,2,7,1,2,1,2,3,3,2,4,0,2,0,0,2,6,6,1
8135,13,380,465,148,393,5,8,60,470,4,31,20,31,35,51,161,261,2,523,29,0,2,1,1,1
8136,13,380,16,12,9,0,0,6,16,1,2,1,2,3,3,2,4,0,2,0,0,2,1,1,1
8137,57,3235,1782,648,1425,9,47,279,1791,8,171,97,189,179,286,1292,2140,4,9462,525,0,2,1,2,1
8138,9,192,256,139,192,9,7,47,265,4,23,12,24,27,36,112,171,2,357,19,0,2,1,1,1
8139,49,1690,1450,624,1228,12,26,181,1462,14,306,186,354,320,540,2580,4493,8,36391,2021,1,2,2,2,1
8140,115,2864,1660,832,1314,41,38,274,1701,20,312,209,395,332,604,2671,5058,12,64042,3557,1,2,7,8,1
8141,45,2786,1296,573,1062,40,33,157,1336,8,201,118,231,209,349,1561,2689,4,12365,686,0,2,6,6,1
8142,39,1924,1457,730,1242,11,6,188,1468,10,292,166,329,302,495,2424,4078,5,22973,1276,1,2,6,6,1
8143,29,1370,652,304,544,16,6,88,668,6,89,51,101,95,152,591,998,3,3399,188,0,2,4,4,1
8144,22,950,1455,414,1257,16,76,112,1471,5,41,23,46,46,69,231,381,2,1069,59,0,2,2,2,1
8145,11,343,74,35,59,1,0,14,75,3,14,7,14,17,21,58,85,1,128,7,0,2,1,1,1
8146,37,2252,1523,757,1297,19,12,193,1542,12,193,117,230,205,347,1508,2664,7,19053,1058,0,2,2,4,1
8147,48,2093,1020,354,843,12,15,144,1032,8,134,77,144,142,221,970,1580,4,6792,377,0,2,3,3,1
8148,16,502,424,94,331,4,0,89,428,1,5,5,5,6,10,11,25,0,12,0,0,2,1,1,1
8149,38,2232,334,251,279,10,4,40,344,5,127,74,143,132,217,899,1528,2,4303,239,0,2,7,8,1
8150,7,291,184,100,137,2,15,30,186,6,38,20,39,44,59,214,322,3,991,55,0,2,1,2,1
8151,27,1009,1293,570,1093,25,15,163,1318,10,195,123,241,205,364,1516,2795,6,17273,959,0,2,2,2,1
8152,14,569,722,423,573,19,0,135,741,12,172,101,199,184,300,1320,2257,6,15668,870,0,2,2,3,1
8153,46,1867,1043,504,840,53,9,147,1096,9,180,112,198,189,310,1377,2344,4,11604,644,0,2,6,6,1
8154,24,972,373,158,315,8,0,51,381,5,76,44,79,81,123,486,779,2,2026,112,0,2,1,1,1
8155,43,1898,1178,367,1042,6,15,115,1184,9,94,51,95,103,146,644,976,4,4439,246,0,2,6,6,1
8156,59,2593,1943,715,1694,26,18,214,1969,12,185,120,237,197,357,1436,2721,7,20915,1161,0,2,20,23,1
8157,7,518,442,244,305,14,16,103,456,11,68,45,75,79,120,452,756,6,4588,254,0,2,0,1,1
8158,34,1293,1098,241,925,5,10,155,1103,7,46,25,49,53,74,273,423,3,1580,87,0,2,1,1,1
8159,439,9491,72,33,56,0,4,12,72,1,1,1,1,2,2,0,2,0,1,0,0,2,3,3,1
8160,439,9491,1454,835,1044,76,110,219,1530,17,275,158,296,292,454,2297,3718,9,34017,1889,1,2,3,3,1
8161,14,399,465,148,393,5,8,60,470,4,31,20,31,35,51,161,261,2,523,29,0,2,4,0,1
8162,14,399,16,12,9,0,0,6,16,1,2,1,2,3,3,2,4,0,2,0,0,2,4,0,1
8163,42,852,447,308,343,6,5,95,453,7,96,59,111,103,170,651,1136,4,4600,255,0,2,4,3,1
8164,42,852,322,174,179,16,74,51,338,10,41,26,46,51,72,252,408,5,2291,127,0,2,4,3,1
8165,33,1483,447,308,343,6,5,95,453,7,96,59,111,103,170,651,1136,4,4600,255,0,2,6,0,1
8166,42,1313,1523,757,1297,19,12,193,1542,12,193,117,230,205,347,1508,2664,7,19053,1058,0,2,7,8,1
8167,42,1313,701,378,504,33,58,109,734,13,110,68,126,123,194,794,1346,7,10027,557,0,2,7,8,1
8168,13,442,42,7,35,4,0,5,46,1,2,1,2,3,3,2,4,0,2,0,0,2,1,1,1
8169,13,442,11,6,10,0,0,1,11,2,4,2,4,6,6,10,15,1,15,0,0,2,1,1,1
8170,38,2361,1523,757,1297,19,12,193,1542,12,193,117,230,205,347,1508,2664,7,19053,1058,0,2,25,2,1
8171,42,852,447,308,343,6,5,95,453,7,96,59,111,103,170,651,1136,4,4600,255,0,2,2,2,1
8172,42,852,322,174,179,16,74,51,338,10,41,26,46,51,72,252,408,5,2291,127,0,2,2,2,1
8173,38,2370,1523,757,1297,19,12,193,1542,12,193,117,230,205,347,1508,2664,7,19053,1058,0,2,4,3,1
8174,13,442,42,7,35,4,0,5,46,1,2,1,2,3,3,2,4,0,2,0,0,2,1,1,0
8175,13,442,11,6,10,0,0,1,11,2,4,2,4,6,6,10,15,1,15,0,0,2,1,1,0
8176,439,9498,72,33,56,0,4,12,72,1,1,1,1,2,2,0,2,0,1,0,0,2,5,4,1
8177,439,9498,1454,835,1044,76,110,219,1530,17,275,158,296,292,454,2297,3718,9,34017,1889,1,2,5,4,1
8178,61,2962,1338,495,1086,10,64,173,1348,11,122,82,157,133,239,883,1686,7,11934,663,0,2,15,0,1
8179,439,9498,72,33,56,0,4,12,72,1,1,1,1,2,2,0,2,0,1,0,0,2,5,4,0
8180,439,9498,1454,835,1044,76,110,219,1530,17,275,158,296,292,454,2297,3718,9,34017,1889,1,2,5,4,0
8181,61,2962,1338,495,1086,10,64,173,1348,11,122,82,157,133,239,883,1686,7,11934,663,0,2,15,0,0
8182,439,9498,72,33,56,0,4,12,72,1,1,1,1,2,2,0,2,0,1,0,0,2,5,4,0
8183,439,9498,1454,835,1044,76,110,219,1530,17,275,158,296,292,454,2297,3718,9,34017,1889,1,2,5,4,0
8184,61,2962,1338,495,1086,10,64,173,1348,11,122,82,157,133,239,883,1686,7,11934,663,0,2,15,0,0
8185,132,4066,1660,832,1314,41,38,274,1701,20,312,209,395,332,604,2671,5058,12,64042,3557,1,2,6,1,1
8186,132,4066,1057,646,719,113,100,145,1170,18,215,134,248,233,382,1740,3004,10,31186,1732,1,2,6,1,1
8187,438,9497,72,33,56,0,4,12,72,1,1,1,1,2,2,0,2,0,1,0,0,2,1,2,1
8188,438,9497,1454,835,1044,76,110,219,1530,17,275,158,296,292,454,2297,3718,9,34017,1889,1,2,1,2,1
8189,30,1496,652,304,544,16,6,88,668,6,89,51,101,95,152,591,998,3,3399,188,0,2,37,0,1
8190,33,1481,447,308,343,6,5,95,453,7,96,59,111,103,170,651,1136,4,4600,255,0,2,2,2,0
8191,23,612,102,59,69,5,3,24,107,6,22,15,28,28,43,113,206,3,789,43,0,2,2,2,0
8192,33,1481,447,308,343,6,5,95,453,7,96,59,111,103,170,651,1136,4,4600,255,0,2,2,2,0
8193,438,9497,72,33,56,0,4,12,72,1,1,1,1,2,2,0,2,0,1,0,0,2,1,2,0
8194,438,9497,1454,835,1044,76,110,219,1530,17,275,158,296,292,454,2297,3718,9,34017,1889,1,2,1,2,0
8195,30,1496,652,304,544,16,6,88,668,6,89,51,101,95,152,591,998,3,3399,188,0,2,37,0,0
8196,23,612,102,59,69,5,3,24,107,6,22,15,28,28,43,113,206,3,789,43,0,2,2,2,0
8197,438,9494,72,33,56,0,4,12,72,1,1,1,1,2,2,0,2,0,1,0,0,2,1,1,1
8198,438,9494,1454,835,1044,76,110,219,1530,17,275,158,296,292,454,2297,3718,9,34017,1889,1,2,1,1,1
8199,438,9494,72,33,56,0,4,12,72,1,1,1,1,2,2,0,2,0,1,0,0,2,1,1,0
8200,438,9494,1454,835,1044,76,110,219,1530,17,275,158,296,292,454,2297,3718,9,34017,1889,1,2,1,1,0
8201,131,4059,1660,832,1314,41,38,274,1701,20,312,209,395,332,604,2671,5058,12,64042,3557,1,2,5,6,0
8202,131,4059,1057,646,719,113,100,145,1170,18,215,134,248,233,382,1740,3004,10,31186,1732,1,2,5,6,0
8203,62,2549,1289,550,1043,56,32,155,1345,10,167,93,185,177,278,1266,2075,5,11498,638,0,2,18,0,0
8204,131,4059,1660,832,1314,41,38,274,1701,20,312,209,395,332,604,2671,5058,12,64042,3557,1,2,6,2,0
8205,131,4059,1057,646,719,113,100,145,1170,18,215,134,248,233,382,1740,3004,10,31186,1732,1,2,6,2,0
8206,62,2549,1289,550,1043,56,32,155,1345,10,167,93,185,177,278,1266,2075,5,11498,638,0,2,18,0,0
8207,11,366,85,59,61,8,0,16,93,5,18,10,18,23,28,86,126,2,316,17,0,0,73,0,1
8208,11,366,85,59,61,8,0,16,93,5,18,10,18,23,28,86,126,2,316,17,0,2,1,1,0
8209,195,4418,722,423,573,19,0,135,741,12,172,101,199,184,300,1320,2257,6,15668,870,0,2,4,3,0
8210,195,4418,1508,847,911,44,250,301,1552,14,148,88,169,162,257,1120,1886,7,15077,837,0,2,4,3,0
8211,27,1034,1293,570,1093,25,15,163,1318,10,195,123,241,205,364,1516,2795,6,17273,959,0,2,7,5,0
8212,54,1029,1098,241,925,5,10,155,1103,7,46,25,49,53,74,273,423,3,1580,87,0,2,0,6,1
8213,54,1029,282,202,222,14,2,44,296,8,42,24,43,50,67,250,378,4,1548,86,0,2,0,6,1
8214,36,1369,1098,241,925,5,10,155,1103,7,46,25,49,53,74,273,423,3,1580,87,0,2,33,4,1
8215,115,2873,1660,832,1314,41,38,274,1701,20,312,209,395,332,604,2671,5058,12,64042,3557,1,2,2,1,0
8216,36,1381,1098,241,925,5,10,155,1103,7,46,25,49,53,74,273,423,3,1580,87,0,2,2,2,1
8217,29,599,215,129,180,6,0,29,221,8,65,43,72,73,115,415,711,4,3153,175,0,2,2,2,0
8218,29,599,97,69,77,3,3,16,100,6,22,13,23,28,36,113,173,3,542,30,0,2,2,2,0
8219,15,1203,215,129,180,6,0,29,221,8,65,43,72,73,115,415,711,4,3153,175,0,2,20,0,0
8220,110,2409,1043,504,840,53,9,147,1096,9,180,112,198,189,310,1377,2344,4,11604,644,0,2,9,1,1
8221,110,2409,383,288,292,26,6,62,409,11,65,38,67,76,105,429,656,5,3719,206,0,2,9,1,1
8222,48,1985,1043,504,840,53,9,147,1096,9,180,112,198,189,310,1377,2344,4,11604,644,0,2,15,0,1
8223,170,3779,77,34,69,0,0,8,77,3,24,16,29,27,45,114,213,1,387,21,0,2,0,7,1
8224,170,3779,712,438,573,51,9,84,763,14,102,71,128,116,199,733,1364,8,11988,666,0,2,0,7,1
8225,441,9544,72,33,56,0,4,12,72,1,1,1,1,2,2,0,2,0,1,0,0,2,10,1,1
8226,441,9544,1454,835,1044,76,110,219,1530,17,275,158,296,292,454,2297,3718,9,34017,1889,1,2,10,1,1
8227,22,555,465,148,393,5,8,60,470,4,31,20,31,35,51,161,261,2,523,29,0,2,37,0,1
8228,22,555,16,12,9,0,0,6,16,1,2,1,2,3,3,2,4,0,2,0,0,2,37,0,1
8229,11,370,85,59,61,8,0,16,93,5,18,10,18,23,28,86,126,2,316,17,0,2,2,1,0
8230,110,2406,1043,504,840,53,9,147,1096,9,180,112,198,189,310,1377,2344,4,11604,644,0,2,5,4,1
8231,110,2406,383,288,292,26,6,62,409,11,65,38,67,76,105,429,656,5,3719,206,0,2,5,4,1
8232,50,2071,1043,504,840,53,9,147,1096,9,180,112,198,189,310,1377,2344,4,11604,644,0,2,13,0,1
8233,170,3779,77,34,69,0,0,8,77,3,24,16,29,27,45,114,213,1,387,21,0,2,0,7,0
8234,170,3779,712,438,573,51,9,84,763,14,102,71,128,116,199,733,1364,8,11988,666,0,2,0,7,0
8235,441,9544,72,33,56,0,4,12,72,1,1,1,1,2,2,0,2,0,1,0,0,2,10,1,0
8236,441,9544,1454,835,1044,76,110,219,1530,17,275,158,296,292,454,2297,3718,9,34017,1889,1,2,10,1,0
8237,11,370,85,59,61,8,0,16,93,5,18,10,18,23,28,86,126,2,316,17,0,2,2,1,0
8238,22,555,465,148,393,5,8,60,470,4,31,20,31,35,51,161,261,2,523,29,0,2,37,0,0
8239,22,555,16,12,9,0,0,6,16,1,2,1,2,3,3,2,4,0,2,0,0,2,37,0,0
8240,118,4924,139,89,101,2,0,35,141,7,54,34,62,61,96,330,569,4,2287,127,0,2,55,1,1
8241,118,4924,7,5,5,0,0,2,7,1,2,1,2,3,3,2,4,0,2,0,0,2,55,1,1
8242,119,5017,139,89,101,2,0,35,141,7,54,34,62,61,96,330,569,4,2287,127,0,2,33,1,1
8243,119,5017,7,5,5,0,0,2,7,1,2,1,2,3,3,2,4,0,2,0,0,2,33,1,1
8244,444,9618,72,33,56,0,4,12,72,1,1,1,1,2,2,0,2,0,1,0,0,2,44,36,1
8245,444,9618,1454,835,1044,76,110,219,1530,17,275,158,296,292,454,2297,3718,9,34017,1889,1,2,44,36,1
8246,120,5065,139,89,101,2,0,35,141,7,54,34,62,61,96,330,569,4,2287,127,0,2,15,1,1
8247,120,5065,7,5,5,0,0,2,7,1,2,1,2,3,3,2,4,0,2,0,0,2,15,1,1
8248,50,2075,1043,504,840,53,9,147,1096,9,180,112,198,189,310,1377,2344,4,11604,644,0,2,2,0,1
8249,444,9616,72,33,56,0,4,12,72,1,1,1,1,2,2,0,2,0,1,0,0,2,4,5,1
8250,444,9616,1454,835,1044,76,110,219,1530,17,275,158,296,292,454,2297,3718,9,34017,1889,1,2,4,5,1
8251,446,9627,72,33,56,0,4,12,72,1,1,1,1,2,2,0,2,0,1,0,0,2,31,24,1
8252,446,9627,1454,835,1044,76,110,219,1530,17,275,158,296,292,454,2297,3718,9,34017,1889,1,2,31,24,1
8253,111,2398,1043,504,840,53,9,147,1096,9,180,112,198,189,310,1377,2344,4,11604,644,0,2,12,12,1
8254,111,2398,383,288,292,26,6,62,409,11,65,38,67,76,105,429,656,5,3719,206,0,2,12,12,1
8255,50,2070,1043,504,840,53,9,147,1096,9,180,112,198,189,310,1377,2344,4,11604,644,0,2,2,2,1
8256,446,9641,72,33,56,0,4,12,72,1,1,1,1,2,2,0,2,0,1,0,0,2,4,0,1
8257,446,9641,1454,835,1044,76,110,219,1530,17,275,158,296,292,454,2297,3718,9,34017,1889,1,2,4,0,1
8258,120,5027,139,89,101,2,0,35,141,7,54,34,62,61,96,330,569,4,2287,127,0,2,8,11,1
8259,120,5027,7,5,5,0,0,2,7,1,2,1,2,3,3,2,4,0,2,0,0,2,8,11,1
8260,29,556,127,75,83,2,11,30,129,4,14,7,14,18,21,61,87,2,175,9,0,2,4,18,0
8261,29,556,652,304,544,16,6,88,668,6,89,51,101,95,152,591,998,3,3399,188,0,2,4,18,0
8262,29,556,2,2,2,0,0,0,2,0,0,0,0,0,0,0,0,0,0,0,0,2,4,18,0
8263,29,556,8,5,5,0,0,3,8,0,0,0,0,0,0,0,0,0,0,0,0,2,4,18,0
8264,29,556,2,2,2,0,0,0,2,0,0,0,0,0,0,0,0,0,0,0,0,2,4,18,0
8265,29,556,14,8,8,0,0,6,14,0,0,0,0,0,0,0,0,0,0,0,0,2,4,18,0
8266,29,556,6,4,4,0,0,2,6,0,0,0,0,0,0,0,0,0,0,0,0,2,4,18,0
8267,29,556,6,4,4,0,0,2,6,1,2,1,2,3,3,2,4,0,2,0,0,2,4,18,0
8268,29,556,6,4,4,0,0,2,6,0,0,0,0,0,0,0,0,0,0,0,0,2,4,18,0
8269,29,556,7,5,5,0,0,2,7,0,0,0,0,0,0,0,0,0,0,0,0,2,4,18,0
8270,29,556,6,4,4,0,0,2,6,0,0,0,0,0,0,0,0,0,0,0,0,2,4,18,0
8271,29,556,10,6,6,0,0,4,10,0,0,0,0,0,0,0,0,0,0,0,0,2,4,18,0
8272,29,556,1,1,1,0,0,0,1,0,0,0,0,0,0,0,0,0,0,0,0,2,4,18,0
8273,29,556,1,1,1,0,0,0,1,0,0,0,0,0,0,0,0,0,0,0,0,2,4,18,0
8274,29,556,14,10,10,0,0,4,14,1,1,1,1,2,2,0,2,0,1,0,0,2,4,18,0
8275,29,556,46,26,30,3,0,12,49,3,6,3,6,9,9,20,28,1,42,2,0,2,4,18,0
8276,42,1782,1513,682,1277,25,13,200,1538,11,199,116,219,210,335,1557,2584,6,15641,868,0,2,3,3,0
8277,39,1924,1457,730,1242,11,6,188,1468,10,292,166,329,302,495,2424,4078,5,22973,1276,1,2,1,1,0
8278,30,1496,652,304,544,16,6,88,668,6,89,51,101,95,152,591,998,3,3399,188,0,2,1,1,0
8279,48,2093,1020,354,843,12,15,144,1032,8,134,77,144,142,221,970,1580,4,6792,377,0,2,3,3,0
8280,36,1381,1098,241,925,5,10,155,1103,7,46,25,49,53,74,273,423,3,1580,87,0,2,2,2,0
8281,28,546,127,75,83,2,11,30,129,4,14,7,14,18,21,61,87,2,175,9,0,2,2,5,0
8282,28,546,652,304,544,16,6,88,668,6,89,51,101,95,152,591,998,3,3399,188,0,2,2,5,0
8283,28,546,2,2,2,0,0,0,2,0,0,0,0,0,0,0,0,0,0,0,0,2,2,5,0
8284,28,546,8,5,5,0,0,3,8,0,0,0,0,0,0,0,0,0,0,0,0,2,2,5,0
8285,28,546,2,2,2,0,0,0,2,0,0,0,0,0,0,0,0,0,0,0,0,2,2,5,0
8286,28,546,14,8,8,0,0,6,14,0,0,0,0,0,0,0,0,0,0,0,0,2,2,5,0
8287,28,546,6,4,4,0,0,2,6,0,0,0,0,0,0,0,0,0,0,0,0,2,2,5,0
8288,28,546,6,4,4,0,0,2,6,1,2,1,2,3,3,2,4,0,2,0,0,2,2,5,0
8289,28,546,6,4,4,0,0,2,6,0,0,0,0,0,0,0,0,0,0,0,0,2,2,5,0
8290,28,546,7,5,5,0,0,2,7,0,0,0,0,0,0,0,0,0,0,0,0,2,2,5,0
8291,28,546,6,4,4,0,0,2,6,0,0,0,0,0,0,0,0,0,0,0,0,2,2,5,0
8292,28,546,10,6,6,0,0,4,10,0,0,0,0,0,0,0,0,0,0,0,0,2,2,5,0
8293,28,546,1,1,1,0,0,0,1,0,0,0,0,0,0,0,0,0,0,0,0,2,2,5,0
8294,28,546,1,1,1,0,0,0,1,0,0,0,0,0,0,0,0,0,0,0,0,2,2,5,0
8295,28,546,14,10,10,0,0,4,14,1,1,1,1,2,2,0,2,0,1,0,0,2,2,5,0
8296,28,546,46,26,30,3,0,12,49,3,6,3,6,9,9,20,28,1,42,2,0,2,2,5,0
8297,66,1213,1020,354,843,12,15,144,1032,8,134,77,144,142,221,970,1580,4,6792,377,0,2,7,1,1
8298,50,2222,1020,354,843,12,15,144,1032,8,134,77,144,142,221,970,1580,4,6792,377,0,2,23,1,1
8299,131,4059,1660,832,1314,41,38,274,1701,20,312,209,395,332,604,2671,5058,12,64042,3557,1,2,1,1,0
8300,131,4059,1057,646,719,113,100,145,1170,18,215,134,248,233,382,1740,3004,10,31186,1732,1,2,1,1,0
8301,30,640,2,2,2,0,0,0,2,0,0,0,0,0,0,0,0,0,0,0,0,2,7,4,1
8302,30,640,99,48,90,1,3,5,100,0,0,0,0,0,0,0,0,0,0,0,0,2,7,4,1
8303,30,640,8,5,5,2,0,1,10,0,0,0,0,0,0,0,0,0,0,0,0,2,7,4,1
8304,30,640,1217,716,841,84,126,174,1301,14,185,118,215,199,333,1446,2542,8,20687,1149,0,2,7,4,1
8305,30,640,160,89,115,0,13,31,160,7,15,11,17,22,28,78,124,3,495,27,0,2,7,4,1
8306,30,640,10,10,9,9,0,0,19,0,0,0,0,0,0,0,0,0,0,0,0,2,7,4,1
8307,30,640,173,84,99,8,29,36,181,5,12,7,13,17,20,54,81,2,221,12,0,2,7,4,1
8308,30,640,3,1,1,3,0,0,6,0,0,0,0,0,0,0,0,0,0,0,0,2,7,4,1
8309,75,1656,477,336,357,30,23,73,507,16,194,134,250,210,384,1538,2962,10,30538,1696,0,2,67,37,1
8310,30,619,2,2,2,0,0,0,2,0,0,0,0,0,0,0,0,0,0,0,0,2,4,2,0
8311,30,619,99,48,90,1,3,5,100,0,0,0,0,0,0,0,0,0,0,0,0,2,4,2,0
8312,30,619,8,5,5,2,0,1,10,0,0,0,0,0,0,0,0,0,0,0,0,2,4,2,0
8313,30,619,1217,716,841,84,126,174,1301,14,185,118,215,199,333,1446,2542,8,20687,1149,0,2,4,2,0
8314,30,619,160,89,115,0,13,31,160,7,15,11,17,22,28,78,124,3,495,27,0,2,4,2,0
8315,30,619,10,10,9,9,0,0,19,0,0,0,0,0,0,0,0,0,0,0,0,2,4,2,0
8316,30,619,173,84,99,8,29,36,181,5,12,7,13,17,20,54,81,2,221,12,0,2,4,2,0
8317,30,619,3,1,1,3,0,0,6,0,0,0,0,0,0,0,0,0,0,0,0,2,4,2,0
8318,74,1566,477,336,357,30,23,73,507,16,194,134,250,210,384,1538,2962,10,30538,1696,0,2,10,7,0
8319,30,617,2,2,2,0,0,0,2,0,0,0,0,0,0,0,0,0,0,0,0,2,2,4,1
8320,30,617,99,48,90,1,3,5,100,0,0,0,0,0,0,0,0,0,0,0,0,2,2,4,1
8321,30,617,8,5,5,2,0,1,10,0,0,0,0,0,0,0,0,0,0,0,0,2,2,4,1
8322,30,617,1217,716,841,84,126,174,1301,14,185,118,215,199,333,1446,2542,8,20687,1149,0,2,2,4,1
8323,30,617,160,89,115,0,13,31,160,7,15,11,17,22,28,78,124,3,495,27,0,2,2,4,1
8324,30,617,10,10,9,9,0,0,19,0,0,0,0,0,0,0,0,0,0,0,0,2,2,4,1
8325,30,617,173,84,99,8,29,36,181,5,12,7,13,17,20,54,81,2,221,12,0,2,2,4,1
8326,30,617,3,1,1,3,0,0,6,0,0,0,0,0,0,0,0,0,0,0,0,2,2,4,1
8327,73,1533,477,336,357,30,23,73,507,16,194,134,250,210,384,1538,2962,10,30538,1696,0,2,7,10,1
8328,26,887,1455,414,1257,16,76,112,1471,5,41,23,46,46,69,231,381,2,1069,59,0,2,6,1,1
8329,26,887,669,365,481,22,61,110,691,15,103,63,122,118,185,747,1273,8,11311,628,0,2,6,1,1
8330,23,997,1455,414,1257,16,76,112,1471,5,41,23,46,46,69,231,381,2,1069,59,0,2,20,0,1
8331,75,1656,477,336,357,30,23,73,507,16,194,134,250,210,384,1538,2962,10,30538,1696,0,2,1,1,1
8332,50,1776,1450,624,1228,12,26,181,1462,14,306,186,354,320,540,2580,4493,8,36391,2021,1,2,10,0,1
8333,50,2082,1043,504,840,53,9,147,1096,9,180,112,198,189,310,1377,2344,4,11604,644,0,2,3,1,1
8334,446,9636,72,33,56,0,4,12,72,1,1,1,1,2,2,0,2,0,1,0,0,2,1,2,1
8335,446,9636,1454,835,1044,76,110,219,1530,17,275,158,296,292,454,2297,3718,9,34017,1889,1,2,1,2,1
8336,24,595,465,148,393,5,8,60,470,4,31,20,31,35,51,161,261,2,523,29,0,2,4,0,1
8337,24,595,16,12,9,0,0,6,16,1,2,1,2,3,3,2,4,0,2,0,0,2,4,0,1
8338,443,9662,72,33,56,0,4,12,72,1,1,1,1,2,2,0,2,0,1,0,0,2,15,10,1
8339,443,9662,1454,835,1044,76,110,219,1530,17,275,158,296,292,454,2297,3718,9,34017,1889,1,2,15,10,1
8340,62,2992,1338,495,1086,10,64,173,1348,11,122,82,157,133,239,883,1686,7,11934,663,0,2,29,0,1
8341,443,9662,72,33,56,0,4,12,72,1,1,1,1,2,2,0,2,0,1,0,0,2,15,10,0
8342,443,9662,1454,835,1044,76,110,219,1530,17,275,158,296,292,454,2297,3718,9,34017,1889,1,2,15,10,0
8343,62,2992,1338,495,1086,10,64,173,1348,11,122,82,157,133,239,883,1686,7,11934,663,0,2,29,0,0
8344,444,9672,72,33,56,0,4,12,72,1,1,1,1,2,2,0,2,0,1,0,0,2,3,2,1
8345,444,9672,1454,835,1044,76,110,219,1530,17,275,158,296,292,454,2297,3718,9,34017,1889,1,2,3,2,1
8346,25,622,465,148,393,5,8,60,470,4,31,20,31,35,51,161,261,2,523,29,0,2,13,0,1
8347,25,622,16,12,9,0,0,6,16,1,2,1,2,3,3,2,4,0,2,0,0,2,13,0,1
8348,120,5034,139,89,101,2,0,35,141,7,54,34,62,61,96,330,569,4,2287,127,0,2,6,2,1
8349,120,5034,7,5,5,0,0,2,7,1,2,1,2,3,3,2,4,0,2,0,0,2,6,2,1
8350,440,9611,72,33,56,0,4,12,72,1,1,1,1,2,2,0,2,0,1,0,0,2,67,75,1
8351,440,9611,1454,835,1044,76,110,219,1530,17,275,158,296,292,454,2297,3718,9,34017,1889,1,2,67,75,1
8352,439,9596,72,33,56,0,4,12,72,1,1,1,1,2,2,0,2,0,1,0,0,2,0,2,0
8353,439,9596,1454,835,1044,76,110,219,1530,17,275,158,296,292,454,2297,3718,9,34017,1889,1,2,0,2,0
8354,163,3249,1943,715,1694,26,18,214,1969,12,185,120,237,197,357,1436,2721,7,20915,1161,0,2,8,0,1
8355,163,3249,1168,838,957,57,25,144,1225,19,348,224,416,367,640,3018,5452,11,61921,3440,1,2,8,0,1
8356,61,2682,1943,715,1694,26,18,214,1969,12,185,120,237,197,357,1436,2721,7,20915,1161,0,2,13,0,1
8357,61,2680,1943,715,1694,26,18,214,1969,12,185,120,237,197,357,1436,2721,7,20915,1161,0,2,2,2,0
8358,170,3786,77,34,69,0,0,8,77,3,24,16,29,27,45,114,213,1,387,21,0,2,4,0,1
8359,170,3786,712,438,573,51,9,84,763,14,102,71,128,116,199,733,1364,8,11988,666,0,2,4,0,1
8360,439,9723,72,33,56,0,4,12,72,1,1,1,1,2,2,0,2,0,1,0,0,2,180,149,1
8361,439,9723,1454,835,1044,76,110,219,1530,17,275,158,296,292,454,2297,3718,9,34017,1889,1,2,180,149,1
8362,62,2993,1338,495,1086,10,64,173,1348,11,122,82,157,133,239,883,1686,7,11934,663,0,2,1,1,1
8363,120,5138,139,89,101,2,0,35,141,7,54,34,62,61,96,330,569,4,2287,127,0,2,15,16,1
8364,120,5138,7,5,5,0,0,2,7,1,2,1,2,3,3,2,4,0,2,0,0,2,15,16,1
8365,57,3235,1782,648,1425,9,47,279,1791,8,171,97,189,179,286,1292,2140,4,9462,525,0,2,2,2,1
8366,165,3722,77,34,69,0,0,8,77,3,24,16,29,27,45,114,213,1,387,21,0,2,1,11,1
8367,165,3722,712,438,573,51,9,84,763,14,102,71,128,116,199,733,1364,8,11988,666,0,2,1,11,1
8368,431,9623,72,33,56,0,4,12,72,1,1,1,1,2,2,0,2,0,1,0,0,2,0,18,1
8369,431,9623,1454,835,1044,76,110,219,1530,17,275,158,296,292,454,2297,3718,9,34017,1889,1,2,0,18,1
8370,62,2899,1338,495,1086,10,64,173,1348,11,122,82,157,133,239,883,1686,7,11934,663,0,2,2,14,1
8371,111,2393,1043,504,840,53,9,147,1096,9,180,112,198,189,310,1377,2344,4,11604,644,0,2,0,1,0
8372,111,2393,383,288,292,26,6,62,409,11,65,38,67,76,105,429,656,5,3719,206,0,2,0,1,0
8373,2,34,9,6,6,0,0,3,9,0,0,0,0,0,0,0,0,0,0,0,0,0,10,0,0
8374,2,34,13,9,8,0,0,4,13,0,0,0,0,0,0,0,0,0,0,0,0,0,10,0,0
8375,57,3230,1782,648,1425,9,47,279,1791,8,171,97,189,179,286,1292,2140,4,9462,525,0,2,1,1,0
8376,433,9667,72,33,56,0,4,12,72,1,1,1,1,2,2,0,2,0,1,0,0,2,29,24,1
8377,433,9667,1454,835,1044,76,110,219,1530,17,275,158,296,292,454,2297,3718,9,34017,1889,1,2,29,24,1
8378,121,5214,139,89,101,2,0,35,141,7,54,34,62,61,96,330,569,4,2287,127,0,2,28,0,1
8379,121,5214,7,5,5,0,0,2,7,1,2,1,2,3,3,2,4,0,2,0,0,2,28,0,1
8380,57,3230,1782,648,1425,9,47,279,1791,8,171,97,189,179,286,1292,2140,4,9462,525,0,2,2,0,1
8381,432,9610,72,33,56,0,4,12,72,1,1,1,1,2,2,0,2,0,1,0,0,2,7,14,0
8382,432,9610,1454,835,1044,76,110,219,1530,17,275,158,296,292,454,2297,3718,9,34017,1889,1,2,7,14,0
8383,61,2678,1943,715,1694,26,18,214,1969,12,185,120,237,197,357,1436,2721,7,20915,1161,0,2,1,1,0
8384,163,3249,1943,715,1694,26,18,214,1969,12,185,120,237,197,357,1436,2721,7,20915,1161,0,2,8,0,0
8385,163,3249,1168,838,957,57,25,144,1225,19,348,224,416,367,640,3018,5452,11,61921,3440,1,2,8,0,0
8386,61,2678,1943,715,1694,26,18,214,1969,12,185,120,237,197,357,1436,2721,7,20915,1161,0,2,13,0,0
8387,163,3249,1943,715,1694,26,18,214,1969,12,185,120,237,197,357,1436,2721,7,20915,1161,0,2,1,1,1
8388,163,3249,1168,838,957,57,25,144,1225,19,348,224,416,367,640,3018,5452,11,61921,3440,1,2,1,1,1
8389,61,2676,1943,715,1694,26,18,214,1969,12,185,120,237,197,357,1436,2721,7,20915,1161,0,2,2,2,0
8390,61,2676,1943,715,1694,26,18,214,1969,12,185,120,237,197,357,1436,2721,7,20915,1161,0,2,2,2,0
8391,431,9600,72,33,56,0,4,12,72,1,1,1,1,2,2,0,2,0,1,0,0,2,2,3,1
8392,431,9600,1454,835,1044,76,110,219,1530,17,275,158,296,292,454,2297,3718,9,34017,1889,1,2,2,3,1
8393,24,595,465,148,393,5,8,60,470,4,31,20,31,35,51,161,261,2,523,29,0,2,0,13,1
8394,24,595,16,12,9,0,0,6,16,1,2,1,2,3,3,2,4,0,2,0,0,2,0,13,1
8395,3,42,14,8,8,0,0,6,14,0,0,0,0,0,0,0,0,0,0,0,0,0,12,0,0
8396,437,9678,72,33,56,0,4,12,72,1,1,1,1,2,2,0,2,0,1,0,0,2,61,46,1
8397,437,9678,1454,835,1044,76,110,219,1530,17,275,158,296,292,454,2297,3718,9,34017,1889,1,2,61,46,1
8398,229,4665,1457,730,1242,11,6,188,1468,10,292,166,329,302,495,2424,4078,5,22973,1276,1,2,1,2,1
8399,229,4665,74,35,59,1,0,14,75,3,14,7,14,17,21,58,85,1,128,7,0,2,1,2,1
8400,229,4665,245,125,200,5,7,34,250,7,30,17,34,37,51,166,265,3,1053,58,0,2,1,2,1
8401,437,9677,72,33,56,0,4,12,72,1,1,1,1,2,2,0,2,0,1,0,0,2,5,5,1
8402,437,9677,1454,835,1044,76,110,219,1530,17,275,158,296,292,454,2297,3718,9,34017,1889,1,2,5,5,1
8403,439,9699,72,33,56,0,4,12,72,1,1,1,1,2,2,0,2,0,1,0,0,2,3,2,1
8404,439,9699,1454,835,1044,76,110,219,1530,17,275,158,296,292,454,2297,3718,9,34017,1889,1,2,3,2,1
8405,122,5273,139,89,101,2,0,35,141,7,54,34,62,61,96,330,569,4,2287,127,0,2,28,0,1
8406,122,5273,7,5,5,0,0,2,7,1,2,1,2,3,3,2,4,0,2,0,0,2,28,0,1
8407,439,9701,72,33,56,0,4,12,72,1,1,1,1,2,2,0,2,0,1,0,0,2,6,4,1
8408,439,9701,1454,835,1044,76,110,219,1530,17,275,158,296,292,454,2297,3718,9,34017,1889,1,2,6,4,1
8409,439,9685,72,33,56,0,4,12,72,1,1,1,1,2,2,0,2,0,1,0,0,2,0,2,1
8410,439,9685,1454,835,1044,76,110,219,1530,17,275,158,296,292,454,2297,3718,9,34017,1889,1,2,0,2,1
8411,63,2929,1338,495,1086,10,64,173,1348,11,122,82,157,133,239,883,1686,7,11934,663,0,2,18,0,1
8412,439,9685,72,33,56,0,4,12,72,1,1,1,1,2,2,0,2,0,1,0,0,2,0,2,0
8413,439,9685,1454,835,1044,76,110,219,1530,17,275,158,296,292,454,2297,3718,9,34017,1889,1,2,0,2,0
8414,63,2929,1338,495,1086,10,64,173,1348,11,122,82,157,133,239,883,1686,7,11934,663,0,2,18,0,0
8415,30,640,2,2,2,0,0,0,2,0,0,0,0,0,0,0,0,0,0,0,0,2,7,4,1
8416,30,640,99,48,90,1,3,5,100,0,0,0,0,0,0,0,0,0,0,0,0,2,7,4,1
8417,30,640,8,5,5,2,0,1,10,0,0,0,0,0,0,0,0,0,0,0,0,2,7,4,1
8418,30,640,1217,716,841,84,126,174,1301,14,185,118,215,199,333,1446,2542,8,20687,1149,0,2,7,4,1
8419,30,640,160,89,115,0,13,31,160,7,15,11,17,22,28,78,124,3,495,27,0,2,7,4,1
8420,30,640,10,10,9,9,0,0,19,0,0,0,0,0,0,0,0,0,0,0,0,2,7,4,1
8421,30,640,173,84,99,8,29,36,181,5,12,7,13,17,20,54,81,2,221,12,0,2,7,4,1
8422,30,640,3,1,1,3,0,0,6,0,0,0,0,0,0,0,0,0,0,0,0,2,7,4,1
8423,131,4059,1660,832,1314,41,38,274,1701,20,312,209,395,332,604,2671,5058,12,64042,3557,1,2,1,1,1
8424,131,4059,1057,646,719,113,100,145,1170,18,215,134,248,233,382,1740,3004,10,31186,1732,1,2,1,1,1
8425,75,1656,477,336,357,30,23,73,507,16,194,134,250,210,384,1538,2962,10,30538,1696,0,2,66,36,1
8426,13,442,42,7,35,4,0,5,46,1,2,1,2,3,3,2,4,0,2,0,0,2,2,2,1
8427,13,442,11,6,10,0,0,1,11,2,4,2,4,6,6,10,15,1,15,0,0,2,2,2,1
8428,50,1776,1450,624,1228,12,26,181,1462,14,306,186,354,320,540,2580,4493,8,36391,2021,1,2,10,0,1
8429,13,442,42,7,35,4,0,5,46,1,2,1,2,3,3,2,4,0,2,0,0,2,1,1,1
8430,13,442,11,6,10,0,0,1,11,2,4,2,4,6,6,10,15,1,15,0,0,2,1,1,1
8431,51,1803,1450,624,1228,12,26,181,1462,14,306,186,354,320,540,2580,4493,8,36391,2021,1,2,13,0,1
8432,61,2674,1943,715,1694,26,18,214,1969,12,185,120,237,197,357,1436,2721,7,20915,1161,0,2,0,1,0
8433,13,442,42,7,35,4,0,5,46,1,2,1,2,3,3,2,4,0,2,0,0,2,1,1,0
8434,13,442,11,6,10,0,0,1,11,2,4,2,4,6,6,10,15,1,15,0,0,2,1,1,0
8435,1,225,382,65,130,157,2,92,539,4,10,5,10,14,15,41,57,2,114,6,0,2,2,2,0
8436,1,245,382,65,130,157,2,92,539,4,10,5,10,14,15,41,57,2,114,6,0,2,4,1,0
8437,1,270,382,65,130,157,2,92,539,4,10,5,10,14,15,41,57,2,114,6,0,2,14,0,0
8438,1,272,382,65,130,157,2,92,539,4,10,5,10,14,15,41,57,2,114,6,0,2,1,0,0
8439,1,274,382,65,130,157,2,92,539,4,10,5,10,14,15,41,57,2,114,6,0,2,1,0,0
8440,1,276,382,65,130,157,2,92,539,4,10,5,10,14,15,41,57,2,114,6,0,2,2,1,1
8441,1,279,382,65,130,157,2,92,539,4,10,5,10,14,15,41,57,2,114,6,0,2,3,1,0
8442,42,1312,1523,757,1297,19,12,193,1542,12,193,117,230,205,347,1508,2664,7,19053,1058,0,2,7,7,1
8443,42,1312,701,378,504,33,58,109,734,13,110,68,126,123,194,794,1346,7,10027,557,0,2,7,7,1
8444,39,2399,1523,757,1297,19,12,193,1542,12,193,117,230,205,347,1508,2664,7,19053,1058,0,2,13,1,1
8445,439,9687,72,33,56,0,4,12,72,1,1,1,1,2,2,0,2,0,1,0,0,2,1,0,1
8446,439,9687,1454,835,1044,76,110,219,1530,17,275,158,296,292,454,2297,3718,9,34017,1889,1,2,1,0,1
8447,39,2393,1523,757,1297,19,12,193,1542,12,193,117,230,205,347,1508,2664,7,19053,1058,0,2,1,1,0
8448,435,9731,72,33,56,0,4,12,72,1,1,1,1,2,2,0,2,0,1,0,0,2,17,8,1
8449,435,9731,1454,835,1044,76,110,219,1530,17,275,158,296,292,454,2297,3718,9,34017,1889,1,2,17,8,1
8450,124,5341,139,89,101,2,0,35,141,7,54,34,62,61,96,330,569,4,2287,127,0,2,34,0,1
8451,124,5341,7,5,5,0,0,2,7,1,2,1,2,3,3,2,4,0,2,0,0,2,34,0,1
8452,42,1312,1523,757,1297,19,12,193,1542,12,193,117,230,205,347,1508,2664,7,19053,1058,0,2,7,7,0
8453,42,1312,701,378,504,33,58,109,734,13,110,68,126,123,194,794,1346,7,10027,557,0,2,7,7,0
8454,435,9733,72,33,56,0,4,12,72,1,1,1,1,2,2,0,2,0,1,0,0,2,17,8,0
8455,435,9733,1454,835,1044,76,110,219,1530,17,275,158,296,292,454,2297,3718,9,34017,1889,1,2,17,8,0
8456,124,5341,139,89,101,2,0,35,141,7,54,34,62,61,96,330,569,4,2287,127,0,2,34,0,0
8457,124,5341,7,5,5,0,0,2,7,1,2,1,2,3,3,2,4,0,2,0,0,2,34,0,0
8458,39,2393,1523,757,1297,19,12,193,1542,12,193,117,230,205,347,1508,2664,7,19053,1058,0,2,13,1,0
8459,435,9731,72,33,56,0,4,12,72,1,1,1,1,2,2,0,2,0,1,0,0,2,0,1,0
8460,435,9731,1454,835,1044,76,110,219,1530,17,275,158,296,292,454,2297,3718,9,34017,1889,1,2,0,1,0
8461,435,9729,72,33,56,0,4,12,72,1,1,1,1,2,2,0,2,0,1,0,0,2,2,1,1
8462,435,9729,1454,835,1044,76,110,219,1530,17,275,158,296,292,454,2297,3718,9,34017,1889,1,2,2,1,1
8463,58,3261,1782,648,1425,9,47,279,1791,8,171,97,189,179,286,1292,2140,4,9462,525,0,2,16,0,1
8464,39,2401,1523,757,1297,19,12,193,1542,12,193,117,230,205,347,1508,2664,7,19053,1058,0,2,1,1,0
8465,435,9729,72,33,56,0,4,12,72,1,1,1,1,2,2,0,2,0,1,0,0,2,2,2,1
8466,435,9729,1454,835,1044,76,110,219,1530,17,275,158,296,292,454,2297,3718,9,34017,1889,1,2,2,2,1
8467,58,3259,1782,648,1425,9,47,279,1791,8,171,97,189,179,286,1292,2140,4,9462,525,0,2,1,1,0
8468,229,4665,1457,730,1242,11,6,188,1468,10,292,166,329,302,495,2424,4078,5,22973,1276,1,2,2,2,1
8469,229,4665,74,35,59,1,0,14,75,3,14,7,14,17,21,58,85,1,128,7,0,2,2,2,1
8470,229,4665,245,125,200,5,7,34,250,7,30,17,34,37,51,166,265,3,1053,58,0,2,2,2,1
8471,13,442,42,7,35,4,0,5,46,1,2,1,2,3,3,2,4,0,2,0,0,2,1,1,1
8472,13,442,11,6,10,0,0,1,11,2,4,2,4,6,6,10,15,1,15,0,0,2,1,1,1
8473,1,279,382,65,130,157,2,92,539,4,10,5,10,14,15,41,57,2,114,6,0,2,24,2,0
8474,1,279,382,65,130,157,2,92,539,4,10,5,10,14,15,41,57,2,114,6,0,2,2,2,0
8475,1,279,382,65,130,157,2,92,539,4,10,5,10,14,15,41,57,2,114,6,0,2,3,3,0
8476,75,1645,477,336,357,30,23,73,507,16,194,134,250,210,384,1538,2962,10,30538,1696,0,2,2,6,1
8477,13,442,42,7,35,4,0,5,46,1,2,1,2,3,3,2,4,0,2,0,0,2,1,1,1
8478,13,442,11,6,10,0,0,1,11,2,4,2,4,6,6,10,15,1,15,0,0,2,1,1,1
8479,66,1213,1020,354,843,12,15,144,1032,8,134,77,144,142,221,970,1580,4,6792,377,0,2,1,1,1
8480,51,2245,1020,354,843,12,15,144,1032,8,134,77,144,142,221,970,1580,4,6792,377,0,2,4,0,1
8481,66,1213,1020,354,843,12,15,144,1032,8,134,77,144,142,221,970,1580,4,6792,377,0,2,1,1,0
8482,51,2245,1020,354,843,12,15,144,1032,8,134,77,144,142,221,970,1580,4,6792,377,0,2,4,0,0
8483,62,2549,1289,550,1043,56,32,155,1345,10,167,93,185,177,278,1266,2075,5,11498,638,0,2,2,2,0
8484,131,4059,1660,832,1314,41,38,274,1701,20,312,209,395,332,604,2671,5058,12,64042,3557,1,2,3,3,1
8485,131,4059,1057,646,719,113,100,145,1170,18,215,134,248,233,382,1740,3004,10,31186,1732,1,2,3,3,1
8486,229,4665,1457,730,1242,11,6,188,1468,10,292,166,329,302,495,2424,4078,5,22973,1276,1,2,6,5,1
8487,229,4665,74,35,59,1,0,14,75,3,14,7,14,17,21,58,85,1,128,7,0,2,6,5,1
8488,229,4665,245,125,200,5,7,34,250,7,30,17,34,37,51,166,265,3,1053,58,0,2,6,5,1
8489,42,1119,74,35,59,1,0,14,75,3,14,7,14,17,21,58,85,1,128,7,0,2,1,1,1
8490,42,1119,245,125,200,5,7,34,250,7,30,17,34,37,51,166,265,3,1053,58,0,2,1,1,1
8491,44,432,647,139,84,35,284,233,682,0,0,0,0,0,0,0,0,0,0,0,0,2,2,2,1
8492,165,3720,77,34,69,0,0,8,77,3,24,16,29,27,45,114,213,1,387,21,0,2,1,1,1
8493,165,3720,712,438,573,51,9,84,763,14,102,71,128,116,199,733,1364,8,11988,666,0,2,1,1,1
8494,66,1213,1020,354,843,12,15,144,1032,8,134,77,144,142,221,970,1580,4,6792,377,0,2,4,4,1
8495,23,407,424,94,331,4,0,89,428,1,5,5,5,6,10,11,25,0,12,0,0,2,1,1,1
8496,23,407,38,23,23,6,0,8,44,3,11,7,11,14,18,42,68,1,102,5,0,2,1,1,1
8497,195,4406,722,423,573,19,0,135,741,12,172,101,199,184,300,1320,2257,6,15668,870,0,2,7,7,1
8498,195,4406,1508,847,911,44,250,301,1552,14,148,88,169,162,257,1120,1886,7,15077,837,0,2,7,7,1
8499,435,9729,72,33,56,0,4,12,72,1,1,1,1,2,2,0,2,0,1,0,0,2,3,3,1
8500,435,9729,1454,835,1044,76,110,219,1530,17,275,158,296,292,454,2297,3718,9,34017,1889,1,2,3,3,1
8501,111,2393,1043,504,840,53,9,147,1096,9,180,112,198,189,310,1377,2344,4,11604,644,0,2,6,4,1
8502,111,2393,383,288,292,26,6,62,409,11,65,38,67,76,105,429,656,5,3719,206,0,2,6,4,1
8503,86,1513,1178,367,1042,6,15,115,1184,9,94,51,95,103,146,644,976,4,4439,246,0,2,6,6,1
8504,86,1513,177,108,140,8,0,27,185,6,30,16,32,36,48,162,248,3,794,44,0,2,6,6,1
8505,163,3247,1943,715,1694,26,18,214,1969,12,185,120,237,197,357,1436,2721,7,20915,1161,0,2,1,1,1
8506,163,3247,1168,838,957,57,25,144,1225,19,348,224,416,367,640,3018,5452,11,61921,3440,1,2,1,1,1
8507,56,983,282,196,195,3,0,86,285,8,130,71,141,138,212,936,1507,4,6538,363,0,2,1,1,1
8508,7,296,72,33,56,0,4,12,72,1,1,1,1,2,2,0,2,0,1,0,0,2,3,2,1
8509,13,442,42,7,35,4,0,5,46,1,2,1,2,3,3,2,4,0,2,0,0,2,1,1,1
8510,13,442,11,6,10,0,0,1,11,2,4,2,4,6,6,10,15,1,15,0,0,2,1,1,1
8511,39,1920,1457,730,1242,11,6,188,1468,10,292,166,329,302,495,2424,4078,5,22973,1276,1,2,2,2,1
8512,11,343,74,35,59,1,0,14,75,3,14,7,14,17,21,58,85,1,128,7,0,2,1,1,1
8513,16,498,424,94,331,4,0,89,428,1,5,5,5,6,10,11,25,0,12,0,0,2,2,2,1
8514,14,567,722,423,573,19,0,135,741,12,172,101,199,184,300,1320,2257,6,15668,870,0,2,1,1,1
8515,12,404,386,256,301,16,9,68,402,4,59,35,69,63,104,355,621,2,1453,80,0,2,7,7,1
8516,50,2058,1043,504,840,53,9,147,1096,9,180,112,198,189,310,1377,2344,4,11604,644,0,2,18,18,1
8517,24,968,373,158,315,8,0,51,381,5,76,44,79,81,123,486,779,2,2026,112,0,2,2,2,1
8518,7,514,442,244,305,14,16,103,456,11,68,45,75,79,120,452,756,6,4588,254,0,2,3,3,1
8519,195,4406,722,423,573,19,0,135,741,12,172,101,199,184,300,1320,2257,6,15668,870,0,2,2,2,0
8520,195,4406,1508,847,911,44,250,301,1552,14,148,88,169,162,257,1120,1886,7,15077,837,0,2,2,2,0
8521,435,9729,72,33,56,0,4,12,72,1,1,1,1,2,2,0,2,0,1,0,0,2,1,1,0
8522,435,9729,1454,835,1044,76,110,219,1530,17,275,158,296,292,454,2297,3718,9,34017,1889,1,2,1,1,0
8523,39,1920,1457,730,1242,11,6,188,1468,10,292,166,329,302,495,2424,4078,5,22973,1276,1,2,1,1,0
8524,42,1121,74,35,59,1,0,14,75,3,14,7,14,17,21,58,85,1,128,7,0,2,3,1,1
8525,42,1121,245,125,200,5,7,34,250,7,30,17,34,37,51,166,265,3,1053,58,0,2,3,1,1
8526,67,1216,1020,354,843,12,15,144,1032,8,134,77,144,142,221,970,1580,4,6792,377,0,2,19,1,0
8527,54,2310,1020,354,843,12,15,144,1032,8,134,77,144,142,221,970,1580,4,6792,377,0,2,11,0,0
8528,42,1121,74,35,59,1,0,14,75,3,14,7,14,17,21,58,85,1,128,7,0,2,3,1,0
8529,42,1121,245,125,200,5,7,34,250,7,30,17,34,37,51,166,265,3,1053,58,0,2,3,1,0
8530,42,1128,74,35,59,1,0,14,75,3,14,7,14,17,21,58,85,1,128,7,0,2,2,0,1
8531,42,1128,245,125,200,5,7,34,250,7,30,17,34,37,51,166,265,3,1053,58,0,2,2,0,1
8532,229,4667,1457,730,1242,11,6,188,1468,10,292,166,329,302,495,2424,4078,5,22973,1276,1,2,3,2,0
8533,229,4667,74,35,59,1,0,14,75,3,14,7,14,17,21,58,85,1,128,7,0,2,3,2,0
8534,229,4667,245,125,200,5,7,34,250,7,30,17,34,37,51,166,265,3,1053,58,0,2,3,2,0
8535,163,3251,1943,715,1694,26,18,214,1969,12,185,120,237,197,357,1436,2721,7,20915,1161,0,2,1,1,1
8536,163,3251,1168,838,957,57,25,144,1225,19,348,224,416,367,640,3018,5452,11,61921,3440,1,2,1,1,1
8537,61,2682,1943,715,1694,26,18,214,1969,12,185,120,237,197,357,1436,2721,7,20915,1161,0,2,3,2,1
8538,229,4665,1457,730,1242,11,6,188,1468,10,292,166,329,302,495,2424,4078,5,22973,1276,1,2,0,1,0
8539,229,4665,74,35,59,1,0,14,75,3,14,7,14,17,21,58,85,1,128,7,0,2,0,1,0
8540,229,4665,245,125,200,5,7,34,250,7,30,17,34,37,51,166,265,3,1053,58,0,2,0,1,0
8541,55,2354,1020,354,843,12,15,144,1032,8,134,77,144,142,221,970,1580,4,6792,377,0,2,22,0,0
8542,116,2937,1660,832,1314,41,38,274,1701,20,312,209,395,332,604,2671,5058,12,64042,3557,1,2,7,0,1
8543,116,2937,1660,832,1314,41,38,274,1701,20,312,209,395,332,604,2671,5058,12,64042,3557,1,2,7,0,0
8544,13,442,42,7,35,4,0,5,46,1,2,1,2,3,3,2,4,0,2,0,0,2,1,1,0
8545,13,442,11,6,10,0,0,1,11,2,4,2,4,6,6,10,15,1,15,0,0,2,1,1,0
8546,43,1834,1513,682,1277,25,13,200,1538,11,199,116,219,210,335,1557,2584,6,15641,868,0,2,23,0,0
8547,171,3239,1513,682,1277,25,13,200,1538,11,199,116,219,210,335,1557,2584,6,15641,868,0,2,383,5,0
8548,171,3239,819,519,539,24,98,155,843,15,96,57,106,111,163,690,1107,8,9171,509,0,2,383,5,0
8549,118,4709,1513,682,1277,25,13,200,1538,11,199,116,219,210,335,1557,2584,6,15641,868,0,2,507,2,0
8550,118,4607,1513,682,1277,25,13,200,1538,11,199,116,219,210,335,1557,2584,6,15641,868,0,2,100,68,0
8551,170,3212,1513,682,1277,25,13,200,1538,11,199,116,219,210,335,1557,2584,6,15641,868,0,2,59,30,0
8552,170,3212,819,519,539,24,98,155,843,15,96,57,106,111,163,690,1107,8,9171,509,0,2,59,30,0
8553,169,3198,1513,682,1277,25,13,200,1538,11,199,116,219,210,335,1557,2584,6,15641,868,0,2,8,9,0
8554,169,3198,819,519,539,24,98,155,843,15,96,57,106,111,163,690,1107,8,9171,509,0,2,8,9,0
8555,169,3198,1513,682,1277,25,13,200,1538,11,199,116,219,210,335,1557,2584,6,15641,868,0,2,29,29,0
8556,169,3198,819,519,539,24,98,155,843,15,96,57,106,111,163,690,1107,8,9171,509,0,2,29,29,0
8557,168,3181,1513,682,1277,25,13,200,1538,11,199,116,219,210,335,1557,2584,6,15641,868,0,2,0,4,0
8558,168,3181,819,519,539,24,98,155,843,15,96,57,106,111,163,690,1107,8,9171,509,0,2,0,4,0
8559,168,3179,1513,682,1277,25,13,200,1538,11,199,116,219,210,335,1557,2584,6,15641,868,0,2,1,1,0
8560,168,3179,819,519,539,24,98,155,843,15,96,57,106,111,163,690,1107,8,9171,509,0,2,1,1,0
8561,168,3156,1513,682,1277,25,13,200,1538,11,199,116,219,210,335,1557,2584,6,15641,868,0,2,1,10,0
8562,168,3156,819,519,539,24,98,155,843,15,96,57,106,111,163,690,1107,8,9171,509,0,2,1,10,0
8563,118,4597,1513,682,1277,25,13,200,1538,11,199,116,219,210,335,1557,2584,6,15641,868,0,2,40,44,0
8564,168,3156,1513,682,1277,25,13,200,1538,11,199,116,219,210,335,1557,2584,6,15641,868,0,2,2,0,0
8565,168,3156,819,519,539,24,98,155,843,15,96,57,106,111,163,690,1107,8,9171,509,0,2,2,0,0
8566,118,4597,1513,682,1277,25,13,200,1538,11,199,116,219,210,335,1557,2584,6,15641,868,0,2,2,0,0
8567,168,3156,1513,682,1277,25,13,200,1538,11,199,116,219,210,335,1557,2584,6,15641,868,0,2,5,5,0
8568,168,3156,819,519,539,24,98,155,843,15,96,57,106,111,163,690,1107,8,9171,509,0,2,5,5,0
8569,73,1336,1513,682,1277,25,13,200,1538,11,199,116,219,210,335,1557,2584,6,15641,868,0,2,24,419,0
8570,73,1336,819,519,539,24,98,155,843,15,96,57,106,111,163,690,1107,8,9171,509,0,2,24,419,0
8571,43,1834,1513,682,1277,25,13,200,1538,11,199,116,219,210,335,1557,2584,6,15641,868,0,2,10,545,0
8572,43,1824,1513,682,1277,25,13,200,1538,11,199,116,219,210,335,1557,2584,6,15641,868,0,2,2,2,0
8573,435,9729,72,33,56,0,4,12,72,1,1,1,1,2,2,0,2,0,1,0,0,2,6,0,0
8574,435,9729,1454,835,1044,76,110,219,1530,17,275,158,296,292,454,2297,3718,9,34017,1889,1,2,6,0,0
8575,435,9729,72,33,56,0,4,12,72,1,1,1,1,2,2,0,2,0,1,0,0,2,16,6,0
8576,435,9729,1454,835,1044,76,110,219,1530,17,275,158,296,292,454,2297,3718,9,34017,1889,1,2,16,6,0
8577,435,9729,72,33,56,0,4,12,72,1,1,1,1,2,2,0,2,0,1,0,0,2,16,0,0
8578,435,9729,1454,835,1044,76,110,219,1530,17,275,158,296,292,454,2297,3718,9,34017,1889,1,2,16,0,0
8579,435,9729,72,33,56,0,4,12,72,1,1,1,1,2,2,0,2,0,1,0,0,2,16,0,1
8580,435,9729,1454,835,1044,76,110,219,1530,17,275,158,296,292,454,2297,3718,9,34017,1889,1,2,16,0,1
8581,168,3156,1513,682,1277,25,13,200,1538,11,199,116,219,210,335,1557,2584,6,15641,868,0,2,420,25,1
8582,168,3156,819,519,539,24,98,155,843,15,96,57,106,111,163,690,1107,8,9171,509,0,2,420,25,1
8583,121,4624,1513,682,1277,25,13,200,1538,11,199,116,219,210,335,1557,2584,6,15641,868,0,2,554,10,1
8584,9,241,19,8,11,5,0,4,24,2,5,3,6,7,9,13,25,1,30,1,0,2,5,1,0
8585,9,241,102,59,69,5,3,24,107,6,22,15,28,28,43,113,206,3,789,43,0,2,5,1,0
8586,9,241,106,40,36,3,49,17,109,8,17,13,23,25,36,93,167,5,904,50,0,2,5,1,0
8587,30,640,2,2,2,0,0,0,2,0,0,0,0,0,0,0,0,0,0,0,0,2,13,11,0
8588,30,640,99,48,90,1,3,5,100,0,0,0,0,0,0,0,0,0,0,0,0,2,13,11,0
8589,30,640,8,5,5,2,0,1,10,0,0,0,0,0,0,0,0,0,0,0,0,2,13,11,0
8590,30,640,1217,716,841,84,126,174,1301,14,185,118,215,199,333,1446,2542,8,20687,1149,0,2,13,11,0
8591,30,640,160,89,115,0,13,31,160,7,15,11,17,22,28,78,124,3,495,27,0,2,13,11,0
8592,30,640,10,10,9,9,0,0,19,0,0,0,0,0,0,0,0,0,0,0,0,2,13,11,0
8593,30,640,173,84,99,8,29,36,181,5,12,7,13,17,20,54,81,2,221,12,0,2,13,11,0
8594,30,640,3,1,1,3,0,0,6,0,0,0,0,0,0,0,0,0,0,0,0,2,13,11,0
8595,131,4059,1660,832,1314,41,38,274,1701,20,312,209,395,332,604,2671,5058,12,64042,3557,1,2,35,11,0
8596,131,4059,1057,646,719,113,100,145,1170,18,215,134,248,233,382,1740,3004,10,31186,1732,1,2,35,11,0
8597,75,1645,477,336,357,30,23,73,507,16,194,134,250,210,384,1538,2962,10,30538,1696,0,2,68,42,0
8598,168,3156,1513,682,1277,25,13,200,1538,11,199,116,219,210,335,1557,2584,6,15641,868,0,2,451,32,0
8599,168,3156,819,519,539,24,98,155,843,15,96,57,106,111,163,690,1107,8,9171,509,0,2,451,32,0
8600,229,4665,1457,730,1242,11,6,188,1468,10,292,166,329,302,495,2424,4078,5,22973,1276,1,2,196,75,0
8601,229,4665,74,35,59,1,0,14,75,3,14,7,14,17,21,58,85,1,128,7,0,2,196,75,0
8602,229,4665,245,125,200,5,7,34,250,7,30,17,34,37,51,166,265,3,1053,58,0,2,196,75,0
8603,26,887,1455,414,1257,16,76,112,1471,5,41,23,46,46,69,231,381,2,1069,59,0,2,6,1,0
8604,26,887,669,365,481,22,61,110,691,15,103,63,122,118,185,747,1273,8,11311,628,0,2,6,1,0
8605,42,1128,74,35,59,1,0,14,75,3,14,7,14,17,21,58,85,1,128,7,0,2,8,5,0
8606,42,1128,245,125,200,5,7,34,250,7,30,17,34,37,51,166,265,3,1053,58,0,2,8,5,0
8607,44,432,647,139,84,35,284,233,682,0,0,0,0,0,0,0,0,0,0,0,0,2,9,8,0
8608,42,1312,1523,757,1297,19,12,193,1542,12,193,117,230,205,347,1508,2664,7,19053,1058,0,2,12,13,0
8609,42,1312,701,378,504,33,58,109,734,13,110,68,126,123,194,794,1346,7,10027,557,0,2,12,13,0
8610,166,3723,77,34,69,0,0,8,77,3,24,16,29,27,45,114,213,1,387,21,0,2,51,36,0
8611,166,3723,712,438,573,51,9,84,763,14,102,71,128,116,199,733,1364,8,11988,666,0,2,51,36,0
8612,67,1216,1020,354,843,12,15,144,1032,8,134,77,144,142,221,970,1580,4,6792,377,0,2,58,27,0
8613,42,852,447,308,343,6,5,95,453,7,96,59,111,103,170,651,1136,4,4600,255,0,2,89,58,0
8614,42,852,322,174,179,16,74,51,338,10,41,26,46,51,72,252,408,5,2291,127,0,2,89,58,0
8615,23,407,424,94,331,4,0,89,428,1,5,5,5,6,10,11,25,0,12,0,0,2,1,2,0
8616,23,407,38,23,23,6,0,8,44,3,11,7,11,14,18,42,68,1,102,5,0,2,1,2,0
8617,195,4406,722,423,573,19,0,135,741,12,172,101,199,184,300,1320,2257,6,15668,870,0,2,34,42,0
8618,195,4406,1508,847,911,44,250,301,1552,14,148,88,169,162,257,1120,1886,7,15077,837,0,2,34,42,0
8619,435,9729,72,33,56,0,4,12,72,1,1,1,1,2,2,0,2,0,1,0,0,2,441,336,0
8620,435,9729,1454,835,1044,76,110,219,1530,17,275,158,296,292,454,2297,3718,9,34017,1889,1,2,441,336,0
8621,18,460,386,256,301,16,9,68,402,4,59,35,69,63,104,355,621,2,1453,80,0,2,2,2,0
8622,18,460,264,131,164,11,41,46,275,6,38,22,40,44,62,214,338,3,1068,59,0,2,2,2,0
8623,29,599,215,129,180,6,0,29,221,8,65,43,72,73,115,415,711,4,3153,175,0,2,2,2,0
8624,29,599,97,69,77,3,3,16,100,6,22,13,23,28,36,113,173,3,542,30,0,2,2,2,0
8625,111,2393,1043,504,840,53,9,147,1096,9,180,112,198,189,310,1377,2344,4,11604,644,0,2,27,17,0
8626,111,2393,383,288,292,26,6,62,409,11,65,38,67,76,105,429,656,5,3719,206,0,2,27,17,0
8627,86,1513,1178,367,1042,6,15,115,1184,9,94,51,95,103,146,644,976,4,4439,246,0,2,14,7,0
8628,86,1513,177,108,140,8,0,27,185,6,30,16,32,36,48,162,248,3,794,44,0,2,14,7,0
8629,163,3251,1943,715,1694,26,18,214,1969,12,185,120,237,197,357,1436,2721,7,20915,1161,0,2,24,18,0
8630,163,3251,1168,838,957,57,25,144,1225,19,348,224,416,367,640,3018,5452,11,61921,3440,1,2,24,18,0
8631,12,373,442,244,305,14,16,103,456,11,68,45,75,79,120,452,756,6,4588,254,0,2,3,0,0
8632,12,373,182,102,99,11,40,35,193,3,11,6,11,14,17,42,64,1,97,5,0,2,3,0,0
8633,54,1029,1098,241,925,5,10,155,1103,7,46,25,49,53,74,273,423,3,1580,87,0,2,5,8,0
8634,54,1029,282,202,222,14,2,44,296,8,42,24,43,50,67,250,378,4,1548,86,0,2,5,8,0
8635,3,42,14,8,8,0,0,6,14,0,0,0,0,0,0,0,0,0,0,0,0,0,12,0,0
8636,2,34,9,6,6,0,0,3,9,0,0,0,0,0,0,0,0,0,0,0,0,0,10,0,0
8637,2,34,13,9,8,0,0,4,13,0,0,0,0,0,0,0,0,0,0,0,0,0,10,0,0
8638,1,279,382,65,130,157,2,92,539,4,10,5,10,14,15,41,57,2,114,6,0,2,29,6,0
8639,56,983,282,196,195,3,0,86,285,8,130,71,141,138,212,936,1507,4,6538,363,0,2,1,1,0
8640,7,296,72,33,56,0,4,12,72,1,1,1,1,2,2,0,2,0,1,0,0,2,3,2,0
8641,11,370,85,59,61,8,0,16,93,5,18,10,18,23,28,86,126,2,316,17,0,0,74,0,0
8642,13,442,42,7,35,4,0,5,46,1,2,1,2,3,3,2,4,0,2,0,0,2,20,16,0
8643,13,442,11,6,10,0,0,1,11,2,4,2,4,6,6,10,15,1,15,0,0,2,20,16,0
8644,63,2592,1289,550,1043,56,32,155,1345,10,167,93,185,177,278,1266,2075,5,11498,638,0,2,36,23,0
8645,28,546,127,75,83,2,11,30,129,4,14,7,14,18,21,61,87,2,175,9,0,2,6,23,0
8646,28,546,652,304,544,16,6,88,668,6,89,51,101,95,152,591,998,3,3399,188,0,2,6,23,0
8647,28,546,2,2,2,0,0,0,2,0,0,0,0,0,0,0,0,0,0,0,0,2,6,23,0
8648,28,546,8,5,5,0,0,3,8,0,0,0,0,0,0,0,0,0,0,0,0,2,6,23,0
8649,28,546,2,2,2,0,0,0,2,0,0,0,0,0,0,0,0,0,0,0,0,2,6,23,0
8650,28,546,14,8,8,0,0,6,14,0,0,0,0,0,0,0,0,0,0,0,0,2,6,23,0
8651,28,546,6,4,4,0,0,2,6,0,0,0,0,0,0,0,0,0,0,0,0,2,6,23,0
8652,28,546,6,4,4,0,0,2,6,1,2,1,2,3,3,2,4,0,2,0,0,2,6,23,0
8653,28,546,6,4,4,0,0,2,6,0,0,0,0,0,0,0,0,0,0,0,0,2,6,23,0
8654,28,546,7,5,5,0,0,2,7,0,0,0,0,0,0,0,0,0,0,0,0,2,6,23,0
8655,28,546,6,4,4,0,0,2,6,0,0,0,0,0,0,0,0,0,0,0,0,2,6,23,0
8656,28,546,10,6,6,0,0,4,10,0,0,0,0,0,0,0,0,0,0,0,0,2,6,23,0
8657,28,546,1,1,1,0,0,0,1,0,0,0,0,0,0,0,0,0,0,0,0,2,6,23,0
8658,28,546,1,1,1,0,0,0,1,0,0,0,0,0,0,0,0,0,0,0,0,2,6,23,0
8659,28,546,14,10,10,0,0,4,14,1,1,1,1,2,2,0,2,0,1,0,0,2,6,23,0
8660,28,546,46,26,30,3,0,12,49,3,6,3,6,9,9,20,28,1,42,2,0,2,6,23,0
8661,63,2929,1338,495,1086,10,64,173,1348,11,122,82,157,133,239,883,1686,7,11934,663,0,2,79,21,0
8662,124,5341,139,89,101,2,0,35,141,7,54,34,62,61,96,330,569,4,2287,127,0,2,266,46,0
8663,124,5341,7,5,5,0,0,2,7,1,2,1,2,3,3,2,4,0,2,0,0,2,266,46,0
8664,24,595,465,148,393,5,8,60,470,4,31,20,31,35,51,161,261,2,523,29,0,2,46,1,0
8665,24,595,16,12,9,0,0,6,16,1,2,1,2,3,3,2,4,0,2,0,0,2,46,1,0
8666,58,3259,1782,648,1425,9,47,279,1791,8,171,97,189,179,286,1292,2140,4,9462,525,0,2,22,5,0
8667,9,192,256,139,192,9,7,47,265,4,23,12,24,27,36,112,171,2,357,19,0,2,1,1,0
8668,23,612,102,59,69,5,3,24,107,6,22,15,28,28,43,113,206,3,789,43,0,2,2,0,0
8669,51,1803,1450,624,1228,12,26,181,1462,14,306,186,354,320,540,2580,4493,8,36391,2021,1,2,25,2,0
8670,116,2937,1660,832,1314,41,38,274,1701,20,312,209,395,332,604,2671,5058,12,64042,3557,1,2,73,10,0
8671,121,4624,1513,682,1277,25,13,200,1538,11,199,116,219,210,335,1557,2584,6,15641,868,0,2,588,12,0
8672,45,2786,1296,573,1062,40,33,157,1336,8,201,118,231,209,349,1561,2689,4,12365,686,0,2,30,9,0
8673,39,1920,1457,730,1242,11,6,188,1468,10,292,166,329,302,495,2424,4078,5,22973,1276,1,2,51,10,0
8674,30,1496,652,304,544,16,6,88,668,6,89,51,101,95,152,591,998,3,3399,188,0,2,42,5,0
8675,23,997,1455,414,1257,16,76,112,1471,5,41,23,46,46,69,231,381,2,1069,59,0,2,23,3,0
8676,11,343,74,35,59,1,0,14,75,3,14,7,14,17,21,58,85,1,128,7,0,2,2,2,0
8677,39,2401,1523,757,1297,19,12,193,1542,12,193,117,230,205,347,1508,2664,7,19053,1058,0,2,44,10,0
8678,55,2354,1020,354,843,12,15,144,1032,8,134,77,144,142,221,970,1580,4,6792,377,0,2,103,9,0
8679,33,1481,447,308,343,6,5,95,453,7,96,59,111,103,170,651,1136,4,4600,255,0,2,20,6,0
8680,16,498,424,94,331,4,0,89,428,1,5,5,5,6,10,11,25,0,12,0,0,2,3,3,0
8681,38,2232,334,251,279,10,4,40,344,5,127,74,143,132,217,899,1528,2,4303,239,0,2,25,16,0
8682,7,291,184,100,137,2,15,30,186,6,38,20,39,44,59,214,322,3,991,55,0,2,1,2,0
8683,27,1034,1293,570,1093,25,15,163,1318,10,195,123,241,205,364,1516,2795,6,17273,959,0,2,9,7,0
8684,14,567,722,423,573,19,0,135,741,12,172,101,199,184,300,1320,2257,6,15668,870,0,2,4,5,0
8685,12,404,386,256,301,16,9,68,402,4,59,35,69,63,104,355,621,2,1453,80,0,2,7,7,0
8686,15,1203,215,129,180,6,0,29,221,8,65,43,72,73,115,415,711,4,3153,175,0,2,20,0,0
8687,50,2058,1043,504,840,53,9,147,1096,9,180,112,198,189,310,1377,2344,4,11604,644,0,2,57,25,0
8688,24,968,373,158,315,8,0,51,381,5,76,44,79,81,123,486,779,2,2026,112,0,2,6,5,0
8689,43,1898,1178,367,1042,6,15,115,1184,9,94,51,95,103,146,644,976,4,4439,246,0,2,14,16,0
8690,61,2682,1943,715,1694,26,18,214,1969,12,185,120,237,197,357,1436,2721,7,20915,1161,0,2,50,28,0
8691,7,514,442,244,305,14,16,103,456,11,68,45,75,79,120,452,756,6,4588,254,0,2,13,5,0
8692,36,1381,1098,241,925,5,10,155,1103,7,46,25,49,53,74,273,423,3,1580,87,0,2,54,7,0
8693,166,3723,77,34,69,0,0,8,77,3,24,16,29,27,45,114,213,1,387,21,0,2,8,5,0
8694,166,3723,712,438,573,51,9,84,763,14,102,71,128,116,199,733,1364,8,11988,666,0,2,8,5,0
8695,63,2592,1289,550,1043,56,32,155,1345,10,167,93,185,177,278,1266,2075,5,11498,638,0,2,8,0,0
8696,166,3098,1513,682,1277,25,13,200,1538,11,199,116,219,210,335,1557,2584,6,15641,868,0,2,8,16,1
8697,166,3098,819,519,539,24,98,155,843,15,96,57,106,111,163,690,1107,8,9171,509,0,2,8,16,1
8698,118,4513,1513,682,1277,25,13,200,1538,11,199,116,219,210,335,1557,2584,6,15641,868,0,2,17,34,1
8699,164,3038,1513,682,1277,25,13,200,1538,11,199,116,219,210,335,1557,2584,6,15641,868,0,2,0,16,0
8700,164,3038,819,519,539,24,98,155,843,15,96,57,106,111,163,690,1107,8,9171,509,0,2,0,16,0
8701,113,4338,1513,682,1277,25,13,200,1538,11,199,116,219,210,335,1557,2584,6,15641,868,0,2,0,31,0
8702,161,3000,1513,682,1277,25,13,200,1538,11,199,116,219,210,335,1557,2584,6,15641,868,0,2,4,11,0
8703,161,3000,819,519,539,24,98,155,843,15,96,57,106,111,163,690,1107,8,9171,509,0,2,4,11,0
8704,112,4278,1513,682,1277,25,13,200,1538,11,199,116,219,210,335,1557,2584,6,15641,868,0,2,0,9,0
8705,161,3000,1513,682,1277,25,13,200,1538,11,199,116,219,210,335,1557,2584,6,15641,868,0,2,9,40,0
8706,161,3000,819,519,539,24,98,155,843,15,96,57,106,111,163,690,1107,8,9171,509,0,2,9,40,0
8707,112,4278,1513,682,1277,25,13,200,1538,11,199,116,219,210,335,1557,2584,6,15641,868,0,2,16,73,0
8708,112,2401,1043,504,840,53,9,147,1096,9,180,112,198,189,310,1377,2344,4,11604,644,0,2,3,4,1
8709,112,2401,383,288,292,26,6,62,409,11,65,38,67,76,105,429,656,5,3719,206,0,2,3,4,1
8710,49,1988,1043,504,840,53,9,147,1096,9,180,112,198,189,310,1377,2344,4,11604,644,0,2,0,14,1
8711,434,9721,72,33,56,0,4,12,72,1,1,1,1,2,2,0,2,0,1,0,0,2,9,9,1
8712,434,9721,1454,835,1044,76,110,219,1530,17,275,158,296,292,454,2297,3718,9,34017,1889,1,2,9,9,1
8713,124,5341,139,89,101,2,0,35,141,7,54,34,62,61,96,330,569,4,2287,127,0,2,1,0,1
8714,124,5341,7,5,5,0,0,2,7,1,2,1,2,3,3,2,4,0,2,0,0,2,1,0,1
8715,31,635,2,2,2,0,0,0,2,0,0,0,0,0,0,0,0,0,0,0,0,2,2,2,1
8716,31,635,99,48,90,1,3,5,100,0,0,0,0,0,0,0,0,0,0,0,0,2,2,2,1
8717,31,635,8,5,5,2,0,1,10,0,0,0,0,0,0,0,0,0,0,0,0,2,2,2,1
8718,31,635,1217,716,841,84,126,174,1301,14,185,118,215,199,333,1446,2542,8,20687,1149,0,2,2,2,1
8719,31,635,160,89,115,0,13,31,160,7,15,11,17,22,28,78,124,3,495,27,0,2,2,2,1
8720,31,635,10,10,9,9,0,0,19,0,0,0,0,0,0,0,0,0,0,0,0,2,2,2,1
8721,31,635,173,84,99,8,29,36,181,5,12,7,13,17,20,54,81,2,221,12,0,2,2,2,1
8722,31,635,3,1,1,3,0,0,6,0,0,0,0,0,0,0,0,0,0,0,0,2,2,2,1
8723,77,1715,477,336,357,30,23,73,507,16,194,134,250,210,384,1538,2962,10,30538,1696,0,2,7,1,1
8724,54,1893,1450,624,1228,12,26,181,1462,14,306,186,354,320,540,2580,4493,8,36391,2021,1,2,13,0,1
8725,116,2935,1660,832,1314,41,38,274,1701,20,312,209,395,332,604,2671,5058,12,64042,3557,1,2,1,1,0
8726,16,496,424,94,331,4,0,89,428,1,5,5,5,6,10,11,25,0,12,0,0,2,1,1,0
8727,14,565,722,423,573,19,0,135,741,12,172,101,199,184,300,1320,2257,6,15668,870,0,2,0,1,0
8728,24,966,373,158,315,8,0,51,381,5,76,44,79,81,123,486,779,2,2026,112,0,2,1,1,0
8729,7,512,442,244,305,14,16,103,456,11,68,45,75,79,120,452,756,6,4588,254,0,2,1,1,0
8730,114,4316,1513,682,1277,25,13,200,1538,11,199,116,219,210,335,1557,2584,6,15641,868,0,2,18,13,1
8731,63,2606,1289,550,1043,56,32,155,1345,10,167,93,185,177,278,1266,2075,5,11498,638,0,2,2,1,1
8732,7,528,442,244,305,14,16,103,456,11,68,45,75,79,120,452,756,6,4588,254,0,2,3,1,1
8733,13,442,42,7,35,4,0,5,46,1,2,1,2,3,3,2,4,0,2,0,0,2,1,1,1
8734,13,442,11,6,10,0,0,1,11,2,4,2,4,6,6,10,15,1,15,0,0,2,1,1,1
8735,116,2936,1660,832,1314,41,38,274,1701,20,312,209,395,332,604,2671,5058,12,64042,3557,1,2,2,2,1
8736,1,279,382,65,130,157,2,92,539,4,10,5,10,14,15,41,57,2,114,6,0,2,2,2,1
8737,13,442,42,7,35,4,0,5,46,1,2,1,2,3,3,2,4,0,2,0,0,2,1,1,1
8738,13,442,11,6,10,0,0,1,11,2,4,2,4,6,6,10,15,1,15,0,0,2,1,1,1
8739,114,4337,1513,682,1277,25,13,200,1538,11,199,116,219,210,335,1557,2584,6,15641,868,0,2,1,0,1
8740,114,4342,1513,682,1277,25,13,200,1538,11,199,116,219,210,335,1557,2584,6,15641,868,0,2,1,1,0
8741,438,9758,72,33,56,0,4,12,72,1,1,1,1,2,2,0,2,0,1,0,0,2,7,1,1
8742,438,9758,1454,835,1044,76,110,219,1530,17,275,158,296,292,454,2297,3718,9,34017,1889,1,2,7,1,1
8743,24,595,465,148,393,5,8,60,470,4,31,20,31,35,51,161,261,2,523,29,0,2,3,0,1
8744,24,595,16,12,9,0,0,6,16,1,2,1,2,3,3,2,4,0,2,0,0,2,3,0,1
8745,230,4698,1457,730,1242,11,6,188,1468,10,292,166,329,302,495,2424,4078,5,22973,1276,1,2,5,0,1
8746,230,4698,74,35,59,1,0,14,75,3,14,7,14,17,21,58,85,1,128,7,0,2,5,0,1
8747,230,4698,245,125,200,5,7,34,250,7,30,17,34,37,51,166,265,3,1053,58,0,2,5,0,1
8748,45,445,647,139,84,35,284,233,682,0,0,0,0,0,0,0,0,0,0,0,0,2,5,0,1
8749,168,3801,77,34,69,0,0,8,77,3,24,16,29,27,45,114,213,1,387,21,0,2,14,0,1
8750,168,3801,712,438,573,51,9,84,763,14,102,71,128,116,199,733,1364,8,11988,666,0,2,14,0,1
8751,169,3417,1943,715,1694,26,18,214,1969,12,185,120,237,197,357,1436,2721,7,20915,1161,0,2,27,1,1
8752,169,3417,1168,838,957,57,25,144,1225,19,348,224,416,367,640,3018,5452,11,61921,3440,1,2,27,1,1
8753,41,2014,1457,730,1242,11,6,188,1468,10,292,166,329,302,495,2424,4078,5,22973,1276,1,2,39,0,1
8754,435,9747,72,33,56,0,4,12,72,1,1,1,1,2,2,0,2,0,1,0,0,2,13,8,1
8755,435,9747,1454,835,1044,76,110,219,1530,17,275,158,296,292,454,2297,3718,9,34017,1889,1,2,13,8,1
8756,169,3417,1943,715,1694,26,18,214,1969,12,185,120,237,197,357,1436,2721,7,20915,1161,0,2,1,1,1
8757,169,3417,1168,838,957,57,25,144,1225,19,348,224,416,367,640,3018,5452,11,61921,3440,1,2,1,1,1
8758,63,2938,1338,495,1086,10,64,173,1348,11,122,82,157,133,239,883,1686,7,11934,663,0,2,18,7,1
8759,228,4658,1457,730,1242,11,6,188,1468,10,292,166,329,302,495,2424,4078,5,22973,1276,1,2,3,10,1
8760,228,4658,74,35,59,1,0,14,75,3,14,7,14,17,21,58,85,1,128,7,0,2,3,10,1
8761,228,4658,245,125,200,5,7,34,250,7,30,17,34,37,51,166,265,3,1053,58,0,2,3,10,1
8762,43,1133,74,35,59,1,0,14,75,3,14,7,14,17,21,58,85,1,128,7,0,2,2,1,1
8763,43,1133,245,125,200,5,7,34,250,7,30,17,34,37,51,166,265,3,1053,58,0,2,2,1,1
8764,166,3376,1943,715,1694,26,18,214,1969,12,185,120,237,197,357,1436,2721,7,20915,1161,0,2,0,6,1
8765,166,3376,1168,838,957,57,25,144,1225,19,348,224,416,367,640,3018,5452,11,61921,3440,1,2,0,6,1
8766,37,2191,334,251,279,10,4,40,344,5,127,74,143,132,217,899,1528,2,4303,239,0,2,0,10,1
8767,13,442,42,7,35,4,0,5,46,1,2,1,2,3,3,2,4,0,2,0,0,2,1,1,0
8768,13,442,11,6,10,0,0,1,11,2,4,2,4,6,6,10,15,1,15,0,0,2,1,1,0
8769,160,2985,1513,682,1277,25,13,200,1538,11,199,116,219,210,335,1557,2584,6,15641,868,0,2,1,7,0
8770,160,2985,819,519,539,24,98,155,843,15,96,57,106,111,163,690,1107,8,9171,509,0,2,1,7,0
8771,155,2896,1513,682,1277,25,13,200,1538,11,199,116,219,210,335,1557,2584,6,15641,868,0,2,8,20,1
8772,155,2896,819,519,539,24,98,155,843,15,96,57,106,111,163,690,1107,8,9171,509,0,2,8,20,1
8773,43,1314,1523,757,1297,19,12,193,1542,12,193,117,230,205,347,1508,2664,7,19053,1058,0,2,8,6,1
8774,43,1314,701,378,504,33,58,109,734,13,110,68,126,123,194,794,1346,7,10027,557,0,2,8,6,1
8775,171,3873,77,34,69,0,0,8,77,3,24,16,29,27,45,114,213,1,387,21,0,2,9,0,1
8776,171,3873,712,438,573,51,9,84,763,14,102,71,128,116,199,733,1364,8,11988,666,0,2,9,0,1
8777,24,594,1293,570,1093,25,15,163,1318,10,195,123,241,205,364,1516,2795,6,17273,959,0,2,2,2,1
8778,116,2461,1043,504,840,53,9,147,1096,9,180,112,198,189,310,1377,2344,4,11604,644,0,2,11,3,1
8779,116,2461,383,288,292,26,6,62,409,11,65,38,67,76,105,429,656,5,3719,206,0,2,11,3,1
8780,114,4342,1513,682,1277,25,13,200,1538,11,199,116,219,210,335,1557,2584,6,15641,868,0,2,2,2,1
8781,39,2415,1523,757,1297,19,12,193,1542,12,193,117,230,205,347,1508,2664,7,19053,1058,0,2,3,1,1
8782,161,3047,1513,682,1277,25,13,200,1538,11,199,116,219,210,335,1557,2584,6,15641,868,0,2,105,68,1
8783,161,3047,819,519,539,24,98,155,843,15,96,57,106,111,163,690,1107,8,9171,509,0,2,105,68,1
8784,230,4686,1457,730,1242,11,6,188,1468,10,292,166,329,302,495,2424,4078,5,22973,1276,1,2,12,5,1
8785,230,4686,74,35,59,1,0,14,75,3,14,7,14,17,21,58,85,1,128,7,0,2,12,5,1
8786,230,4686,245,125,200,5,7,34,250,7,30,17,34,37,51,166,265,3,1053,58,0,2,12,5,1
8787,43,1146,74,35,59,1,0,14,75,3,14,7,14,17,21,58,85,1,128,7,0,2,3,1,1
8788,43,1146,245,125,200,5,7,34,250,7,30,17,34,37,51,166,265,3,1053,58,0,2,3,1,1
8789,67,1214,1020,354,843,12,15,144,1032,8,134,77,144,142,221,970,1580,4,6792,377,0,2,1,1,1
8790,25,602,1293,570,1093,25,15,163,1318,10,195,123,241,205,364,1516,2795,6,17273,959,0,2,11,11,1
8791,435,9745,72,33,56,0,4,12,72,1,1,1,1,2,2,0,2,0,1,0,0,2,1,1,1
8792,435,9745,1454,835,1044,76,110,219,1530,17,275,158,296,292,454,2297,3718,9,34017,1889,1,2,1,1,1
8793,114,2464,1043,504,840,53,9,147,1096,9,180,112,198,189,310,1377,2344,4,11604,644,0,2,8,8,1
8794,114,2464,383,288,292,26,6,62,409,11,65,38,67,76,105,429,656,5,3719,206,0,2,8,8,1
8795,167,3404,1943,715,1694,26,18,214,1969,12,185,120,237,197,357,1436,2721,7,20915,1161,0,2,9,1,1
8796,167,3404,1168,838,957,57,25,144,1225,19,348,224,416,367,640,3018,5452,11,61921,3440,1,2,9,1,1
8797,114,4350,1513,682,1277,25,13,200,1538,11,199,116,219,210,335,1557,2584,6,15641,868,0,2,27,23,1
8798,21,559,1293,570,1093,25,15,163,1318,10,195,123,241,205,364,1516,2795,6,17273,959,0,2,8,21,1
8799,168,3795,77,34,69,0,0,8,77,3,24,16,29,27,45,114,213,1,387,21,0,2,0,4,1
8800,168,3795,712,438,573,51,9,84,763,14,102,71,128,116,199,733,1364,8,11988,666,0,2,0,4,1
8801,24,382,424,94,331,4,0,89,428,1,5,5,5,6,10,11,25,0,12,0,0,2,20,10,1
8802,24,382,38,23,23,6,0,8,44,3,11,7,11,14,18,42,68,1,102,5,0,2,20,10,1
8803,112,2415,1043,504,840,53,9,147,1096,9,180,112,198,189,310,1377,2344,4,11604,644,0,2,3,1,1
8804,112,2415,383,288,292,26,6,62,409,11,65,38,67,76,105,429,656,5,3719,206,0,2,3,1,1
8805,17,540,424,94,331,4,0,89,428,1,5,5,5,6,10,11,25,0,12,0,0,2,15,1,1
8806,168,3793,77,34,69,0,0,8,77,3,24,16,29,27,45,114,213,1,387,21,0,2,1,1,1
8807,168,3793,712,438,573,51,9,84,763,14,102,71,128,116,199,733,1364,8,11988,666,0,2,1,1,1
8808,63,2936,1338,495,1086,10,64,173,1348,11,122,82,157,133,239,883,1686,7,11934,663,0,2,1,1,1
8809,23,373,424,94,331,4,0,89,428,1,5,5,5,6,10,11,25,0,12,0,0,2,5,10,1
8810,23,373,38,23,23,6,0,8,44,3,11,7,11,14,18,42,68,1,102,5,0,2,5,10,1
8811,168,3793,77,34,69,0,0,8,77,3,24,16,29,27,45,114,213,1,387,21,0,2,1,5,0
8812,168,3793,712,438,573,51,9,84,763,14,102,71,128,116,199,733,1364,8,11988,666,0,2,1,5,0
8813,23,373,424,94,331,4,0,89,428,1,5,5,5,6,10,11,25,0,12,0,0,2,19,14,0
8814,23,373,38,23,23,6,0,8,44,3,11,7,11,14,18,42,68,1,102,5,0,2,19,14,0
8815,112,2415,1043,504,840,53,9,147,1096,9,180,112,198,189,310,1377,2344,4,11604,644,0,2,3,1,0
8816,112,2415,383,288,292,26,6,62,409,11,65,38,67,76,105,429,656,5,3719,206,0,2,3,1,0
8817,63,2936,1338,495,1086,10,64,173,1348,11,122,82,157,133,239,883,1686,7,11934,663,0,2,1,1,0
8818,17,540,424,94,331,4,0,89,428,1,5,5,5,6,10,11,25,0,12,0,0,2,15,1,0
8819,161,3043,1513,682,1277,25,13,200,1538,11,199,116,219,210,335,1557,2584,6,15641,868,0,2,5,6,1
8820,161,3043,819,519,539,24,98,155,843,15,96,57,106,111,163,690,1107,8,9171,509,0,2,5,6,1
8821,45,445,647,139,84,35,284,233,682,0,0,0,0,0,0,0,0,0,0,0,0,2,2,2,1
8822,438,9764,72,33,56,0,4,12,72,1,1,1,1,2,2,0,2,0,1,0,0,2,3,3,1
8823,438,9764,1454,835,1044,76,110,219,1530,17,275,158,296,292,454,2297,3718,9,34017,1889,1,2,3,3,1
8824,438,9769,72,33,56,0,4,12,72,1,1,1,1,2,2,0,2,0,1,0,0,2,3,3,1
8825,438,9769,1454,835,1044,76,110,219,1530,17,275,158,296,292,454,2297,3718,9,34017,1889,1,2,3,3,1
8826,228,4665,1457,730,1242,11,6,188,1468,10,292,166,329,302,495,2424,4078,5,22973,1276,1,2,1,1,1
8827,228,4665,74,35,59,1,0,14,75,3,14,7,14,17,21,58,85,1,128,7,0,2,1,1,1
8828,228,4665,245,125,200,5,7,34,250,7,30,17,34,37,51,166,265,3,1053,58,0,2,1,1,1
8829,228,4665,1457,730,1242,11,6,188,1468,10,292,166,329,302,495,2424,4078,5,22973,1276,1,2,1,1,0
8830,228,4665,74,35,59,1,0,14,75,3,14,7,14,17,21,58,85,1,128,7,0,2,1,1,0
8831,228,4665,245,125,200,5,7,34,250,7,30,17,34,37,51,166,265,3,1053,58,0,2,1,1,0
8832,439,9795,72,33,56,0,4,12,72,1,1,1,1,2,2,0,2,0,1,0,0,2,7,1,0
8833,439,9795,1454,835,1044,76,110,219,1530,17,275,158,296,292,454,2297,3718,9,34017,1889,1,2,7,1,0
8834,24,595,465,148,393,5,8,60,470,4,31,20,31,35,51,161,261,2,523,29,0,2,3,0,0
8835,24,595,16,12,9,0,0,6,16,1,2,1,2,3,3,2,4,0,2,0,0,2,3,0,0
8836,24,595,465,148,393,5,8,60,470,4,31,20,31,35,51,161,261,2,523,29,0,2,2,1,0
8837,24,595,16,12,9,0,0,6,16,1,2,1,2,3,3,2,4,0,2,0,0,2,2,1,0
8838,115,4390,1513,682,1277,25,13,200,1538,11,199,116,219,210,335,1557,2584,6,15641,868,0,2,18,0,0
8839,230,4693,1457,730,1242,11,6,188,1468,10,292,166,329,302,495,2424,4078,5,22973,1276,1,2,1,1,0
8840,230,4693,74,35,59,1,0,14,75,3,14,7,14,17,21,58,85,1,128,7,0,2,1,1,0
8841,230,4693,245,125,200,5,7,34,250,7,30,17,34,37,51,166,265,3,1053,58,0,2,1,1,0
8842,45,445,647,139,84,35,284,233,682,0,0,0,0,0,0,0,0,0,0,0,0,2,2,2,0
8843,171,3865,77,34,69,0,0,8,77,3,24,16,29,27,45,114,213,1,387,21,0,2,1,5,0
8844,171,3865,712,438,573,51,9,84,763,14,102,71,128,116,199,733,1364,8,11988,666,0,2,1,5,0
8845,23,373,424,94,331,4,0,89,428,1,5,5,5,6,10,11,25,0,12,0,0,2,19,14,0
8846,23,373,38,23,23,6,0,8,44,3,11,7,11,14,18,42,68,1,102,5,0,2,19,14,0
8847,439,9793,72,33,56,0,4,12,72,1,1,1,1,2,2,0,2,0,1,0,0,2,7,1,0
8848,439,9793,1454,835,1044,76,110,219,1530,17,275,158,296,292,454,2297,3718,9,34017,1889,1,2,7,1,0
8849,114,2478,1043,504,840,53,9,147,1096,9,180,112,198,189,310,1377,2344,4,11604,644,0,2,3,1,0
8850,114,2478,383,288,292,26,6,62,409,11,65,38,67,76,105,429,656,5,3719,206,0,2,3,1,0
8851,63,2936,1338,495,1086,10,64,173,1348,11,122,82,157,133,239,883,1686,7,11934,663,0,2,1,1,0
8852,24,595,465,148,393,5,8,60,470,4,31,20,31,35,51,161,261,2,523,29,0,2,4,0,0
8853,24,595,16,12,9,0,0,6,16,1,2,1,2,3,3,2,4,0,2,0,0,2,4,0,0
8854,115,4398,1513,682,1277,25,13,200,1538,11,199,116,219,210,335,1557,2584,6,15641,868,0,2,18,0,0
8855,17,540,424,94,331,4,0,89,428,1,5,5,5,6,10,11,25,0,12,0,0,2,15,1,0
8856,115,4399,1513,682,1277,25,13,200,1538,11,199,116,219,210,335,1557,2584,6,15641,868,0,2,1,1,0
8857,54,1027,1098,241,925,5,10,155,1103,7,46,25,49,53,74,273,423,3,1580,87,0,2,1,1,0
8858,54,1027,282,202,222,14,2,44,296,8,42,24,43,50,67,250,378,4,1548,86,0,2,1,1,0
8859,159,2935,1513,682,1277,25,13,200,1538,11,199,116,219,210,335,1557,2584,6,15641,868,0,2,6,29,1
8860,159,2935,819,519,539,24,98,155,843,15,96,57,106,111,163,690,1107,8,9171,509,0,2,6,29,1
8861,112,4283,1513,682,1277,25,13,200,1538,11,199,116,219,210,335,1557,2584,6,15641,868,0,2,3,25,1
8862,133,2539,1513,682,1277,25,13,200,1538,11,199,116,219,210,335,1557,2584,6,15641,868,0,2,105,195,1
8863,133,2539,819,519,539,24,98,155,843,15,96,57,106,111,163,690,1107,8,9171,509,0,2,105,195,1
8864,111,4191,1513,682,1277,25,13,200,1538,11,199,116,219,210,335,1557,2584,6,15641,868,0,2,24,35,1
8865,127,2479,1513,682,1277,25,13,200,1538,11,199,116,219,210,335,1557,2584,6,15641,868,0,2,49,59,1
8866,127,2479,819,519,539,24,98,155,843,15,96,57,106,111,163,690,1107,8,9171,509,0,2,49,59,1
8867,112,4213,1513,682,1277,25,13,200,1538,11,199,116,219,210,335,1557,2584,6,15641,868,0,2,54,39,1
8868,122,2423,1513,682,1277,25,13,200,1538,11,199,116,219,210,335,1557,2584,6,15641,868,0,2,23,39,1
8869,122,2423,819,519,539,24,98,155,843,15,96,57,106,111,163,690,1107,8,9171,509,0,2,23,39,1
8870,110,4169,1513,682,1277,25,13,200,1538,11,199,116,219,210,335,1557,2584,6,15641,868,0,2,62,79,1
8871,32,641,2,2,2,0,0,0,2,0,0,0,0,0,0,0,0,0,0,0,0,2,1,1,0
8872,32,641,99,48,90,1,3,5,100,0,0,0,0,0,0,0,0,0,0,0,0,2,1,1,0
8873,32,641,8,5,5,2,0,1,10,0,0,0,0,0,0,0,0,0,0,0,0,2,1,1,0
8874,32,641,1217,716,841,84,126,174,1301,14,185,118,215,199,333,1446,2542,8,20687,1149,0,2,1,1,0
8875,32,641,160,89,115,0,13,31,160,7,15,11,17,22,28,78,124,3,495,27,0,2,1,1,0
8876,32,641,10,10,9,9,0,0,19,0,0,0,0,0,0,0,0,0,0,0,0,2,1,1,0
8877,32,641,173,84,99,8,29,36,181,5,12,7,13,17,20,54,81,2,221,12,0,2,1,1,0
8878,32,641,3,1,1,3,0,0,6,0,0,0,0,0,0,0,0,0,0,0,0,2,1,1,0
8879,117,2976,1660,832,1314,41,38,274,1701,20,312,209,395,332,604,2671,5058,12,64042,3557,1,2,16,0,0
8880,117,2960,1660,832,1314,41,38,274,1701,20,312,209,395,332,604,2671,5058,12,64042,3557,1,2,3,13,0
8881,32,641,2,2,2,0,0,0,2,0,0,0,0,0,0,0,0,0,0,0,0,2,1,1,0
8882,32,641,99,48,90,1,3,5,100,0,0,0,0,0,0,0,0,0,0,0,0,2,1,1,0
8883,32,641,8,5,5,2,0,1,10,0,0,0,0,0,0,0,0,0,0,0,0,2,1,1,0
8884,32,641,1217,716,841,84,126,174,1301,14,185,118,215,199,333,1446,2542,8,20687,1149,0,2,1,1,0
8885,32,641,160,89,115,0,13,31,160,7,15,11,17,22,28,78,124,3,495,27,0,2,1,1,0
8886,32,641,10,10,9,9,0,0,19,0,0,0,0,0,0,0,0,0,0,0,0,2,1,1,0
8887,32,641,173,84,99,8,29,36,181,5,12,7,13,17,20,54,81,2,221,12,0,2,1,1,0
8888,32,641,3,1,1,3,0,0,6,0,0,0,0,0,0,0,0,0,0,0,0,2,1,1,0
8889,117,2960,1660,832,1314,41,38,274,1701,20,312,209,395,332,604,2671,5058,12,64042,3557,1,2,6,0,0
8890,122,2423,1513,682,1277,25,13,200,1538,11,199,116,219,210,335,1557,2584,6,15641,868,0,2,209,330,0
8891,122,2423,819,519,539,24,98,155,843,15,96,57,106,111,163,690,1107,8,9171,509,0,2,209,330,0
8892,230,4693,1457,730,1242,11,6,188,1468,10,292,166,329,302,495,2424,4078,5,22973,1276,1,2,12,5,0
8893,230,4693,74,35,59,1,0,14,75,3,14,7,14,17,21,58,85,1,128,7,0,2,12,5,0
8894,230,4693,245,125,200,5,7,34,250,7,30,17,34,37,51,166,265,3,1053,58,0,2,12,5,0
8895,43,1146,74,35,59,1,0,14,75,3,14,7,14,17,21,58,85,1,128,7,0,2,3,1,0
8896,43,1146,245,125,200,5,7,34,250,7,30,17,34,37,51,166,265,3,1053,58,0,2,3,1,0
8897,43,1314,1523,757,1297,19,12,193,1542,12,193,117,230,205,347,1508,2664,7,19053,1058,0,2,8,6,0
8898,43,1314,701,378,504,33,58,109,734,13,110,68,126,123,194,794,1346,7,10027,557,0,2,8,6,0
8899,171,3865,77,34,69,0,0,8,77,3,24,16,29,27,45,114,213,1,387,21,0,2,9,0,0
8900,171,3865,712,438,573,51,9,84,763,14,102,71,128,116,199,733,1364,8,11988,666,0,2,9,0,0
8901,67,1214,1020,354,843,12,15,144,1032,8,134,77,144,142,221,970,1580,4,6792,377,0,2,1,1,0
8902,21,559,1293,570,1093,25,15,163,1318,10,195,123,241,205,364,1516,2795,6,17273,959,0,2,12,25,0
8903,439,9793,72,33,56,0,4,12,72,1,1,1,1,2,2,0,2,0,1,0,0,2,1,1,0
8904,439,9793,1454,835,1044,76,110,219,1530,17,275,158,296,292,454,2297,3718,9,34017,1889,1,2,1,1,0
8905,114,2478,1043,504,840,53,9,147,1096,9,180,112,198,189,310,1377,2344,4,11604,644,0,2,19,11,0
8906,114,2478,383,288,292,26,6,62,409,11,65,38,67,76,105,429,656,5,3719,206,0,2,19,11,0
8907,167,3404,1943,715,1694,26,18,214,1969,12,185,120,237,197,357,1436,2721,7,20915,1161,0,2,9,1,0
8908,167,3404,1168,838,957,57,25,144,1225,19,348,224,416,367,640,3018,5452,11,61921,3440,1,2,9,1,0
8909,110,4178,1513,682,1277,25,13,200,1538,11,199,116,219,210,335,1557,2584,6,15641,868,0,2,134,165,0
8910,39,2415,1523,757,1297,19,12,193,1542,12,193,117,230,205,347,1508,2664,7,19053,1058,0,2,3,1,0
8911,118,2308,1513,682,1277,25,13,200,1538,11,199,116,219,210,335,1557,2584,6,15641,868,0,2,5,26,1
8912,118,2308,819,519,539,24,98,155,843,15,96,57,106,111,163,690,1107,8,9171,509,0,2,5,26,1
8913,110,4160,1513,682,1277,25,13,200,1538,11,199,116,219,210,335,1557,2584,6,15641,868,0,2,9,8,1
8914,116,2252,1513,682,1277,25,13,200,1538,11,199,116,219,210,335,1557,2584,6,15641,868,0,2,23,42,1
8915,116,2252,819,519,539,24,98,155,843,15,96,57,106,111,163,690,1107,8,9171,509,0,2,23,42,1
8916,168,3427,1943,715,1694,26,18,214,1969,12,185,120,237,197,357,1436,2721,7,20915,1161,0,2,4,2,1
8917,168,3427,1168,838,957,57,25,144,1225,19,348,224,416,367,640,3018,5452,11,61921,3440,1,2,4,2,1
8918,110,4131,1513,682,1277,25,13,200,1538,11,199,116,219,210,335,1557,2584,6,15641,868,0,2,12,17,1
8919,54,1027,1098,241,925,5,10,155,1103,7,46,25,49,53,74,273,423,3,1580,87,0,2,1,1,0
8920,54,1027,282,202,222,14,2,44,296,8,42,24,43,50,67,250,378,4,1548,86,0,2,1,1,0
8921,198,4464,722,423,573,19,0,135,741,12,172,101,199,184,300,1320,2257,6,15668,870,0,2,8,2,1
8922,198,4464,1508,847,911,44,250,301,1552,14,148,88,169,162,257,1120,1886,7,15077,837,0,2,8,2,1
8923,117,2950,1660,832,1314,41,38,274,1701,20,312,209,395,332,604,2671,5058,12,64042,3557,1,2,15,14,1
8924,117,2932,1660,832,1314,41,38,274,1701,20,312,209,395,332,604,2671,5058,12,64042,3557,1,2,6,6,0
8925,115,4404,1513,682,1277,25,13,200,1538,11,199,116,219,210,335,1557,2584,6,15641,868,0,2,3,2,0
8926,116,2252,1513,682,1277,25,13,200,1538,11,199,116,219,210,335,1557,2584,6,15641,868,0,2,5,5,0
8927,116,2252,819,519,539,24,98,155,843,15,96,57,106,111,163,690,1107,8,9171,509,0,2,5,5,0
8928,111,4160,1513,682,1277,25,13,200,1538,11,199,116,219,210,335,1557,2584,6,15641,868,0,2,23,4,0
8929,118,2356,1513,682,1277,25,13,200,1538,11,199,116,219,210,335,1557,2584,6,15641,868,0,2,46,25,1
8930,118,2356,819,519,539,24,98,155,843,15,96,57,106,111,163,690,1107,8,9171,509,0,2,46,25,1
8931,114,4320,1513,682,1277,25,13,200,1538,11,199,116,219,210,335,1557,2584,6,15641,868,0,2,32,6,1
8932,122,2415,1513,682,1277,25,13,200,1538,11,199,116,219,210,335,1557,2584,6,15641,868,0,2,19,11,0
8933,122,2415,819,519,539,24,98,155,843,15,96,57,106,111,163,690,1107,8,9171,509,0,2,19,11,0
8934,64,2630,1289,550,1043,56,32,155,1345,10,167,93,185,177,278,1266,2075,5,11498,638,0,2,6,0,0
8935,114,2276,1513,682,1277,25,13,200,1538,11,199,116,219,210,335,1557,2584,6,15641,868,0,2,49,79,1
8936,114,2276,819,519,539,24,98,155,843,15,96,57,106,111,163,690,1107,8,9171,509,0,2,49,79,1
8937,21,564,1293,570,1093,25,15,163,1318,10,195,123,241,205,364,1516,2795,6,17273,959,0,2,3,3,1
8938,109,4150,1513,682,1277,25,13,200,1538,11,199,116,219,210,335,1557,2584,6,15641,868,0,2,26,51,1
8939,29,1113,1293,570,1093,25,15,163,1318,10,195,123,241,205,364,1516,2795,6,17273,959,0,2,20,0,1
8940,114,2255,1513,682,1277,25,13,200,1538,11,199,116,219,210,335,1557,2584,6,15641,868,0,2,15,20,1
8941,114,2255,819,519,539,24,98,155,843,15,96,57,106,111,163,690,1107,8,9171,509,0,2,15,20,1
8942,43,1133,74,35,59,1,0,14,75,3,14,7,14,17,21,58,85,1,128,7,0,2,1,3,1
8943,43,1133,245,125,200,5,7,34,250,7,30,17,34,37,51,166,265,3,1053,58,0,2,1,3,1
8944,67,1216,1020,354,843,12,15,144,1032,8,134,77,144,142,221,970,1580,4,6792,377,0,2,1,1,1
8945,439,9795,72,33,56,0,4,12,72,1,1,1,1,2,2,0,2,0,1,0,0,2,1,1,1
8946,439,9795,1454,835,1044,76,110,219,1530,17,275,158,296,292,454,2297,3718,9,34017,1889,1,2,1,1,1
8947,167,3399,1943,715,1694,26,18,214,1969,12,185,120,237,197,357,1436,2721,7,20915,1161,0,2,1,10,1
8948,167,3399,1168,838,957,57,25,144,1225,19,348,224,416,367,640,3018,5452,11,61921,3440,1,2,1,10,1
8949,54,1027,1098,241,925,5,10,155,1103,7,46,25,49,53,74,273,423,3,1580,87,0,2,1,1,0
8950,54,1027,282,202,222,14,2,44,296,8,42,24,43,50,67,250,378,4,1548,86,0,2,1,1,0
8951,38,647,127,75,83,2,11,30,129,4,14,7,14,18,21,61,87,2,175,9,0,2,21,5,0
8952,38,647,652,304,544,16,6,88,668,6,89,51,101,95,152,591,998,3,3399,188,0,2,21,5,0
8953,38,647,2,2,2,0,0,0,2,0,0,0,0,0,0,0,0,0,0,0,0,2,21,5,0
8954,38,647,8,5,5,0,0,3,8,0,0,0,0,0,0,0,0,0,0,0,0,2,21,5,0
8955,38,647,2,2,2,0,0,0,2,0,0,0,0,0,0,0,0,0,0,0,0,2,21,5,0
8956,38,647,14,8,8,0,0,6,14,0,0,0,0,0,0,0,0,0,0,0,0,2,21,5,0
8957,38,647,6,4,4,0,0,2,6,0,0,0,0,0,0,0,0,0,0,0,0,2,21,5,0
8958,38,647,6,4,4,0,0,2,6,1,2,1,2,3,3,2,4,0,2,0,0,2,21,5,0
8959,38,647,6,4,4,0,0,2,6,0,0,0,0,0,0,0,0,0,0,0,0,2,21,5,0
8960,38,647,7,5,5,0,0,2,7,0,0,0,0,0,0,0,0,0,0,0,0,2,21,5,0
8961,38,647,6,4,4,0,0,2,6,0,0,0,0,0,0,0,0,0,0,0,0,2,21,5,0
8962,38,647,10,6,6,0,0,4,10,0,0,0,0,0,0,0,0,0,0,0,0,2,21,5,0
8963,38,647,1,1,1,0,0,0,1,0,0,0,0,0,0,0,0,0,0,0,0,2,21,5,0
8964,38,647,1,1,1,0,0,0,1,0,0,0,0,0,0,0,0,0,0,0,0,2,21,5,0
8965,38,647,14,10,10,0,0,4,14,1,1,1,1,2,2,0,2,0,1,0,0,2,21,5,0
8966,38,647,46,26,30,3,0,12,49,3,6,3,6,9,9,20,28,1,42,2,0,2,21,5,0
8967,46,790,127,75,83,2,11,30,129,4,14,7,14,18,21,61,87,2,175,9,0,2,24,8,0
8968,46,790,652,304,544,16,6,88,668,6,89,51,101,95,152,591,998,3,3399,188,0,2,24,8,0
8969,46,790,2,2,2,0,0,0,2,0,0,0,0,0,0,0,0,0,0,0,0,2,24,8,0
8970,46,790,8,5,5,0,0,3,8,0,0,0,0,0,0,0,0,0,0,0,0,2,24,8,0
8971,46,790,2,2,2,0,0,0,2,0,0,0,0,0,0,0,0,0,0,0,0,2,24,8,0
8972,46,790,14,8,8,0,0,6,14,0,0,0,0,0,0,0,0,0,0,0,0,2,24,8,0
8973,46,790,6,4,4,0,0,2,6,0,0,0,0,0,0,0,0,0,0,0,0,2,24,8,0
8974,46,790,6,4,4,0,0,2,6,1,2,1,2,3,3,2,4,0,2,0,0,2,24,8,0
8975,46,790,6,4,4,0,0,2,6,0,0,0,0,0,0,0,0,0,0,0,0,2,24,8,0
8976,46,790,7,5,5,0,0,2,7,0,0,0,0,0,0,0,0,0,0,0,0,2,24,8,0
8977,46,790,6,4,4,0,0,2,6,0,0,0,0,0,0,0,0,0,0,0,0,2,24,8,0
8978,46,790,10,6,6,0,0,4,10,0,0,0,0,0,0,0,0,0,0,0,0,2,24,8,0
8979,46,790,1,1,1,0,0,0,1,0,0,0,0,0,0,0,0,0,0,0,0,2,24,8,0
8980,46,790,1,1,1,0,0,0,1,0,0,0,0,0,0,0,0,0,0,0,0,2,24,8,0
8981,46,790,14,10,10,0,0,4,14,1,1,1,1,2,2,0,2,0,1,0,0,2,24,8,0
8982,46,790,46,26,30,3,0,12,49,3,6,3,6,9,9,20,28,1,42,2,0,2,24,8,0
8983,38,718,127,75,83,2,11,30,129,4,14,7,14,18,21,61,87,2,175,9,0,2,3,12,0
8984,38,718,652,304,544,16,6,88,668,6,89,51,101,95,152,591,998,3,3399,188,0,2,3,12,0
8985,38,718,2,2,2,0,0,0,2,0,0,0,0,0,0,0,0,0,0,0,0,2,3,12,0
8986,38,718,8,5,5,0,0,3,8,0,0,0,0,0,0,0,0,0,0,0,0,2,3,12,0
8987,38,718,2,2,2,0,0,0,2,0,0,0,0,0,0,0,0,0,0,0,0,2,3,12,0
8988,38,718,14,8,8,0,0,6,14,0,0,0,0,0,0,0,0,0,0,0,0,2,3,12,0
8989,38,718,6,4,4,0,0,2,6,0,0,0,0,0,0,0,0,0,0,0,0,2,3,12,0
8990,38,718,6,4,4,0,0,2,6,1,2,1,2,3,3,2,4,0,2,0,0,2,3,12,0
8991,38,718,6,4,4,0,0,2,6,0,0,0,0,0,0,0,0,0,0,0,0,2,3,12,0
8992,38,718,7,5,5,0,0,2,7,0,0,0,0,0,0,0,0,0,0,0,0,2,3,12,0
8993,38,718,6,4,4,0,0,2,6,0,0,0,0,0,0,0,0,0,0,0,0,2,3,12,0
8994,38,718,10,6,6,0,0,4,10,0,0,0,0,0,0,0,0,0,0,0,0,2,3,12,0
8995,38,718,1,1,1,0,0,0,1,0,0,0,0,0,0,0,0,0,0,0,0,2,3,12,0
8996,38,718,1,1,1,0,0,0,1,0,0,0,0,0,0,0,0,0,0,0,0,2,3,12,0
8997,38,718,14,10,10,0,0,4,14,1,1,1,1,2,2,0,2,0,1,0,0,2,3,12,0
8998,38,718,46,26,30,3,0,12,49,3,6,3,6,9,9,20,28,1,42,2,0,2,3,12,0
8999,38,712,127,75,83,2,11,30,129,4,14,7,14,18,21,61,87,2,175,9,0,2,2,2,0
9000,38,712,652,304,544,16,6,88,668,6,89,51,101,95,152,591,998,3,3399,188,0,2,2,2,0
9001,38,712,2,2,2,0,0,0,2,0,0,0,0,0,0,0,0,0,0,0,0,2,2,2,0
9002,38,712,8,5,5,0,0,3,8,0,0,0,0,0,0,0,0,0,0,0,0,2,2,2,0
9003,38,712,2,2,2,0,0,0,2,0,0,0,0,0,0,0,0,0,0,0,0,2,2,2,0
9004,38,712,14,8,8,0,0,6,14,0,0,0,0,0,0,0,0,0,0,0,0,2,2,2,0
9005,38,712,6,4,4,0,0,2,6,0,0,0,0,0,0,0,0,0,0,0,0,2,2,2,0
9006,38,712,6,4,4,0,0,2,6,1,2,1,2,3,3,2,4,0,2,0,0,2,2,2,0
9007,38,712,6,4,4,0,0,2,6,0,0,0,0,0,0,0,0,0,0,0,0,2,2,2,0
9008,38,712,7,5,5,0,0,2,7,0,0,0,0,0,0,0,0,0,0,0,0,2,2,2,0
9009,38,712,6,4,4,0,0,2,6,0,0,0,0,0,0,0,0,0,0,0,0,2,2,2,0
9010,38,712,10,6,6,0,0,4,10,0,0,0,0,0,0,0,0,0,0,0,0,2,2,2,0
9011,38,712,1,1,1,0,0,0,1,0,0,0,0,0,0,0,0,0,0,0,0,2,2,2,0
9012,38,712,1,1,1,0,0,0,1,0,0,0,0,0,0,0,0,0,0,0,0,2,2,2,0
9013,38,712,14,10,10,0,0,4,14,1,1,1,1,2,2,0,2,0,1,0,0,2,2,2,0
9014,38,712,46,26,30,3,0,12,49,3,6,3,6,9,9,20,28,1,42,2,0,2,2,2,0
9015,38,712,127,75,83,2,11,30,129,4,14,7,14,18,21,61,87,2,175,9,0,2,43,20,0
9016,38,712,652,304,544,16,6,88,668,6,89,51,101,95,152,591,998,3,3399,188,0,2,43,20,0
9017,38,712,2,2,2,0,0,0,2,0,0,0,0,0,0,0,0,0,0,0,0,2,43,20,0
9018,38,712,8,5,5,0,0,3,8,0,0,0,0,0,0,0,0,0,0,0,0,2,43,20,0
9019,38,712,2,2,2,0,0,0,2,0,0,0,0,0,0,0,0,0,0,0,0,2,43,20,0
9020,38,712,14,8,8,0,0,6,14,0,0,0,0,0,0,0,0,0,0,0,0,2,43,20,0
9021,38,712,6,4,4,0,0,2,6,0,0,0,0,0,0,0,0,0,0,0,0,2,43,20,0
9022,38,712,6,4,4,0,0,2,6,1,2,1,2,3,3,2,4,0,2,0,0,2,43,20,0
9023,38,712,6,4,4,0,0,2,6,0,0,0,0,0,0,0,0,0,0,0,0,2,43,20,0
9024,38,712,7,5,5,0,0,2,7,0,0,0,0,0,0,0,0,0,0,0,0,2,43,20,0
9025,38,712,6,4,4,0,0,2,6,0,0,0,0,0,0,0,0,0,0,0,0,2,43,20,0
9026,38,712,10,6,6,0,0,4,10,0,0,0,0,0,0,0,0,0,0,0,0,2,43,20,0
9027,38,712,1,1,1,0,0,0,1,0,0,0,0,0,0,0,0,0,0,0,0,2,43,20,0
9028,38,712,1,1,1,0,0,0,1,0,0,0,0,0,0,0,0,0,0,0,0,2,43,20,0
9029,38,712,14,10,10,0,0,4,14,1,1,1,1,2,2,0,2,0,1,0,0,2,43,20,0
9030,38,712,46,26,30,3,0,12,49,3,6,3,6,9,9,20,28,1,42,2,0,2,43,20,0
9031,109,4155,1513,682,1277,25,13,200,1538,11,199,116,219,210,335,1557,2584,6,15641,868,0,2,3,2,0
9032,38,712,127,75,83,2,11,30,129,4,14,7,14,18,21,61,87,2,175,9,0,2,1,1,0
9033,38,712,652,304,544,16,6,88,668,6,89,51,101,95,152,591,998,3,3399,188,0,2,1,1,0
9034,38,712,2,2,2,0,0,0,2,0,0,0,0,0,0,0,0,0,0,0,0,2,1,1,0
9035,38,712,8,5,5,0,0,3,8,0,0,0,0,0,0,0,0,0,0,0,0,2,1,1,0
9036,38,712,2,2,2,0,0,0,2,0,0,0,0,0,0,0,0,0,0,0,0,2,1,1,0
9037,38,712,14,8,8,0,0,6,14,0,0,0,0,0,0,0,0,0,0,0,0,2,1,1,0
9038,38,712,6,4,4,0,0,2,6,0,0,0,0,0,0,0,0,0,0,0,0,2,1,1,0
9039,38,712,6,4,4,0,0,2,6,1,2,1,2,3,3,2,4,0,2,0,0,2,1,1,0
9040,38,712,6,4,4,0,0,2,6,0,0,0,0,0,0,0,0,0,0,0,0,2,1,1,0
9041,38,712,7,5,5,0,0,2,7,0,0,0,0,0,0,0,0,0,0,0,0,2,1,1,0
9042,38,712,6,4,4,0,0,2,6,0,0,0,0,0,0,0,0,0,0,0,0,2,1,1,0
9043,38,712,10,6,6,0,0,4,10,0,0,0,0,0,0,0,0,0,0,0,0,2,1,1,0
9044,38,712,1,1,1,0,0,0,1,0,0,0,0,0,0,0,0,0,0,0,0,2,1,1,0
9045,38,712,1,1,1,0,0,0,1,0,0,0,0,0,0,0,0,0,0,0,0,2,1,1,0
9046,38,712,14,10,10,0,0,4,14,1,1,1,1,2,2,0,2,0,1,0,0,2,1,1,0
9047,38,712,46,26,30,3,0,12,49,3,6,3,6,9,9,20,28,1,42,2,0,2,1,1,0
9048,114,2252,1513,682,1277,25,13,200,1538,11,199,116,219,210,335,1557,2584,6,15641,868,0,2,1,1,1
9049,114,2252,819,519,539,24,98,155,843,15,96,57,106,111,163,690,1107,8,9171,509,0,2,1,1,1
9050,224,4615,1457,730,1242,11,6,188,1468,10,292,166,329,302,495,2424,4078,5,22973,1276,1,2,18,29,1
9051,224,4615,74,35,59,1,0,14,75,3,14,7,14,17,21,58,85,1,128,7,0,2,18,29,1
9052,224,4615,245,125,200,5,7,34,250,7,30,17,34,37,51,166,265,3,1053,58,0,2,18,29,1
9053,41,2012,1457,730,1242,11,6,188,1468,10,292,166,329,302,495,2424,4078,5,22973,1276,1,2,1,1,1
9054,32,1557,652,304,544,16,6,88,668,6,89,51,101,95,152,591,998,3,3399,188,0,2,39,28,1
9055,108,4151,1513,682,1277,25,13,200,1538,11,199,116,219,210,335,1557,2584,6,15641,868,0,2,5,7,0
9056,13,444,42,7,35,4,0,5,46,1,2,1,2,3,3,2,4,0,2,0,0,2,1,1,0
9057,13,444,11,6,10,0,0,1,11,2,4,2,4,6,6,10,15,1,15,0,0,2,1,1,0
9058,77,1712,477,336,357,30,23,73,507,16,194,134,250,210,384,1538,2962,10,30538,1696,0,2,1,2,0
9059,171,3868,77,34,69,0,0,8,77,3,24,16,29,27,45,114,213,1,387,21,0,2,1,0,0
9060,171,3868,712,438,573,51,9,84,763,14,102,71,128,116,199,733,1364,8,11988,666,0,2,1,0,0
9061,439,9792,72,33,56,0,4,12,72,1,1,1,1,2,2,0,2,0,1,0,0,2,2,2,0
9062,439,9792,1454,835,1044,76,110,219,1530,17,275,158,296,292,454,2297,3718,9,34017,1889,1,2,2,2,0
9063,108,4149,1513,682,1277,25,13,200,1538,11,199,116,219,210,335,1557,2584,6,15641,868,0,2,0,1,0
9064,32,641,2,2,2,0,0,0,2,0,0,0,0,0,0,0,0,0,0,0,0,2,37,17,1
9065,32,641,99,48,90,1,3,5,100,0,0,0,0,0,0,0,0,0,0,0,0,2,37,17,1
9066,32,641,8,5,5,2,0,1,10,0,0,0,0,0,0,0,0,0,0,0,0,2,37,17,1
9067,32,641,1217,716,841,84,126,174,1301,14,185,118,215,199,333,1446,2542,8,20687,1149,0,2,37,17,1
9068,32,641,160,89,115,0,13,31,160,7,15,11,17,22,28,78,124,3,495,27,0,2,37,17,1
9069,32,641,10,10,9,9,0,0,19,0,0,0,0,0,0,0,0,0,0,0,0,2,37,17,1
9070,32,641,173,84,99,8,29,36,181,5,12,7,13,17,20,54,81,2,221,12,0,2,37,17,1
9071,32,641,3,1,1,3,0,0,6,0,0,0,0,0,0,0,0,0,0,0,0,2,37,17,1
9072,33,659,2,2,2,0,0,0,2,0,0,0,0,0,0,0,0,0,0,0,0,2,22,5,1
9073,33,659,99,48,90,1,3,5,100,0,0,0,0,0,0,0,0,0,0,0,0,2,22,5,1
9074,33,659,8,5,5,2,0,1,10,0,0,0,0,0,0,0,0,0,0,0,0,2,22,5,1
9075,33,659,1217,716,841,84,126,174,1301,14,185,118,215,199,333,1446,2542,8,20687,1149,0,2,22,5,1
9076,33,659,160,89,115,0,13,31,160,7,15,11,17,22,28,78,124,3,495,27,0,2,22,5,1
9077,33,659,10,10,9,9,0,0,19,0,0,0,0,0,0,0,0,0,0,0,0,2,22,5,1
9078,33,659,173,84,99,8,29,36,181,5,12,7,13,17,20,54,81,2,221,12,0,2,22,5,1
9079,33,659,3,1,1,3,0,0,6,0,0,0,0,0,0,0,0,0,0,0,0,2,22,5,1
9080,55,1940,1450,624,1228,12,26,181,1462,14,306,186,354,320,540,2580,4493,8,36391,2021,1,2,16,0,1
9081,108,4145,1513,682,1277,25,13,200,1538,11,199,116,219,210,335,1557,2584,6,15641,868,0,2,2,2,0
9082,108,4145,1513,682,1277,25,13,200,1538,11,199,116,219,210,335,1557,2584,6,15641,868,0,2,2,3,0
9083,109,4172,1513,682,1277,25,13,200,1538,11,199,116,219,210,335,1557,2584,6,15641,868,0,2,18,0,1
9084,231,4784,1457,730,1242,11,6,188,1468,10,292,166,329,302,495,2424,4078,5,22973,1276,1,2,39,9,1
9085,231,4784,74,35,59,1,0,14,75,3,14,7,14,17,21,58,85,1,128,7,0,2,39,9,1
9086,231,4784,245,125,200,5,7,34,250,7,30,17,34,37,51,166,265,3,1053,58,0,2,39,9,1
9087,42,1077,74,35,59,1,0,14,75,3,14,7,14,17,21,58,85,1,128,7,0,2,1,9,1
9088,42,1077,245,125,200,5,7,34,250,7,30,17,34,37,51,166,265,3,1053,58,0,2,1,9,1
9089,65,2681,1289,550,1043,56,32,155,1345,10,167,93,185,177,278,1266,2075,5,11498,638,0,2,12,0,1
9090,109,4172,1513,682,1277,25,13,200,1538,11,199,116,219,210,335,1557,2584,6,15641,868,0,2,1,1,1
9091,218,4490,1457,730,1242,11,6,188,1468,10,292,166,329,302,495,2424,4078,5,22973,1276,1,2,20,46,1
9092,218,4490,74,35,59,1,0,14,75,3,14,7,14,17,21,58,85,1,128,7,0,2,20,46,1
9093,218,4490,245,125,200,5,7,34,250,7,30,17,34,37,51,166,265,3,1053,58,0,2,20,46,1
9094,171,3865,77,34,69,0,0,8,77,3,24,16,29,27,45,114,213,1,387,21,0,2,1,1,1
9095,171,3865,712,438,573,51,9,84,763,14,102,71,128,116,199,733,1364,8,11988,666,0,2,1,1,1
9096,38,1794,1457,730,1242,11,6,188,1468,10,292,166,329,302,495,2424,4078,5,22973,1276,1,2,8,36,1
9097,26,1455,652,304,544,16,6,88,668,6,89,51,101,95,152,591,998,3,3399,188,0,2,22,48,1
9098,231,4784,1457,730,1242,11,6,188,1468,10,292,166,329,302,495,2424,4078,5,22973,1276,1,2,39,9,0
9099,231,4784,74,35,59,1,0,14,75,3,14,7,14,17,21,58,85,1,128,7,0,2,39,9,0
9100,231,4784,245,125,200,5,7,34,250,7,30,17,34,37,51,166,265,3,1053,58,0,2,39,9,0
9101,42,1077,74,35,59,1,0,14,75,3,14,7,14,17,21,58,85,1,128,7,0,2,1,9,0
9102,42,1077,245,125,200,5,7,34,250,7,30,17,34,37,51,166,265,3,1053,58,0,2,1,9,0
9103,65,2681,1289,550,1043,56,32,155,1345,10,167,93,185,177,278,1266,2075,5,11498,638,0,2,12,0,0
9104,225,4659,1457,730,1242,11,6,188,1468,10,292,166,329,302,495,2424,4078,5,22973,1276,1,2,20,46,0
9105,225,4659,74,35,59,1,0,14,75,3,14,7,14,17,21,58,85,1,128,7,0,2,20,46,0
9106,225,4659,245,125,200,5,7,34,250,7,30,17,34,37,51,166,265,3,1053,58,0,2,20,46,0
9107,171,3865,77,34,69,0,0,8,77,3,24,16,29,27,45,114,213,1,387,21,0,2,1,1,0
9108,171,3865,712,438,573,51,9,84,763,14,102,71,128,116,199,733,1364,8,11988,666,0,2,1,1,0
9109,38,1794,1457,730,1242,11,6,188,1468,10,292,166,329,302,495,2424,4078,5,22973,1276,1,2,8,36,0
9110,26,1455,652,304,544,16,6,88,668,6,89,51,101,95,152,591,998,3,3399,188,0,2,22,48,0
9111,77,1712,477,336,357,30,23,73,507,16,194,134,250,210,384,1538,2962,10,30538,1696,0,2,1,2,0
9112,171,3868,77,34,69,0,0,8,77,3,24,16,29,27,45,114,213,1,387,21,0,2,1,0,0
9113,171,3868,712,438,573,51,9,84,763,14,102,71,128,116,199,733,1364,8,11988,666,0,2,1,0,0
9114,439,9792,72,33,56,0,4,12,72,1,1,1,1,2,2,0,2,0,1,0,0,2,2,2,0
9115,439,9792,1454,835,1044,76,110,219,1530,17,275,158,296,292,454,2297,3718,9,34017,1889,1,2,2,2,0
9116,114,2252,1513,682,1277,25,13,200,1538,11,199,116,219,210,335,1557,2584,6,15641,868,0,2,1,1,1
9117,114,2252,819,519,539,24,98,155,843,15,96,57,106,111,163,690,1107,8,9171,509,0,2,1,1,1
9118,198,4464,722,423,573,19,0,135,741,12,172,101,199,184,300,1320,2257,6,15668,870,0,2,8,2,0
9119,198,4464,1508,847,911,44,250,301,1552,14,148,88,169,162,257,1120,1886,7,15077,837,0,2,8,2,0
9120,117,2932,1660,832,1314,41,38,274,1701,20,312,209,395,332,604,2671,5058,12,64042,3557,1,2,15,14,0
9121,114,2252,1513,682,1277,25,13,200,1538,11,199,116,219,210,335,1557,2584,6,15641,868,0,2,1,1,0
9122,114,2252,819,519,539,24,98,155,843,15,96,57,106,111,163,690,1107,8,9171,509,0,2,1,1,0
9123,13,444,42,7,35,4,0,5,46,1,2,1,2,3,3,2,4,0,2,0,0,2,1,1,1
9124,13,444,11,6,10,0,0,1,11,2,4,2,4,6,6,10,15,1,15,0,0,2,1,1,1
9125,440,9798,72,33,56,0,4,12,72,1,1,1,1,2,2,0,2,0,1,0,0,2,8,6,1
9126,440,9798,1454,835,1044,76,110,219,1530,17,275,158,296,292,454,2297,3718,9,34017,1889,1,2,8,6,1
9127,125,5370,139,89,101,2,0,35,141,7,54,34,62,61,96,330,569,4,2287,127,0,2,29,0,1
9128,125,5370,7,5,5,0,0,2,7,1,2,1,2,3,3,2,4,0,2,0,0,2,29,0,1
9129,440,9798,72,33,56,0,4,12,72,1,1,1,1,2,2,0,2,0,1,0,0,2,8,6,0
9130,440,9798,1454,835,1044,76,110,219,1530,17,275,158,296,292,454,2297,3718,9,34017,1889,1,2,8,6,0
9131,125,5370,139,89,101,2,0,35,141,7,54,34,62,61,96,330,569,4,2287,127,0,2,29,0,0
9132,125,5370,7,5,5,0,0,2,7,1,2,1,2,3,3,2,4,0,2,0,0,2,29,0,0
9133,440,9808,72,33,56,0,4,12,72,1,1,1,1,2,2,0,2,0,1,0,0,2,2,0,1
9134,440,9808,1454,835,1044,76,110,219,1530,17,275,158,296,292,454,2297,3718,9,34017,1889,1,2,2,0,1
9135,25,624,465,148,393,5,8,60,470,4,31,20,31,35,51,161,261,2,523,29,0,2,15,0,1
9136,25,624,16,12,9,0,0,6,16,1,2,1,2,3,3,2,4,0,2,0,0,2,15,0,1
9137,440,9808,72,33,56,0,4,12,72,1,1,1,1,2,2,0,2,0,1,0,0,2,2,0,0
9138,440,9808,1454,835,1044,76,110,219,1530,17,275,158,296,292,454,2297,3718,9,34017,1889,1,2,2,0,0
9139,25,624,465,148,393,5,8,60,470,4,31,20,31,35,51,161,261,2,523,29,0,2,15,0,0
9140,25,624,16,12,9,0,0,6,16,1,2,1,2,3,3,2,4,0,2,0,0,2,15,0,0
9141,441,9824,72,33,56,0,4,12,72,1,1,1,1,2,2,0,2,0,1,0,0,2,3,0,1
9142,441,9824,1454,835,1044,76,110,219,1530,17,275,158,296,292,454,2297,3718,9,34017,1889,1,2,3,0,1
9143,55,1039,1098,241,925,5,10,155,1103,7,46,25,49,53,74,273,423,3,1580,87,0,2,3,1,1
9144,55,1039,282,202,222,14,2,44,296,8,42,24,43,50,67,250,378,4,1548,86,0,2,3,1,1
9145,28,753,465,148,393,5,8,60,470,4,31,20,31,35,51,161,261,2,523,29,0,2,51,4,1
9146,28,753,16,12,9,0,0,6,16,1,2,1,2,3,3,2,4,0,2,0,0,2,51,4,1
9147,28,753,465,148,393,5,8,60,470,4,31,20,31,35,51,161,261,2,523,29,0,2,2,2,0
9148,28,753,16,12,9,0,0,6,16,1,2,1,2,3,3,2,4,0,2,0,0,2,2,2,0
9149,442,9834,72,33,56,0,4,12,72,1,1,1,1,2,2,0,2,0,1,0,0,2,5,4,1
9150,442,9834,1454,835,1044,76,110,219,1530,17,275,158,296,292,454,2297,3718,9,34017,1889,1,2,5,4,1
9151,28,774,465,148,393,5,8,60,470,4,31,20,31,35,51,161,261,2,523,29,0,2,4,1,1
9152,28,774,16,12,9,0,0,6,16,1,2,1,2,3,3,2,4,0,2,0,0,2,4,1,1
9153,442,9834,72,33,56,0,4,12,72,1,1,1,1,2,2,0,2,0,1,0,0,2,8,4,0
9154,442,9834,1454,835,1044,76,110,219,1530,17,275,158,296,292,454,2297,3718,9,34017,1889,1,2,8,4,0
9155,55,1039,1098,241,925,5,10,155,1103,7,46,25,49,53,74,273,423,3,1580,87,0,2,3,1,0
9156,55,1039,282,202,222,14,2,44,296,8,42,24,43,50,67,250,378,4,1548,86,0,2,3,1,0
9157,28,774,465,148,393,5,8,60,470,4,31,20,31,35,51,161,261,2,523,29,0,2,52,2,0
9158,28,774,16,12,9,0,0,6,16,1,2,1,2,3,3,2,4,0,2,0,0,2,52,2,0
9159,86,1521,1178,367,1042,6,15,115,1184,9,94,51,95,103,146,644,976,4,4439,246,0,2,1,1,0
9160,86,1521,177,108,140,8,0,27,185,6,30,16,32,36,48,162,248,3,794,44,0,2,1,1,0
9161,226,4706,1457,730,1242,11,6,188,1468,10,292,166,329,302,495,2424,4078,5,22973,1276,1,2,9,2,1
9162,226,4706,74,35,59,1,0,14,75,3,14,7,14,17,21,58,85,1,128,7,0,2,9,2,1
9163,226,4706,245,125,200,5,7,34,250,7,30,17,34,37,51,166,265,3,1053,58,0,2,9,2,1
9164,167,3428,1943,715,1694,26,18,214,1969,12,185,120,237,197,357,1436,2721,7,20915,1161,0,2,4,2,1
9165,167,3428,1168,838,957,57,25,144,1225,19,348,224,416,367,640,3018,5452,11,61921,3440,1,2,4,2,1
9166,125,5370,139,89,101,2,0,35,141,7,54,34,62,61,96,330,569,4,2287,127,0,2,30,30,1
9167,125,5370,7,5,5,0,0,2,7,1,2,1,2,3,3,2,4,0,2,0,0,2,30,30,1
9168,38,2226,334,251,279,10,4,40,344,5,127,74,143,132,217,899,1528,2,4303,239,0,2,4,0,1
9169,61,2682,1943,715,1694,26,18,214,1969,12,185,120,237,197,357,1436,2721,7,20915,1161,0,2,9,9,1
9170,36,1381,1098,241,925,5,10,155,1103,7,46,25,49,53,74,273,423,3,1580,87,0,2,2,2,1
9171,446,9892,72,33,56,0,4,12,72,1,1,1,1,2,2,0,2,0,1,0,0,2,20,10,1
9172,446,9892,1454,835,1044,76,110,219,1530,17,275,158,296,292,454,2297,3718,9,34017,1889,1,2,20,10,1
9173,11,239,256,139,192,9,7,47,265,4,23,12,24,27,36,112,171,2,357,19,0,2,7,0,1
9174,226,4706,1457,730,1242,11,6,188,1468,10,292,166,329,302,495,2424,4078,5,22973,1276,1,2,9,2,0
9175,226,4706,74,35,59,1,0,14,75,3,14,7,14,17,21,58,85,1,128,7,0,2,9,2,0
9176,226,4706,245,125,200,5,7,34,250,7,30,17,34,37,51,166,265,3,1053,58,0,2,9,2,0
9177,167,3428,1943,715,1694,26,18,214,1969,12,185,120,237,197,357,1436,2721,7,20915,1161,0,2,4,2,0
9178,167,3428,1168,838,957,57,25,144,1225,19,348,224,416,367,640,3018,5452,11,61921,3440,1,2,4,2,0
9179,125,5370,139,89,101,2,0,35,141,7,54,34,62,61,96,330,569,4,2287,127,0,2,30,30,0
9180,125,5370,7,5,5,0,0,2,7,1,2,1,2,3,3,2,4,0,2,0,0,2,30,30,0
9181,38,2226,334,251,279,10,4,40,344,5,127,74,143,132,217,899,1528,2,4303,239,0,2,4,0,0
9182,61,2682,1943,715,1694,26,18,214,1969,12,185,120,237,197,357,1436,2721,7,20915,1161,0,2,9,9,0
9183,36,1381,1098,241,925,5,10,155,1103,7,46,25,49,53,74,273,423,3,1580,87,0,2,2,2,0
9184,448,9938,72,33,56,0,4,12,72,1,1,1,1,2,2,0,2,0,1,0,0,2,14,11,1
9185,448,9938,1454,835,1044,76,110,219,1530,17,275,158,296,292,454,2297,3718,9,34017,1889,1,2,14,11,1
9186,126,5403,139,89,101,2,0,35,141,7,54,34,62,61,96,330,569,4,2287,127,0,2,19,0,1
9187,126,5403,7,5,5,0,0,2,7,1,2,1,2,3,3,2,4,0,2,0,0,2,19,0,1
9188,454,9994,72,33,56,0,4,12,72,1,1,1,1,2,2,0,2,0,1,0,0,2,38,15,1
9189,454,9994,1454,835,1044,76,110,219,1530,17,275,158,296,292,454,2297,3718,9,34017,1889,1,2,38,15,1
9190,65,3525,1782,648,1425,9,47,279,1791,8,171,97,189,179,286,1292,2140,4,9462,525,0,2,46,0,1
9191,43,1323,1523,757,1297,19,12,193,1542,12,193,117,230,205,347,1508,2664,7,19053,1058,0,2,1,0,0
9192,43,1323,701,378,504,33,58,109,734,13,110,68,126,123,194,794,1346,7,10027,557,0,2,1,0,0
9193,43,1318,1523,757,1297,19,12,193,1542,12,193,117,230,205,347,1508,2664,7,19053,1058,0,2,1,2,0
9194,43,1318,701,378,504,33,58,109,734,13,110,68,126,123,194,794,1346,7,10027,557,0,2,1,2,0
9195,39,2430,1523,757,1297,19,12,193,1542,12,193,117,230,205,347,1508,2664,7,19053,1058,0,2,2,0,1
9196,15,465,42,7,35,4,0,5,46,1,2,1,2,3,3,2,4,0,2,0,0,2,2,1,0
9197,15,465,11,6,10,0,0,1,11,2,4,2,4,6,6,10,15,1,15,0,0,2,2,1,0
9198,43,863,447,308,343,6,5,95,453,7,96,59,111,103,170,651,1136,4,4600,255,0,2,5,1,1
9199,43,863,322,174,179,16,74,51,338,10,41,26,46,51,72,252,408,5,2291,127,0,2,5,1,1
9200,15,465,42,7,35,4,0,5,46,1,2,1,2,3,3,2,4,0,2,0,0,2,2,1,0
9201,15,465,11,6,10,0,0,1,11,2,4,2,4,6,6,10,15,1,15,0,0,2,2,1,0
9202,14,452,42,7,35,4,0,5,46,1,2,1,2,3,3,2,4,0,2,0,0,2,31,29,1
9203,14,452,11,6,10,0,0,1,11,2,4,2,4,6,6,10,15,1,15,0,0,2,31,29,1
9204,14,452,42,7,35,4,0,5,46,1,2,1,2,3,3,2,4,0,2,0,0,2,1,1,0
9205,14,452,11,6,10,0,0,1,11,2,4,2,4,6,6,10,15,1,15,0,0,2,1,1,0
9206,114,2482,1043,504,840,53,9,147,1096,9,180,112,198,189,310,1377,2344,4,11604,644,0,2,1,1,1
9207,114,2482,383,288,292,26,6,62,409,11,65,38,67,76,105,429,656,5,3719,206,0,2,1,1,1
9208,114,2482,1043,504,840,53,9,147,1096,9,180,112,198,189,310,1377,2344,4,11604,644,0,2,1,1,0
9209,114,2482,383,288,292,26,6,62,409,11,65,38,67,76,105,429,656,5,3719,206,0,2,1,1,0
9210,229,4732,1457,730,1242,11,6,188,1468,10,292,166,329,302,495,2424,4078,5,22973,1276,1,2,11,3,1
9211,229,4732,74,35,59,1,0,14,75,3,14,7,14,17,21,58,85,1,128,7,0,2,11,3,1
9212,229,4732,245,125,200,5,7,34,250,7,30,17,34,37,51,166,265,3,1053,58,0,2,11,3,1
9213,39,1827,1457,730,1242,11,6,188,1468,10,292,166,329,302,495,2424,4078,5,22973,1276,1,2,9,0,1
9214,14,452,42,7,35,4,0,5,46,1,2,1,2,3,3,2,4,0,2,0,0,2,31,29,0
9215,14,452,11,6,10,0,0,1,11,2,4,2,4,6,6,10,15,1,15,0,0,2,31,29,0
9216,55,1940,1450,624,1228,12,26,181,1462,14,306,186,354,320,540,2580,4493,8,36391,2021,1,2,1,1,0
9217,1,282,382,65,130,157,2,92,539,4,10,5,10,14,15,41,57,2,114,6,0,2,1,1,0
9218,1,285,382,65,130,157,2,92,539,4,10,5,10,14,15,41,57,2,114,6,0,2,1,1,0
9219,45,445,647,139,84,35,284,233,682,0,0,0,0,0,0,0,0,0,0,0,0,2,1,1,0
9220,45,445,647,139,84,35,284,233,682,0,0,0,0,0,0,0,0,0,0,0,0,2,6,6,0
9221,45,445,647,139,84,35,284,233,682,0,0,0,0,0,0,0,0,0,0,0,0,2,6,6,0
9222,127,5436,139,89,101,2,0,35,141,7,54,34,62,61,96,330,569,4,2287,127,0,2,24,0,1
9223,127,5436,7,5,5,0,0,2,7,1,2,1,2,3,3,2,4,0,2,0,0,2,24,0,1
9224,55,1934,1450,624,1228,12,26,181,1462,14,306,186,354,320,540,2580,4493,8,36391,2021,1,2,0,1,0
9225,108,4145,1513,682,1277,25,13,200,1538,11,199,116,219,210,335,1557,2584,6,15641,868,0,2,2,19,0
9226,39,1833,1457,730,1242,11,6,188,1468,10,292,166,329,302,495,2424,4078,5,22973,1276,1,2,2,2,0
9227,234,4805,1457,730,1242,11,6,188,1468,10,292,166,329,302,495,2424,4078,5,22973,1276,1,2,8,0,1
9228,234,4805,74,35,59,1,0,14,75,3,14,7,14,17,21,58,85,1,128,7,0,2,8,0,1
9229,234,4805,245,125,200,5,7,34,250,7,30,17,34,37,51,166,265,3,1053,58,0,2,8,0,1
9230,171,3890,77,34,69,0,0,8,77,3,24,16,29,27,45,114,213,1,387,21,0,2,3,0,1
9231,171,3890,712,438,573,51,9,84,763,14,102,71,128,116,199,733,1364,8,11988,666,0,2,3,0,1
9232,40,1882,1457,730,1242,11,6,188,1468,10,292,166,329,302,495,2424,4078,5,22973,1276,1,2,15,0,1
9233,231,4784,1457,730,1242,11,6,188,1468,10,292,166,329,302,495,2424,4078,5,22973,1276,1,2,9,9,1
9234,231,4784,74,35,59,1,0,14,75,3,14,7,14,17,21,58,85,1,128,7,0,2,9,9,1
9235,231,4784,245,125,200,5,7,34,250,7,30,17,34,37,51,166,265,3,1053,58,0,2,9,9,1
9236,171,3890,77,34,69,0,0,8,77,3,24,16,29,27,45,114,213,1,387,21,0,2,1,2,1
9237,171,3890,712,438,573,51,9,84,763,14,102,71,128,116,199,733,1364,8,11988,666,0,2,1,2,1
9238,231,4784,1457,730,1242,11,6,188,1468,10,292,166,329,302,495,2424,4078,5,22973,1276,1,2,9,1,0
9239,231,4784,74,35,59,1,0,14,75,3,14,7,14,17,21,58,85,1,128,7,0,2,9,1,0
9240,231,4784,245,125,200,5,7,34,250,7,30,17,34,37,51,166,265,3,1053,58,0,2,9,1,0
9241,171,3890,77,34,69,0,0,8,77,3,24,16,29,27,45,114,213,1,387,21,0,2,2,0,0
9242,171,3890,712,438,573,51,9,84,763,14,102,71,128,116,199,733,1364,8,11988,666,0,2,2,0,0
9243,40,1882,1457,730,1242,11,6,188,1468,10,292,166,329,302,495,2424,4078,5,22973,1276,1,2,15,0,0
9244,172,3908,77,34,69,0,0,8,77,3,24,16,29,27,45,114,213,1,387,21,0,2,7,3,1
9245,172,3908,712,438,573,51,9,84,763,14,102,71,128,116,199,733,1364,8,11988,666,0,2,7,3,1
9246,450,9943,72,33,56,0,4,12,72,1,1,1,1,2,2,0,2,0,1,0,0,2,10,2,1
9247,450,9943,1454,835,1044,76,110,219,1530,17,275,158,296,292,454,2297,3718,9,34017,1889,1,2,10,2,1
9248,167,3430,1943,715,1694,26,18,214,1969,12,185,120,237,197,357,1436,2721,7,20915,1161,0,2,2,2,1
9249,167,3430,1168,838,957,57,25,144,1225,19,348,224,416,367,640,3018,5452,11,61921,3440,1,2,2,2,1
9250,14,452,42,7,35,4,0,5,46,1,2,1,2,3,3,2,4,0,2,0,0,2,2,2,1
9251,14,452,11,6,10,0,0,1,11,2,4,2,4,6,6,10,15,1,15,0,0,2,2,2,1
9252,63,2936,1338,495,1086,10,64,173,1348,11,122,82,157,133,239,883,1686,7,11934,663,0,2,1,1,1
9253,55,1982,1450,624,1228,12,26,181,1462,14,306,186,354,320,540,2580,4493,8,36391,2021,1,2,20,1,1
9254,61,2682,1943,715,1694,26,18,214,1969,12,185,120,237,197,357,1436,2721,7,20915,1161,0,2,3,3,1
9255,231,4784,1457,730,1242,11,6,188,1468,10,292,166,329,302,495,2424,4078,5,22973,1276,1,2,2,1,1
9256,231,4784,74,35,59,1,0,14,75,3,14,7,14,17,21,58,85,1,128,7,0,2,2,1,1
9257,231,4784,245,125,200,5,7,34,250,7,30,17,34,37,51,166,265,3,1053,58,0,2,2,1,1
9258,171,3870,77,34,69,0,0,8,77,3,24,16,29,27,45,114,213,1,387,21,0,2,1,1,1
9259,171,3870,712,438,573,51,9,84,763,14,102,71,128,116,199,733,1364,8,11988,666,0,2,1,1,1
9260,172,3910,77,34,69,0,0,8,77,3,24,16,29,27,45,114,213,1,387,21,0,2,1,1,0
9261,172,3910,712,438,573,51,9,84,763,14,102,71,128,116,199,733,1364,8,11988,666,0,2,1,1,0
9262,23,1010,1455,414,1257,16,76,112,1471,5,41,23,46,46,69,231,381,2,1069,59,0,2,2,0,0
9263,43,1318,1523,757,1297,19,12,193,1542,12,193,117,230,205,347,1508,2664,7,19053,1058,0,2,1,1,0
9264,43,1318,701,378,504,33,58,109,734,13,110,68,126,123,194,794,1346,7,10027,557,0,2,1,1,0
9265,39,2430,1523,757,1297,19,12,193,1542,12,193,117,230,205,347,1508,2664,7,19053,1058,0,2,2,0,0
9266,14,452,42,7,35,4,0,5,46,1,2,1,2,3,3,2,4,0,2,0,0,2,2,2,1
9267,14,452,11,6,10,0,0,1,11,2,4,2,4,6,6,10,15,1,15,0,0,2,2,2,1
9268,14,452,42,7,35,4,0,5,46,1,2,1,2,3,3,2,4,0,2,0,0,2,1,1,0
9269,14,452,11,6,10,0,0,1,11,2,4,2,4,6,6,10,15,1,15,0,0,2,1,1,0
9270,1,285,382,65,130,157,2,92,539,4,10,5,10,14,15,41,57,2,114,6,0,2,1,1,1
9271,1,285,382,65,130,157,2,92,539,4,10,5,10,14,15,41,57,2,114,6,0,2,2,2,1
9272,128,5483,139,89,101,2,0,35,141,7,54,34,62,61,96,330,569,4,2287,127,0,2,29,0,0
9273,128,5483,7,5,5,0,0,2,7,1,2,1,2,3,3,2,4,0,2,0,0,2,29,0,0
9274,231,4784,1457,730,1242,11,6,188,1468,10,292,166,329,302,495,2424,4078,5,22973,1276,1,2,11,2,0
9275,231,4784,74,35,59,1,0,14,75,3,14,7,14,17,21,58,85,1,128,7,0,2,11,2,0
9276,231,4784,245,125,200,5,7,34,250,7,30,17,34,37,51,166,265,3,1053,58,0,2,11,2,0
9277,43,1318,1523,757,1297,19,12,193,1542,12,193,117,230,205,347,1508,2664,7,19053,1058,0,2,1,1,0
9278,43,1318,701,378,504,33,58,109,734,13,110,68,126,123,194,794,1346,7,10027,557,0,2,1,1,0
9279,172,3910,77,34,69,0,0,8,77,3,24,16,29,27,45,114,213,1,387,21,0,2,10,4,0
9280,172,3910,712,438,573,51,9,84,763,14,102,71,128,116,199,733,1364,8,11988,666,0,2,10,4,0
9281,452,9989,72,33,56,0,4,12,72,1,1,1,1,2,2,0,2,0,1,0,0,2,10,2,0
9282,452,9989,1454,835,1044,76,110,219,1530,17,275,158,296,292,454,2297,3718,9,34017,1889,1,2,10,2,0
9283,167,3430,1943,715,1694,26,18,214,1969,12,185,120,237,197,357,1436,2721,7,20915,1161,0,2,2,2,0
9284,167,3430,1168,838,957,57,25,144,1225,19,348,224,416,367,640,3018,5452,11,61921,3440,1,2,2,2,0
9285,1,285,382,65,130,157,2,92,539,4,10,5,10,14,15,41,57,2,114,6,0,2,1,1,0
9286,14,452,42,7,35,4,0,5,46,1,2,1,2,3,3,2,4,0,2,0,0,2,2,2,0
9287,14,452,11,6,10,0,0,1,11,2,4,2,4,6,6,10,15,1,15,0,0,2,2,2,0
9288,63,2936,1338,495,1086,10,64,173,1348,11,122,82,157,133,239,883,1686,7,11934,663,0,2,1,1,0
9289,55,1982,1450,624,1228,12,26,181,1462,14,306,186,354,320,540,2580,4493,8,36391,2021,1,2,20,2,0
9290,108,4145,1513,682,1277,25,13,200,1538,11,199,116,219,210,335,1557,2584,6,15641,868,0,2,2,19,0
9291,40,1882,1457,730,1242,11,6,188,1468,10,292,166,329,302,495,2424,4078,5,22973,1276,1,2,17,2,0
9292,23,1010,1455,414,1257,16,76,112,1471,5,41,23,46,46,69,231,381,2,1069,59,0,2,2,0,0
9293,39,2430,1523,757,1297,19,12,193,1542,12,193,117,230,205,347,1508,2664,7,19053,1058,0,2,2,0,0
9294,61,2682,1943,715,1694,26,18,214,1969,12,185,120,237,197,357,1436,2721,7,20915,1161,0,2,3,3,0
9295,1,285,382,65,130,157,2,92,539,4,10,5,10,14,15,41,57,2,114,6,0,2,2,2,0
9296,90,1584,1178,367,1042,6,15,115,1184,9,94,51,95,103,146,644,976,4,4439,246,0,2,19,4,1
9297,90,1584,177,108,140,8,0,27,185,6,30,16,32,36,48,162,248,3,794,44,0,2,19,4,1
9298,47,2038,1178,367,1042,6,15,115,1184,9,94,51,95,103,146,644,976,4,4439,246,0,2,48,2,1
9299,29,809,465,148,393,5,8,60,470,4,31,20,31,35,51,161,261,2,523,29,0,2,20,0,0
9300,29,809,16,12,9,0,0,6,16,1,2,1,2,3,3,2,4,0,2,0,0,2,20,0,0
9301,89,1573,1178,367,1042,6,15,115,1184,9,94,51,95,103,146,644,976,4,4439,246,0,2,3,6,1
9302,89,1573,177,108,140,8,0,27,185,6,30,16,32,36,48,162,248,3,794,44,0,2,3,6,1
9303,44,1992,1178,367,1042,6,15,115,1184,9,94,51,95,103,146,644,976,4,4439,246,0,2,13,38,1
9304,7,103,38,23,23,0,0,15,38,0,0,0,0,0,0,0,0,0,0,0,0,2,5,0,0
9305,44,1989,1178,367,1042,6,15,115,1184,9,94,51,95,103,146,644,976,4,4439,246,0,2,7,9,0
9306,7,102,38,23,23,0,0,15,38,0,0,0,0,0,0,0,0,0,0,0,0,2,1,1,0
9307,454,10020,72,33,56,0,4,12,72,1,1,1,1,2,2,0,2,0,1,0,0,2,22,7,1
9308,454,10020,1454,835,1044,76,110,219,1530,17,275,158,296,292,454,2297,3718,9,34017,1889,1,2,22,7,1
9309,454,10020,72,33,56,0,4,12,72,1,1,1,1,2,2,0,2,0,1,0,0,2,4,2,1
9310,454,10020,1454,835,1044,76,110,219,1530,17,275,158,296,292,454,2297,3718,9,34017,1889,1,2,4,2,1
9311,89,1573,1178,367,1042,6,15,115,1184,9,94,51,95,103,146,644,976,4,4439,246,0,2,16,4,0
9312,89,1573,177,108,140,8,0,27,185,6,30,16,32,36,48,162,248,3,794,44,0,2,16,4,0
9313,7,102,38,23,23,0,0,15,38,0,0,0,0,0,0,0,0,0,0,0,0,2,5,0,0
9314,44,1989,1178,367,1042,6,15,115,1184,9,94,51,95,103,146,644,976,4,4439,246,0,2,21,2,0
9315,14,452,42,7,35,4,0,5,46,1,2,1,2,3,3,2,4,0,2,0,0,2,1,1,0
9316,14,452,11,6,10,0,0,1,11,2,4,2,4,6,6,10,15,1,15,0,0,2,1,1,0
9317,454,10020,72,33,56,0,4,12,72,1,1,1,1,2,2,0,2,0,1,0,0,2,24,7,0
9318,454,10020,1454,835,1044,76,110,219,1530,17,275,158,296,292,454,2297,3718,9,34017,1889,1,2,24,7,0
9319,29,809,465,148,393,5,8,60,470,4,31,20,31,35,51,161,261,2,523,29,0,2,20,0,0
9320,29,809,16,12,9,0,0,6,16,1,2,1,2,3,3,2,4,0,2,0,0,2,20,0,0
9321,454,10012,72,33,56,0,4,12,72,1,1,1,1,2,2,0,2,0,1,0,0,2,12,23,1
9322,454,10012,1454,835,1044,76,110,219,1530,17,275,158,296,292,454,2297,3718,9,34017,1889,1,2,12,23,1
9323,232,4811,1457,730,1242,11,6,188,1468,10,292,166,329,302,495,2424,4078,5,22973,1276,1,2,5,0,1
9324,232,4811,74,35,59,1,0,14,75,3,14,7,14,17,21,58,85,1,128,7,0,2,5,0,1
9325,232,4811,245,125,200,5,7,34,250,7,30,17,34,37,51,166,265,3,1053,58,0,2,5,0,1
9326,27,1535,652,304,544,16,6,88,668,6,89,51,101,95,152,591,998,3,3399,188,0,2,18,0,1
9327,234,4833,1457,730,1242,11,6,188,1468,10,292,166,329,302,495,2424,4078,5,22973,1276,1,2,7,3,1
9328,234,4833,74,35,59,1,0,14,75,3,14,7,14,17,21,58,85,1,128,7,0,2,7,3,1
9329,234,4833,245,125,200,5,7,34,250,7,30,17,34,37,51,166,265,3,1053,58,0,2,7,3,1
9330,38,2236,334,251,279,10,4,40,344,5,127,74,143,132,217,899,1528,2,4303,239,0,2,11,2,1
9331,113,2244,1513,682,1277,25,13,200,1538,11,199,116,219,210,335,1557,2584,6,15641,868,0,2,1,3,0
9332,113,2244,819,519,539,24,98,155,843,15,96,57,106,111,163,690,1107,8,9171,509,0,2,1,3,0
9333,108,4168,1513,682,1277,25,13,200,1538,11,199,116,219,210,335,1557,2584,6,15641,868,0,2,3,2,0
9334,233,4817,1457,730,1242,11,6,188,1468,10,292,166,329,302,495,2424,4078,5,22973,1276,1,2,4,7,0
9335,233,4817,74,35,59,1,0,14,75,3,14,7,14,17,21,58,85,1,128,7,0,2,4,7,0
9336,233,4817,245,125,200,5,7,34,250,7,30,17,34,37,51,166,265,3,1053,58,0,2,4,7,0
9337,38,2236,334,251,279,10,4,40,344,5,127,74,143,132,217,899,1528,2,4303,239,0,2,6,4,0
9338,233,4817,1457,730,1242,11,6,188,1468,10,292,166,329,302,495,2424,4078,5,22973,1276,1,2,9,3,0
9339,233,4817,74,35,59,1,0,14,75,3,14,7,14,17,21,58,85,1,128,7,0,2,9,3,0
9340,233,4817,245,125,200,5,7,34,250,7,30,17,34,37,51,166,265,3,1053,58,0,2,9,3,0
9341,27,1535,652,304,544,16,6,88,668,6,89,51,101,95,152,591,998,3,3399,188,0,2,18,0,0
9342,38,2236,334,251,279,10,4,40,344,5,127,74,143,132,217,899,1528,2,4303,239,0,2,13,2,0
9343,2,26,6,4,4,0,0,2,6,1,4,2,4,5,6,8,13,0,6,0,0,0,6,0,1
9344,77,1700,477,336,357,30,23,73,507,16,194,134,250,210,384,1538,2962,10,30538,1696,0,2,9,7,1
9345,233,4771,1457,730,1242,11,6,188,1468,10,292,166,329,302,495,2424,4078,5,22973,1276,1,2,20,15,1
9346,233,4771,74,35,59,1,0,14,75,3,14,7,14,17,21,58,85,1,128,7,0,2,20,15,1
9347,233,4771,245,125,200,5,7,34,250,7,30,17,34,37,51,166,265,3,1053,58,0,2,20,15,1
9348,26,866,1455,414,1257,16,76,112,1471,5,41,23,46,46,69,231,381,2,1069,59,0,2,8,7,1
9349,26,866,669,365,481,22,61,110,691,15,103,63,122,118,185,747,1273,8,11311,628,0,2,8,7,1
9350,43,1312,1523,757,1297,19,12,193,1542,12,193,117,230,205,347,1508,2664,7,19053,1058,0,2,3,2,1
9351,43,1312,701,378,504,33,58,109,734,13,110,68,126,123,194,794,1346,7,10027,557,0,2,3,2,1
9352,172,3904,77,34,69,0,0,8,77,3,24,16,29,27,45,114,213,1,387,21,0,2,3,2,1
9353,172,3904,712,438,573,51,9,84,763,14,102,71,128,116,199,733,1364,8,11988,666,0,2,3,2,1
9354,21,545,1293,570,1093,25,15,163,1318,10,195,123,241,205,364,1516,2795,6,17273,959,0,2,12,8,1
9355,198,4430,722,423,573,19,0,135,741,12,172,101,199,184,300,1320,2257,6,15668,870,0,2,22,17,1
9356,198,4430,1508,847,911,44,250,301,1552,14,148,88,169,162,257,1120,1886,7,15077,837,0,2,22,17,1
9357,18,440,386,256,301,16,9,68,402,4,59,35,69,63,104,355,621,2,1453,80,0,2,11,15,1
9358,18,440,264,131,164,11,41,46,275,6,38,22,40,44,62,214,338,3,1068,59,0,2,11,15,1
9359,114,2480,1043,504,840,53,9,147,1096,9,180,112,198,189,310,1377,2344,4,11604,644,0,2,4,3,1
9360,114,2480,383,288,292,26,6,62,409,11,65,38,67,76,105,429,656,5,3719,206,0,2,4,3,1
9361,89,1565,1178,367,1042,6,15,115,1184,9,94,51,95,103,146,644,976,4,4439,246,0,2,7,4,1
9362,89,1565,177,108,140,8,0,27,185,6,30,16,32,36,48,162,248,3,794,44,0,2,7,4,1
9363,167,3416,1943,715,1694,26,18,214,1969,12,185,120,237,197,357,1436,2721,7,20915,1161,0,2,6,4,1
9364,167,3416,1168,838,957,57,25,144,1225,19,348,224,416,367,640,3018,5452,11,61921,3440,1,2,6,4,1
9365,12,371,442,244,305,14,16,103,456,11,68,45,75,79,120,452,756,6,4588,254,0,2,6,2,1
9366,12,371,182,102,99,11,40,35,193,3,11,6,11,14,17,42,64,1,97,5,0,2,6,2,1
9367,55,1039,1098,241,925,5,10,155,1103,7,46,25,49,53,74,273,423,3,1580,87,0,2,9,3,1
9368,55,1039,282,202,222,14,2,44,296,8,42,24,43,50,67,250,378,4,1548,86,0,2,9,3,1
9369,108,4168,1513,682,1277,25,13,200,1538,11,199,116,219,210,335,1557,2584,6,15641,868,0,2,0,2,0
9370,231,4764,1457,730,1242,11,6,188,1468,10,292,166,329,302,495,2424,4078,5,22973,1276,1,2,1,10,1
9371,231,4764,74,35,59,1,0,14,75,3,14,7,14,17,21,58,85,1,128,7,0,2,1,10,1
9372,231,4764,245,125,200,5,7,34,250,7,30,17,34,37,51,166,265,3,1053,58,0,2,1,10,1
9373,166,3413,1943,715,1694,26,18,214,1969,12,185,120,237,197,357,1436,2721,7,20915,1161,0,2,0,3,1
9374,166,3413,1168,838,957,57,25,144,1225,19,348,224,416,367,640,3018,5452,11,61921,3440,1,2,0,3,1
9375,128,5483,139,89,101,2,0,35,141,7,54,34,62,61,96,330,569,4,2287,127,0,2,28,28,1
9376,128,5483,7,5,5,0,0,2,7,1,2,1,2,3,3,2,4,0,2,0,0,2,28,28,1
9377,27,1535,652,304,544,16,6,88,668,6,89,51,101,95,152,591,998,3,3399,188,0,2,1,1,1
9378,37,2191,334,251,279,10,4,40,344,5,127,74,143,132,217,899,1528,2,4303,239,0,2,0,15,1
9379,61,2682,1943,715,1694,26,18,214,1969,12,185,120,237,197,357,1436,2721,7,20915,1161,0,2,9,9,1
9380,108,4168,1513,682,1277,25,13,200,1538,11,199,116,219,210,335,1557,2584,6,15641,868,0,2,2,0,0
9381,42,1271,1523,757,1297,19,12,193,1542,12,193,117,230,205,347,1508,2664,7,19053,1058,0,2,4,17,1
9382,42,1271,701,378,504,33,58,109,734,13,110,68,126,123,194,794,1346,7,10027,557,0,2,4,17,1
9383,52,1014,1098,241,925,5,10,155,1103,7,46,25,49,53,74,273,423,3,1580,87,0,2,10,17,1
9384,52,1014,282,202,222,14,2,44,296,8,42,24,43,50,67,250,378,4,1548,86,0,2,10,17,1
9385,14,452,42,7,35,4,0,5,46,1,2,1,2,3,3,2,4,0,2,0,0,2,1,1,1
9386,14,452,11,6,10,0,0,1,11,2,4,2,4,6,6,10,15,1,15,0,0,2,1,1,1
9387,77,1700,477,336,357,30,23,73,507,16,194,134,250,210,384,1538,2962,10,30538,1696,0,2,9,7,0
9388,231,4718,1457,730,1242,11,6,188,1468,10,292,166,329,302,495,2424,4078,5,22973,1276,1,2,20,15,0
9389,231,4718,74,35,59,1,0,14,75,3,14,7,14,17,21,58,85,1,128,7,0,2,20,15,0
9390,231,4718,245,125,200,5,7,34,250,7,30,17,34,37,51,166,265,3,1053,58,0,2,20,15,0
9391,26,866,1455,414,1257,16,76,112,1471,5,41,23,46,46,69,231,381,2,1069,59,0,2,8,7,0
9392,26,866,669,365,481,22,61,110,691,15,103,63,122,118,185,747,1273,8,11311,628,0,2,8,7,0
9393,42,1271,1523,757,1297,19,12,193,1542,12,193,117,230,205,347,1508,2664,7,19053,1058,0,2,4,16,0
9394,42,1271,701,378,504,33,58,109,734,13,110,68,126,123,194,794,1346,7,10027,557,0,2,4,16,0
9395,172,3904,77,34,69,0,0,8,77,3,24,16,29,27,45,114,213,1,387,21,0,2,3,2,0
9396,172,3904,712,438,573,51,9,84,763,14,102,71,128,116,199,733,1364,8,11988,666,0,2,3,2,0
9397,21,545,1293,570,1093,25,15,163,1318,10,195,123,241,205,364,1516,2795,6,17273,959,0,2,12,8,0
9398,198,4430,722,423,573,19,0,135,741,12,172,101,199,184,300,1320,2257,6,15668,870,0,2,22,17,0
9399,198,4430,1508,847,911,44,250,301,1552,14,148,88,169,162,257,1120,1886,7,15077,837,0,2,22,17,0
9400,18,440,386,256,301,16,9,68,402,4,59,35,69,63,104,355,621,2,1453,80,0,2,11,15,0
9401,18,440,264,131,164,11,41,46,275,6,38,22,40,44,62,214,338,3,1068,59,0,2,11,15,0
9402,114,2480,1043,504,840,53,9,147,1096,9,180,112,198,189,310,1377,2344,4,11604,644,0,2,4,3,0
9403,114,2480,383,288,292,26,6,62,409,11,65,38,67,76,105,429,656,5,3719,206,0,2,4,3,0
9404,89,1565,1178,367,1042,6,15,115,1184,9,94,51,95,103,146,644,976,4,4439,246,0,2,7,4,0
9405,89,1565,177,108,140,8,0,27,185,6,30,16,32,36,48,162,248,3,794,44,0,2,7,4,0
9406,166,3399,1943,715,1694,26,18,214,1969,12,185,120,237,197,357,1436,2721,7,20915,1161,0,2,6,4,0
9407,166,3399,1168,838,957,57,25,144,1225,19,348,224,416,367,640,3018,5452,11,61921,3440,1,2,6,4,0
9408,12,371,442,244,305,14,16,103,456,11,68,45,75,79,120,452,756,6,4588,254,0,2,6,2,0
9409,12,371,182,102,99,11,40,35,193,3,11,6,11,14,17,42,64,1,97,5,0,2,6,2,0
9410,52,1014,1098,241,925,5,10,155,1103,7,46,25,49,53,74,273,423,3,1580,87,0,2,17,18,0
9411,52,1014,282,202,222,14,2,44,296,8,42,24,43,50,67,250,378,4,1548,86,0,2,17,18,0
9412,14,452,42,7,35,4,0,5,46,1,2,1,2,3,3,2,4,0,2,0,0,2,1,1,0
9413,14,452,11,6,10,0,0,1,11,2,4,2,4,6,6,10,15,1,15,0,0,2,1,1,0
9414,132,4072,1660,832,1314,41,38,274,1701,20,312,209,395,332,604,2671,5058,12,64042,3557,1,2,4,1,1
9415,132,4072,1057,646,719,113,100,145,1170,18,215,134,248,233,382,1740,3004,10,31186,1732,1,2,4,1,1
9416,118,3030,1660,832,1314,41,38,274,1701,20,312,209,395,332,604,2671,5058,12,64042,3557,1,2,22,0,1
9417,133,4121,1660,832,1314,41,38,274,1701,20,312,209,395,332,604,2671,5058,12,64042,3557,1,2,10,5,0
9418,133,4121,1057,646,719,113,100,145,1170,18,215,134,248,233,382,1740,3004,10,31186,1732,1,2,10,5,0
9419,131,4107,1660,832,1314,41,38,274,1701,20,312,209,395,332,604,2671,5058,12,64042,3557,1,2,12,8,0
9420,131,4107,1057,646,719,113,100,145,1170,18,215,134,248,233,382,1740,3004,10,31186,1732,1,2,12,8,0
9421,118,3030,1660,832,1314,41,38,274,1701,20,312,209,395,332,604,2671,5058,12,64042,3557,1,2,22,0,0
9422,113,2247,1513,682,1277,25,13,200,1538,11,199,116,219,210,335,1557,2584,6,15641,868,0,2,1,0,0
9423,113,2247,819,519,539,24,98,155,843,15,96,57,106,111,163,690,1107,8,9171,509,0,2,1,0,0
9424,14,452,42,7,35,4,0,5,46,1,2,1,2,3,3,2,4,0,2,0,0,2,1,1,0
9425,14,452,11,6,10,0,0,1,11,2,4,2,4,6,6,10,15,1,15,0,0,2,1,1,0
9426,109,4195,1513,682,1277,25,13,200,1538,11,199,116,219,210,335,1557,2584,6,15641,868,0,2,10,0,0
9427,114,2252,1513,682,1277,25,13,200,1538,11,199,116,219,210,335,1557,2584,6,15641,868,0,2,2,1,1
9428,114,2252,819,519,539,24,98,155,843,15,96,57,106,111,163,690,1107,8,9171,509,0,2,2,1,1
9429,114,2261,1513,682,1277,25,13,200,1538,11,199,116,219,210,335,1557,2584,6,15641,868,0,2,6,2,1
9430,114,2261,819,519,539,24,98,155,843,15,96,57,106,111,163,690,1107,8,9171,509,0,2,6,2,1
9431,114,2261,1513,682,1277,25,13,200,1538,11,199,116,219,210,335,1557,2584,6,15641,868,0,2,3,3,1
9432,114,2261,819,519,539,24,98,155,843,15,96,57,106,111,163,690,1107,8,9171,509,0,2,3,3,1
9433,7,103,38,23,23,0,0,15,38,0,0,0,0,0,0,0,0,0,0,0,0,2,1,1,1
9434,14,452,42,7,35,4,0,5,46,1,2,1,2,3,3,2,4,0,2,0,0,2,1,1,1
9435,14,452,11,6,10,0,0,1,11,2,4,2,4,6,6,10,15,1,15,0,0,2,1,1,1
9436,1,288,382,65,130,157,2,92,539,4,10,5,10,14,15,41,57,2,114,6,0,2,2,2,0
9437,14,452,42,7,35,4,0,5,46,1,2,1,2,3,3,2,4,0,2,0,0,2,1,1,0
9438,14,452,11,6,10,0,0,1,11,2,4,2,4,6,6,10,15,1,15,0,0,2,1,1,0
9439,114,2255,1513,682,1277,25,13,200,1538,11,199,116,219,210,335,1557,2584,6,15641,868,0,2,2,6,0
9440,114,2255,819,519,539,24,98,155,843,15,96,57,106,111,163,690,1107,8,9171,509,0,2,2,6,0
9441,114,2264,1513,682,1277,25,13,200,1538,11,199,116,219,210,335,1557,2584,6,15641,868,0,2,2,0,0
9442,114,2264,819,519,539,24,98,155,843,15,96,57,106,111,163,690,1107,8,9171,509,0,2,2,0,0
9443,173,3920,77,34,69,0,0,8,77,3,24,16,29,27,45,114,213,1,387,21,0,2,2,0,0
9444,173,3920,712,438,573,51,9,84,763,14,102,71,128,116,199,733,1364,8,11988,666,0,2,2,0,0
9445,131,4107,1660,832,1314,41,38,274,1701,20,312,209,395,332,604,2671,5058,12,64042,3557,1,2,12,8,0
9446,131,4107,1057,646,719,113,100,145,1170,18,215,134,248,233,382,1740,3004,10,31186,1732,1,2,12,8,0
9447,77,1700,477,336,357,30,23,73,507,16,194,134,250,210,384,1538,2962,10,30538,1696,0,2,9,7,0
9448,113,2247,1513,682,1277,25,13,200,1538,11,199,116,219,210,335,1557,2584,6,15641,868,0,2,1,0,0
9449,113,2247,819,519,539,24,98,155,843,15,96,57,106,111,163,690,1107,8,9171,509,0,2,1,0,0
9450,231,4718,1457,730,1242,11,6,188,1468,10,292,166,329,302,495,2424,4078,5,22973,1276,1,2,21,25,0
9451,231,4718,74,35,59,1,0,14,75,3,14,7,14,17,21,58,85,1,128,7,0,2,21,25,0
9452,231,4718,245,125,200,5,7,34,250,7,30,17,34,37,51,166,265,3,1053,58,0,2,21,25,0
9453,26,866,1455,414,1257,16,76,112,1471,5,41,23,46,46,69,231,381,2,1069,59,0,2,8,7,0
9454,26,866,669,365,481,22,61,110,691,15,103,63,122,118,185,747,1273,8,11311,628,0,2,8,7,0
9455,42,1271,1523,757,1297,19,12,193,1542,12,193,117,230,205,347,1508,2664,7,19053,1058,0,2,4,16,0
9456,42,1271,701,378,504,33,58,109,734,13,110,68,126,123,194,794,1346,7,10027,557,0,2,4,16,0
9457,172,3904,77,34,69,0,0,8,77,3,24,16,29,27,45,114,213,1,387,21,0,2,3,2,0
9458,172,3904,712,438,573,51,9,84,763,14,102,71,128,116,199,733,1364,8,11988,666,0,2,3,2,0
9459,21,545,1293,570,1093,25,15,163,1318,10,195,123,241,205,364,1516,2795,6,17273,959,0,2,12,8,0
9460,198,4430,722,423,573,19,0,135,741,12,172,101,199,184,300,1320,2257,6,15668,870,0,2,22,17,0
9461,198,4430,1508,847,911,44,250,301,1552,14,148,88,169,162,257,1120,1886,7,15077,837,0,2,22,17,0
9462,18,440,386,256,301,16,9,68,402,4,59,35,69,63,104,355,621,2,1453,80,0,2,11,15,0
9463,18,440,264,131,164,11,41,46,275,6,38,22,40,44,62,214,338,3,1068,59,0,2,11,15,0
9464,114,2480,1043,504,840,53,9,147,1096,9,180,112,198,189,310,1377,2344,4,11604,644,0,2,4,3,0
9465,114,2480,383,288,292,26,6,62,409,11,65,38,67,76,105,429,656,5,3719,206,0,2,4,3,0
9466,89,1565,1178,367,1042,6,15,115,1184,9,94,51,95,103,146,644,976,4,4439,246,0,2,7,4,0
9467,89,1565,177,108,140,8,0,27,185,6,30,16,32,36,48,162,248,3,794,44,0,2,7,4,0
9468,166,3399,1943,715,1694,26,18,214,1969,12,185,120,237,197,357,1436,2721,7,20915,1161,0,2,6,7,0
9469,166,3399,1168,838,957,57,25,144,1225,19,348,224,416,367,640,3018,5452,11,61921,3440,1,2,6,7,0
9470,12,371,442,244,305,14,16,103,456,11,68,45,75,79,120,452,756,6,4588,254,0,2,6,2,0
9471,12,371,182,102,99,11,40,35,193,3,11,6,11,14,17,42,64,1,97,5,0,2,6,2,0
9472,52,1014,1098,241,925,5,10,155,1103,7,46,25,49,53,74,273,423,3,1580,87,0,2,17,18,0
9473,52,1014,282,202,222,14,2,44,296,8,42,24,43,50,67,250,378,4,1548,86,0,2,17,18,0
9474,1,288,382,65,130,157,2,92,539,4,10,5,10,14,15,41,57,2,114,6,0,2,2,2,0
9475,7,103,38,23,23,0,0,15,38,0,0,0,0,0,0,0,0,0,0,0,0,2,1,1,0
9476,14,452,42,7,35,4,0,5,46,1,2,1,2,3,3,2,4,0,2,0,0,2,1,1,0
9477,14,452,11,6,10,0,0,1,11,2,4,2,4,6,6,10,15,1,15,0,0,2,1,1,0
9478,128,5483,139,89,101,2,0,35,141,7,54,34,62,61,96,330,569,4,2287,127,0,2,28,28,0
9479,128,5483,7,5,5,0,0,2,7,1,2,1,2,3,3,2,4,0,2,0,0,2,28,28,0
9480,118,3030,1660,832,1314,41,38,274,1701,20,312,209,395,332,604,2671,5058,12,64042,3557,1,2,22,0,0
9481,109,4195,1513,682,1277,25,13,200,1538,11,199,116,219,210,335,1557,2584,6,15641,868,0,2,10,0,0
9482,27,1535,652,304,544,16,6,88,668,6,89,51,101,95,152,591,998,3,3399,188,0,2,1,1,0
9483,37,2191,334,251,279,10,4,40,344,5,127,74,143,132,217,899,1528,2,4303,239,0,2,0,15,0
9484,61,2682,1943,715,1694,26,18,214,1969,12,185,120,237,197,357,1436,2721,7,20915,1161,0,2,9,9,0
9485,14,452,42,7,35,4,0,5,46,1,2,1,2,3,3,2,4,0,2,0,0,2,1,1,1
9486,14,452,11,6,10,0,0,1,11,2,4,2,4,6,6,10,15,1,15,0,0,2,1,1,1
9487,50,2018,1043,504,840,53,9,147,1096,9,180,112,198,189,310,1377,2344,4,11604,644,0,2,10,1,1
9488,133,4157,1660,832,1314,41,38,274,1701,20,312,209,395,332,604,2671,5058,12,64042,3557,1,2,9,1,1
9489,133,4157,1057,646,719,113,100,145,1170,18,215,134,248,233,382,1740,3004,10,31186,1732,1,2,9,1,1
9490,121,3087,1660,832,1314,41,38,274,1701,20,312,209,395,332,604,2671,5058,12,64042,3557,1,2,11,0,1
9491,110,4226,1513,682,1277,25,13,200,1538,11,199,116,219,210,335,1557,2584,6,15641,868,0,2,10,0,1
9492,133,4158,1660,832,1314,41,38,274,1701,20,312,209,395,332,604,2671,5058,12,64042,3557,1,2,7,0,0
9493,133,4158,1057,646,719,113,100,145,1170,18,215,134,248,233,382,1740,3004,10,31186,1732,1,2,7,0,0
9494,133,4158,1660,832,1314,41,38,274,1701,20,312,209,395,332,604,2671,5058,12,64042,3557,1,2,6,3,0
9495,133,4158,1057,646,719,113,100,145,1170,18,215,134,248,233,382,1740,3004,10,31186,1732,1,2,6,3,0
9496,136,4252,1660,832,1314,41,38,274,1701,20,312,209,395,332,604,2671,5058,12,64042,3557,1,2,118,6,1
9497,136,4252,1057,646,719,113,100,145,1170,18,215,134,248,233,382,1740,3004,10,31186,1732,1,2,118,6,1
9498,77,1717,477,336,357,30,23,73,507,16,194,134,250,210,384,1538,2962,10,30538,1696,0,2,5,4,1
9499,60,1070,282,196,195,3,0,86,285,8,130,71,141,138,212,936,1507,4,6538,363,0,2,24,0,1
9500,63,2320,1450,624,1228,12,26,181,1462,14,306,186,354,320,540,2580,4493,8,36391,2021,1,2,79,1,1
9501,122,3201,1660,832,1314,41,38,274,1701,20,312,209,395,332,604,2671,5058,12,64042,3557,1,2,50,1,1
9502,1,84,13,10,10,0,0,3,13,1,2,1,2,3,3,2,4,0,2,0,0,2,1,1,0
9503,133,4158,1660,832,1314,41,38,274,1701,20,312,209,395,332,604,2671,5058,12,64042,3557,1,2,19,1,0
9504,133,4158,1057,646,719,113,100,145,1170,18,215,134,248,233,382,1740,3004,10,31186,1732,1,2,19,1,0
9505,121,3087,1660,832,1314,41,38,274,1701,20,312,209,395,332,604,2671,5058,12,64042,3557,1,2,11,0,0
9506,50,2028,1043,504,840,53,9,147,1096,9,180,112,198,189,310,1377,2344,4,11604,644,0,2,1,0,0
9507,133,4206,1660,832,1314,41,38,274,1701,20,312,209,395,332,604,2671,5058,12,64042,3557,1,2,22,17,1
9508,133,4206,1057,646,719,113,100,145,1170,18,215,134,248,233,382,1740,3004,10,31186,1732,1,2,22,17,1
9509,121,3095,1660,832,1314,41,38,274,1701,20,312,209,395,332,604,2671,5058,12,64042,3557,1,2,2,2,1
9510,133,4194,1660,832,1314,41,38,274,1701,20,312,209,395,332,604,2671,5058,12,64042,3557,1,2,0,1,0
9511,133,4194,1057,646,719,113,100,145,1170,18,215,134,248,233,382,1740,3004,10,31186,1732,1,2,0,1,0
9512,14,452,42,7,35,4,0,5,46,1,2,1,2,3,3,2,4,0,2,0,0,2,1,1,0
9513,14,452,11,6,10,0,0,1,11,2,4,2,4,6,6,10,15,1,15,0,0,2,1,1,0
9514,50,2028,1043,504,840,53,9,147,1096,9,180,112,198,189,310,1377,2344,4,11604,644,0,2,11,1,0
9515,2,26,6,4,4,0,0,2,6,1,4,2,4,5,6,8,13,0,6,0,0,0,6,0,0
9516,7,292,72,33,56,0,4,12,72,1,1,1,1,2,2,0,2,0,1,0,0,2,1,1,1
9517,38,707,127,75,83,2,11,30,129,4,14,7,14,18,21,61,87,2,175,9,0,2,3,5,1
9518,38,707,652,304,544,16,6,88,668,6,89,51,101,95,152,591,998,3,3399,188,0,2,3,5,1
9519,38,707,2,2,2,0,0,0,2,0,0,0,0,0,0,0,0,0,0,0,0,2,3,5,1
9520,38,707,8,5,5,0,0,3,8,0,0,0,0,0,0,0,0,0,0,0,0,2,3,5,1
9521,38,707,2,2,2,0,0,0,2,0,0,0,0,0,0,0,0,0,0,0,0,2,3,5,1
9522,38,707,14,8,8,0,0,6,14,0,0,0,0,0,0,0,0,0,0,0,0,2,3,5,1
9523,38,707,6,4,4,0,0,2,6,0,0,0,0,0,0,0,0,0,0,0,0,2,3,5,1
9524,38,707,6,4,4,0,0,2,6,1,2,1,2,3,3,2,4,0,2,0,0,2,3,5,1
9525,38,707,6,4,4,0,0,2,6,0,0,0,0,0,0,0,0,0,0,0,0,2,3,5,1
9526,38,707,7,5,5,0,0,2,7,0,0,0,0,0,0,0,0,0,0,0,0,2,3,5,1
9527,38,707,6,4,4,0,0,2,6,0,0,0,0,0,0,0,0,0,0,0,0,2,3,5,1
9528,38,707,10,6,6,0,0,4,10,0,0,0,0,0,0,0,0,0,0,0,0,2,3,5,1
9529,38,707,1,1,1,0,0,0,1,0,0,0,0,0,0,0,0,0,0,0,0,2,3,5,1
9530,38,707,1,1,1,0,0,0,1,0,0,0,0,0,0,0,0,0,0,0,0,2,3,5,1
9531,38,707,14,10,10,0,0,4,14,1,1,1,1,2,2,0,2,0,1,0,0,2,3,5,1
9532,38,707,46,26,30,3,0,12,49,3,6,3,6,9,9,20,28,1,42,2,0,2,3,5,1
9533,1,288,382,65,130,157,2,92,539,4,10,5,10,14,15,41,57,2,114,6,0,2,1,1,1
9534,14,452,42,7,35,4,0,5,46,1,2,1,2,3,3,2,4,0,2,0,0,2,2,2,1
9535,14,452,11,6,10,0,0,1,11,2,4,2,4,6,6,10,15,1,15,0,0,2,2,2,1
9536,14,452,42,7,35,4,0,5,46,1,2,1,2,3,3,2,4,0,2,0,0,2,1,1,1
9537,14,452,11,6,10,0,0,1,11,2,4,2,4,6,6,10,15,1,15,0,0,2,1,1,1
9538,113,2252,1513,682,1277,25,13,200,1538,11,199,116,219,210,335,1557,2584,6,15641,868,0,2,1,4,0
9539,113,2252,819,519,539,24,98,155,843,15,96,57,106,111,163,690,1107,8,9171,509,0,2,1,4,0
9540,172,3915,77,34,69,0,0,8,77,3,24,16,29,27,45,114,213,1,387,21,0,2,3,4,0
9541,172,3915,712,438,573,51,9,84,763,14,102,71,128,116,199,733,1364,8,11988,666,0,2,3,4,0
9542,110,4226,1513,682,1277,25,13,200,1538,11,199,116,219,210,335,1557,2584,6,15641,868,0,2,6,6,0
9543,113,2252,1513,682,1277,25,13,200,1538,11,199,116,219,210,335,1557,2584,6,15641,868,0,2,1,1,0
9544,113,2252,819,519,539,24,98,155,843,15,96,57,106,111,163,690,1107,8,9171,509,0,2,1,1,0
9545,172,3915,77,34,69,0,0,8,77,3,24,16,29,27,45,114,213,1,387,21,0,2,3,2,0
9546,172,3915,712,438,573,51,9,84,763,14,102,71,128,116,199,733,1364,8,11988,666,0,2,3,2,0
9547,110,4226,1513,682,1277,25,13,200,1538,11,199,116,219,210,335,1557,2584,6,15641,868,0,2,10,0,0
9548,38,705,127,75,83,2,11,30,129,4,14,7,14,18,21,61,87,2,175,9,0,2,1,1,0
9549,38,705,652,304,544,16,6,88,668,6,89,51,101,95,152,591,998,3,3399,188,0,2,1,1,0
9550,38,705,2,2,2,0,0,0,2,0,0,0,0,0,0,0,0,0,0,0,0,2,1,1,0
9551,38,705,8,5,5,0,0,3,8,0,0,0,0,0,0,0,0,0,0,0,0,2,1,1,0
9552,38,705,2,2,2,0,0,0,2,0,0,0,0,0,0,0,0,0,0,0,0,2,1,1,0
9553,38,705,14,8,8,0,0,6,14,0,0,0,0,0,0,0,0,0,0,0,0,2,1,1,0
9554,38,705,6,4,4,0,0,2,6,0,0,0,0,0,0,0,0,0,0,0,0,2,1,1,0
9555,38,705,6,4,4,0,0,2,6,1,2,1,2,3,3,2,4,0,2,0,0,2,1,1,0
9556,38,705,6,4,4,0,0,2,6,0,0,0,0,0,0,0,0,0,0,0,0,2,1,1,0
9557,38,705,7,5,5,0,0,2,7,0,0,0,0,0,0,0,0,0,0,0,0,2,1,1,0
9558,38,705,6,4,4,0,0,2,6,0,0,0,0,0,0,0,0,0,0,0,0,2,1,1,0
9559,38,705,10,6,6,0,0,4,10,0,0,0,0,0,0,0,0,0,0,0,0,2,1,1,0
9560,38,705,1,1,1,0,0,0,1,0,0,0,0,0,0,0,0,0,0,0,0,2,1,1,0
9561,38,705,1,1,1,0,0,0,1,0,0,0,0,0,0,0,0,0,0,0,0,2,1,1,0
9562,38,705,14,10,10,0,0,4,14,1,1,1,1,2,2,0,2,0,1,0,0,2,1,1,0
9563,38,705,46,26,30,3,0,12,49,3,6,3,6,9,9,20,28,1,42,2,0,2,1,1,0
9564,14,452,42,7,35,4,0,5,46,1,2,1,2,3,3,2,4,0,2,0,0,2,1,1,1
9565,14,452,11,6,10,0,0,1,11,2,4,2,4,6,6,10,15,1,15,0,0,2,1,1,1
9566,455,10020,72,33,56,0,4,12,72,1,1,1,1,2,2,0,2,0,1,0,0,2,6,1,1
9567,455,10020,1454,835,1044,76,110,219,1530,17,275,158,296,292,454,2297,3718,9,34017,1889,1,2,6,1,1
9568,14,452,42,7,35,4,0,5,46,1,2,1,2,3,3,2,4,0,2,0,0,2,1,1,1
9569,14,452,11,6,10,0,0,1,11,2,4,2,4,6,6,10,15,1,15,0,0,2,1,1,1
9570,129,5619,139,89,101,2,0,35,141,7,54,34,62,61,96,330,569,4,2287,127,0,2,34,0,1
9571,129,5619,7,5,5,0,0,2,7,1,2,1,2,3,3,2,4,0,2,0,0,2,34,0,1
9572,455,10020,72,33,56,0,4,12,72,1,1,1,1,2,2,0,2,0,1,0,0,2,6,1,0
9573,455,10020,1454,835,1044,76,110,219,1530,17,275,158,296,292,454,2297,3718,9,34017,1889,1,2,6,1,0
9574,14,452,42,7,35,4,0,5,46,1,2,1,2,3,3,2,4,0,2,0,0,2,1,1,0
9575,14,452,11,6,10,0,0,1,11,2,4,2,4,6,6,10,15,1,15,0,0,2,1,1,0
9576,129,5619,139,89,101,2,0,35,141,7,54,34,62,61,96,330,569,4,2287,127,0,2,34,0,0
9577,129,5619,7,5,5,0,0,2,7,1,2,1,2,3,3,2,4,0,2,0,0,2,34,0,0
9578,42,1271,1523,757,1297,19,12,193,1542,12,193,117,230,205,347,1508,2664,7,19053,1058,0,2,4,4,1
9579,42,1271,701,378,504,33,58,109,734,13,110,68,126,123,194,794,1346,7,10027,557,0,2,4,4,1
9580,39,2430,1523,757,1297,19,12,193,1542,12,193,117,230,205,347,1508,2664,7,19053,1058,0,2,2,2,1
9581,46,451,647,139,84,35,284,233,682,0,0,0,0,0,0,0,0,0,0,0,0,2,2,0,1
9582,21,554,1293,570,1093,25,15,163,1318,10,195,123,241,205,364,1516,2795,6,17273,959,0,2,1,0,1
9583,31,1175,1293,570,1093,25,15,163,1318,10,195,123,241,205,364,1516,2795,6,17273,959,0,2,18,0,1
9584,113,2255,1513,682,1277,25,13,200,1538,11,199,116,219,210,335,1557,2584,6,15641,868,0,2,3,0,0
9585,113,2255,819,519,539,24,98,155,843,15,96,57,106,111,163,690,1107,8,9171,509,0,2,3,0,0
9586,111,4253,1513,682,1277,25,13,200,1538,11,199,116,219,210,335,1557,2584,6,15641,868,0,2,12,0,0
9587,113,2255,1513,682,1277,25,13,200,1538,11,199,116,219,210,335,1557,2584,6,15641,868,0,2,3,0,0
9588,113,2255,819,519,539,24,98,155,843,15,96,57,106,111,163,690,1107,8,9171,509,0,2,3,0,0
9589,111,4253,1513,682,1277,25,13,200,1538,11,199,116,219,210,335,1557,2584,6,15641,868,0,2,12,0,0
9590,111,4259,1513,682,1277,25,13,200,1538,11,199,116,219,210,335,1557,2584,6,15641,868,0,2,2,0,0
9591,111,4259,1513,682,1277,25,13,200,1538,11,199,116,219,210,335,1557,2584,6,15641,868,0,2,2,0,0
9592,138,4339,1660,832,1314,41,38,274,1701,20,312,209,395,332,604,2671,5058,12,64042,3557,1,2,118,6,0
9593,138,4339,1057,646,719,113,100,145,1170,18,215,134,248,233,382,1740,3004,10,31186,1732,1,2,118,6,0
9594,77,1717,477,336,357,30,23,73,507,16,194,134,250,210,384,1538,2962,10,30538,1696,0,2,5,4,0
9595,60,1070,282,196,195,3,0,86,285,8,130,71,141,138,212,936,1507,4,6538,363,0,2,24,0,0
9596,1,84,13,10,10,0,0,3,13,1,2,1,2,3,3,2,4,0,2,0,0,2,1,1,0
9597,63,2320,1450,624,1228,12,26,181,1462,14,306,186,354,320,540,2580,4493,8,36391,2021,1,2,79,1,0
9598,125,3266,1660,832,1314,41,38,274,1701,20,312,209,395,332,604,2671,5058,12,64042,3557,1,2,50,1,0
9599,42,1271,1523,757,1297,19,12,193,1542,12,193,117,230,205,347,1508,2664,7,19053,1058,0,2,4,4,0
9600,42,1271,701,378,504,33,58,109,734,13,110,68,126,123,194,794,1346,7,10027,557,0,2,4,4,0
9601,39,2430,1523,757,1297,19,12,193,1542,12,193,117,230,205,347,1508,2664,7,19053,1058,0,2,2,2,0
9602,46,451,647,139,84,35,284,233,682,0,0,0,0,0,0,0,0,0,0,0,0,2,2,0,0
9603,21,554,1293,570,1093,25,15,163,1318,10,195,123,241,205,364,1516,2795,6,17273,959,0,2,1,0,0
9604,31,1175,1293,570,1093,25,15,163,1318,10,195,123,241,205,364,1516,2795,6,17273,959,0,2,18,0,0
9605,87,1541,1178,367,1042,6,15,115,1184,9,94,51,95,103,146,644,976,4,4439,246,0,2,1,4,0
9606,87,1541,177,108,140,8,0,27,185,6,30,16,32,36,48,162,248,3,794,44,0,2,1,4,0
9607,47,2040,1178,367,1042,6,15,115,1184,9,94,51,95,103,146,644,976,4,4439,246,0,2,20,0,0
9608,14,452,42,7,35,4,0,5,46,1,2,1,2,3,3,2,4,0,2,0,0,2,2,2,1
9609,14,452,11,6,10,0,0,1,11,2,4,2,4,6,6,10,15,1,15,0,0,2,2,2,1
9610,1,288,382,65,130,157,2,92,539,4,10,5,10,14,15,41,57,2,114,6,0,2,1,1,0
9611,14,452,42,7,35,4,0,5,46,1,2,1,2,3,3,2,4,0,2,0,0,2,1,1,0
9612,14,452,11,6,10,0,0,1,11,2,4,2,4,6,6,10,15,1,15,0,0,2,1,1,0
9613,85,1860,477,336,357,30,23,73,507,16,194,134,250,210,384,1538,2962,10,30538,1696,0,2,33,6,0
9614,64,2475,1450,624,1228,12,26,181,1462,14,306,186,354,320,540,2580,4493,8,36391,2021,1,2,45,0,0
9615,85,1860,477,336,357,30,23,73,507,16,194,134,250,210,384,1538,2962,10,30538,1696,0,2,33,6,1
9616,64,2475,1450,624,1228,12,26,181,1462,14,306,186,354,320,540,2580,4493,8,36391,2021,1,2,45,0,1
9617,85,1860,477,336,357,30,23,73,507,16,194,134,250,210,384,1538,2962,10,30538,1696,0,2,33,6,0
9618,64,2475,1450,624,1228,12,26,181,1462,14,306,186,354,320,540,2580,4493,8,36391,2021,1,2,45,0,0
9619,85,1860,477,336,357,30,23,73,507,16,194,134,250,210,384,1538,2962,10,30538,1696,0,2,33,6,0
9620,64,2475,1450,624,1228,12,26,181,1462,14,306,186,354,320,540,2580,4493,8,36391,2021,1,2,45,0,0
9621,229,4691,1457,730,1242,11,6,188,1468,10,292,166,329,302,495,2424,4078,5,22973,1276,1,2,2,5,0
9622,229,4691,74,35,59,1,0,14,75,3,14,7,14,17,21,58,85,1,128,7,0,2,2,5,0
9623,229,4691,245,125,200,5,7,34,250,7,30,17,34,37,51,166,265,3,1053,58,0,2,2,5,0
9624,176,4053,77,34,69,0,0,8,77,3,24,16,29,27,45,114,213,1,387,21,0,2,34,9,0
9625,176,4053,712,438,573,51,9,84,763,14,102,71,128,116,199,733,1364,8,11988,666,0,2,34,9,0
9626,456,10021,72,33,56,0,4,12,72,1,1,1,1,2,2,0,2,0,1,0,0,2,8,6,0
9627,456,10021,1454,835,1044,76,110,219,1530,17,275,158,296,292,454,2297,3718,9,34017,1889,1,2,8,6,0
9628,229,4691,1457,730,1242,11,6,188,1468,10,292,166,329,302,495,2424,4078,5,22973,1276,1,2,2,5,1
9629,229,4691,74,35,59,1,0,14,75,3,14,7,14,17,21,58,85,1,128,7,0,2,2,5,1
9630,229,4691,245,125,200,5,7,34,250,7,30,17,34,37,51,166,265,3,1053,58,0,2,2,5,1
9631,176,4053,77,34,69,0,0,8,77,3,24,16,29,27,45,114,213,1,387,21,0,2,34,9,1
9632,176,4053,712,438,573,51,9,84,763,14,102,71,128,116,199,733,1364,8,11988,666,0,2,34,9,1
9633,456,10021,72,33,56,0,4,12,72,1,1,1,1,2,2,0,2,0,1,0,0,2,8,6,1
9634,456,10021,1454,835,1044,76,110,219,1530,17,275,158,296,292,454,2297,3718,9,34017,1889,1,2,8,6,1
9635,24,753,74,35,59,1,0,14,75,3,14,7,14,17,21,58,85,1,128,7,0,2,0,67,0
9636,24,753,245,125,200,5,7,34,250,7,30,17,34,37,51,166,265,3,1053,58,0,2,0,67,0
9637,172,3928,77,34,69,0,0,8,77,3,24,16,29,27,45,114,213,1,387,21,0,2,0,22,0
9638,172,3928,712,438,573,51,9,84,763,14,102,71,128,116,199,733,1364,8,11988,666,0,2,0,22,0
9639,196,4405,722,423,573,19,0,135,741,12,172,101,199,184,300,1320,2257,6,15668,870,0,2,1,4,0
9640,196,4405,1508,847,911,44,250,301,1552,14,148,88,169,162,257,1120,1886,7,15077,837,0,2,1,4,0
9641,11,343,74,35,59,1,0,14,75,3,14,7,14,17,21,58,85,1,128,7,0,2,1,1,0
9642,16,595,722,423,573,19,0,135,741,12,172,101,199,184,300,1320,2257,6,15668,870,0,2,27,16,0
9643,24,753,74,35,59,1,0,14,75,3,14,7,14,17,21,58,85,1,128,7,0,2,0,67,1
9644,24,753,245,125,200,5,7,34,250,7,30,17,34,37,51,166,265,3,1053,58,0,2,0,67,1
9645,172,3928,77,34,69,0,0,8,77,3,24,16,29,27,45,114,213,1,387,21,0,2,0,22,1
9646,172,3928,712,438,573,51,9,84,763,14,102,71,128,116,199,733,1364,8,11988,666,0,2,0,22,1
9647,196,4405,722,423,573,19,0,135,741,12,172,101,199,184,300,1320,2257,6,15668,870,0,2,1,4,1
9648,196,4405,1508,847,911,44,250,301,1552,14,148,88,169,162,257,1120,1886,7,15077,837,0,2,1,4,1
9649,11,343,74,35,59,1,0,14,75,3,14,7,14,17,21,58,85,1,128,7,0,2,1,1,1
9650,16,595,722,423,573,19,0,135,741,12,172,101,199,184,300,1320,2257,6,15668,870,0,2,27,16,1
9651,46,449,647,139,84,35,284,233,682,0,0,0,0,0,0,0,0,0,0,0,0,2,1,1,0
9652,46,449,647,139,84,35,284,233,682,0,0,0,0,0,0,0,0,0,0,0,0,2,1,1,0
9653,229,4687,1457,730,1242,11,6,188,1468,10,292,166,329,302,495,2424,4078,5,22973,1276,1,2,1,1,0
9654,229,4687,74,35,59,1,0,14,75,3,14,7,14,17,21,58,85,1,128,7,0,2,1,1,0
9655,229,4687,245,125,200,5,7,34,250,7,30,17,34,37,51,166,265,3,1053,58,0,2,1,1,0
9656,24,743,74,35,59,1,0,14,75,3,14,7,14,17,21,58,85,1,128,7,0,2,2,3,0
9657,24,743,245,125,200,5,7,34,250,7,30,17,34,37,51,166,265,3,1053,58,0,2,2,3,0
9658,8,257,74,35,59,1,0,14,75,3,14,7,14,17,21,58,85,1,128,7,0,2,1,14,0
9659,229,4687,1457,730,1242,11,6,188,1468,10,292,166,329,302,495,2424,4078,5,22973,1276,1,2,1,1,1
9660,229,4687,74,35,59,1,0,14,75,3,14,7,14,17,21,58,85,1,128,7,0,2,1,1,1
9661,229,4687,245,125,200,5,7,34,250,7,30,17,34,37,51,166,265,3,1053,58,0,2,1,1,1
9662,24,743,74,35,59,1,0,14,75,3,14,7,14,17,21,58,85,1,128,7,0,2,2,3,1
9663,24,743,245,125,200,5,7,34,250,7,30,17,34,37,51,166,265,3,1053,58,0,2,2,3,1
9664,8,257,74,35,59,1,0,14,75,3,14,7,14,17,21,58,85,1,128,7,0,2,1,14,1
9665,172,3915,77,34,69,0,0,8,77,3,24,16,29,27,45,114,213,1,387,21,0,2,1,1,0
9666,172,3915,712,438,573,51,9,84,763,14,102,71,128,116,199,733,1364,8,11988,666,0,2,1,1,0
9667,172,3915,77,34,69,0,0,8,77,3,24,16,29,27,45,114,213,1,387,21,0,2,1,1,0
9668,172,3915,712,438,573,51,9,84,763,14,102,71,128,116,199,733,1364,8,11988,666,0,2,1,1,0
9669,455,10020,72,33,56,0,4,12,72,1,1,1,1,2,2,0,2,0,1,0,0,2,3,3,0
9670,455,10020,1454,835,1044,76,110,219,1530,17,275,158,296,292,454,2297,3718,9,34017,1889,1,2,3,3,0
9671,455,10020,72,33,56,0,4,12,72,1,1,1,1,2,2,0,2,0,1,0,0,2,3,3,1
9672,455,10020,1454,835,1044,76,110,219,1530,17,275,158,296,292,454,2297,3718,9,34017,1889,1,2,3,3,1
9673,172,3915,77,34,69,0,0,8,77,3,24,16,29,27,45,114,213,1,387,21,0,2,1,1,0
9674,172,3915,712,438,573,51,9,84,763,14,102,71,128,116,199,733,1364,8,11988,666,0,2,1,1,0
9675,455,10020,72,33,56,0,4,12,72,1,1,1,1,2,2,0,2,0,1,0,0,2,3,3,0
9676,455,10020,1454,835,1044,76,110,219,1530,17,275,158,296,292,454,2297,3718,9,34017,1889,1,2,3,3,0
9677,172,3915,77,34,69,0,0,8,77,3,24,16,29,27,45,114,213,1,387,21,0,2,1,1,0
9678,172,3915,712,438,573,51,9,84,763,14,102,71,128,116,199,733,1364,8,11988,666,0,2,1,1,0
9679,455,10020,72,33,56,0,4,12,72,1,1,1,1,2,2,0,2,0,1,0,0,2,3,3,0
9680,455,10020,1454,835,1044,76,110,219,1530,17,275,158,296,292,454,2297,3718,9,34017,1889,1,2,3,3,0
9681,186,4159,722,423,573,19,0,135,741,12,172,101,199,184,300,1320,2257,6,15668,870,0,2,12,55,0
9682,186,4159,1508,847,911,44,250,301,1552,14,148,88,169,162,257,1120,1886,7,15077,837,0,2,12,55,0
9683,16,595,722,423,573,19,0,135,741,12,172,101,199,184,300,1320,2257,6,15668,870,0,2,3,3,0
9684,186,4159,722,423,573,19,0,135,741,12,172,101,199,184,300,1320,2257,6,15668,870,0,2,12,55,0
9685,186,4159,1508,847,911,44,250,301,1552,14,148,88,169,162,257,1120,1886,7,15077,837,0,2,12,55,0
9686,16,595,722,423,573,19,0,135,741,12,172,101,199,184,300,1320,2257,6,15668,870,0,2,3,3,0
9687,68,1223,1020,354,843,12,15,144,1032,8,134,77,144,142,221,970,1580,4,6792,377,0,2,5,1,0
9688,55,2363,1020,354,843,12,15,144,1032,8,134,77,144,142,221,970,1580,4,6792,377,0,2,4,3,0
9689,68,1223,1020,354,843,12,15,144,1032,8,134,77,144,142,221,970,1580,4,6792,377,0,2,5,1,1
9690,55,2363,1020,354,843,12,15,144,1032,8,134,77,144,142,221,970,1580,4,6792,377,0,2,4,3,1
9691,173,3969,722,423,573,19,0,135,741,12,172,101,199,184,300,1320,2257,6,15668,870,0,2,82,118,1
9692,173,3969,1508,847,911,44,250,301,1552,14,148,88,169,162,257,1120,1886,7,15077,837,0,2,82,118,1
9693,45,2770,1296,573,1062,40,33,157,1336,8,201,118,231,209,349,1561,2689,4,12365,686,0,2,8,8,1
9694,15,573,722,423,573,19,0,135,741,12,172,101,199,184,300,1320,2257,6,15668,870,0,2,2,23,1
9695,173,3969,722,423,573,19,0,135,741,12,172,101,199,184,300,1320,2257,6,15668,870,0,2,82,118,1
9696,173,3969,1508,847,911,44,250,301,1552,14,148,88,169,162,257,1120,1886,7,15077,837,0,2,82,118,1
9697,45,2770,1296,573,1062,40,33,157,1336,8,201,118,231,209,349,1561,2689,4,12365,686,0,2,8,8,1
9698,15,573,722,423,573,19,0,135,741,12,172,101,199,184,300,1320,2257,6,15668,870,0,2,2,23,1
9699,68,1223,1020,354,843,12,15,144,1032,8,134,77,144,142,221,970,1580,4,6792,377,0,2,5,1,0
9700,55,2363,1020,354,843,12,15,144,1032,8,134,77,144,142,221,970,1580,4,6792,377,0,2,4,3,0
9701,68,1223,1020,354,843,12,15,144,1032,8,134,77,144,142,221,970,1580,4,6792,377,0,2,5,1,0
9702,55,2363,1020,354,843,12,15,144,1032,8,134,77,144,142,221,970,1580,4,6792,377,0,2,4,3,0
9703,455,9950,72,33,56,0,4,12,72,1,1,1,1,2,2,0,2,0,1,0,0,2,16,26,0
9704,455,9950,1454,835,1044,76,110,219,1530,17,275,158,296,292,454,2297,3718,9,34017,1889,1,2,16,26,0
9705,455,9950,72,33,56,0,4,12,72,1,1,1,1,2,2,0,2,0,1,0,0,2,16,26,1
9706,455,9950,1454,835,1044,76,110,219,1530,17,275,158,296,292,454,2297,3718,9,34017,1889,1,2,16,26,1
9707,172,3928,77,34,69,0,0,8,77,3,24,16,29,27,45,114,213,1,387,21,0,2,1,1,0
9708,172,3928,712,438,573,51,9,84,763,14,102,71,128,116,199,733,1364,8,11988,666,0,2,1,1,0
9709,68,1223,1020,354,843,12,15,144,1032,8,134,77,144,142,221,970,1580,4,6792,377,0,2,5,1,0
9710,455,9950,72,33,56,0,4,12,72,1,1,1,1,2,2,0,2,0,1,0,0,2,3,3,0
9711,455,9950,1454,835,1044,76,110,219,1530,17,275,158,296,292,454,2297,3718,9,34017,1889,1,2,3,3,0
9712,55,2363,1020,354,843,12,15,144,1032,8,134,77,144,142,221,970,1580,4,6792,377,0,2,4,3,0
9713,172,3928,77,34,69,0,0,8,77,3,24,16,29,27,45,114,213,1,387,21,0,2,1,1,0
9714,172,3928,712,438,573,51,9,84,763,14,102,71,128,116,199,733,1364,8,11988,666,0,2,1,1,0
9715,68,1223,1020,354,843,12,15,144,1032,8,134,77,144,142,221,970,1580,4,6792,377,0,2,5,1,0
9716,455,9950,72,33,56,0,4,12,72,1,1,1,1,2,2,0,2,0,1,0,0,2,3,3,0
9717,455,9950,1454,835,1044,76,110,219,1530,17,275,158,296,292,454,2297,3718,9,34017,1889,1,2,3,3,0
9718,55,2363,1020,354,843,12,15,144,1032,8,134,77,144,142,221,970,1580,4,6792,377,0,2,4,3,0
9719,138,4352,1660,832,1314,41,38,274,1701,20,312,209,395,332,604,2671,5058,12,64042,3557,1,2,1,1,1
9720,138,4352,1057,646,719,113,100,145,1170,18,215,134,248,233,382,1740,3004,10,31186,1732,1,2,1,1,1
9721,126,3306,1660,832,1314,41,38,274,1701,20,312,209,395,332,604,2671,5058,12,64042,3557,1,2,12,0,1
9722,138,4352,1660,832,1314,41,38,274,1701,20,312,209,395,332,604,2671,5058,12,64042,3557,1,2,1,1,0
9723,138,4352,1057,646,719,113,100,145,1170,18,215,134,248,233,382,1740,3004,10,31186,1732,1,2,1,1,0
9724,126,3306,1660,832,1314,41,38,274,1701,20,312,209,395,332,604,2671,5058,12,64042,3557,1,2,12,0,0
9725,172,3915,77,34,69,0,0,8,77,3,24,16,29,27,45,114,213,1,387,21,0,2,1,1,0
9726,172,3915,712,438,573,51,9,84,763,14,102,71,128,116,199,733,1364,8,11988,666,0,2,1,1,0
9727,68,1223,1020,354,843,12,15,144,1032,8,134,77,144,142,221,970,1580,4,6792,377,0,2,5,1,0
9728,455,10020,72,33,56,0,4,12,72,1,1,1,1,2,2,0,2,0,1,0,0,2,3,3,0
9729,455,10020,1454,835,1044,76,110,219,1530,17,275,158,296,292,454,2297,3718,9,34017,1889,1,2,3,3,0
9730,55,2363,1020,354,843,12,15,144,1032,8,134,77,144,142,221,970,1580,4,6792,377,0,2,4,3,0
9731,172,3915,77,34,69,0,0,8,77,3,24,16,29,27,45,114,213,1,387,21,0,2,1,1,0
9732,172,3915,712,438,573,51,9,84,763,14,102,71,128,116,199,733,1364,8,11988,666,0,2,1,1,0
9733,68,1223,1020,354,843,12,15,144,1032,8,134,77,144,142,221,970,1580,4,6792,377,0,2,5,1,0
9734,455,10020,72,33,56,0,4,12,72,1,1,1,1,2,2,0,2,0,1,0,0,2,3,3,0
9735,455,10020,1454,835,1044,76,110,219,1530,17,275,158,296,292,454,2297,3718,9,34017,1889,1,2,3,3,0
9736,55,2363,1020,354,843,12,15,144,1032,8,134,77,144,142,221,970,1580,4,6792,377,0,2,4,3,0
9737,138,4352,1660,832,1314,41,38,274,1701,20,312,209,395,332,604,2671,5058,12,64042,3557,1,2,1,1,0
9738,138,4352,1057,646,719,113,100,145,1170,18,215,134,248,233,382,1740,3004,10,31186,1732,1,2,1,1,0
9739,126,3306,1660,832,1314,41,38,274,1701,20,312,209,395,332,604,2671,5058,12,64042,3557,1,2,12,0,0
9740,138,4352,1660,832,1314,41,38,274,1701,20,312,209,395,332,604,2671,5058,12,64042,3557,1,2,1,1,0
9741,138,4352,1057,646,719,113,100,145,1170,18,215,134,248,233,382,1740,3004,10,31186,1732,1,2,1,1,0
9742,126,3306,1660,832,1314,41,38,274,1701,20,312,209,395,332,604,2671,5058,12,64042,3557,1,2,12,0,0
9743,14,452,42,7,35,4,0,5,46,1,2,1,2,3,3,2,4,0,2,0,0,2,1,1,1
9744,14,452,11,6,10,0,0,1,11,2,4,2,4,6,6,10,15,1,15,0,0,2,1,1,1
9745,229,4687,1457,730,1242,11,6,188,1468,10,292,166,329,302,495,2424,4078,5,22973,1276,1,2,3,6,0
9746,229,4687,74,35,59,1,0,14,75,3,14,7,14,17,21,58,85,1,128,7,0,2,3,6,0
9747,229,4687,245,125,200,5,7,34,250,7,30,17,34,37,51,166,265,3,1053,58,0,2,3,6,0
9748,24,743,74,35,59,1,0,14,75,3,14,7,14,17,21,58,85,1,128,7,0,2,2,70,0
9749,24,743,245,125,200,5,7,34,250,7,30,17,34,37,51,166,265,3,1053,58,0,2,2,70,0
9750,46,449,647,139,84,35,284,233,682,0,0,0,0,0,0,0,0,0,0,0,0,2,1,1,0
9751,172,3928,77,34,69,0,0,8,77,3,24,16,29,27,45,114,213,1,387,21,0,2,11,8,0
9752,172,3928,712,438,573,51,9,84,763,14,102,71,128,116,199,733,1364,8,11988,666,0,2,11,8,0
9753,173,3969,722,423,573,19,0,135,741,12,172,101,199,184,300,1320,2257,6,15668,870,0,2,89,171,0
9754,173,3969,1508,847,911,44,250,301,1552,14,148,88,169,162,257,1120,1886,7,15077,837,0,2,89,171,0
9755,455,9950,72,33,56,0,4,12,72,1,1,1,1,2,2,0,2,0,1,0,0,2,24,32,0
9756,455,9950,1454,835,1044,76,110,219,1530,17,275,158,296,292,454,2297,3718,9,34017,1889,1,2,24,32,0
9757,45,2770,1296,573,1062,40,33,157,1336,8,201,118,231,209,349,1561,2689,4,12365,686,0,2,8,8,0
9758,8,257,74,35,59,1,0,14,75,3,14,7,14,17,21,58,85,1,128,7,0,2,1,14,0
9759,15,573,722,423,573,19,0,135,741,12,172,101,199,184,300,1320,2257,6,15668,870,0,2,25,35,0
9760,229,4687,1457,730,1242,11,6,188,1468,10,292,166,329,302,495,2424,4078,5,22973,1276,1,2,3,6,0
9761,229,4687,74,35,59,1,0,14,75,3,14,7,14,17,21,58,85,1,128,7,0,2,3,6,0
9762,229,4687,245,125,200,5,7,34,250,7,30,17,34,37,51,166,265,3,1053,58,0,2,3,6,0
9763,24,743,74,35,59,1,0,14,75,3,14,7,14,17,21,58,85,1,128,7,0,2,2,70,0
9764,24,743,245,125,200,5,7,34,250,7,30,17,34,37,51,166,265,3,1053,58,0,2,2,70,0
9765,46,449,647,139,84,35,284,233,682,0,0,0,0,0,0,0,0,0,0,0,0,2,1,1,0
9766,172,3928,77,34,69,0,0,8,77,3,24,16,29,27,45,114,213,1,387,21,0,2,11,8,0
9767,172,3928,712,438,573,51,9,84,763,14,102,71,128,116,199,733,1364,8,11988,666,0,2,11,8,0
9768,173,3969,722,423,573,19,0,135,741,12,172,101,199,184,300,1320,2257,6,15668,870,0,2,89,171,0
9769,173,3969,1508,847,911,44,250,301,1552,14,148,88,169,162,257,1120,1886,7,15077,837,0,2,89,171,0
9770,455,9950,72,33,56,0,4,12,72,1,1,1,1,2,2,0,2,0,1,0,0,2,24,32,0
9771,455,9950,1454,835,1044,76,110,219,1530,17,275,158,296,292,454,2297,3718,9,34017,1889,1,2,24,32,0
9772,45,2770,1296,573,1062,40,33,157,1336,8,201,118,231,209,349,1561,2689,4,12365,686,0,2,8,8,0
9773,8,257,74,35,59,1,0,14,75,3,14,7,14,17,21,58,85,1,128,7,0,2,1,14,0
9774,15,573,722,423,573,19,0,135,741,12,172,101,199,184,300,1320,2257,6,15668,870,0,2,25,35,0
9775,30,853,465,148,393,5,8,60,470,4,31,20,31,35,51,161,261,2,523,29,0,2,54,1,1
9776,30,853,16,12,9,0,0,6,16,1,2,1,2,3,3,2,4,0,2,0,0,2,54,1,1
9777,173,3969,722,423,573,19,0,135,741,12,172,101,199,184,300,1320,2257,6,15668,870,0,2,2,2,0
9778,173,3969,1508,847,911,44,250,301,1552,14,148,88,169,162,257,1120,1886,7,15077,837,0,2,2,2,0
9779,173,3969,722,423,573,19,0,135,741,12,172,101,199,184,300,1320,2257,6,15668,870,0,2,2,2,1
9780,173,3969,1508,847,911,44,250,301,1552,14,148,88,169,162,257,1120,1886,7,15077,837,0,2,2,2,1
9781,30,982,1455,414,1257,16,76,112,1471,5,41,23,46,46,69,231,381,2,1069,59,0,2,26,2,0
9782,30,982,669,365,481,22,61,110,691,15,103,63,122,118,185,747,1273,8,11311,628,0,2,26,2,0
9783,25,1094,1455,414,1257,16,76,112,1471,5,41,23,46,46,69,231,381,2,1069,59,0,2,34,0,0
9784,30,982,1455,414,1257,16,76,112,1471,5,41,23,46,46,69,231,381,2,1069,59,0,2,26,2,1
9785,30,982,669,365,481,22,61,110,691,15,103,63,122,118,185,747,1273,8,11311,628,0,2,26,2,1
9786,25,1094,1455,414,1257,16,76,112,1471,5,41,23,46,46,69,231,381,2,1069,59,0,2,34,0,1
9787,29,974,1455,414,1257,16,76,112,1471,5,41,23,46,46,69,231,381,2,1069,59,0,2,0,3,0
9788,29,974,669,365,481,22,61,110,691,15,103,63,122,118,185,747,1273,8,11311,628,0,2,0,3,0
9789,29,974,1455,414,1257,16,76,112,1471,5,41,23,46,46,69,231,381,2,1069,59,0,2,0,3,1
9790,29,974,669,365,481,22,61,110,691,15,103,63,122,118,185,747,1273,8,11311,628,0,2,0,3,1
9791,27,1182,1455,414,1257,16,76,112,1471,5,41,23,46,46,69,231,381,2,1069,59,0,2,26,0,0
9792,27,1182,1455,414,1257,16,76,112,1471,5,41,23,46,46,69,231,381,2,1069,59,0,2,26,0,0
9793,111,2245,1513,682,1277,25,13,200,1538,11,199,116,219,210,335,1557,2584,6,15641,868,0,2,17,22,0
9794,111,2245,819,519,539,24,98,155,843,15,96,57,106,111,163,690,1107,8,9171,509,0,2,17,22,0
9795,24,750,74,35,59,1,0,14,75,3,14,7,14,17,21,58,85,1,128,7,0,2,8,5,0
9796,24,750,245,125,200,5,7,34,250,7,30,17,34,37,51,166,265,3,1053,58,0,2,8,5,0
9797,23,371,424,94,331,4,0,89,428,1,5,5,5,6,10,11,25,0,12,0,0,2,1,1,0
9798,23,371,38,23,23,6,0,8,44,3,11,7,11,14,18,42,68,1,102,5,0,2,1,1,0
9799,14,454,184,100,137,2,15,30,186,6,38,20,39,44,59,214,322,3,991,55,0,2,4,3,0
9800,14,454,103,65,74,8,5,16,111,7,17,9,17,24,26,89,119,3,417,23,0,2,4,3,0
9801,454,9966,72,33,56,0,4,12,72,1,1,1,1,2,2,0,2,0,1,0,0,2,24,22,0
9802,454,9966,1454,835,1044,76,110,219,1530,17,275,158,296,292,454,2297,3718,9,34017,1889,1,2,24,22,0
9803,83,1483,1178,367,1042,6,15,115,1184,9,94,51,95,103,146,644,976,4,4439,246,0,2,26,40,0
9804,83,1483,177,108,140,8,0,27,185,6,30,16,32,36,48,162,248,3,794,44,0,2,26,40,0
9805,166,3406,1943,715,1694,26,18,214,1969,12,185,120,237,197,357,1436,2721,7,20915,1161,0,2,4,2,0
9806,166,3406,1168,838,957,57,25,144,1225,19,348,224,416,367,640,3018,5452,11,61921,3440,1,2,4,2,0
9807,51,1012,1098,241,925,5,10,155,1103,7,46,25,49,53,74,273,423,3,1580,87,0,2,26,23,0
9808,51,1012,282,202,222,14,2,44,296,8,42,24,43,50,67,250,378,4,1548,86,0,2,26,23,0
9809,63,2936,1338,495,1086,10,64,173,1348,11,122,82,157,133,239,883,1686,7,11934,663,0,2,9,6,0
9810,55,2363,1020,354,843,12,15,144,1032,8,134,77,144,142,221,970,1580,4,6792,377,0,2,5,3,0
9811,111,2245,1513,682,1277,25,13,200,1538,11,199,116,219,210,335,1557,2584,6,15641,868,0,2,17,22,1
9812,111,2245,819,519,539,24,98,155,843,15,96,57,106,111,163,690,1107,8,9171,509,0,2,17,22,1
9813,24,750,74,35,59,1,0,14,75,3,14,7,14,17,21,58,85,1,128,7,0,2,8,5,1
9814,24,750,245,125,200,5,7,34,250,7,30,17,34,37,51,166,265,3,1053,58,0,2,8,5,1
9815,23,371,424,94,331,4,0,89,428,1,5,5,5,6,10,11,25,0,12,0,0,2,1,1,1
9816,23,371,38,23,23,6,0,8,44,3,11,7,11,14,18,42,68,1,102,5,0,2,1,1,1
9817,14,454,184,100,137,2,15,30,186,6,38,20,39,44,59,214,322,3,991,55,0,2,4,3,1
9818,14,454,103,65,74,8,5,16,111,7,17,9,17,24,26,89,119,3,417,23,0,2,4,3,1
9819,454,9966,72,33,56,0,4,12,72,1,1,1,1,2,2,0,2,0,1,0,0,2,24,22,1
9820,454,9966,1454,835,1044,76,110,219,1530,17,275,158,296,292,454,2297,3718,9,34017,1889,1,2,24,22,1
9821,83,1483,1178,367,1042,6,15,115,1184,9,94,51,95,103,146,644,976,4,4439,246,0,2,26,40,1
9822,83,1483,177,108,140,8,0,27,185,6,30,16,32,36,48,162,248,3,794,44,0,2,26,40,1
9823,166,3406,1943,715,1694,26,18,214,1969,12,185,120,237,197,357,1436,2721,7,20915,1161,0,2,4,2,1
9824,166,3406,1168,838,957,57,25,144,1225,19,348,224,416,367,640,3018,5452,11,61921,3440,1,2,4,2,1
9825,51,1012,1098,241,925,5,10,155,1103,7,46,25,49,53,74,273,423,3,1580,87,0,2,26,23,1
9826,51,1012,282,202,222,14,2,44,296,8,42,24,43,50,67,250,378,4,1548,86,0,2,26,23,1
9827,63,2936,1338,495,1086,10,64,173,1348,11,122,82,157,133,239,883,1686,7,11934,663,0,2,9,6,1
9828,55,2363,1020,354,843,12,15,144,1032,8,134,77,144,142,221,970,1580,4,6792,377,0,2,5,3,1
9829,29,974,1455,414,1257,16,76,112,1471,5,41,23,46,46,69,231,381,2,1069,59,0,2,23,2,0
9830,29,974,669,365,481,22,61,110,691,15,103,63,122,118,185,747,1273,8,11311,628,0,2,23,2,0
9831,27,1182,1455,414,1257,16,76,112,1471,5,41,23,46,46,69,231,381,2,1069,59,0,2,60,0,0
9832,29,974,1455,414,1257,16,76,112,1471,5,41,23,46,46,69,231,381,2,1069,59,0,2,23,2,0
9833,29,974,669,365,481,22,61,110,691,15,103,63,122,118,185,747,1273,8,11311,628,0,2,23,2,0
9834,27,1182,1455,414,1257,16,76,112,1471,5,41,23,46,46,69,231,381,2,1069,59,0,2,60,0,0
9835,29,972,1455,414,1257,16,76,112,1471,5,41,23,46,46,69,231,381,2,1069,59,0,2,0,1,0
9836,29,972,669,365,481,22,61,110,691,15,103,63,122,118,185,747,1273,8,11311,628,0,2,0,1,0
9837,29,972,1455,414,1257,16,76,112,1471,5,41,23,46,46,69,231,381,2,1069,59,0,2,0,1,0
9838,29,972,669,365,481,22,61,110,691,15,103,63,122,118,185,747,1273,8,11311,628,0,2,0,1,0
9839,166,3406,1943,715,1694,26,18,214,1969,12,185,120,237,197,357,1436,2721,7,20915,1161,0,2,1,1,0
9840,166,3406,1168,838,957,57,25,144,1225,19,348,224,416,367,640,3018,5452,11,61921,3440,1,2,1,1,0
9841,166,3406,1943,715,1694,26,18,214,1969,12,185,120,237,197,357,1436,2721,7,20915,1161,0,2,1,1,1
9842,166,3406,1168,838,957,57,25,144,1225,19,348,224,416,367,640,3018,5452,11,61921,3440,1,2,1,1,1
9843,131,3359,1660,832,1314,41,38,274,1701,20,312,209,395,332,604,2671,5058,12,64042,3557,1,2,10,0,1
9844,138,4352,1660,832,1314,41,38,274,1701,20,312,209,395,332,604,2671,5058,12,64042,3557,1,2,1,1,1
9845,138,4352,1057,646,719,113,100,145,1170,18,215,134,248,233,382,1740,3004,10,31186,1732,1,2,1,1,1
9846,138,4352,1660,832,1314,41,38,274,1701,20,312,209,395,332,604,2671,5058,12,64042,3557,1,2,1,1,0
9847,138,4352,1057,646,719,113,100,145,1170,18,215,134,248,233,382,1740,3004,10,31186,1732,1,2,1,1,0
9848,131,3359,1660,832,1314,41,38,274,1701,20,312,209,395,332,604,2671,5058,12,64042,3557,1,2,10,0,0
9849,454,9990,72,33,56,0,4,12,72,1,1,1,1,2,2,0,2,0,1,0,0,2,17,7,1
9850,454,9990,1454,835,1044,76,110,219,1530,17,275,158,296,292,454,2297,3718,9,34017,1889,1,2,17,7,1
9851,47,2824,1296,573,1062,40,33,157,1336,8,201,118,231,209,349,1561,2689,4,12365,686,0,2,24,0,1
9852,138,4358,1660,832,1314,41,38,274,1701,20,312,209,395,332,604,2671,5058,12,64042,3557,1,2,1,1,0
9853,138,4358,1057,646,719,113,100,145,1170,18,215,134,248,233,382,1740,3004,10,31186,1732,1,2,1,1,0
9854,457,10005,72,33,56,0,4,12,72,1,1,1,1,2,2,0,2,0,1,0,0,2,5,1,0
9855,457,10005,1454,835,1044,76,110,219,1530,17,275,158,296,292,454,2297,3718,9,34017,1889,1,2,5,1,0
9856,457,10005,72,33,56,0,4,12,72,1,1,1,1,2,2,0,2,0,1,0,0,2,21,7,0
9857,457,10005,1454,835,1044,76,110,219,1530,17,275,158,296,292,454,2297,3718,9,34017,1889,1,2,21,7,0
9858,47,2824,1296,573,1062,40,33,157,1336,8,201,118,231,209,349,1561,2689,4,12365,686,0,2,24,0,0
9859,465,10107,72,33,56,0,4,12,72,1,1,1,1,2,2,0,2,0,1,0,0,2,38,15,0
9860,465,10107,1454,835,1044,76,110,219,1530,17,275,158,296,292,454,2297,3718,9,34017,1889,1,2,38,15,0
9861,31,888,465,148,393,5,8,60,470,4,31,20,31,35,51,161,261,2,523,29,0,2,54,1,0
9862,31,888,16,12,9,0,0,6,16,1,2,1,2,3,3,2,4,0,2,0,0,2,54,1,0
9863,65,3525,1782,648,1425,9,47,279,1791,8,171,97,189,179,286,1292,2140,4,9462,525,0,2,46,0,0
9864,15,468,184,100,137,2,15,30,186,6,38,20,39,44,59,214,322,3,991,55,0,2,31,16,1
9865,15,468,103,65,74,8,5,16,111,7,17,9,17,24,26,89,119,3,417,23,0,2,31,16,1
9866,11,374,184,100,137,2,15,30,186,6,38,20,39,44,59,214,322,3,991,55,0,2,48,19,1
9867,15,468,184,100,137,2,15,30,186,6,38,20,39,44,59,214,322,3,991,55,0,2,31,16,0
9868,15,468,103,65,74,8,5,16,111,7,17,9,17,24,26,89,119,3,417,23,0,2,31,16,0
9869,11,374,184,100,137,2,15,30,186,6,38,20,39,44,59,214,322,3,991,55,0,2,48,19,0
9870,1,288,382,65,130,157,2,92,539,4,10,5,10,14,15,41,57,2,114,6,0,2,1,1,1
9871,14,452,42,7,35,4,0,5,46,1,2,1,2,3,3,2,4,0,2,0,0,2,1,1,1
9872,14,452,11,6,10,0,0,1,11,2,4,2,4,6,6,10,15,1,15,0,0,2,1,1,1
9873,15,467,184,100,137,2,15,30,186,6,38,20,39,44,59,214,322,3,991,55,0,2,31,16,0
9874,15,467,103,65,74,8,5,16,111,7,17,9,17,24,26,89,119,3,417,23,0,2,31,16,0
9875,11,374,184,100,137,2,15,30,186,6,38,20,39,44,59,214,322,3,991,55,0,2,48,19,0
9876,14,452,42,7,35,4,0,5,46,1,2,1,2,3,3,2,4,0,2,0,0,2,1,1,1
9877,14,452,11,6,10,0,0,1,11,2,4,2,4,6,6,10,15,1,15,0,0,2,1,1,1
9878,139,4400,1660,832,1314,41,38,274,1701,20,312,209,395,332,604,2671,5058,12,64042,3557,1,2,6,1,1
9879,139,4400,1057,646,719,113,100,145,1170,18,215,134,248,233,382,1740,3004,10,31186,1732,1,2,6,1,1
9880,131,3348,1660,832,1314,41,38,274,1701,20,312,209,395,332,604,2671,5058,12,64042,3557,1,2,5,7,1
9881,465,10105,72,33,56,0,4,12,72,1,1,1,1,2,2,0,2,0,1,0,0,2,2,2,0
9882,465,10105,1454,835,1044,76,110,219,1530,17,275,158,296,292,454,2297,3718,9,34017,1889,1,2,2,2,0
9883,139,4400,1660,832,1314,41,38,274,1701,20,312,209,395,332,604,2671,5058,12,64042,3557,1,2,6,1,0
9884,139,4400,1057,646,719,113,100,145,1170,18,215,134,248,233,382,1740,3004,10,31186,1732,1,2,6,1,0
9885,131,3348,1660,832,1314,41,38,274,1701,20,312,209,395,332,604,2671,5058,12,64042,3557,1,2,5,7,0
9886,43,863,447,308,343,6,5,95,453,7,96,59,111,103,170,651,1136,4,4600,255,0,2,23,14,1
9887,43,863,322,174,179,16,74,51,338,10,41,26,46,51,72,252,408,5,2291,127,0,2,23,14,1
9888,465,10120,72,33,56,0,4,12,72,1,1,1,1,2,2,0,2,0,1,0,0,2,11,4,1
9889,465,10120,1454,835,1044,76,110,219,1530,17,275,158,296,292,454,2297,3718,9,34017,1889,1,2,11,4,1
9890,130,5646,139,89,101,2,0,35,141,7,54,34,62,61,96,330,569,4,2287,127,0,2,23,0,1
9891,130,5646,7,5,5,0,0,2,7,1,2,1,2,3,3,2,4,0,2,0,0,2,23,0,1
9892,16,474,184,100,137,2,15,30,186,6,38,20,39,44,59,214,322,3,991,55,0,2,10,6,1
9893,16,474,103,65,74,8,5,16,111,7,17,9,17,24,26,89,119,3,417,23,0,2,10,6,1
9894,16,474,184,100,137,2,15,30,186,6,38,20,39,44,59,214,322,3,991,55,0,2,10,6,0
9895,16,474,103,65,74,8,5,16,111,7,17,9,17,24,26,89,119,3,417,23,0,2,10,6,0
9896,43,1307,1523,757,1297,19,12,193,1542,12,193,117,230,205,347,1508,2664,7,19053,1058,0,2,6,1,1
9897,43,1307,701,378,504,33,58,109,734,13,110,68,126,123,194,794,1346,7,10027,557,0,2,6,1,1
9898,40,2493,1523,757,1297,19,12,193,1542,12,193,117,230,205,347,1508,2664,7,19053,1058,0,2,15,2,1
9899,229,4718,1457,730,1242,11,6,188,1468,10,292,166,329,302,495,2424,4078,5,22973,1276,1,2,2,0,0
9900,229,4718,74,35,59,1,0,14,75,3,14,7,14,17,21,58,85,1,128,7,0,2,2,0,0
9901,229,4718,245,125,200,5,7,34,250,7,30,17,34,37,51,166,265,3,1053,58,0,2,2,0,0
9902,40,1923,1457,730,1242,11,6,188,1468,10,292,166,329,302,495,2424,4078,5,22973,1276,1,2,7,0,0
9903,229,4709,1457,730,1242,11,6,188,1468,10,292,166,329,302,495,2424,4078,5,22973,1276,1,2,1,2,0
9904,229,4709,74,35,59,1,0,14,75,3,14,7,14,17,21,58,85,1,128,7,0,2,1,2,0
9905,229,4709,245,125,200,5,7,34,250,7,30,17,34,37,51,166,265,3,1053,58,0,2,1,2,0
9906,40,1916,1457,730,1242,11,6,188,1468,10,292,166,329,302,495,2424,4078,5,22973,1276,1,2,2,5,0
9907,31,1022,1455,414,1257,16,76,112,1471,5,41,23,46,46,69,231,381,2,1069,59,0,2,13,3,1
9908,31,1022,669,365,481,22,61,110,691,15,103,63,122,118,185,747,1273,8,11311,628,0,2,13,3,1
9909,229,4709,1457,730,1242,11,6,188,1468,10,292,166,329,302,495,2424,4078,5,22973,1276,1,2,1,0,0
9910,229,4709,74,35,59,1,0,14,75,3,14,7,14,17,21,58,85,1,128,7,0,2,1,0,0
9911,229,4709,245,125,200,5,7,34,250,7,30,17,34,37,51,166,265,3,1053,58,0,2,1,0,0
9912,40,1916,1457,730,1242,11,6,188,1468,10,292,166,329,302,495,2424,4078,5,22973,1276,1,2,5,1,0
9913,27,1147,1455,414,1257,16,76,112,1471,5,41,23,46,46,69,231,381,2,1069,59,0,2,0,8,0
9914,31,1169,1293,570,1093,25,15,163,1318,10,195,123,241,205,364,1516,2795,6,17273,959,0,2,0,2,0
9915,27,1147,1455,414,1257,16,76,112,1471,5,41,23,46,46,69,231,381,2,1069,59,0,2,0,8,0
9916,31,1169,1293,570,1093,25,15,163,1318,10,195,123,241,205,364,1516,2795,6,17273,959,0,2,0,2,0
9917,1,288,382,65,130,157,2,92,539,4,10,5,10,14,15,41,57,2,114,6,0,2,1,1,0
9918,27,1147,1455,414,1257,16,76,112,1471,5,41,23,46,46,69,231,381,2,1069,59,0,2,0,8,0
9919,31,1169,1293,570,1093,25,15,163,1318,10,195,123,241,205,364,1516,2795,6,17273,959,0,2,0,2,0
9920,43,1307,1523,757,1297,19,12,193,1542,12,193,117,230,205,347,1508,2664,7,19053,1058,0,2,6,1,0
9921,43,1307,701,378,504,33,58,109,734,13,110,68,126,123,194,794,1346,7,10027,557,0,2,6,1,0
9922,40,2493,1523,757,1297,19,12,193,1542,12,193,117,230,205,347,1508,2664,7,19053,1058,0,2,15,2,0
9923,28,1226,1455,414,1257,16,76,112,1471,5,41,23,46,46,69,231,381,2,1069,59,0,2,16,0,0
9924,247,4978,1457,730,1242,11,6,188,1468,10,292,166,329,302,495,2424,4078,5,22973,1276,1,2,61,10,1
9925,247,4978,74,35,59,1,0,14,75,3,14,7,14,17,21,58,85,1,128,7,0,2,61,10,1
9926,247,4978,245,125,200,5,7,34,250,7,30,17,34,37,51,166,265,3,1053,58,0,2,61,10,1
9927,172,3925,77,34,69,0,0,8,77,3,24,16,29,27,45,114,213,1,387,21,0,2,6,5,1
9928,172,3925,712,438,573,51,9,84,763,14,102,71,128,116,199,733,1364,8,11988,666,0,2,6,5,1
9929,173,3958,722,423,573,19,0,135,741,12,172,101,199,184,300,1320,2257,6,15668,870,0,2,2,4,1
9930,173,3958,1508,847,911,44,250,301,1552,14,148,88,169,162,257,1120,1886,7,15077,837,0,2,2,4,1
9931,464,10112,72,33,56,0,4,12,72,1,1,1,1,2,2,0,2,0,1,0,0,2,1,3,1
9932,464,10112,1454,835,1044,76,110,219,1530,17,275,158,296,292,454,2297,3718,9,34017,1889,1,2,1,3,1
9933,83,1504,1178,367,1042,6,15,115,1184,9,94,51,95,103,146,644,976,4,4439,246,0,2,4,4,1
9934,83,1504,177,108,140,8,0,27,185,6,30,16,32,36,48,162,248,3,794,44,0,2,4,4,1
9935,168,3515,1943,715,1694,26,18,214,1969,12,185,120,237,197,357,1436,2721,7,20915,1161,0,2,31,21,1
9936,168,3515,1168,838,957,57,25,144,1225,19,348,224,416,367,640,3018,5452,11,61921,3440,1,2,31,21,1
9937,47,2824,1296,573,1062,40,33,157,1336,8,201,118,231,209,349,1561,2689,4,12365,686,0,2,2,2,1
9938,47,2300,1457,730,1242,11,6,188,1468,10,292,166,329,302,495,2424,4078,5,22973,1276,1,2,54,2,1
9939,30,1941,652,304,544,16,6,88,668,6,89,51,101,95,152,591,998,3,3399,188,0,2,89,0,1
9940,27,1145,1455,414,1257,16,76,112,1471,5,41,23,46,46,69,231,381,2,1069,59,0,2,0,3,1
9941,61,2681,1943,715,1694,26,18,214,1969,12,185,120,237,197,357,1436,2721,7,20915,1161,0,2,3,3,1
9942,31,1022,1455,414,1257,16,76,112,1471,5,41,23,46,46,69,231,381,2,1069,59,0,2,13,3,0
9943,31,1022,669,365,481,22,61,110,691,15,103,63,122,118,185,747,1273,8,11311,628,0,2,13,3,0
9944,28,1191,1455,414,1257,16,76,112,1471,5,41,23,46,46,69,231,381,2,1069,59,0,2,16,0,0
9945,30,1950,652,304,544,16,6,88,668,6,89,51,101,95,152,591,998,3,3399,188,0,2,84,85,1
9946,465,10120,72,33,56,0,4,12,72,1,1,1,1,2,2,0,2,0,1,0,0,2,1,1,1
9947,465,10120,1454,835,1044,76,110,219,1530,17,275,158,296,292,454,2297,3718,9,34017,1889,1,2,1,1,1
9948,11,370,85,59,61,8,0,16,93,5,18,10,18,23,28,86,126,2,316,17,0,2,2,2,1
9949,111,4259,1513,682,1277,25,13,200,1538,11,199,116,219,210,335,1557,2584,6,15641,868,0,2,1,1,1
9950,465,10120,72,33,56,0,4,12,72,1,1,1,1,2,2,0,2,0,1,0,0,2,1,1,0
9951,465,10120,1454,835,1044,76,110,219,1530,17,275,158,296,292,454,2297,3718,9,34017,1889,1,2,1,1,0
9952,11,370,85,59,61,8,0,16,93,5,18,10,18,23,28,86,126,2,316,17,0,2,2,2,0
9953,111,4259,1513,682,1277,25,13,200,1538,11,199,116,219,210,335,1557,2584,6,15641,868,0,2,1,1,0
9954,11,370,85,59,61,8,0,16,93,5,18,10,18,23,28,86,126,2,316,17,0,2,1,1,0
9955,11,370,85,59,61,8,0,16,93,5,18,10,18,23,28,86,126,2,316,17,0,2,1,1,0
9956,247,4978,1457,730,1242,11,6,188,1468,10,292,166,329,302,495,2424,4078,5,22973,1276,1,2,61,10,0
9957,247,4978,74,35,59,1,0,14,75,3,14,7,14,17,21,58,85,1,128,7,0,2,61,10,0
9958,247,4978,245,125,200,5,7,34,250,7,30,17,34,37,51,166,265,3,1053,58,0,2,61,10,0
9959,172,3925,77,34,69,0,0,8,77,3,24,16,29,27,45,114,213,1,387,21,0,2,6,5,0
9960,172,3925,712,438,573,51,9,84,763,14,102,71,128,116,199,733,1364,8,11988,666,0,2,6,5,0
9961,173,3958,722,423,573,19,0,135,741,12,172,101,199,184,300,1320,2257,6,15668,870,0,2,2,4,0
9962,173,3958,1508,847,911,44,250,301,1552,14,148,88,169,162,257,1120,1886,7,15077,837,0,2,2,4,0
9963,464,10112,72,33,56,0,4,12,72,1,1,1,1,2,2,0,2,0,1,0,0,2,1,3,0
9964,464,10112,1454,835,1044,76,110,219,1530,17,275,158,296,292,454,2297,3718,9,34017,1889,1,2,1,3,0
9965,83,1504,1178,367,1042,6,15,115,1184,9,94,51,95,103,146,644,976,4,4439,246,0,2,4,4,0
9966,83,1504,177,108,140,8,0,27,185,6,30,16,32,36,48,162,248,3,794,44,0,2,4,4,0
9967,168,3515,1943,715,1694,26,18,214,1969,12,185,120,237,197,357,1436,2721,7,20915,1161,0,2,31,21,0
9968,168,3515,1168,838,957,57,25,144,1225,19,348,224,416,367,640,3018,5452,11,61921,3440,1,2,31,21,0
9969,47,2824,1296,573,1062,40,33,157,1336,8,201,118,231,209,349,1561,2689,4,12365,686,0,2,2,2,0
9970,47,2300,1457,730,1242,11,6,188,1468,10,292,166,329,302,495,2424,4078,5,22973,1276,1,2,54,2,0
9971,30,1950,652,304,544,16,6,88,668,6,89,51,101,95,152,591,998,3,3399,188,0,2,88,0,0
9972,28,1189,1455,414,1257,16,76,112,1471,5,41,23,46,46,69,231,381,2,1069,59,0,2,0,3,0
9973,61,2681,1943,715,1694,26,18,214,1969,12,185,120,237,197,357,1436,2721,7,20915,1161,0,2,3,3,0
9974,464,10117,72,33,56,0,4,12,72,1,1,1,1,2,2,0,2,0,1,0,0,2,1,1,1
9975,464,10117,1454,835,1044,76,110,219,1530,17,275,158,296,292,454,2297,3718,9,34017,1889,1,2,1,1,1
9976,14,457,42,7,35,4,0,5,46,1,2,1,2,3,3,2,4,0,2,0,0,2,2,1,1
9977,14,457,11,6,10,0,0,1,11,2,4,2,4,6,6,10,15,1,15,0,0,2,2,1,1
9978,134,5956,139,89,101,2,0,35,141,7,54,34,62,61,96,330,569,4,2287,127,0,2,108,0,1
9979,134,5956,7,5,5,0,0,2,7,1,2,1,2,3,3,2,4,0,2,0,0,2,108,0,1
9980,466,10154,72,33,56,0,4,12,72,1,1,1,1,2,2,0,2,0,1,0,0,2,6,3,1
9981,466,10154,1454,835,1044,76,110,219,1530,17,275,158,296,292,454,2297,3718,9,34017,1889,1,2,6,3,1
9982,64,2966,1338,495,1086,10,64,173,1348,11,122,82,157,133,239,883,1686,7,11934,663,0,2,17,0,1
9983,30,1950,652,304,544,16,6,88,668,6,89,51,101,95,152,591,998,3,3399,188,0,2,4,0,0
9984,465,10151,72,33,56,0,4,12,72,1,1,1,1,2,2,0,2,0,1,0,0,2,4,3,1
9985,465,10151,1454,835,1044,76,110,219,1530,17,275,158,296,292,454,2297,3718,9,34017,1889,1,2,4,3,1
9986,30,1950,652,304,544,16,6,88,668,6,89,51,101,95,152,591,998,3,3399,188,0,2,4,0,0
9987,64,2966,1338,495,1086,10,64,173,1348,11,122,82,157,133,239,883,1686,7,11934,663,0,2,6,6,0
9988,465,10151,72,33,56,0,4,12,72,1,1,1,1,2,2,0,2,0,1,0,0,2,4,3,0
9989,465,10151,1454,835,1044,76,110,219,1530,17,275,158,296,292,454,2297,3718,9,34017,1889,1,2,4,3,0
9990,140,4414,1660,832,1314,41,38,274,1701,20,312,209,395,332,604,2671,5058,12,64042,3557,1,2,6,0,1
9991,140,4414,1057,646,719,113,100,145,1170,18,215,134,248,233,382,1740,3004,10,31186,1732,1,2,6,0,1
9992,132,3417,1660,832,1314,41,38,274,1701,20,312,209,395,332,604,2671,5058,12,64042,3557,1,2,24,0,1
9993,464,10116,72,33,56,0,4,12,72,1,1,1,1,2,2,0,2,0,1,0,0,2,1,1,1
9994,464,10116,1454,835,1044,76,110,219,1530,17,275,158,296,292,454,2297,3718,9,34017,1889,1,2,1,1,1
9995,131,5688,139,89,101,2,0,35,141,7,54,34,62,61,96,330,569,4,2287,127,0,2,31,1,1
9996,131,5688,7,5,5,0,0,2,7,1,2,1,2,3,3,2,4,0,2,0,0,2,31,1,1
9997,464,10116,72,33,56,0,4,12,72,1,1,1,1,2,2,0,2,0,1,0,0,2,1,1,0
9998,464,10116,1454,835,1044,76,110,219,1530,17,275,158,296,292,454,2297,3718,9,34017,1889,1,2,1,1,0
9999,131,5688,139,89,101,2,0,35,141,7,54,34,62,61,96,330,569,4,2287,127,0,2,31,1,0
10000,131,5688,7,5,5,0,0,2,7,1,2,1,2,3,3,2,4,0,2,0,0,2,31,1,0
10001,465,10155,72,33,56,0,4,12,72,1,1,1,1,2,2,0,2,0,1,0,0,2,10,6,0
10002,465,10155,1454,835,1044,76,110,219,1530,17,275,158,296,292,454,2297,3718,9,34017,1889,1,2,10,6,0
10003,14,457,42,7,35,4,0,5,46,1,2,1,2,3,3,2,4,0,2,0,0,2,2,1,0
10004,14,457,11,6,10,0,0,1,11,2,4,2,4,6,6,10,15,1,15,0,0,2,2,1,0
10005,64,2966,1338,495,1086,10,64,173,1348,11,122,82,157,133,239,883,1686,7,11934,663,0,2,20,3,0
10006,135,5998,139,89,101,2,0,35,141,7,54,34,62,61,96,330,569,4,2287,127,0,2,108,0,0
10007,135,5998,7,5,5,0,0,2,7,1,2,1,2,3,3,2,4,0,2,0,0,2,108,0,0
10008,115,2519,1043,504,840,53,9,147,1096,9,180,112,198,189,310,1377,2344,4,11604,644,0,2,11,1,0
10009,115,2519,383,288,292,26,6,62,409,11,65,38,67,76,105,429,656,5,3719,206,0,2,11,1,0
10010,53,2083,1043,504,840,53,9,147,1096,9,180,112,198,189,310,1377,2344,4,11604,644,0,2,15,0,1
10011,53,2083,1043,504,840,53,9,147,1096,9,180,112,198,189,310,1377,2344,4,11604,644,0,2,4,1,1
10012,466,10185,72,33,56,0,4,12,72,1,1,1,1,2,2,0,2,0,1,0,0,2,7,0,0
10013,466,10185,1454,835,1044,76,110,219,1530,17,275,158,296,292,454,2297,3718,9,34017,1889,1,2,7,0,0
10014,66,3583,1782,648,1425,9,47,279,1791,8,171,97,189,179,286,1292,2140,4,9462,525,0,2,15,0,0
10015,466,10182,72,33,56,0,4,12,72,1,1,1,1,2,2,0,2,0,1,0,0,2,2,5,0
10016,466,10182,1454,835,1044,76,110,219,1530,17,275,158,296,292,454,2297,3718,9,34017,1889,1,2,2,5,0
10017,466,10182,72,33,56,0,4,12,72,1,1,1,1,2,2,0,2,0,1,0,0,2,1,1,0
10018,466,10182,1454,835,1044,76,110,219,1530,17,275,158,296,292,454,2297,3718,9,34017,1889,1,2,1,1,0
10019,140,4414,1660,832,1314,41,38,274,1701,20,312,209,395,332,604,2671,5058,12,64042,3557,1,2,6,0,0
10020,140,4414,1057,646,719,113,100,145,1170,18,215,134,248,233,382,1740,3004,10,31186,1732,1,2,6,0,0
10021,132,3417,1660,832,1314,41,38,274,1701,20,312,209,395,332,604,2671,5058,12,64042,3557,1,2,24,0,0
10022,465,10150,72,33,56,0,4,12,72,1,1,1,1,2,2,0,2,0,1,0,0,2,0,1,0
10023,465,10150,1454,835,1044,76,110,219,1530,17,275,158,296,292,454,2297,3718,9,34017,1889,1,2,0,1,0
10024,68,1230,1020,354,843,12,15,144,1032,8,134,77,144,142,221,970,1580,4,6792,377,0,2,3,0,1
10025,466,10184,72,33,56,0,4,12,72,1,1,1,1,2,2,0,2,0,1,0,0,2,3,3,1
10026,466,10184,1454,835,1044,76,110,219,1530,17,275,158,296,292,454,2297,3718,9,34017,1889,1,2,3,3,1
10027,66,3583,1782,648,1425,9,47,279,1791,8,171,97,189,179,286,1292,2140,4,9462,525,0,2,1,1,1
10028,68,1230,1020,354,843,12,15,144,1032,8,134,77,144,142,221,970,1580,4,6792,377,0,2,3,1,1
10029,140,4414,1660,832,1314,41,38,274,1701,20,312,209,395,332,604,2671,5058,12,64042,3557,1,2,6,0,0
10030,140,4414,1057,646,719,113,100,145,1170,18,215,134,248,233,382,1740,3004,10,31186,1732,1,2,6,0,0
10031,466,10179,72,33,56,0,4,12,72,1,1,1,1,2,2,0,2,0,1,0,0,2,0,1,0
10032,466,10179,1454,835,1044,76,110,219,1530,17,275,158,296,292,454,2297,3718,9,34017,1889,1,2,0,1,0
10033,132,3417,1660,832,1314,41,38,274,1701,20,312,209,395,332,604,2671,5058,12,64042,3557,1,2,24,0,0
10034,68,1230,1020,354,843,12,15,144,1032,8,134,77,144,142,221,970,1580,4,6792,377,0,2,5,0,0
10035,466,10179,72,33,56,0,4,12,72,1,1,1,1,2,2,0,2,0,1,0,0,2,5,1,0
10036,466,10179,1454,835,1044,76,110,219,1530,17,275,158,296,292,454,2297,3718,9,34017,1889,1,2,5,1,0
10037,66,3583,1782,648,1425,9,47,279,1791,8,171,97,189,179,286,1292,2140,4,9462,525,0,2,15,0,0
10038,115,2519,1043,504,840,53,9,147,1096,9,180,112,198,189,310,1377,2344,4,11604,644,0,2,11,1,0
10039,115,2519,383,288,292,26,6,62,409,11,65,38,67,76,105,429,656,5,3719,206,0,2,11,1,0
10040,53,2083,1043,504,840,53,9,147,1096,9,180,112,198,189,310,1377,2344,4,11604,644,0,2,18,0,0
10041,68,1230,1020,354,843,12,15,144,1032,8,134,77,144,142,221,970,1580,4,6792,377,0,2,3,3,0
10042,1,288,382,65,130,157,2,92,539,4,10,5,10,14,15,41,57,2,114,6,0,2,2,2,1
10043,7,292,72,33,56,0,4,12,72,1,1,1,1,2,2,0,2,0,1,0,0,2,2,2,1
10044,14,457,42,7,35,4,0,5,46,1,2,1,2,3,3,2,4,0,2,0,0,2,1,1,1
10045,14,457,11,6,10,0,0,1,11,2,4,2,4,6,6,10,15,1,15,0,0,2,1,1,1
10046,135,5990,139,89,101,2,0,35,141,7,54,34,62,61,96,330,569,4,2287,127,0,2,3,4,1
10047,135,5990,7,5,5,0,0,2,7,1,2,1,2,3,3,2,4,0,2,0,0,2,3,4,1
10048,1,288,382,65,130,157,2,92,539,4,10,5,10,14,15,41,57,2,114,6,0,2,1,1,0
10049,14,457,42,7,35,4,0,5,46,1,2,1,2,3,3,2,4,0,2,0,0,2,1,1,0
10050,14,457,11,6,10,0,0,1,11,2,4,2,4,6,6,10,15,1,15,0,0,2,1,1,0
10051,466,10197,72,33,56,0,4,12,72,1,1,1,1,2,2,0,2,0,1,0,0,2,17,16,1
10052,466,10197,1454,835,1044,76,110,219,1530,17,275,158,296,292,454,2297,3718,9,34017,1889,1,2,17,16,1
10053,136,6025,139,89,101,2,0,35,141,7,54,34,62,61,96,330,569,4,2287,127,0,2,21,0,1
10054,136,6025,7,5,5,0,0,2,7,1,2,1,2,3,3,2,4,0,2,0,0,2,21,0,1
10055,1,315,382,65,130,157,2,92,539,4,10,5,10,14,15,41,57,2,114,6,0,2,7,4,1
10056,17,539,42,7,35,4,0,5,46,1,2,1,2,3,3,2,4,0,2,0,0,2,10,1,1
10057,17,539,11,6,10,0,0,1,11,2,4,2,4,6,6,10,15,1,15,0,0,2,10,1,1
10058,1,315,382,65,130,157,2,92,539,4,10,5,10,14,15,41,57,2,114,6,0,2,7,4,0
10059,17,539,42,7,35,4,0,5,46,1,2,1,2,3,3,2,4,0,2,0,0,2,10,1,0
10060,17,539,11,6,10,0,0,1,11,2,4,2,4,6,6,10,15,1,15,0,0,2,10,1,0
10061,1,315,382,65,130,157,2,92,539,4,10,5,10,14,15,41,57,2,114,6,0,2,7,4,0
10062,17,539,42,7,35,4,0,5,46,1,2,1,2,3,3,2,4,0,2,0,0,2,10,1,0
10063,17,539,11,6,10,0,0,1,11,2,4,2,4,6,6,10,15,1,15,0,0,2,10,1,0
10064,21,612,42,7,35,4,0,5,46,1,2,1,2,3,3,2,4,0,2,0,0,2,18,4,1
10065,21,612,11,6,10,0,0,1,11,2,4,2,4,6,6,10,15,1,15,0,0,2,18,4,1
10066,20,614,42,7,35,4,0,5,46,1,2,1,2,3,3,2,4,0,2,0,0,2,4,2,0
10067,20,614,11,6,10,0,0,1,11,2,4,2,4,6,6,10,15,1,15,0,0,2,4,2,0
10068,20,614,42,7,35,4,0,5,46,1,2,1,2,3,3,2,4,0,2,0,0,2,1,1,1
10069,20,614,11,6,10,0,0,1,11,2,4,2,4,6,6,10,15,1,15,0,0,2,1,1,1
10070,20,614,42,7,35,4,0,5,46,1,2,1,2,3,3,2,4,0,2,0,0,2,1,1,0
10071,20,614,11,6,10,0,0,1,11,2,4,2,4,6,6,10,15,1,15,0,0,2,1,1,0
10072,20,615,42,7,35,4,0,5,46,1,2,1,2,3,3,2,4,0,2,0,0,2,13,2,1
10073,20,615,11,6,10,0,0,1,11,2,4,2,4,6,6,10,15,1,15,0,0,2,13,2,1
10074,173,4001,722,423,573,19,0,135,741,12,172,101,199,184,300,1320,2257,6,15668,870,0,2,322,1,1
10075,173,4001,1508,847,911,44,250,301,1552,14,148,88,169,162,257,1120,1886,7,15077,837,0,2,322,1,1
10076,20,615,42,7,35,4,0,5,46,1,2,1,2,3,3,2,4,0,2,0,0,2,2,2,0
10077,20,615,11,6,10,0,0,1,11,2,4,2,4,6,6,10,15,1,15,0,0,2,2,2,0
10078,20,615,42,7,35,4,0,5,46,1,2,1,2,3,3,2,4,0,2,0,0,2,31,4,0
10079,20,615,11,6,10,0,0,1,11,2,4,2,4,6,6,10,15,1,15,0,0,2,31,4,0
10080,466,10197,72,33,56,0,4,12,72,1,1,1,1,2,2,0,2,0,1,0,0,2,17,16,0
10081,466,10197,1454,835,1044,76,110,219,1530,17,275,158,296,292,454,2297,3718,9,34017,1889,1,2,17,16,0
10082,136,6025,139,89,101,2,0,35,141,7,54,34,62,61,96,330,569,4,2287,127,0,2,21,0,0
10083,136,6025,7,5,5,0,0,2,7,1,2,1,2,3,3,2,4,0,2,0,0,2,21,0,0
10084,466,10197,72,33,56,0,4,12,72,1,1,1,1,2,2,0,2,0,1,0,0,2,17,16,0
10085,466,10197,1454,835,1044,76,110,219,1530,17,275,158,296,292,454,2297,3718,9,34017,1889,1,2,17,16,0
10086,136,6025,139,89,101,2,0,35,141,7,54,34,62,61,96,330,569,4,2287,127,0,2,21,0,0
10087,136,6025,7,5,5,0,0,2,7,1,2,1,2,3,3,2,4,0,2,0,0,2,21,0,0
10088,466,10197,72,33,56,0,4,12,72,1,1,1,1,2,2,0,2,0,1,0,0,2,1,1,0
10089,466,10197,1454,835,1044,76,110,219,1530,17,275,158,296,292,454,2297,3718,9,34017,1889,1,2,1,1,0
10090,467,10219,72,33,56,0,4,12,72,1,1,1,1,2,2,0,2,0,1,0,0,2,12,7,1
10091,467,10219,1454,835,1044,76,110,219,1530,17,275,158,296,292,454,2297,3718,9,34017,1889,1,2,12,7,1
10092,66,2718,1289,550,1043,56,32,155,1345,10,167,93,185,177,278,1266,2075,5,11498,638,0,2,17,0,1
10093,466,10197,72,33,56,0,4,12,72,1,1,1,1,2,2,0,2,0,1,0,0,2,1,1,1
10094,466,10197,1454,835,1044,76,110,219,1530,17,275,158,296,292,454,2297,3718,9,34017,1889,1,2,1,1,1
10095,172,3989,722,423,573,19,0,135,741,12,172,101,199,184,300,1320,2257,6,15668,870,0,2,2,4,1
10096,172,3989,1508,847,911,44,250,301,1552,14,148,88,169,162,257,1120,1886,7,15077,837,0,2,2,4,1
10097,466,10197,72,33,56,0,4,12,72,1,1,1,1,2,2,0,2,0,1,0,0,2,2,1,1
10098,466,10197,1454,835,1044,76,110,219,1530,17,275,158,296,292,454,2297,3718,9,34017,1889,1,2,2,1,1
10099,20,615,42,7,35,4,0,5,46,1,2,1,2,3,3,2,4,0,2,0,0,2,5,5,1
10100,20,615,11,6,10,0,0,1,11,2,4,2,4,6,6,10,15,1,15,0,0,2,5,5,1
10101,65,3083,1338,495,1086,10,64,173,1348,11,122,82,157,133,239,883,1686,7,11934,663,0,2,20,0,1
10102,31,888,465,148,393,5,8,60,470,4,31,20,31,35,51,161,261,2,523,29,0,2,2,2,1
10103,31,888,16,12,9,0,0,6,16,1,2,1,2,3,3,2,4,0,2,0,0,2,2,2,1
10104,467,10219,72,33,56,0,4,12,72,1,1,1,1,2,2,0,2,0,1,0,0,2,12,7,0
10105,467,10219,1454,835,1044,76,110,219,1530,17,275,158,296,292,454,2297,3718,9,34017,1889,1,2,12,7,0
10106,66,2718,1289,550,1043,56,32,155,1345,10,167,93,185,177,278,1266,2075,5,11498,638,0,2,17,0,0
10107,467,10219,72,33,56,0,4,12,72,1,1,1,1,2,2,0,2,0,1,0,0,2,12,7,0
10108,467,10219,1454,835,1044,76,110,219,1530,17,275,158,296,292,454,2297,3718,9,34017,1889,1,2,12,7,0
10109,66,2718,1289,550,1043,56,32,155,1345,10,167,93,185,177,278,1266,2075,5,11498,638,0,2,17,0,0
10110,174,4018,722,423,573,19,0,135,741,12,172,101,199,184,300,1320,2257,6,15668,870,0,2,11,2,1
10111,174,4018,1508,847,911,44,250,301,1552,14,148,88,169,162,257,1120,1886,7,15077,837,0,2,11,2,1
10112,16,635,722,423,573,19,0,135,741,12,172,101,199,184,300,1320,2257,6,15668,870,0,2,11,0,1
10113,172,3989,722,423,573,19,0,135,741,12,172,101,199,184,300,1320,2257,6,15668,870,0,2,2,4,0
10114,172,3989,1508,847,911,44,250,301,1552,14,148,88,169,162,257,1120,1886,7,15077,837,0,2,2,4,0
10115,467,10219,72,33,56,0,4,12,72,1,1,1,1,2,2,0,2,0,1,0,0,2,2,1,0
10116,467,10219,1454,835,1044,76,110,219,1530,17,275,158,296,292,454,2297,3718,9,34017,1889,1,2,2,1,0
10117,20,615,42,7,35,4,0,5,46,1,2,1,2,3,3,2,4,0,2,0,0,2,5,5,0
10118,20,615,11,6,10,0,0,1,11,2,4,2,4,6,6,10,15,1,15,0,0,2,5,5,0
10119,65,3083,1338,495,1086,10,64,173,1348,11,122,82,157,133,239,883,1686,7,11934,663,0,2,20,0,0
10120,31,888,465,148,393,5,8,60,470,4,31,20,31,35,51,161,261,2,523,29,0,2,2,2,0
10121,31,888,16,12,9,0,0,6,16,1,2,1,2,3,3,2,4,0,2,0,0,2,2,2,0
10122,173,4006,722,423,573,19,0,135,741,12,172,101,199,184,300,1320,2257,6,15668,870,0,2,11,2,0
10123,173,4006,1508,847,911,44,250,301,1552,14,148,88,169,162,257,1120,1886,7,15077,837,0,2,11,2,0
10124,16,635,722,423,573,19,0,135,741,12,172,101,199,184,300,1320,2257,6,15668,870,0,2,11,0,0
10125,287,5589,1457,730,1242,11,6,188,1468,10,292,166,329,302,495,2424,4078,5,22973,1276,1,2,113,2,1
10126,287,5589,74,35,59,1,0,14,75,3,14,7,14,17,21,58,85,1,128,7,0,2,113,2,1
10127,287,5589,245,125,200,5,7,34,250,7,30,17,34,37,51,166,265,3,1053,58,0,2,113,2,1
10128,46,449,647,139,84,35,284,233,682,0,0,0,0,0,0,0,0,0,0,0,0,2,1,1,1
10129,172,3925,77,34,69,0,0,8,77,3,24,16,29,27,45,114,213,1,387,21,0,2,1,1,1
10130,172,3925,712,438,573,51,9,84,763,14,102,71,128,116,199,733,1364,8,11988,666,0,2,1,1,1
10131,16,631,722,423,573,19,0,135,741,12,172,101,199,184,300,1320,2257,6,15668,870,0,2,3,3,1
10132,62,2690,1943,715,1694,26,18,214,1969,12,185,120,237,197,357,1436,2721,7,20915,1161,0,2,3,1,1
10133,172,3933,77,34,69,0,0,8,77,3,24,16,29,27,45,114,213,1,387,21,0,2,3,1,0
10134,172,3933,712,438,573,51,9,84,763,14,102,71,128,116,199,733,1364,8,11988,666,0,2,3,1,0
10135,292,5675,1457,730,1242,11,6,188,1468,10,292,166,329,302,495,2424,4078,5,22973,1276,1,2,15,1,1
10136,292,5675,74,35,59,1,0,14,75,3,14,7,14,17,21,58,85,1,128,7,0,2,15,1,1
10137,292,5675,245,125,200,5,7,34,250,7,30,17,34,37,51,166,265,3,1053,58,0,2,15,1,1
10138,291,5664,1457,730,1242,11,6,188,1468,10,292,166,329,302,495,2424,4078,5,22973,1276,1,2,1,4,1
10139,291,5664,74,35,59,1,0,14,75,3,14,7,14,17,21,58,85,1,128,7,0,2,1,4,1
10140,291,5664,245,125,200,5,7,34,250,7,30,17,34,37,51,166,265,3,1053,58,0,2,1,4,1
10141,290,5645,1457,730,1242,11,6,188,1468,10,292,166,329,302,495,2424,4078,5,22973,1276,1,2,0,2,0
10142,290,5645,74,35,59,1,0,14,75,3,14,7,14,17,21,58,85,1,128,7,0,2,0,2,0
10143,290,5645,245,125,200,5,7,34,250,7,30,17,34,37,51,166,265,3,1053,58,0,2,0,2,0
10144,16,631,722,423,573,19,0,135,741,12,172,101,199,184,300,1320,2257,6,15668,870,0,2,1,1,0
10145,12,404,386,256,301,16,9,68,402,4,59,35,69,63,104,355,621,2,1453,80,0,2,0,1,0
10146,36,1381,1098,241,925,5,10,155,1103,7,46,25,49,53,74,273,423,3,1580,87,0,2,0,2,0
10147,287,5589,1457,730,1242,11,6,188,1468,10,292,166,329,302,495,2424,4078,5,22973,1276,1,2,92,98,1
10148,287,5589,74,35,59,1,0,14,75,3,14,7,14,17,21,58,85,1,128,7,0,2,92,98,1
10149,287,5589,245,125,200,5,7,34,250,7,30,17,34,37,51,166,265,3,1053,58,0,2,92,98,1
10150,31,1022,1455,414,1257,16,76,112,1471,5,41,23,46,46,69,231,381,2,1069,59,0,2,1,1,1
10151,31,1022,669,365,481,22,61,110,691,15,103,63,122,118,185,747,1273,8,11311,628,0,2,1,1,1
10152,136,6025,139,89,101,2,0,35,141,7,54,34,62,61,96,330,569,4,2287,127,0,2,1,1,1
10153,136,6025,7,5,5,0,0,2,7,1,2,1,2,3,3,2,4,0,2,0,0,2,1,1,1
10154,29,1861,652,304,544,16,6,88,668,6,89,51,101,95,152,591,998,3,3399,188,0,2,32,43,1
10155,289,5621,1457,730,1242,11,6,188,1468,10,292,166,329,302,495,2424,4078,5,22973,1276,1,2,6,1,0
10156,289,5621,74,35,59,1,0,14,75,3,14,7,14,17,21,58,85,1,128,7,0,2,6,1,0
10157,289,5621,245,125,200,5,7,34,250,7,30,17,34,37,51,166,265,3,1053,58,0,2,6,1,0
10158,33,664,2,2,2,0,0,0,2,0,0,0,0,0,0,0,0,0,0,0,0,2,5,6,1
10159,33,664,99,48,90,1,3,5,100,0,0,0,0,0,0,0,0,0,0,0,0,2,5,6,1
10160,33,664,8,5,5,2,0,1,10,0,0,0,0,0,0,0,0,0,0,0,0,2,5,6,1
10161,33,664,1217,716,841,84,126,174,1301,14,185,118,215,199,333,1446,2542,8,20687,1149,0,2,5,6,1
10162,33,664,160,89,115,0,13,31,160,7,15,11,17,22,28,78,124,3,495,27,0,2,5,6,1
10163,33,664,10,10,9,9,0,0,19,0,0,0,0,0,0,0,0,0,0,0,0,2,5,6,1
10164,33,664,173,84,99,8,29,36,181,5,12,7,13,17,20,54,81,2,221,12,0,2,5,6,1
10165,33,664,3,1,1,3,0,0,6,0,0,0,0,0,0,0,0,0,0,0,0,2,5,6,1
10166,111,2245,1513,682,1277,25,13,200,1538,11,199,116,219,210,335,1557,2584,6,15641,868,0,2,2,2,1
10167,111,2245,819,519,539,24,98,155,843,15,96,57,106,111,163,690,1107,8,9171,509,0,2,2,2,1
10168,289,5615,1457,730,1242,11,6,188,1468,10,292,166,329,302,495,2424,4078,5,22973,1276,1,2,19,20,1
10169,289,5615,74,35,59,1,0,14,75,3,14,7,14,17,21,58,85,1,128,7,0,2,19,20,1
10170,289,5615,245,125,200,5,7,34,250,7,30,17,34,37,51,166,265,3,1053,58,0,2,19,20,1
10171,23,732,74,35,59,1,0,14,75,3,14,7,14,17,21,58,85,1,128,7,0,2,11,15,1
10172,23,732,245,125,200,5,7,34,250,7,30,17,34,37,51,166,265,3,1053,58,0,2,11,15,1
10173,171,3921,77,34,69,0,0,8,77,3,24,16,29,27,45,114,213,1,387,21,0,2,2,4,1
10174,171,3921,712,438,573,51,9,84,763,14,102,71,128,116,199,733,1364,8,11988,666,0,2,2,4,1
10175,68,1230,1020,354,843,12,15,144,1032,8,134,77,144,142,221,970,1580,4,6792,377,0,2,2,2,1
10176,171,3970,722,423,573,19,0,135,741,12,172,101,199,184,300,1320,2257,6,15668,870,0,2,5,9,1
10177,171,3970,1508,847,911,44,250,301,1552,14,148,88,169,162,257,1120,1886,7,15077,837,0,2,5,9,1
10178,38,711,127,75,83,2,11,30,129,4,14,7,14,18,21,61,87,2,175,9,0,2,1,0,1
10179,38,711,652,304,544,16,6,88,668,6,89,51,101,95,152,591,998,3,3399,188,0,2,1,0,1
10180,38,711,2,2,2,0,0,0,2,0,0,0,0,0,0,0,0,0,0,0,0,2,1,0,1
10181,38,711,8,5,5,0,0,3,8,0,0,0,0,0,0,0,0,0,0,0,0,2,1,0,1
10182,38,711,2,2,2,0,0,0,2,0,0,0,0,0,0,0,0,0,0,0,0,2,1,0,1
10183,38,711,14,8,8,0,0,6,14,0,0,0,0,0,0,0,0,0,0,0,0,2,1,0,1
10184,38,711,6,4,4,0,0,2,6,0,0,0,0,0,0,0,0,0,0,0,0,2,1,0,1
10185,38,711,6,4,4,0,0,2,6,1,2,1,2,3,3,2,4,0,2,0,0,2,1,0,1
10186,38,711,6,4,4,0,0,2,6,0,0,0,0,0,0,0,0,0,0,0,0,2,1,0,1
10187,38,711,7,5,5,0,0,2,7,0,0,0,0,0,0,0,0,0,0,0,0,2,1,0,1
10188,38,711,6,4,4,0,0,2,6,0,0,0,0,0,0,0,0,0,0,0,0,2,1,0,1
10189,38,711,10,6,6,0,0,4,10,0,0,0,0,0,0,0,0,0,0,0,0,2,1,0,1
10190,38,711,1,1,1,0,0,0,1,0,0,0,0,0,0,0,0,0,0,0,0,2,1,0,1
10191,38,711,1,1,1,0,0,0,1,0,0,0,0,0,0,0,0,0,0,0,0,2,1,0,1
10192,38,711,14,10,10,0,0,4,14,1,1,1,1,2,2,0,2,0,1,0,0,2,1,0,1
10193,38,711,46,26,30,3,0,12,49,3,6,3,6,9,9,20,28,1,42,2,0,2,1,0,1
10194,24,966,373,158,315,8,0,51,381,5,76,44,79,81,123,486,779,2,2026,112,0,2,2,2,1
10195,176,4013,722,423,573,19,0,135,741,12,172,101,199,184,300,1320,2257,6,15668,870,0,2,13,0,1
10196,176,4013,1508,847,911,44,250,301,1552,14,148,88,169,162,257,1120,1886,7,15077,837,0,2,13,0,1
10197,176,4018,722,423,573,19,0,135,741,12,172,101,199,184,300,1320,2257,6,15668,870,0,2,6,1,1
10198,176,4018,1508,847,911,44,250,301,1552,14,148,88,169,162,257,1120,1886,7,15077,837,0,2,6,1,1
10199,176,4018,722,423,573,19,0,135,741,12,172,101,199,184,300,1320,2257,6,15668,870,0,2,18,0,0
10200,176,4018,1508,847,911,44,250,301,1552,14,148,88,169,162,257,1120,1886,7,15077,837,0,2,18,0,0
10201,176,4066,722,423,573,19,0,135,741,12,172,101,199,184,300,1320,2257,6,15668,870,0,2,18,0,0
10202,176,4066,1508,847,911,44,250,301,1552,14,148,88,169,162,257,1120,1886,7,15077,837,0,2,18,0,0
10203,174,4030,722,423,573,19,0,135,741,12,172,101,199,184,300,1320,2257,6,15668,870,0,2,18,0,0
10204,174,4030,1508,847,911,44,250,301,1552,14,148,88,169,162,257,1120,1886,7,15077,837,0,2,18,0,0
10205,285,5557,1457,730,1242,11,6,188,1468,10,292,166,329,302,495,2424,4078,5,22973,1276,1,2,14,20,0
10206,285,5557,74,35,59,1,0,14,75,3,14,7,14,17,21,58,85,1,128,7,0,2,14,20,0
10207,285,5557,245,125,200,5,7,34,250,7,30,17,34,37,51,166,265,3,1053,58,0,2,14,20,0
10208,283,5525,1457,730,1242,11,6,188,1468,10,292,166,329,302,495,2424,4078,5,22973,1276,1,2,11,15,1
10209,283,5525,74,35,59,1,0,14,75,3,14,7,14,17,21,58,85,1,128,7,0,2,11,15,1
10210,283,5525,245,125,200,5,7,34,250,7,30,17,34,37,51,166,265,3,1053,58,0,2,11,15,1
10211,33,664,2,2,2,0,0,0,2,0,0,0,0,0,0,0,0,0,0,0,0,2,5,6,0
10212,33,664,99,48,90,1,3,5,100,0,0,0,0,0,0,0,0,0,0,0,0,2,5,6,0
10213,33,664,8,5,5,2,0,1,10,0,0,0,0,0,0,0,0,0,0,0,0,2,5,6,0
10214,33,664,1217,716,841,84,126,174,1301,14,185,118,215,199,333,1446,2542,8,20687,1149,0,2,5,6,0
10215,33,664,160,89,115,0,13,31,160,7,15,11,17,22,28,78,124,3,495,27,0,2,5,6,0
10216,33,664,10,10,9,9,0,0,19,0,0,0,0,0,0,0,0,0,0,0,0,2,5,6,0
10217,33,664,173,84,99,8,29,36,181,5,12,7,13,17,20,54,81,2,221,12,0,2,5,6,0
10218,33,664,3,1,1,3,0,0,6,0,0,0,0,0,0,0,0,0,0,0,0,2,5,6,0
10219,111,2245,1513,682,1277,25,13,200,1538,11,199,116,219,210,335,1557,2584,6,15641,868,0,2,2,2,0
10220,111,2245,819,519,539,24,98,155,843,15,96,57,106,111,163,690,1107,8,9171,509,0,2,2,2,0
10221,283,5525,1457,730,1242,11,6,188,1468,10,292,166,329,302,495,2424,4078,5,22973,1276,1,2,230,122,0
10222,283,5525,74,35,59,1,0,14,75,3,14,7,14,17,21,58,85,1,128,7,0,2,230,122,0
10223,283,5525,245,125,200,5,7,34,250,7,30,17,34,37,51,166,265,3,1053,58,0,2,230,122,0
10224,31,1022,1455,414,1257,16,76,112,1471,5,41,23,46,46,69,231,381,2,1069,59,0,2,1,1,0
10225,31,1022,669,365,481,22,61,110,691,15,103,63,122,118,185,747,1273,8,11311,628,0,2,1,1,0
10226,23,732,74,35,59,1,0,14,75,3,14,7,14,17,21,58,85,1,128,7,0,2,11,15,0
10227,23,732,245,125,200,5,7,34,250,7,30,17,34,37,51,166,265,3,1053,58,0,2,11,15,0
10228,46,449,647,139,84,35,284,233,682,0,0,0,0,0,0,0,0,0,0,0,0,2,1,1,0
10229,171,3921,77,34,69,0,0,8,77,3,24,16,29,27,45,114,213,1,387,21,0,2,6,6,0
10230,171,3921,712,438,573,51,9,84,763,14,102,71,128,116,199,733,1364,8,11988,666,0,2,6,6,0
10231,68,1230,1020,354,843,12,15,144,1032,8,134,77,144,142,221,970,1580,4,6792,377,0,2,2,2,0
10232,174,4030,722,423,573,19,0,135,741,12,172,101,199,184,300,1320,2257,6,15668,870,0,2,5,9,0
10233,174,4030,1508,847,911,44,250,301,1552,14,148,88,169,162,257,1120,1886,7,15077,837,0,2,5,9,0
10234,38,711,127,75,83,2,11,30,129,4,14,7,14,18,21,61,87,2,175,9,0,2,1,0,0
10235,38,711,652,304,544,16,6,88,668,6,89,51,101,95,152,591,998,3,3399,188,0,2,1,0,0
10236,38,711,2,2,2,0,0,0,2,0,0,0,0,0,0,0,0,0,0,0,0,2,1,0,0
10237,38,711,8,5,5,0,0,3,8,0,0,0,0,0,0,0,0,0,0,0,0,2,1,0,0
10238,38,711,2,2,2,0,0,0,2,0,0,0,0,0,0,0,0,0,0,0,0,2,1,0,0
10239,38,711,14,8,8,0,0,6,14,0,0,0,0,0,0,0,0,0,0,0,0,2,1,0,0
10240,38,711,6,4,4,0,0,2,6,0,0,0,0,0,0,0,0,0,0,0,0,2,1,0,0
10241,38,711,6,4,4,0,0,2,6,1,2,1,2,3,3,2,4,0,2,0,0,2,1,0,0
10242,38,711,6,4,4,0,0,2,6,0,0,0,0,0,0,0,0,0,0,0,0,2,1,0,0
10243,38,711,7,5,5,0,0,2,7,0,0,0,0,0,0,0,0,0,0,0,0,2,1,0,0
10244,38,711,6,4,4,0,0,2,6,0,0,0,0,0,0,0,0,0,0,0,0,2,1,0,0
10245,38,711,10,6,6,0,0,4,10,0,0,0,0,0,0,0,0,0,0,0,0,2,1,0,0
10246,38,711,1,1,1,0,0,0,1,0,0,0,0,0,0,0,0,0,0,0,0,2,1,0,0
10247,38,711,1,1,1,0,0,0,1,0,0,0,0,0,0,0,0,0,0,0,0,2,1,0,0
10248,38,711,14,10,10,0,0,4,14,1,1,1,1,2,2,0,2,0,1,0,0,2,1,0,0
10249,38,711,46,26,30,3,0,12,49,3,6,3,6,9,9,20,28,1,42,2,0,2,1,0,0
10250,136,6025,139,89,101,2,0,35,141,7,54,34,62,61,96,330,569,4,2287,127,0,2,1,1,0
10251,136,6025,7,5,5,0,0,2,7,1,2,1,2,3,3,2,4,0,2,0,0,2,1,1,0
10252,29,1861,652,304,544,16,6,88,668,6,89,51,101,95,152,591,998,3,3399,188,0,2,32,43,0
10253,16,631,722,423,573,19,0,135,741,12,172,101,199,184,300,1320,2257,6,15668,870,0,2,4,4,0
10254,12,404,386,256,301,16,9,68,402,4,59,35,69,63,104,355,621,2,1453,80,0,2,0,1,0
10255,24,966,373,158,315,8,0,51,381,5,76,44,79,81,123,486,779,2,2026,112,0,2,2,2,0
10256,62,2690,1943,715,1694,26,18,214,1969,12,185,120,237,197,357,1436,2721,7,20915,1161,0,2,3,1,0
10257,36,1381,1098,241,925,5,10,155,1103,7,46,25,49,53,74,273,423,3,1580,87,0,2,0,2,0
10258,283,5532,1457,730,1242,11,6,188,1468,10,292,166,329,302,495,2424,4078,5,22973,1276,1,2,1,0,1
10259,283,5532,74,35,59,1,0,14,75,3,14,7,14,17,21,58,85,1,128,7,0,2,1,0,1
10260,283,5532,245,125,200,5,7,34,250,7,30,17,34,37,51,166,265,3,1053,58,0,2,1,0,1
10261,47,2308,1457,730,1242,11,6,188,1468,10,292,166,329,302,495,2424,4078,5,22973,1276,1,2,2,1,0
10262,282,5509,1457,730,1242,11,6,188,1468,10,292,166,329,302,495,2424,4078,5,22973,1276,1,2,6,10,0
10263,282,5509,74,35,59,1,0,14,75,3,14,7,14,17,21,58,85,1,128,7,0,2,6,10,0
10264,282,5509,245,125,200,5,7,34,250,7,30,17,34,37,51,166,265,3,1053,58,0,2,6,10,0
10265,111,2266,1513,682,1277,25,13,200,1538,11,199,116,219,210,335,1557,2584,6,15641,868,0,2,7,7,0
10266,111,2266,819,519,539,24,98,155,843,15,96,57,106,111,163,690,1107,8,9171,509,0,2,7,7,0
10267,23,735,74,35,59,1,0,14,75,3,14,7,14,17,21,58,85,1,128,7,0,2,1,1,0
10268,23,735,245,125,200,5,7,34,250,7,30,17,34,37,51,166,265,3,1053,58,0,2,1,1,0
10269,46,483,647,139,84,35,284,233,682,0,0,0,0,0,0,0,0,0,0,0,0,2,16,14,0
10270,171,3927,77,34,69,0,0,8,77,3,24,16,29,27,45,114,213,1,387,21,0,2,2,2,0
10271,171,3927,712,438,573,51,9,84,763,14,102,71,128,116,199,733,1364,8,11988,666,0,2,2,2,0
10272,23,374,424,94,331,4,0,89,428,1,5,5,5,6,10,11,25,0,12,0,0,2,1,1,0
10273,23,374,38,23,23,6,0,8,44,3,11,7,11,14,18,42,68,1,102,5,0,2,1,1,0
10274,16,477,184,100,137,2,15,30,186,6,38,20,39,44,59,214,322,3,991,55,0,2,1,1,0
10275,16,477,103,65,74,8,5,16,111,7,17,9,17,24,26,89,119,3,417,23,0,2,1,1,0
10276,467,10231,72,33,56,0,4,12,72,1,1,1,1,2,2,0,2,0,1,0,0,2,4,4,0
10277,467,10231,1454,835,1044,76,110,219,1530,17,275,158,296,292,454,2297,3718,9,34017,1889,1,2,4,4,0
10278,83,1510,1178,367,1042,6,15,115,1184,9,94,51,95,103,146,644,976,4,4439,246,0,2,2,2,0
10279,83,1510,177,108,140,8,0,27,185,6,30,16,32,36,48,162,248,3,794,44,0,2,2,2,0
10280,168,3521,1943,715,1694,26,18,214,1969,12,185,120,237,197,357,1436,2721,7,20915,1161,0,2,2,2,0
10281,168,3521,1168,838,957,57,25,144,1225,19,348,224,416,367,640,3018,5452,11,61921,3440,1,2,2,2,0
10282,51,1018,1098,241,925,5,10,155,1103,7,46,25,49,53,74,273,423,3,1580,87,0,2,2,2,0
10283,51,1018,282,202,222,14,2,44,296,8,42,24,43,50,67,250,378,4,1548,86,0,2,2,2,0
10284,38,714,127,75,83,2,11,30,129,4,14,7,14,18,21,61,87,2,175,9,0,2,1,1,0
10285,38,714,652,304,544,16,6,88,668,6,89,51,101,95,152,591,998,3,3399,188,0,2,1,1,0
10286,38,714,2,2,2,0,0,0,2,0,0,0,0,0,0,0,0,0,0,0,0,2,1,1,0
10287,38,714,8,5,5,0,0,3,8,0,0,0,0,0,0,0,0,0,0,0,0,2,1,1,0
10288,38,714,2,2,2,0,0,0,2,0,0,0,0,0,0,0,0,0,0,0,0,2,1,1,0
10289,38,714,14,8,8,0,0,6,14,0,0,0,0,0,0,0,0,0,0,0,0,2,1,1,0
10290,38,714,6,4,4,0,0,2,6,0,0,0,0,0,0,0,0,0,0,0,0,2,1,1,0
10291,38,714,6,4,4,0,0,2,6,1,2,1,2,3,3,2,4,0,2,0,0,2,1,1,0
10292,38,714,6,4,4,0,0,2,6,0,0,0,0,0,0,0,0,0,0,0,0,2,1,1,0
10293,38,714,7,5,5,0,0,2,7,0,0,0,0,0,0,0,0,0,0,0,0,2,1,1,0
10294,38,714,6,4,4,0,0,2,6,0,0,0,0,0,0,0,0,0,0,0,0,2,1,1,0
10295,38,714,10,6,6,0,0,4,10,0,0,0,0,0,0,0,0,0,0,0,0,2,1,1,0
10296,38,714,1,1,1,0,0,0,1,0,0,0,0,0,0,0,0,0,0,0,0,2,1,1,0
10297,38,714,1,1,1,0,0,0,1,0,0,0,0,0,0,0,0,0,0,0,0,2,1,1,0
10298,38,714,14,10,10,0,0,4,14,1,1,1,1,2,2,0,2,0,1,0,0,2,1,1,0
10299,38,714,46,26,30,3,0,12,49,3,6,3,6,9,9,20,28,1,42,2,0,2,1,1,0
10300,65,3083,1338,495,1086,10,64,173,1348,11,122,82,157,133,239,883,1686,7,11934,663,0,2,1,1,0
10301,8,257,74,35,59,1,0,14,75,3,14,7,14,17,21,58,85,1,128,7,0,2,1,1,0
10302,55,2363,1020,354,843,12,15,144,1032,8,134,77,144,142,221,970,1580,4,6792,377,0,2,1,1,0
10303,278,5480,1457,730,1242,11,6,188,1468,10,292,166,329,302,495,2424,4078,5,22973,1276,1,2,8,14,1
10304,278,5480,74,35,59,1,0,14,75,3,14,7,14,17,21,58,85,1,128,7,0,2,8,14,1
10305,278,5480,245,125,200,5,7,34,250,7,30,17,34,37,51,166,265,3,1053,58,0,2,8,14,1
10306,46,511,647,139,84,35,284,233,682,0,0,0,0,0,0,0,0,0,0,0,0,2,36,23,1
10307,468,10250,72,33,56,0,4,12,72,1,1,1,1,2,2,0,2,0,1,0,0,2,7,5,1
10308,468,10250,1454,835,1044,76,110,219,1530,17,275,158,296,292,454,2297,3718,9,34017,1889,1,2,7,5,1
10309,47,2308,1457,730,1242,11,6,188,1468,10,292,166,329,302,495,2424,4078,5,22973,1276,1,2,1,1,1
10310,278,5491,1457,730,1242,11,6,188,1468,10,292,166,329,302,495,2424,4078,5,22973,1276,1,2,7,6,1
10311,278,5491,74,35,59,1,0,14,75,3,14,7,14,17,21,58,85,1,128,7,0,2,7,6,1
10312,278,5491,245,125,200,5,7,34,250,7,30,17,34,37,51,166,265,3,1053,58,0,2,7,6,1
10313,46,518,647,139,84,35,284,233,682,0,0,0,0,0,0,0,0,0,0,0,0,2,5,3,1
10314,465,10193,72,33,56,0,4,12,72,1,1,1,1,2,2,0,2,0,1,0,0,2,2,13,1
10315,465,10193,1454,835,1044,76,110,219,1530,17,275,158,296,292,454,2297,3718,9,34017,1889,1,2,2,13,1
10316,278,5472,1457,730,1242,11,6,188,1468,10,292,166,329,302,495,2424,4078,5,22973,1276,1,2,7,8,1
10317,278,5472,74,35,59,1,0,14,75,3,14,7,14,17,21,58,85,1,128,7,0,2,7,8,1
10318,278,5472,245,125,200,5,7,34,250,7,30,17,34,37,51,166,265,3,1053,58,0,2,7,8,1
10319,47,2310,1457,730,1242,11,6,188,1468,10,292,166,329,302,495,2424,4078,5,22973,1276,1,2,2,2,1
10320,278,5481,1457,730,1242,11,6,188,1468,10,292,166,329,302,495,2424,4078,5,22973,1276,1,2,2,1,0
10321,278,5481,74,35,59,1,0,14,75,3,14,7,14,17,21,58,85,1,128,7,0,2,2,1,0
10322,278,5481,245,125,200,5,7,34,250,7,30,17,34,37,51,166,265,3,1053,58,0,2,2,1,0
10323,23,749,74,35,59,1,0,14,75,3,14,7,14,17,21,58,85,1,128,7,0,2,3,1,0
10324,23,749,245,125,200,5,7,34,250,7,30,17,34,37,51,166,265,3,1053,58,0,2,3,1,0
10325,175,4049,722,423,573,19,0,135,741,12,172,101,199,184,300,1320,2257,6,15668,870,0,2,7,7,0
10326,175,4049,1508,847,911,44,250,301,1552,14,148,88,169,162,257,1120,1886,7,15077,837,0,2,7,7,0
10327,276,5455,1457,730,1242,11,6,188,1468,10,292,166,329,302,495,2424,4078,5,22973,1276,1,2,12,16,1
10328,276,5455,74,35,59,1,0,14,75,3,14,7,14,17,21,58,85,1,128,7,0,2,12,16,1
10329,276,5455,245,125,200,5,7,34,250,7,30,17,34,37,51,166,265,3,1053,58,0,2,12,16,1
10330,175,4047,722,423,573,19,0,135,741,12,172,101,199,184,300,1320,2257,6,15668,870,0,2,1,1,1
10331,175,4047,1508,847,911,44,250,301,1552,14,148,88,169,162,257,1120,1886,7,15077,837,0,2,1,1,1
10332,47,2309,1457,730,1242,11,6,188,1468,10,292,166,329,302,495,2424,4078,5,22973,1276,1,2,1,1,1
10333,62,2690,1943,715,1694,26,18,214,1969,12,185,120,237,197,357,1436,2721,7,20915,1161,0,2,1,1,1
10334,276,5455,1457,730,1242,11,6,188,1468,10,292,166,329,302,495,2424,4078,5,22973,1276,1,2,2,0,0
10335,276,5455,74,35,59,1,0,14,75,3,14,7,14,17,21,58,85,1,128,7,0,2,2,0,0
10336,276,5455,245,125,200,5,7,34,250,7,30,17,34,37,51,166,265,3,1053,58,0,2,2,0,0
10337,170,3910,77,34,69,0,0,8,77,3,24,16,29,27,45,114,213,1,387,21,0,2,0,3,0
10338,170,3910,712,438,573,51,9,84,763,14,102,71,128,116,199,733,1364,8,11988,666,0,2,0,3,0
10339,273,5403,1457,730,1242,11,6,188,1468,10,292,166,329,302,495,2424,4078,5,22973,1276,1,2,17,23,1
10340,273,5403,74,35,59,1,0,14,75,3,14,7,14,17,21,58,85,1,128,7,0,2,17,23,1
10341,273,5403,245,125,200,5,7,34,250,7,30,17,34,37,51,166,265,3,1053,58,0,2,17,23,1
10342,171,3942,77,34,69,0,0,8,77,3,24,16,29,27,45,114,213,1,387,21,0,2,19,8,1
10343,171,3942,712,438,573,51,9,84,763,14,102,71,128,116,199,733,1364,8,11988,666,0,2,19,8,1
10344,273,5395,1457,730,1242,11,6,188,1468,10,292,166,329,302,495,2424,4078,5,22973,1276,1,2,2,3,1
10345,273,5395,74,35,59,1,0,14,75,3,14,7,14,17,21,58,85,1,128,7,0,2,2,3,1
10346,273,5395,245,125,200,5,7,34,250,7,30,17,34,37,51,166,265,3,1053,58,0,2,2,3,1
10347,267,5292,1457,730,1242,11,6,188,1468,10,292,166,329,302,495,2424,4078,5,22973,1276,1,2,5,26,0
10348,267,5292,74,35,59,1,0,14,75,3,14,7,14,17,21,58,85,1,128,7,0,2,5,26,0
10349,267,5292,245,125,200,5,7,34,250,7,30,17,34,37,51,166,265,3,1053,58,0,2,5,26,0
10350,267,5310,1457,730,1242,11,6,188,1468,10,292,166,329,302,495,2424,4078,5,22973,1276,1,2,8,0,1
10351,267,5310,74,35,59,1,0,14,75,3,14,7,14,17,21,58,85,1,128,7,0,2,8,0,1
10352,267,5310,245,125,200,5,7,34,250,7,30,17,34,37,51,166,265,3,1053,58,0,2,8,0,1
10353,270,5415,1457,730,1242,11,6,188,1468,10,292,166,329,302,495,2424,4078,5,22973,1276,1,2,19,4,1
10354,270,5415,74,35,59,1,0,14,75,3,14,7,14,17,21,58,85,1,128,7,0,2,19,4,1
10355,270,5415,245,125,200,5,7,34,250,7,30,17,34,37,51,166,265,3,1053,58,0,2,19,4,1
10356,169,3534,1943,715,1694,26,18,214,1969,12,185,120,237,197,357,1436,2721,7,20915,1161,0,2,2,0,1
10357,169,3534,1168,838,957,57,25,144,1225,19,348,224,416,367,640,3018,5452,11,61921,3440,1,2,2,0,1
10358,38,708,127,75,83,2,11,30,129,4,14,7,14,18,21,61,87,2,175,9,0,2,3,4,1
10359,38,708,652,304,544,16,6,88,668,6,89,51,101,95,152,591,998,3,3399,188,0,2,3,4,1
10360,38,708,2,2,2,0,0,0,2,0,0,0,0,0,0,0,0,0,0,0,0,2,3,4,1
10361,38,708,8,5,5,0,0,3,8,0,0,0,0,0,0,0,0,0,0,0,0,2,3,4,1
10362,38,708,2,2,2,0,0,0,2,0,0,0,0,0,0,0,0,0,0,0,0,2,3,4,1
10363,38,708,14,8,8,0,0,6,14,0,0,0,0,0,0,0,0,0,0,0,0,2,3,4,1
10364,38,708,6,4,4,0,0,2,6,0,0,0,0,0,0,0,0,0,0,0,0,2,3,4,1
10365,38,708,6,4,4,0,0,2,6,1,2,1,2,3,3,2,4,0,2,0,0,2,3,4,1
10366,38,708,6,4,4,0,0,2,6,0,0,0,0,0,0,0,0,0,0,0,0,2,3,4,1
10367,38,708,7,5,5,0,0,2,7,0,0,0,0,0,0,0,0,0,0,0,0,2,3,4,1
10368,38,708,6,4,4,0,0,2,6,0,0,0,0,0,0,0,0,0,0,0,0,2,3,4,1
10369,38,708,10,6,6,0,0,4,10,0,0,0,0,0,0,0,0,0,0,0,0,2,3,4,1
10370,38,708,1,1,1,0,0,0,1,0,0,0,0,0,0,0,0,0,0,0,0,2,3,4,1
10371,38,708,1,1,1,0,0,0,1,0,0,0,0,0,0,0,0,0,0,0,0,2,3,4,1
10372,38,708,14,10,10,0,0,4,14,1,1,1,1,2,2,0,2,0,1,0,0,2,3,4,1
10373,38,708,46,26,30,3,0,12,49,3,6,3,6,9,9,20,28,1,42,2,0,2,3,4,1
10374,271,5435,1457,730,1242,11,6,188,1468,10,292,166,329,302,495,2424,4078,5,22973,1276,1,2,4,1,0
10375,271,5435,74,35,59,1,0,14,75,3,14,7,14,17,21,58,85,1,128,7,0,2,4,1,0
10376,271,5435,245,125,200,5,7,34,250,7,30,17,34,37,51,166,265,3,1053,58,0,2,4,1,0
10377,111,2266,1513,682,1277,25,13,200,1538,11,199,116,219,210,335,1557,2584,6,15641,868,0,2,7,7,0
10378,111,2266,819,519,539,24,98,155,843,15,96,57,106,111,163,690,1107,8,9171,509,0,2,7,7,0
10379,271,5435,1457,730,1242,11,6,188,1468,10,292,166,329,302,495,2424,4078,5,22973,1276,1,2,75,87,0
10380,271,5435,74,35,59,1,0,14,75,3,14,7,14,17,21,58,85,1,128,7,0,2,75,87,0
10381,271,5435,245,125,200,5,7,34,250,7,30,17,34,37,51,166,265,3,1053,58,0,2,75,87,0
10382,23,749,74,35,59,1,0,14,75,3,14,7,14,17,21,58,85,1,128,7,0,2,4,2,0
10383,23,749,245,125,200,5,7,34,250,7,30,17,34,37,51,166,265,3,1053,58,0,2,4,2,0
10384,46,518,647,139,84,35,284,233,682,0,0,0,0,0,0,0,0,0,0,0,0,2,53,36,0
10385,171,3942,77,34,69,0,0,8,77,3,24,16,29,27,45,114,213,1,387,21,0,2,21,13,0
10386,171,3942,712,438,573,51,9,84,763,14,102,71,128,116,199,733,1364,8,11988,666,0,2,21,13,0
10387,23,374,424,94,331,4,0,89,428,1,5,5,5,6,10,11,25,0,12,0,0,2,1,1,0
10388,23,374,38,23,23,6,0,8,44,3,11,7,11,14,18,42,68,1,102,5,0,2,1,1,0
10389,16,477,184,100,137,2,15,30,186,6,38,20,39,44,59,214,322,3,991,55,0,2,1,1,0
10390,16,477,103,65,74,8,5,16,111,7,17,9,17,24,26,89,119,3,417,23,0,2,1,1,0
10391,175,4047,722,423,573,19,0,135,741,12,172,101,199,184,300,1320,2257,6,15668,870,0,2,7,7,0
10392,175,4047,1508,847,911,44,250,301,1552,14,148,88,169,162,257,1120,1886,7,15077,837,0,2,7,7,0
10393,465,10193,72,33,56,0,4,12,72,1,1,1,1,2,2,0,2,0,1,0,0,2,11,20,0
10394,465,10193,1454,835,1044,76,110,219,1530,17,275,158,296,292,454,2297,3718,9,34017,1889,1,2,11,20,0
10395,83,1510,1178,367,1042,6,15,115,1184,9,94,51,95,103,146,644,976,4,4439,246,0,2,2,2,0
10396,83,1510,177,108,140,8,0,27,185,6,30,16,32,36,48,162,248,3,794,44,0,2,2,2,0
10397,169,3534,1943,715,1694,26,18,214,1969,12,185,120,237,197,357,1436,2721,7,20915,1161,0,2,4,2,0
10398,169,3534,1168,838,957,57,25,144,1225,19,348,224,416,367,640,3018,5452,11,61921,3440,1,2,4,2,0
10399,51,1018,1098,241,925,5,10,155,1103,7,46,25,49,53,74,273,423,3,1580,87,0,2,2,2,0
10400,51,1018,282,202,222,14,2,44,296,8,42,24,43,50,67,250,378,4,1548,86,0,2,2,2,0
10401,38,708,127,75,83,2,11,30,129,4,14,7,14,18,21,61,87,2,175,9,0,2,3,4,0
10402,38,708,652,304,544,16,6,88,668,6,89,51,101,95,152,591,998,3,3399,188,0,2,3,4,0
10403,38,708,2,2,2,0,0,0,2,0,0,0,0,0,0,0,0,0,0,0,0,2,3,4,0
10404,38,708,8,5,5,0,0,3,8,0,0,0,0,0,0,0,0,0,0,0,0,2,3,4,0
10405,38,708,2,2,2,0,0,0,2,0,0,0,0,0,0,0,0,0,0,0,0,2,3,4,0
10406,38,708,14,8,8,0,0,6,14,0,0,0,0,0,0,0,0,0,0,0,0,2,3,4,0
10407,38,708,6,4,4,0,0,2,6,0,0,0,0,0,0,0,0,0,0,0,0,2,3,4,0
10408,38,708,6,4,4,0,0,2,6,1,2,1,2,3,3,2,4,0,2,0,0,2,3,4,0
10409,38,708,6,4,4,0,0,2,6,0,0,0,0,0,0,0,0,0,0,0,0,2,3,4,0
10410,38,708,7,5,5,0,0,2,7,0,0,0,0,0,0,0,0,0,0,0,0,2,3,4,0
10411,38,708,6,4,4,0,0,2,6,0,0,0,0,0,0,0,0,0,0,0,0,2,3,4,0
10412,38,708,10,6,6,0,0,4,10,0,0,0,0,0,0,0,0,0,0,0,0,2,3,4,0
10413,38,708,1,1,1,0,0,0,1,0,0,0,0,0,0,0,0,0,0,0,0,2,3,4,0
10414,38,708,1,1,1,0,0,0,1,0,0,0,0,0,0,0,0,0,0,0,0,2,3,4,0
10415,38,708,14,10,10,0,0,4,14,1,1,1,1,2,2,0,2,0,1,0,0,2,3,4,0
10416,38,708,46,26,30,3,0,12,49,3,6,3,6,9,9,20,28,1,42,2,0,2,3,4,0
10417,65,3083,1338,495,1086,10,64,173,1348,11,122,82,157,133,239,883,1686,7,11934,663,0,2,1,1,0
10418,47,2309,1457,730,1242,11,6,188,1468,10,292,166,329,302,495,2424,4078,5,22973,1276,1,2,5,4,0
10419,8,257,74,35,59,1,0,14,75,3,14,7,14,17,21,58,85,1,128,7,0,2,1,1,0
10420,55,2363,1020,354,843,12,15,144,1032,8,134,77,144,142,221,970,1580,4,6792,377,0,2,1,1,0
10421,62,2690,1943,715,1694,26,18,214,1969,12,185,120,237,197,357,1436,2721,7,20915,1161,0,2,1,1,0
10422,176,4105,722,423,573,19,0,135,741,12,172,101,199,184,300,1320,2257,6,15668,870,0,2,8,0,1
10423,176,4105,1508,847,911,44,250,301,1552,14,148,88,169,162,257,1120,1886,7,15077,837,0,2,8,0,1
10424,65,3083,1338,495,1086,10,64,173,1348,11,122,82,157,133,239,883,1686,7,11934,663,0,2,1,5,1
10425,66,3580,1782,648,1425,9,47,279,1791,8,171,97,189,179,286,1292,2140,4,9462,525,0,2,1,3,1
10426,47,2312,1457,730,1242,11,6,188,1468,10,292,166,329,302,495,2424,4078,5,22973,1276,1,2,4,7,1
10427,17,526,424,94,331,4,0,89,428,1,5,5,5,6,10,11,25,0,12,0,0,2,1,3,1
10428,62,2690,1943,715,1694,26,18,214,1969,12,185,120,237,197,357,1436,2721,7,20915,1161,0,2,1,1,1
10429,176,4105,722,423,573,19,0,135,741,12,172,101,199,184,300,1320,2257,6,15668,870,0,2,8,0,0
10430,176,4105,1508,847,911,44,250,301,1552,14,148,88,169,162,257,1120,1886,7,15077,837,0,2,8,0,0
10431,65,3083,1338,495,1086,10,64,173,1348,11,122,82,157,133,239,883,1686,7,11934,663,0,2,1,5,0
10432,66,3580,1782,648,1425,9,47,279,1791,8,171,97,189,179,286,1292,2140,4,9462,525,0,2,1,3,0
10433,47,2312,1457,730,1242,11,6,188,1468,10,292,166,329,302,495,2424,4078,5,22973,1276,1,2,4,7,0
10434,17,526,424,94,331,4,0,89,428,1,5,5,5,6,10,11,25,0,12,0,0,2,1,3,0
10435,62,2690,1943,715,1694,26,18,214,1969,12,185,120,237,197,357,1436,2721,7,20915,1161,0,2,1,1,0
10436,273,5456,1457,730,1242,11,6,188,1468,10,292,166,329,302,495,2424,4078,5,22973,1276,1,2,14,10,1
10437,273,5456,74,35,59,1,0,14,75,3,14,7,14,17,21,58,85,1,128,7,0,2,14,10,1
10438,273,5456,245,125,200,5,7,34,250,7,30,17,34,37,51,166,265,3,1053,58,0,2,14,10,1
10439,170,3908,77,34,69,0,0,8,77,3,24,16,29,27,45,114,213,1,387,21,0,2,1,4,1
10440,170,3908,712,438,573,51,9,84,763,14,102,71,128,116,199,733,1364,8,11988,666,0,2,1,4,1
10441,180,4204,722,423,573,19,0,135,741,12,172,101,199,184,300,1320,2257,6,15668,870,0,2,31,4,1
10442,180,4204,1508,847,911,44,250,301,1552,14,148,88,169,162,257,1120,1886,7,15077,837,0,2,31,4,1
10443,65,3083,1338,495,1086,10,64,173,1348,11,122,82,157,133,239,883,1686,7,11934,663,0,2,18,18,1
10444,136,6025,139,89,101,2,0,35,141,7,54,34,62,61,96,330,569,4,2287,127,0,2,57,57,1
10445,136,6025,7,5,5,0,0,2,7,1,2,1,2,3,3,2,4,0,2,0,0,2,57,57,1
10446,66,3569,1782,648,1425,9,47,279,1791,8,171,97,189,179,286,1292,2140,4,9462,525,0,2,26,34,1
10447,64,2475,1450,624,1228,12,26,181,1462,14,306,186,354,320,540,2580,4493,8,36391,2021,1,2,1,1,1
10448,47,2312,1457,730,1242,11,6,188,1468,10,292,166,329,302,495,2424,4078,5,22973,1276,1,2,5,5,1
10449,17,522,424,94,331,4,0,89,428,1,5,5,5,6,10,11,25,0,12,0,0,2,16,20,1
10450,276,5499,1457,730,1242,11,6,188,1468,10,292,166,329,302,495,2424,4078,5,22973,1276,1,2,21,9,1
10451,276,5499,74,35,59,1,0,14,75,3,14,7,14,17,21,58,85,1,128,7,0,2,21,9,1
10452,276,5499,245,125,200,5,7,34,250,7,30,17,34,37,51,166,265,3,1053,58,0,2,21,9,1
10453,181,4293,722,423,573,19,0,135,741,12,172,101,199,184,300,1320,2257,6,15668,870,0,2,29,13,1
10454,181,4293,1508,847,911,44,250,301,1552,14,148,88,169,162,257,1120,1886,7,15077,837,0,2,29,13,1
10455,1,88,13,10,10,0,0,3,13,1,2,1,2,3,3,2,4,0,2,0,0,2,1,1,1
10456,66,2732,1289,550,1043,56,32,155,1345,10,167,93,185,177,278,1266,2075,5,11498,638,0,2,3,2,1
10457,39,715,127,75,83,2,11,30,129,4,14,7,14,18,21,61,87,2,175,9,0,2,39,35,1
10458,39,715,652,304,544,16,6,88,668,6,89,51,101,95,152,591,998,3,3399,188,0,2,39,35,1
10459,39,715,2,2,2,0,0,0,2,0,0,0,0,0,0,0,0,0,0,0,0,2,39,35,1
10460,39,715,8,5,5,0,0,3,8,0,0,0,0,0,0,0,0,0,0,0,0,2,39,35,1
10461,39,715,2,2,2,0,0,0,2,0,0,0,0,0,0,0,0,0,0,0,0,2,39,35,1
10462,39,715,14,8,8,0,0,6,14,0,0,0,0,0,0,0,0,0,0,0,0,2,39,35,1
10463,39,715,6,4,4,0,0,2,6,0,0,0,0,0,0,0,0,0,0,0,0,2,39,35,1
10464,39,715,6,4,4,0,0,2,6,1,2,1,2,3,3,2,4,0,2,0,0,2,39,35,1
10465,39,715,6,4,4,0,0,2,6,0,0,0,0,0,0,0,0,0,0,0,0,2,39,35,1
10466,39,715,7,5,5,0,0,2,7,0,0,0,0,0,0,0,0,0,0,0,0,2,39,35,1
10467,39,715,6,4,4,0,0,2,6,0,0,0,0,0,0,0,0,0,0,0,0,2,39,35,1
10468,39,715,10,6,6,0,0,4,10,0,0,0,0,0,0,0,0,0,0,0,0,2,39,35,1
10469,39,715,1,1,1,0,0,0,1,0,0,0,0,0,0,0,0,0,0,0,0,2,39,35,1
10470,39,715,1,1,1,0,0,0,1,0,0,0,0,0,0,0,0,0,0,0,0,2,39,35,1
10471,39,715,14,10,10,0,0,4,14,1,1,1,1,2,2,0,2,0,1,0,0,2,39,35,1
10472,39,715,46,26,30,3,0,12,49,3,6,3,6,9,9,20,28,1,42,2,0,2,39,35,1
10473,65,3081,1338,495,1086,10,64,173,1348,11,122,82,157,133,239,883,1686,7,11934,663,0,2,2,4,1
10474,136,6023,139,89,101,2,0,35,141,7,54,34,62,61,96,330,569,4,2287,127,0,2,2,4,1
10475,136,6023,7,5,5,0,0,2,7,1,2,1,2,3,3,2,4,0,2,0,0,2,2,4,1
10476,66,3569,1782,648,1425,9,47,279,1791,8,171,97,189,179,286,1292,2140,4,9462,525,0,2,1,1,1
10477,64,2475,1450,624,1228,12,26,181,1462,14,306,186,354,320,540,2580,4493,8,36391,2021,1,2,3,3,1
10478,132,3414,1660,832,1314,41,38,274,1701,20,312,209,395,332,604,2671,5058,12,64042,3557,1,2,3,5,1
10479,111,4259,1513,682,1277,25,13,200,1538,11,199,116,219,210,335,1557,2584,6,15641,868,0,2,29,29,1
10480,47,2814,1296,573,1062,40,33,157,1336,8,201,118,231,209,349,1561,2689,4,12365,686,0,2,0,2,1
10481,28,1176,1455,414,1257,16,76,112,1471,5,41,23,46,46,69,231,381,2,1069,59,0,2,0,2,1
10482,8,257,74,35,59,1,0,14,75,3,14,7,14,17,21,58,85,1,128,7,0,2,2,2,1
10483,31,1169,1293,570,1093,25,15,163,1318,10,195,123,241,205,364,1516,2795,6,17273,959,0,2,1,1,1
10484,24,961,373,158,315,8,0,51,381,5,76,44,79,81,123,486,779,2,2026,112,0,2,0,1,1
10485,211,4765,722,423,573,19,0,135,741,12,172,101,199,184,300,1320,2257,6,15668,870,0,2,158,96,1
10486,211,4765,1508,847,911,44,250,301,1552,14,148,88,169,162,257,1120,1886,7,15077,837,0,2,158,96,1
10487,66,2728,1289,550,1043,56,32,155,1345,10,167,93,185,177,278,1266,2075,5,11498,638,0,2,1,1,1
10488,65,3081,1338,495,1086,10,64,173,1348,11,122,82,157,133,239,883,1686,7,11934,663,0,2,17,17,1
10489,136,6023,139,89,101,2,0,35,141,7,54,34,62,61,96,330,569,4,2287,127,0,2,56,56,1
10490,136,6023,7,5,5,0,0,2,7,1,2,1,2,3,3,2,4,0,2,0,0,2,56,56,1
10491,66,3569,1782,648,1425,9,47,279,1791,8,171,97,189,179,286,1292,2140,4,9462,525,0,2,18,18,1
10492,132,3410,1660,832,1314,41,38,274,1701,20,312,209,395,332,604,2671,5058,12,64042,3557,1,2,2,2,1
10493,111,4256,1513,682,1277,25,13,200,1538,11,199,116,219,210,335,1557,2584,6,15641,868,0,2,18,20,1
10494,47,2814,1296,573,1062,40,33,157,1336,8,201,118,231,209,349,1561,2689,4,12365,686,0,2,1,1,1
10495,47,2312,1457,730,1242,11,6,188,1468,10,292,166,329,302,495,2424,4078,5,22973,1276,1,2,4,4,1
10496,28,1174,1455,414,1257,16,76,112,1471,5,41,23,46,46,69,231,381,2,1069,59,0,2,1,1,1
10497,17,522,424,94,331,4,0,89,428,1,5,5,5,6,10,11,25,0,12,0,0,2,11,11,1
10498,32,1211,1293,570,1093,25,15,163,1318,10,195,123,241,205,364,1516,2795,6,17273,959,0,2,11,4,1
10499,14,581,722,423,573,19,0,135,741,12,172,101,199,184,300,1320,2257,6,15668,870,0,2,1,13,1
10500,65,3081,1338,495,1086,10,64,173,1348,11,122,82,157,133,239,883,1686,7,11934,663,0,2,17,17,1
10501,136,6023,139,89,101,2,0,35,141,7,54,34,62,61,96,330,569,4,2287,127,0,2,56,56,1
10502,136,6023,7,5,5,0,0,2,7,1,2,1,2,3,3,2,4,0,2,0,0,2,56,56,1
10503,66,3569,1782,648,1425,9,47,279,1791,8,171,97,189,179,286,1292,2140,4,9462,525,0,2,18,18,1
10504,47,2312,1457,730,1242,11,6,188,1468,10,292,166,329,302,495,2424,4078,5,22973,1276,1,2,4,4,1
10505,17,522,424,94,331,4,0,89,428,1,5,5,5,6,10,11,25,0,12,0,0,2,11,11,1
10506,276,5499,1457,730,1242,11,6,188,1468,10,292,166,329,302,495,2424,4078,5,22973,1276,1,2,33,17,0
10507,276,5499,74,35,59,1,0,14,75,3,14,7,14,17,21,58,85,1,128,7,0,2,33,17,0
10508,276,5499,245,125,200,5,7,34,250,7,30,17,34,37,51,166,265,3,1053,58,0,2,33,17,0
10509,170,3908,77,34,69,0,0,8,77,3,24,16,29,27,45,114,213,1,387,21,0,2,1,4,0
10510,170,3908,712,438,573,51,9,84,763,14,102,71,128,116,199,733,1364,8,11988,666,0,2,1,4,0
10511,211,4765,722,423,573,19,0,135,741,12,172,101,199,184,300,1320,2257,6,15668,870,0,2,211,106,0
10512,211,4765,1508,847,911,44,250,301,1552,14,148,88,169,162,257,1120,1886,7,15077,837,0,2,211,106,0
10513,1,88,13,10,10,0,0,3,13,1,2,1,2,3,3,2,4,0,2,0,0,2,1,1,0
10514,66,2728,1289,550,1043,56,32,155,1345,10,167,93,185,177,278,1266,2075,5,11498,638,0,2,4,3,0
10515,65,3081,1338,495,1086,10,64,173,1348,11,122,82,157,133,239,883,1686,7,11934,663,0,2,1,3,0
10516,136,6023,139,89,101,2,0,35,141,7,54,34,62,61,96,330,569,4,2287,127,0,2,1,3,0
10517,136,6023,7,5,5,0,0,2,7,1,2,1,2,3,3,2,4,0,2,0,0,2,1,3,0
10518,66,3569,1782,648,1425,9,47,279,1791,8,171,97,189,179,286,1292,2140,4,9462,525,0,2,9,17,0
10519,64,2475,1450,624,1228,12,26,181,1462,14,306,186,354,320,540,2580,4493,8,36391,2021,1,2,2,2,0
10520,132,3410,1660,832,1314,41,38,274,1701,20,312,209,395,332,604,2671,5058,12,64042,3557,1,2,5,7,0
10521,111,4256,1513,682,1277,25,13,200,1538,11,199,116,219,210,335,1557,2584,6,15641,868,0,2,13,15,0
10522,47,2814,1296,573,1062,40,33,157,1336,8,201,118,231,209,349,1561,2689,4,12365,686,0,2,1,3,0
10523,47,2312,1457,730,1242,11,6,188,1468,10,292,166,329,302,495,2424,4078,5,22973,1276,1,2,1,1,0
10524,28,1174,1455,414,1257,16,76,112,1471,5,41,23,46,46,69,231,381,2,1069,59,0,2,1,3,0
10525,8,257,74,35,59,1,0,14,75,3,14,7,14,17,21,58,85,1,128,7,0,2,2,2,0
10526,17,522,424,94,331,4,0,89,428,1,5,5,5,6,10,11,25,0,12,0,0,2,6,10,0
10527,32,1211,1293,570,1093,25,15,163,1318,10,195,123,241,205,364,1516,2795,6,17273,959,0,2,12,5,0
10528,14,581,722,423,573,19,0,135,741,12,172,101,199,184,300,1320,2257,6,15668,870,0,2,1,13,0
10529,24,961,373,158,315,8,0,51,381,5,76,44,79,81,123,486,779,2,2026,112,0,2,0,1,0
10530,276,5497,1457,730,1242,11,6,188,1468,10,292,166,329,302,495,2424,4078,5,22973,1276,1,2,1,1,1
10531,276,5497,74,35,59,1,0,14,75,3,14,7,14,17,21,58,85,1,128,7,0,2,1,1,1
10532,276,5497,245,125,200,5,7,34,250,7,30,17,34,37,51,166,265,3,1053,58,0,2,1,1,1
10533,46,516,647,139,84,35,284,233,682,0,0,0,0,0,0,0,0,0,0,0,0,2,1,1,1
10534,211,4763,722,423,573,19,0,135,741,12,172,101,199,184,300,1320,2257,6,15668,870,0,2,2,2,1
10535,211,4763,1508,847,911,44,250,301,1552,14,148,88,169,162,257,1120,1886,7,15077,837,0,2,2,2,1
10536,468,10239,72,33,56,0,4,12,72,1,1,1,1,2,2,0,2,0,1,0,0,2,15,2,1
10537,468,10239,1454,835,1044,76,110,219,1530,17,275,158,296,292,454,2297,3718,9,34017,1889,1,2,15,2,1
10538,20,617,42,7,35,4,0,5,46,1,2,1,2,3,3,2,4,0,2,0,0,2,1,1,1
10539,20,617,11,6,10,0,0,1,11,2,4,2,4,6,6,10,15,1,15,0,0,2,1,1,1
10540,31,1709,384,251,317,7,8,52,391,11,70,44,84,81,128,467,811,6,5355,297,0,0,311,0,1
10541,283,5665,1457,730,1242,11,6,188,1468,10,292,166,329,302,495,2424,4078,5,22973,1276,1,2,31,9,1
10542,283,5665,74,35,59,1,0,14,75,3,14,7,14,17,21,58,85,1,128,7,0,2,31,9,1
10543,283,5665,245,125,200,5,7,34,250,7,30,17,34,37,51,166,265,3,1053,58,0,2,31,9,1
10544,46,522,647,139,84,35,284,233,682,0,0,0,0,0,0,0,0,0,0,0,0,2,3,1,1
10545,170,3908,77,34,69,0,0,8,77,3,24,16,29,27,45,114,213,1,387,21,0,2,2,2,1
10546,170,3908,712,438,573,51,9,84,763,14,102,71,128,116,199,733,1364,8,11988,666,0,2,2,2,1
10547,47,2318,1457,730,1242,11,6,188,1468,10,292,166,329,302,495,2424,4078,5,22973,1276,1,2,3,3,1
10548,85,1873,477,336,357,30,23,73,507,16,194,134,250,210,384,1538,2962,10,30538,1696,0,2,4,2,0
10549,134,3458,1660,832,1314,41,38,274,1701,20,312,209,395,332,604,2671,5058,12,64042,3557,1,2,21,0,0
10550,85,1873,477,336,357,30,23,73,507,16,194,134,250,210,384,1538,2962,10,30538,1696,0,2,4,2,0
10551,134,3451,1660,832,1314,41,38,274,1701,20,312,209,395,332,604,2671,5058,12,64042,3557,1,2,21,0,0
10552,43,863,447,308,343,6,5,95,453,7,96,59,111,103,170,651,1136,4,4600,255,0,2,2,2,0
10553,43,863,322,174,179,16,74,51,338,10,41,26,46,51,72,252,408,5,2291,127,0,2,2,2,0
10554,44,1315,1523,757,1297,19,12,193,1542,12,193,117,230,205,347,1508,2664,7,19053,1058,0,2,4,4,0
10555,44,1315,701,378,504,33,58,109,734,13,110,68,126,123,194,794,1346,7,10027,557,0,2,4,4,0
10556,40,2493,1523,757,1297,19,12,193,1542,12,193,117,230,205,347,1508,2664,7,19053,1058,0,2,5,1,0
10557,43,863,447,308,343,6,5,95,453,7,96,59,111,103,170,651,1136,4,4600,255,0,2,2,2,0
10558,43,863,322,174,179,16,74,51,338,10,41,26,46,51,72,252,408,5,2291,127,0,2,2,2,0
10559,284,5669,1457,730,1242,11,6,188,1468,10,292,166,329,302,495,2424,4078,5,22973,1276,1,2,12,11,0
10560,284,5669,74,35,59,1,0,14,75,3,14,7,14,17,21,58,85,1,128,7,0,2,12,11,0
10561,284,5669,245,125,200,5,7,34,250,7,30,17,34,37,51,166,265,3,1053,58,0,2,12,11,0
10562,85,1873,477,336,357,30,23,73,507,16,194,134,250,210,384,1538,2962,10,30538,1696,0,2,4,2,0
10563,43,863,447,308,343,6,5,95,453,7,96,59,111,103,170,651,1136,4,4600,255,0,2,2,2,0
10564,43,863,322,174,179,16,74,51,338,10,41,26,46,51,72,252,408,5,2291,127,0,2,2,2,0
10565,134,3451,1660,832,1314,41,38,274,1701,20,312,209,395,332,604,2671,5058,12,64042,3557,1,2,21,0,0
10566,284,5694,1457,730,1242,11,6,188,1468,10,292,166,329,302,495,2424,4078,5,22973,1276,1,2,27,20,1
10567,284,5694,74,35,59,1,0,14,75,3,14,7,14,17,21,58,85,1,128,7,0,2,27,20,1
10568,284,5694,245,125,200,5,7,34,250,7,30,17,34,37,51,166,265,3,1053,58,0,2,27,20,1
10569,23,749,74,35,59,1,0,14,75,3,14,7,14,17,21,58,85,1,128,7,0,2,3,3,1
10570,23,749,245,125,200,5,7,34,250,7,30,17,34,37,51,166,265,3,1053,58,0,2,3,3,1
10571,46,522,647,139,84,35,284,233,682,0,0,0,0,0,0,0,0,0,0,0,0,2,2,2,1
10572,169,3542,1943,715,1694,26,18,214,1969,12,185,120,237,197,357,1436,2721,7,20915,1161,0,2,6,3,1
10573,169,3542,1168,838,957,57,25,144,1225,19,348,224,416,367,640,3018,5452,11,61921,3440,1,2,6,3,1
10574,20,617,42,7,35,4,0,5,46,1,2,1,2,3,3,2,4,0,2,0,0,2,1,1,1
10575,20,617,11,6,10,0,0,1,11,2,4,2,4,6,6,10,15,1,15,0,0,2,1,1,1
10576,8,259,74,35,59,1,0,14,75,3,14,7,14,17,21,58,85,1,128,7,0,2,1,1,1
10577,62,2698,1943,715,1694,26,18,214,1969,12,185,120,237,197,357,1436,2721,7,20915,1161,0,2,6,4,1
10578,111,2266,1513,682,1277,25,13,200,1538,11,199,116,219,210,335,1557,2584,6,15641,868,0,2,7,7,1
10579,111,2266,819,519,539,24,98,155,843,15,96,57,106,111,163,690,1107,8,9171,509,0,2,7,7,1
10580,284,5696,1457,730,1242,11,6,188,1468,10,292,166,329,302,495,2424,4078,5,22973,1276,1,2,7,7,1
10581,284,5696,74,35,59,1,0,14,75,3,14,7,14,17,21,58,85,1,128,7,0,2,7,7,1
10582,284,5696,245,125,200,5,7,34,250,7,30,17,34,37,51,166,265,3,1053,58,0,2,7,7,1
10583,23,749,74,35,59,1,0,14,75,3,14,7,14,17,21,58,85,1,128,7,0,2,1,1,1
10584,23,749,245,125,200,5,7,34,250,7,30,17,34,37,51,166,265,3,1053,58,0,2,1,1,1
10585,46,522,647,139,84,35,284,233,682,0,0,0,0,0,0,0,0,0,0,0,0,2,22,22,1
10586,170,3908,77,34,69,0,0,8,77,3,24,16,29,27,45,114,213,1,387,21,0,2,2,2,1
10587,170,3908,712,438,573,51,9,84,763,14,102,71,128,116,199,733,1364,8,11988,666,0,2,2,2,1
10588,23,374,424,94,331,4,0,89,428,1,5,5,5,6,10,11,25,0,12,0,0,2,1,1,1
10589,23,374,38,23,23,6,0,8,44,3,11,7,11,14,18,42,68,1,102,5,0,2,1,1,1
10590,16,477,184,100,137,2,15,30,186,6,38,20,39,44,59,214,322,3,991,55,0,2,1,1,1
10591,16,477,103,65,74,8,5,16,111,7,17,9,17,24,26,89,119,3,417,23,0,2,1,1,1
10592,211,4763,722,423,573,19,0,135,741,12,172,101,199,184,300,1320,2257,6,15668,870,0,2,1,1,1
10593,211,4763,1508,847,911,44,250,301,1552,14,148,88,169,162,257,1120,1886,7,15077,837,0,2,1,1,1
10594,468,10239,72,33,56,0,4,12,72,1,1,1,1,2,2,0,2,0,1,0,0,2,3,3,1
10595,468,10239,1454,835,1044,76,110,219,1530,17,275,158,296,292,454,2297,3718,9,34017,1889,1,2,3,3,1
10596,83,1510,1178,367,1042,6,15,115,1184,9,94,51,95,103,146,644,976,4,4439,246,0,2,2,2,1
10597,83,1510,177,108,140,8,0,27,185,6,30,16,32,36,48,162,248,3,794,44,0,2,2,2,1
10598,169,3542,1943,715,1694,26,18,214,1969,12,185,120,237,197,357,1436,2721,7,20915,1161,0,2,2,2,1
10599,169,3542,1168,838,957,57,25,144,1225,19,348,224,416,367,640,3018,5452,11,61921,3440,1,2,2,2,1
10600,51,1018,1098,241,925,5,10,155,1103,7,46,25,49,53,74,273,423,3,1580,87,0,2,2,2,1
10601,51,1018,282,202,222,14,2,44,296,8,42,24,43,50,67,250,378,4,1548,86,0,2,2,2,1
10602,65,3081,1338,495,1086,10,64,173,1348,11,122,82,157,133,239,883,1686,7,11934,663,0,2,1,1,1
10603,8,259,74,35,59,1,0,14,75,3,14,7,14,17,21,58,85,1,128,7,0,2,1,1,1
10604,55,2363,1020,354,843,12,15,144,1032,8,134,77,144,142,221,970,1580,4,6792,377,0,2,1,1,1
10605,212,4789,722,423,573,19,0,135,741,12,172,101,199,184,300,1320,2257,6,15668,870,0,2,14,6,1
10606,212,4789,1508,847,911,44,250,301,1552,14,148,88,169,162,257,1120,1886,7,15077,837,0,2,14,6,1
10607,20,617,42,7,35,4,0,5,46,1,2,1,2,3,3,2,4,0,2,0,0,2,1,1,1
10608,20,617,11,6,10,0,0,1,11,2,4,2,4,6,6,10,15,1,15,0,0,2,1,1,1
10609,111,2266,1513,682,1277,25,13,200,1538,11,199,116,219,210,335,1557,2584,6,15641,868,0,2,7,7,0
10610,111,2266,819,519,539,24,98,155,843,15,96,57,106,111,163,690,1107,8,9171,509,0,2,7,7,0
10611,284,5696,1457,730,1242,11,6,188,1468,10,292,166,329,302,495,2424,4078,5,22973,1276,1,2,42,12,0
10612,284,5696,74,35,59,1,0,14,75,3,14,7,14,17,21,58,85,1,128,7,0,2,42,12,0
10613,284,5696,245,125,200,5,7,34,250,7,30,17,34,37,51,166,265,3,1053,58,0,2,42,12,0
10614,23,749,74,35,59,1,0,14,75,3,14,7,14,17,21,58,85,1,128,7,0,2,4,4,0
10615,23,749,245,125,200,5,7,34,250,7,30,17,34,37,51,166,265,3,1053,58,0,2,4,4,0
10616,46,522,647,139,84,35,284,233,682,0,0,0,0,0,0,0,0,0,0,0,0,2,23,21,0
10617,170,3908,77,34,69,0,0,8,77,3,24,16,29,27,45,114,213,1,387,21,0,2,4,4,0
10618,170,3908,712,438,573,51,9,84,763,14,102,71,128,116,199,733,1364,8,11988,666,0,2,4,4,0
10619,23,374,424,94,331,4,0,89,428,1,5,5,5,6,10,11,25,0,12,0,0,2,1,1,0
10620,23,374,38,23,23,6,0,8,44,3,11,7,11,14,18,42,68,1,102,5,0,2,1,1,0
10621,16,477,184,100,137,2,15,30,186,6,38,20,39,44,59,214,322,3,991,55,0,2,1,1,0
10622,16,477,103,65,74,8,5,16,111,7,17,9,17,24,26,89,119,3,417,23,0,2,1,1,0
10623,212,4789,722,423,573,19,0,135,741,12,172,101,199,184,300,1320,2257,6,15668,870,0,2,17,9,0
10624,212,4789,1508,847,911,44,250,301,1552,14,148,88,169,162,257,1120,1886,7,15077,837,0,2,17,9,0
10625,468,10239,72,33,56,0,4,12,72,1,1,1,1,2,2,0,2,0,1,0,0,2,18,5,0
10626,468,10239,1454,835,1044,76,110,219,1530,17,275,158,296,292,454,2297,3718,9,34017,1889,1,2,18,5,0
10627,83,1510,1178,367,1042,6,15,115,1184,9,94,51,95,103,146,644,976,4,4439,246,0,2,2,2,0
10628,83,1510,177,108,140,8,0,27,185,6,30,16,32,36,48,162,248,3,794,44,0,2,2,2,0
10629,169,3542,1943,715,1694,26,18,214,1969,12,185,120,237,197,357,1436,2721,7,20915,1161,0,2,8,5,0
10630,169,3542,1168,838,957,57,25,144,1225,19,348,224,416,367,640,3018,5452,11,61921,3440,1,2,8,5,0
10631,51,1018,1098,241,925,5,10,155,1103,7,46,25,49,53,74,273,423,3,1580,87,0,2,2,2,0
10632,51,1018,282,202,222,14,2,44,296,8,42,24,43,50,67,250,378,4,1548,86,0,2,2,2,0
10633,20,617,42,7,35,4,0,5,46,1,2,1,2,3,3,2,4,0,2,0,0,2,1,1,0
10634,20,617,11,6,10,0,0,1,11,2,4,2,4,6,6,10,15,1,15,0,0,2,1,1,0
10635,65,3081,1338,495,1086,10,64,173,1348,11,122,82,157,133,239,883,1686,7,11934,663,0,2,1,1,0
10636,47,2318,1457,730,1242,11,6,188,1468,10,292,166,329,302,495,2424,4078,5,22973,1276,1,2,3,3,0
10637,8,259,74,35,59,1,0,14,75,3,14,7,14,17,21,58,85,1,128,7,0,2,2,2,0
10638,55,2363,1020,354,843,12,15,144,1032,8,134,77,144,142,221,970,1580,4,6792,377,0,2,1,1,0
10639,31,1709,384,251,317,7,8,52,391,11,70,44,84,81,128,467,811,6,5355,297,0,0,311,0,0
10640,62,2698,1943,715,1694,26,18,214,1969,12,185,120,237,197,357,1436,2721,7,20915,1161,0,2,6,4,0
10641,216,4821,722,423,573,19,0,135,741,12,172,101,199,184,300,1320,2257,6,15668,870,0,2,15,7,1
10642,216,4821,1508,847,911,44,250,301,1552,14,148,88,169,162,257,1120,1886,7,15077,837,0,2,15,7,1
10643,20,617,42,7,35,4,0,5,46,1,2,1,2,3,3,2,4,0,2,0,0,2,1,1,1
10644,20,617,11,6,10,0,0,1,11,2,4,2,4,6,6,10,15,1,15,0,0,2,1,1,1
10645,62,2705,1943,715,1694,26,18,214,1969,12,185,120,237,197,357,1436,2721,7,20915,1161,0,2,5,5,1
10646,216,4821,722,423,573,19,0,135,741,12,172,101,199,184,300,1320,2257,6,15668,870,0,2,15,7,0
10647,216,4821,1508,847,911,44,250,301,1552,14,148,88,169,162,257,1120,1886,7,15077,837,0,2,15,7,0
10648,20,617,42,7,35,4,0,5,46,1,2,1,2,3,3,2,4,0,2,0,0,2,1,1,0
10649,20,617,11,6,10,0,0,1,11,2,4,2,4,6,6,10,15,1,15,0,0,2,1,1,0
10650,62,2705,1943,715,1694,26,18,214,1969,12,185,120,237,197,357,1436,2721,7,20915,1161,0,2,5,5,0
10651,20,617,42,7,35,4,0,5,46,1,2,1,2,3,3,2,4,0,2,0,0,2,1,1,0
10652,20,617,11,6,10,0,0,1,11,2,4,2,4,6,6,10,15,1,15,0,0,2,1,1,0
10653,216,4831,722,423,573,19,0,135,741,12,172,101,199,184,300,1320,2257,6,15668,870,0,2,2,1,1
10654,216,4831,1508,847,911,44,250,301,1552,14,148,88,169,162,257,1120,1886,7,15077,837,0,2,2,1,1
10655,44,872,447,308,343,6,5,95,453,7,96,59,111,103,170,651,1136,4,4600,255,0,2,5,4,1
10656,44,872,322,174,179,16,74,51,338,10,41,26,46,51,72,252,408,5,2291,127,0,2,5,4,1
10657,34,1509,447,308,343,6,5,95,453,7,96,59,111,103,170,651,1136,4,4600,255,0,2,5,0,1
10658,169,3532,1943,715,1694,26,18,214,1969,12,185,120,237,197,357,1436,2721,7,20915,1161,0,2,2,1,1
10659,169,3532,1168,838,957,57,25,144,1225,19,348,224,416,367,640,3018,5452,11,61921,3440,1,2,2,1,1
10660,44,872,447,308,343,6,5,95,453,7,96,59,111,103,170,651,1136,4,4600,255,0,2,5,4,0
10661,44,872,322,174,179,16,74,51,338,10,41,26,46,51,72,252,408,5,2291,127,0,2,5,4,0
10662,34,1509,447,308,343,6,5,95,453,7,96,59,111,103,170,651,1136,4,4600,255,0,2,5,0,0
10663,216,4831,722,423,573,19,0,135,741,12,172,101,199,184,300,1320,2257,6,15668,870,0,2,2,1,0
10664,216,4831,1508,847,911,44,250,301,1552,14,148,88,169,162,257,1120,1886,7,15077,837,0,2,2,1,0
10665,141,4443,1660,832,1314,41,38,274,1701,20,312,209,395,332,604,2671,5058,12,64042,3557,1,2,8,1,0
10666,141,4443,1057,646,719,113,100,145,1170,18,215,134,248,233,382,1740,3004,10,31186,1732,1,2,8,1,0
10667,141,4443,1660,832,1314,41,38,274,1701,20,312,209,395,332,604,2671,5058,12,64042,3557,1,2,8,1,0
10668,141,4443,1057,646,719,113,100,145,1170,18,215,134,248,233,382,1740,3004,10,31186,1732,1,2,8,1,0
10669,141,4443,1660,832,1314,41,38,274,1701,20,312,209,395,332,604,2671,5058,12,64042,3557,1,2,8,1,0
10670,141,4443,1057,646,719,113,100,145,1170,18,215,134,248,233,382,1740,3004,10,31186,1732,1,2,8,1,0
10671,44,1315,1523,757,1297,19,12,193,1542,12,193,117,230,205,347,1508,2664,7,19053,1058,0,2,4,4,0
10672,44,1315,701,378,504,33,58,109,734,13,110,68,126,123,194,794,1346,7,10027,557,0,2,4,4,0
10673,40,2493,1523,757,1297,19,12,193,1542,12,193,117,230,205,347,1508,2664,7,19053,1058,0,2,5,1,0
10674,468,10239,72,33,56,0,4,12,72,1,1,1,1,2,2,0,2,0,1,0,0,2,1,1,1
10675,468,10239,1454,835,1044,76,110,219,1530,17,275,158,296,292,454,2297,3718,9,34017,1889,1,2,1,1,1
10676,34,1509,447,308,343,6,5,95,453,7,96,59,111,103,170,651,1136,4,4600,255,0,2,1,1,1
10677,45,1333,1523,757,1297,19,12,193,1542,12,193,117,230,205,347,1508,2664,7,19053,1058,0,2,4,2,0
10678,45,1333,701,378,504,33,58,109,734,13,110,68,126,123,194,794,1346,7,10027,557,0,2,4,2,0
10679,29,1210,1455,414,1257,16,76,112,1471,5,41,23,46,46,69,231,381,2,1069,59,0,2,13,0,0
10680,29,1211,1455,414,1257,16,76,112,1471,5,41,23,46,46,69,231,381,2,1069,59,0,2,3,0,0
10681,44,1325,1523,757,1297,19,12,193,1542,12,193,117,230,205,347,1508,2664,7,19053,1058,0,2,4,2,0
10682,44,1325,701,378,504,33,58,109,734,13,110,68,126,123,194,794,1346,7,10027,557,0,2,4,2,0
10683,29,1226,1455,414,1257,16,76,112,1471,5,41,23,46,46,69,231,381,2,1069,59,0,2,16,0,0
10684,44,1343,1523,757,1297,19,12,193,1542,12,193,117,230,205,347,1508,2664,7,19053,1058,0,2,3,0,0
10685,44,1343,701,378,504,33,58,109,734,13,110,68,126,123,194,794,1346,7,10027,557,0,2,3,0,0
10686,30,635,215,129,180,6,0,29,221,8,65,43,72,73,115,415,711,4,3153,175,0,2,4,0,0
10687,30,635,97,69,77,3,3,16,100,6,22,13,23,28,36,113,173,3,542,30,0,2,4,0,0
10688,41,2532,1523,757,1297,19,12,193,1542,12,193,117,230,205,347,1508,2664,7,19053,1058,0,2,9,0,0
10689,16,1260,215,129,180,6,0,29,221,8,65,43,72,73,115,415,711,4,3153,175,0,2,14,0,0
10690,45,1361,1523,757,1297,19,12,193,1542,12,193,117,230,205,347,1508,2664,7,19053,1058,0,2,3,0,0
10691,45,1361,701,378,504,33,58,109,734,13,110,68,126,123,194,794,1346,7,10027,557,0,2,3,0,0
10692,30,635,215,129,180,6,0,29,221,8,65,43,72,73,115,415,711,4,3153,175,0,2,4,0,0
10693,30,635,97,69,77,3,3,16,100,6,22,13,23,28,36,113,173,3,542,30,0,2,4,0,0
10694,41,2532,1523,757,1297,19,12,193,1542,12,193,117,230,205,347,1508,2664,7,19053,1058,0,2,9,0,0
10695,16,1260,215,129,180,6,0,29,221,8,65,43,72,73,115,415,711,4,3153,175,0,2,14,0,0
10696,41,2533,1523,757,1297,19,12,193,1542,12,193,117,230,205,347,1508,2664,7,19053,1058,0,2,1,0,0
10697,16,1261,215,129,180,6,0,29,221,8,65,43,72,73,115,415,711,4,3153,175,0,2,1,0,0
10698,45,1361,1523,757,1297,19,12,193,1542,12,193,117,230,205,347,1508,2664,7,19053,1058,0,2,1,1,0
10699,45,1361,701,378,504,33,58,109,734,13,110,68,126,123,194,794,1346,7,10027,557,0,2,1,1,0
10700,30,635,215,129,180,6,0,29,221,8,65,43,72,73,115,415,711,4,3153,175,0,2,1,1,0
10701,30,635,97,69,77,3,3,16,100,6,22,13,23,28,36,113,173,3,542,30,0,2,1,1,0
10702,45,1361,1523,757,1297,19,12,193,1542,12,193,117,230,205,347,1508,2664,7,19053,1058,0,2,3,0,0
10703,45,1361,701,378,504,33,58,109,734,13,110,68,126,123,194,794,1346,7,10027,557,0,2,3,0,0
10704,30,635,215,129,180,6,0,29,221,8,65,43,72,73,115,415,711,4,3153,175,0,2,4,0,0
10705,30,635,97,69,77,3,3,16,100,6,22,13,23,28,36,113,173,3,542,30,0,2,4,0,0
10706,41,2533,1523,757,1297,19,12,193,1542,12,193,117,230,205,347,1508,2664,7,19053,1058,0,2,10,0,0
10707,16,1261,215,129,180,6,0,29,221,8,65,43,72,73,115,415,711,4,3153,175,0,2,15,0,0
10708,46,1369,1523,757,1297,19,12,193,1542,12,193,117,230,205,347,1508,2664,7,19053,1058,0,2,3,0,0
10709,46,1369,701,378,504,33,58,109,734,13,110,68,126,123,194,794,1346,7,10027,557,0,2,3,0,0
10710,30,635,215,129,180,6,0,29,221,8,65,43,72,73,115,415,711,4,3153,175,0,2,4,0,0
10711,30,635,97,69,77,3,3,16,100,6,22,13,23,28,36,113,173,3,542,30,0,2,4,0,0
10712,41,2533,1523,757,1297,19,12,193,1542,12,193,117,230,205,347,1508,2664,7,19053,1058,0,2,10,0,0
10713,16,1261,215,129,180,6,0,29,221,8,65,43,72,73,115,415,711,4,3153,175,0,2,15,0,0
10714,86,1567,1178,367,1042,6,15,115,1184,9,94,51,95,103,146,644,976,4,4439,246,0,2,9,0,1
10715,86,1567,177,108,140,8,0,27,185,6,30,16,32,36,48,162,248,3,794,44,0,2,9,0,1
10716,47,2042,1178,367,1042,6,15,115,1184,9,94,51,95,103,146,644,976,4,4439,246,0,2,2,2,1
10717,51,1035,1098,241,925,5,10,155,1103,7,46,25,49,53,74,273,423,3,1580,87,0,2,3,0,1
10718,51,1035,282,202,222,14,2,44,296,8,42,24,43,50,67,250,378,4,1548,86,0,2,3,0,1
10719,37,1422,1098,241,925,5,10,155,1103,7,46,25,49,53,74,273,423,3,1580,87,0,2,13,0,1
10720,86,1567,1178,367,1042,6,15,115,1184,9,94,51,95,103,146,644,976,4,4439,246,0,2,9,0,0
10721,86,1567,177,108,140,8,0,27,185,6,30,16,32,36,48,162,248,3,794,44,0,2,9,0,0
10722,51,1035,1098,241,925,5,10,155,1103,7,46,25,49,53,74,273,423,3,1580,87,0,2,3,0,0
10723,51,1035,282,202,222,14,2,44,296,8,42,24,43,50,67,250,378,4,1548,86,0,2,3,0,0
10724,47,2042,1178,367,1042,6,15,115,1184,9,94,51,95,103,146,644,976,4,4439,246,0,2,2,2,0
10725,37,1422,1098,241,925,5,10,155,1103,7,46,25,49,53,74,273,423,3,1580,87,0,2,13,0,0
10726,86,1573,1178,367,1042,6,15,115,1184,9,94,51,95,103,146,644,976,4,4439,246,0,2,9,0,0
10727,86,1573,177,108,140,8,0,27,185,6,30,16,32,36,48,162,248,3,794,44,0,2,9,0,0
10728,51,1041,1098,241,925,5,10,155,1103,7,46,25,49,53,74,273,423,3,1580,87,0,2,3,0,0
10729,51,1041,282,202,222,14,2,44,296,8,42,24,43,50,67,250,378,4,1548,86,0,2,3,0,0
10730,47,2042,1178,367,1042,6,15,115,1184,9,94,51,95,103,146,644,976,4,4439,246,0,2,2,2,0
10731,37,1422,1098,241,925,5,10,155,1103,7,46,25,49,53,74,273,423,3,1580,87,0,2,13,0,0
10732,469,10259,72,33,56,0,4,12,72,1,1,1,1,2,2,0,2,0,1,0,0,2,7,0,1
10733,469,10259,1454,835,1044,76,110,219,1530,17,275,158,296,292,454,2297,3718,9,34017,1889,1,2,7,0,1
10734,11,239,256,139,192,9,7,47,265,4,23,12,24,27,36,112,171,2,357,19,0,2,1,0,1
10735,88,1912,477,336,357,30,23,73,507,16,194,134,250,210,384,1538,2962,10,30538,1696,0,2,12,4,1
10736,72,2650,1450,624,1228,12,26,181,1462,14,306,186,354,320,540,2580,4493,8,36391,2021,1,2,36,0,1
10737,88,1912,477,336,357,30,23,73,507,16,194,134,250,210,384,1538,2962,10,30538,1696,0,2,12,4,0
10738,72,2650,1450,624,1228,12,26,181,1462,14,306,186,354,320,540,2580,4493,8,36391,2021,1,2,36,0,0
10739,469,10259,72,33,56,0,4,12,72,1,1,1,1,2,2,0,2,0,1,0,0,2,7,0,0
10740,469,10259,1454,835,1044,76,110,219,1530,17,275,158,296,292,454,2297,3718,9,34017,1889,1,2,7,0,0
10741,11,239,256,139,192,9,7,47,265,4,23,12,24,27,36,112,171,2,357,19,0,2,1,0,0
10742,20,615,42,7,35,4,0,5,46,1,2,1,2,3,3,2,4,0,2,0,0,2,5,5,1
10743,20,615,11,6,10,0,0,1,11,2,4,2,4,6,6,10,15,1,15,0,0,2,5,5,1
10744,285,5722,1457,730,1242,11,6,188,1468,10,292,166,329,302,495,2424,4078,5,22973,1276,1,2,4,0,1
10745,285,5722,74,35,59,1,0,14,75,3,14,7,14,17,21,58,85,1,128,7,0,2,4,0,1
10746,285,5722,245,125,200,5,7,34,250,7,30,17,34,37,51,166,265,3,1053,58,0,2,4,0,1
10747,170,3930,77,34,69,0,0,8,77,3,24,16,29,27,45,114,213,1,387,21,0,2,3,0,1
10748,170,3930,712,438,573,51,9,84,763,14,102,71,128,116,199,733,1364,8,11988,666,0,2,3,0,1
10749,30,1892,652,304,544,16,6,88,668,6,89,51,101,95,152,591,998,3,3399,188,0,2,6,0,1
10750,30,1961,652,304,544,16,6,88,668,6,89,51,101,95,152,591,998,3,3399,188,0,2,1,0,0
10751,30,1961,652,304,544,16,6,88,668,6,89,51,101,95,152,591,998,3,3399,188,0,2,1,0,0
10752,285,5716,1457,730,1242,11,6,188,1468,10,292,166,329,302,495,2424,4078,5,22973,1276,1,2,1,1,0
10753,285,5716,74,35,59,1,0,14,75,3,14,7,14,17,21,58,85,1,128,7,0,2,1,1,0
10754,285,5716,245,125,200,5,7,34,250,7,30,17,34,37,51,166,265,3,1053,58,0,2,1,1,0
10755,38,712,127,75,83,2,11,30,129,4,14,7,14,18,21,61,87,2,175,9,0,2,4,2,1
10756,38,712,652,304,544,16,6,88,668,6,89,51,101,95,152,591,998,3,3399,188,0,2,4,2,1
10757,38,712,2,2,2,0,0,0,2,0,0,0,0,0,0,0,0,0,0,0,0,2,4,2,1
10758,38,712,8,5,5,0,0,3,8,0,0,0,0,0,0,0,0,0,0,0,0,2,4,2,1
10759,38,712,2,2,2,0,0,0,2,0,0,0,0,0,0,0,0,0,0,0,0,2,4,2,1
10760,38,712,14,8,8,0,0,6,14,0,0,0,0,0,0,0,0,0,0,0,0,2,4,2,1
10761,38,712,6,4,4,0,0,2,6,0,0,0,0,0,0,0,0,0,0,0,0,2,4,2,1
10762,38,712,6,4,4,0,0,2,6,1,2,1,2,3,3,2,4,0,2,0,0,2,4,2,1
10763,38,712,6,4,4,0,0,2,6,0,0,0,0,0,0,0,0,0,0,0,0,2,4,2,1
10764,38,712,7,5,5,0,0,2,7,0,0,0,0,0,0,0,0,0,0,0,0,2,4,2,1
10765,38,712,6,4,4,0,0,2,6,0,0,0,0,0,0,0,0,0,0,0,0,2,4,2,1
10766,38,712,10,6,6,0,0,4,10,0,0,0,0,0,0,0,0,0,0,0,0,2,4,2,1
10767,38,712,1,1,1,0,0,0,1,0,0,0,0,0,0,0,0,0,0,0,0,2,4,2,1
10768,38,712,1,1,1,0,0,0,1,0,0,0,0,0,0,0,0,0,0,0,0,2,4,2,1
10769,38,712,14,10,10,0,0,4,14,1,1,1,1,2,2,0,2,0,1,0,0,2,4,2,1
10770,38,712,46,26,30,3,0,12,49,3,6,3,6,9,9,20,28,1,42,2,0,2,4,2,1
10771,88,1912,477,336,357,30,23,73,507,16,194,134,250,210,384,1538,2962,10,30538,1696,0,2,12,4,0
10772,470,10279,72,33,56,0,4,12,72,1,1,1,1,2,2,0,2,0,1,0,0,2,7,0,0
10773,470,10279,1454,835,1044,76,110,219,1530,17,275,158,296,292,454,2297,3718,9,34017,1889,1,2,7,0,0
10774,20,617,42,7,35,4,0,5,46,1,2,1,2,3,3,2,4,0,2,0,0,2,1,1,0
10775,20,617,11,6,10,0,0,1,11,2,4,2,4,6,6,10,15,1,15,0,0,2,1,1,0
10776,11,239,256,139,192,9,7,47,265,4,23,12,24,27,36,112,171,2,357,19,0,2,1,0,0
10777,72,2650,1450,624,1228,12,26,181,1462,14,306,186,354,320,540,2580,4493,8,36391,2021,1,2,36,0,0
10778,29,1872,652,304,544,16,6,88,668,6,89,51,101,95,152,591,998,3,3399,188,0,2,1,0,0
10779,285,5716,1457,730,1242,11,6,188,1468,10,292,166,329,302,495,2424,4078,5,22973,1276,1,2,4,0,0
10780,285,5716,74,35,59,1,0,14,75,3,14,7,14,17,21,58,85,1,128,7,0,2,4,0,0
10781,285,5716,245,125,200,5,7,34,250,7,30,17,34,37,51,166,265,3,1053,58,0,2,4,0,0
10782,170,3930,77,34,69,0,0,8,77,3,24,16,29,27,45,114,213,1,387,21,0,2,3,0,0
10783,170,3930,712,438,573,51,9,84,763,14,102,71,128,116,199,733,1364,8,11988,666,0,2,3,0,0
10784,30,1903,652,304,544,16,6,88,668,6,89,51,101,95,152,591,998,3,3399,188,0,2,6,0,0
10785,286,5730,1457,730,1242,11,6,188,1468,10,292,166,329,302,495,2424,4078,5,22973,1276,1,2,24,0,1
10786,286,5730,74,35,59,1,0,14,75,3,14,7,14,17,21,58,85,1,128,7,0,2,24,0,1
10787,286,5730,245,125,200,5,7,34,250,7,30,17,34,37,51,166,265,3,1053,58,0,2,24,0,1
10788,67,2756,1289,550,1043,56,32,155,1345,10,167,93,185,177,278,1266,2075,5,11498,638,0,2,6,0,1
10789,18,440,386,256,301,16,9,68,402,4,59,35,69,63,104,355,621,2,1453,80,0,2,2,2,0
10790,18,440,264,131,164,11,41,46,275,6,38,22,40,44,62,214,338,3,1068,59,0,2,2,2,0
10791,12,397,386,256,301,16,9,68,402,4,59,35,69,63,104,355,621,2,1453,80,0,2,4,4,0
10792,12,442,386,256,301,16,9,68,402,4,59,35,69,63,104,355,621,2,1453,80,0,2,6,2,0
10793,170,3536,1943,715,1694,26,18,214,1969,12,185,120,237,197,357,1436,2721,7,20915,1161,0,2,22,19,1
10794,170,3536,1168,838,957,57,25,144,1225,19,348,224,416,367,640,3018,5452,11,61921,3440,1,2,22,19,1
10795,63,3152,1943,715,1694,26,18,214,1969,12,185,120,237,197,357,1436,2721,7,20915,1161,0,2,53,0,1
10796,63,3178,1943,715,1694,26,18,214,1969,12,185,120,237,197,357,1436,2721,7,20915,1161,0,2,3,0,0
10797,63,3215,1943,715,1694,26,18,214,1969,12,185,120,237,197,357,1436,2721,7,20915,1161,0,2,4,0,0
10798,170,3536,1943,715,1694,26,18,214,1969,12,185,120,237,197,357,1436,2721,7,20915,1161,0,2,5,5,1
10799,170,3536,1168,838,957,57,25,144,1225,19,348,224,416,367,640,3018,5452,11,61921,3440,1,2,5,5,1
10800,170,3536,1943,715,1694,26,18,214,1969,12,185,120,237,197,357,1436,2721,7,20915,1161,0,2,1,1,1
10801,170,3536,1168,838,957,57,25,144,1225,19,348,224,416,367,640,3018,5452,11,61921,3440,1,2,1,1,1
10802,172,3552,1943,715,1694,26,18,214,1969,12,185,120,237,197,357,1436,2721,7,20915,1161,0,2,4,0,0
10803,172,3552,1168,838,957,57,25,144,1225,19,348,224,416,367,640,3018,5452,11,61921,3440,1,2,4,0,0
10804,63,3215,1943,715,1694,26,18,214,1969,12,185,120,237,197,357,1436,2721,7,20915,1161,0,2,4,4,0
10805,173,3560,1943,715,1694,26,18,214,1969,12,185,120,237,197,357,1436,2721,7,20915,1161,0,2,3,1,0
10806,173,3560,1168,838,957,57,25,144,1225,19,348,224,416,367,640,3018,5452,11,61921,3440,1,2,3,1,0
10807,63,3215,1943,715,1694,26,18,214,1969,12,185,120,237,197,357,1436,2721,7,20915,1161,0,2,13,7,0
10808,63,3215,1943,715,1694,26,18,214,1969,12,185,120,237,197,357,1436,2721,7,20915,1161,0,2,25,25,1
10809,47,1407,1523,757,1297,19,12,193,1542,12,193,117,230,205,347,1508,2664,7,19053,1058,0,2,11,5,1
10810,47,1407,701,378,504,33,58,109,734,13,110,68,126,123,194,794,1346,7,10027,557,0,2,11,5,1
10811,41,2655,1523,757,1297,19,12,193,1542,12,193,117,230,205,347,1508,2664,7,19053,1058,0,2,25,0,1
10812,47,1407,1523,757,1297,19,12,193,1542,12,193,117,230,205,347,1508,2664,7,19053,1058,0,2,11,5,0
10813,47,1407,701,378,504,33,58,109,734,13,110,68,126,123,194,794,1346,7,10027,557,0,2,11,5,0
10814,41,2655,1523,757,1297,19,12,193,1542,12,193,117,230,205,347,1508,2664,7,19053,1058,0,2,25,0,0
10815,173,3560,1943,715,1694,26,18,214,1969,12,185,120,237,197,357,1436,2721,7,20915,1161,0,2,28,19,0
10816,173,3560,1168,838,957,57,25,144,1225,19,348,224,416,367,640,3018,5452,11,61921,3440,1,2,28,19,0
10817,63,3215,1943,715,1694,26,18,214,1969,12,185,120,237,197,357,1436,2721,7,20915,1161,0,2,66,0,0
10818,41,2660,1523,757,1297,19,12,193,1542,12,193,117,230,205,347,1508,2664,7,19053,1058,0,2,1,1,0
10819,286,5730,1457,730,1242,11,6,188,1468,10,292,166,329,302,495,2424,4078,5,22973,1276,1,2,24,0,0
10820,286,5730,74,35,59,1,0,14,75,3,14,7,14,17,21,58,85,1,128,7,0,2,24,0,0
10821,286,5730,245,125,200,5,7,34,250,7,30,17,34,37,51,166,265,3,1053,58,0,2,24,0,0
10822,67,2756,1289,550,1043,56,32,155,1345,10,167,93,185,177,278,1266,2075,5,11498,638,0,2,6,0,0
10823,470,10280,72,33,56,0,4,12,72,1,1,1,1,2,2,0,2,0,1,0,0,2,21,0,1
10824,470,10280,1454,835,1044,76,110,219,1530,17,275,158,296,292,454,2297,3718,9,34017,1889,1,2,21,0,1
10825,470,10280,72,33,56,0,4,12,72,1,1,1,1,2,2,0,2,0,1,0,0,2,21,0,0
10826,470,10280,1454,835,1044,76,110,219,1530,17,275,158,296,292,454,2297,3718,9,34017,1889,1,2,21,0,0
10827,288,5751,1457,730,1242,11,6,188,1468,10,292,166,329,302,495,2424,4078,5,22973,1276,1,2,5,1,1
10828,288,5751,74,35,59,1,0,14,75,3,14,7,14,17,21,58,85,1,128,7,0,2,5,1,1
10829,288,5751,245,125,200,5,7,34,250,7,30,17,34,37,51,166,265,3,1053,58,0,2,5,1,1
10830,170,3947,77,34,69,0,0,8,77,3,24,16,29,27,45,114,213,1,387,21,0,2,2,0,1
10831,170,3947,712,438,573,51,9,84,763,14,102,71,128,116,199,733,1364,8,11988,666,0,2,2,0,1
10832,53,2991,1296,573,1062,40,33,157,1336,8,201,118,231,209,349,1561,2689,4,12365,686,0,2,29,0,1
10833,288,5813,1457,730,1242,11,6,188,1468,10,292,166,329,302,495,2424,4078,5,22973,1276,1,2,19,5,0
10834,288,5813,74,35,59,1,0,14,75,3,14,7,14,17,21,58,85,1,128,7,0,2,19,5,0
10835,288,5813,245,125,200,5,7,34,250,7,30,17,34,37,51,166,265,3,1053,58,0,2,19,5,0
10836,48,2366,1457,730,1242,11,6,188,1468,10,292,166,329,302,495,2424,4078,5,22973,1276,1,2,13,0,0
10837,288,5751,1457,730,1242,11,6,188,1468,10,292,166,329,302,495,2424,4078,5,22973,1276,1,2,5,1,0
10838,288,5751,74,35,59,1,0,14,75,3,14,7,14,17,21,58,85,1,128,7,0,2,5,1,0
10839,288,5751,245,125,200,5,7,34,250,7,30,17,34,37,51,166,265,3,1053,58,0,2,5,1,0
10840,170,3947,77,34,69,0,0,8,77,3,24,16,29,27,45,114,213,1,387,21,0,2,2,0,0
10841,170,3947,712,438,573,51,9,84,763,14,102,71,128,116,199,733,1364,8,11988,666,0,2,2,0,0
10842,53,2991,1296,573,1062,40,33,157,1336,8,201,118,231,209,349,1561,2689,4,12365,686,0,2,29,0,0
10843,290,5834,1457,730,1242,11,6,188,1468,10,292,166,329,302,495,2424,4078,5,22973,1276,1,2,19,5,0
10844,290,5834,74,35,59,1,0,14,75,3,14,7,14,17,21,58,85,1,128,7,0,2,19,5,0
10845,290,5834,245,125,200,5,7,34,250,7,30,17,34,37,51,166,265,3,1053,58,0,2,19,5,0
10846,48,2366,1457,730,1242,11,6,188,1468,10,292,166,329,302,495,2424,4078,5,22973,1276,1,2,13,0,0
10847,142,4468,1660,832,1314,41,38,274,1701,20,312,209,395,332,604,2671,5058,12,64042,3557,1,2,6,0,1
10848,142,4468,1057,646,719,113,100,145,1170,18,215,134,248,233,382,1740,3004,10,31186,1732,1,2,6,0,1
10849,135,3512,1660,832,1314,41,38,274,1701,20,312,209,395,332,604,2671,5058,12,64042,3557,1,2,15,0,1
10850,468,10189,72,33,56,0,4,12,72,1,1,1,1,2,2,0,2,0,1,0,0,2,1,9,0
10851,468,10189,1454,835,1044,76,110,219,1530,17,275,158,296,292,454,2297,3718,9,34017,1889,1,2,1,9,0
10852,137,6066,139,89,101,2,0,35,141,7,54,34,62,61,96,330,569,4,2287,127,0,2,38,0,0
10853,137,6066,7,5,5,0,0,2,7,1,2,1,2,3,3,2,4,0,2,0,0,2,38,0,0
10854,142,4468,1660,832,1314,41,38,274,1701,20,312,209,395,332,604,2671,5058,12,64042,3557,1,2,6,0,0
10855,142,4468,1057,646,719,113,100,145,1170,18,215,134,248,233,382,1740,3004,10,31186,1732,1,2,6,0,0
10856,135,3512,1660,832,1314,41,38,274,1701,20,312,209,395,332,604,2671,5058,12,64042,3557,1,2,15,0,0
10857,32,1014,1455,414,1257,16,76,112,1471,5,41,23,46,46,69,231,381,2,1069,59,0,2,20,14,1
10858,32,1014,669,365,481,22,61,110,691,15,103,63,122,118,185,747,1273,8,11311,628,0,2,20,14,1
10859,30,1250,1455,414,1257,16,76,112,1471,5,41,23,46,46,69,231,381,2,1069,59,0,2,33,0,1
10860,468,10189,72,33,56,0,4,12,72,1,1,1,1,2,2,0,2,0,1,0,0,2,1,9,0
10861,468,10189,1454,835,1044,76,110,219,1530,17,275,158,296,292,454,2297,3718,9,34017,1889,1,2,1,9,0
10862,137,6066,139,89,101,2,0,35,141,7,54,34,62,61,96,330,569,4,2287,127,0,2,38,0,0
10863,137,6066,7,5,5,0,0,2,7,1,2,1,2,3,3,2,4,0,2,0,0,2,38,0,0
10864,32,1014,1455,414,1257,16,76,112,1471,5,41,23,46,46,69,231,381,2,1069,59,0,2,20,14,0
10865,32,1014,669,365,481,22,61,110,691,15,103,63,122,118,185,747,1273,8,11311,628,0,2,20,14,0
10866,30,1250,1455,414,1257,16,76,112,1471,5,41,23,46,46,69,231,381,2,1069,59,0,2,33,0,0
10867,147,4753,1660,832,1314,41,38,274,1701,20,312,209,395,332,604,2671,5058,12,64042,3557,1,2,57,5,1
10868,147,4753,1057,646,719,113,100,145,1170,18,215,134,248,233,382,1740,3004,10,31186,1732,1,2,57,5,1
10869,147,4710,1660,832,1314,41,38,274,1701,20,312,209,395,332,604,2671,5058,12,64042,3557,1,2,4,8,0
10870,147,4710,1057,646,719,113,100,145,1170,18,215,134,248,233,382,1740,3004,10,31186,1732,1,2,4,8,0
10871,170,3950,77,34,69,0,0,8,77,3,24,16,29,27,45,114,213,1,387,21,0,2,5,3,1
10872,170,3950,712,438,573,51,9,84,763,14,102,71,128,116,199,733,1364,8,11988,666,0,2,5,3,1
10873,147,4716,1660,832,1314,41,38,274,1701,20,312,209,395,332,604,2671,5058,12,64042,3557,1,2,6,4,0
10874,147,4716,1057,646,719,113,100,145,1170,18,215,134,248,233,382,1740,3004,10,31186,1732,1,2,6,4,0
10875,216,4838,722,423,573,19,0,135,741,12,172,101,199,184,300,1320,2257,6,15668,870,0,2,8,6,1
10876,216,4838,1508,847,911,44,250,301,1552,14,148,88,169,162,257,1120,1886,7,15077,837,0,2,8,6,1
10877,13,397,442,244,305,14,16,103,456,11,68,45,75,79,120,452,756,6,4588,254,0,2,31,4,1
10878,13,397,182,102,99,11,40,35,193,3,11,6,11,14,17,42,64,1,97,5,0,2,31,4,1
10879,136,6023,139,89,101,2,0,35,141,7,54,34,62,61,96,330,569,4,2287,127,0,2,2,1,1
10880,136,6023,7,5,5,0,0,2,7,1,2,1,2,3,3,2,4,0,2,0,0,2,2,1,1
10881,30,1907,652,304,544,16,6,88,668,6,89,51,101,95,152,591,998,3,3399,188,0,2,2,2,1
10882,7,514,442,244,305,14,16,103,456,11,68,45,75,79,120,452,756,6,4588,254,0,2,18,17,1
10883,7,524,442,244,305,14,16,103,456,11,68,45,75,79,120,452,756,6,4588,254,0,2,3,1,1
10884,147,4716,1660,832,1314,41,38,274,1701,20,312,209,395,332,604,2671,5058,12,64042,3557,1,2,2,2,1
10885,147,4716,1057,646,719,113,100,145,1170,18,215,134,248,233,382,1740,3004,10,31186,1732,1,2,2,2,1
10886,68,1230,1020,354,843,12,15,144,1032,8,134,77,144,142,221,970,1580,4,6792,377,0,2,11,8,1
10887,62,2551,1020,354,843,12,15,144,1032,8,134,77,144,142,221,970,1580,4,6792,377,0,2,55,0,1
10888,12,410,442,244,305,14,16,103,456,11,68,45,75,79,120,452,756,6,4588,254,0,2,8,1,0
10889,12,410,182,102,99,11,40,35,193,3,11,6,11,14,17,42,64,1,97,5,0,2,8,1,0
10890,216,4838,722,423,573,19,0,135,741,12,172,101,199,184,300,1320,2257,6,15668,870,0,2,8,6,0
10891,216,4838,1508,847,911,44,250,301,1552,14,148,88,169,162,257,1120,1886,7,15077,837,0,2,8,6,0
10892,13,397,442,244,305,14,16,103,456,11,68,45,75,79,120,452,756,6,4588,254,0,2,31,4,0
10893,13,397,182,102,99,11,40,35,193,3,11,6,11,14,17,42,64,1,97,5,0,2,31,4,0
10894,136,6023,139,89,101,2,0,35,141,7,54,34,62,61,96,330,569,4,2287,127,0,2,2,1,0
10895,136,6023,7,5,5,0,0,2,7,1,2,1,2,3,3,2,4,0,2,0,0,2,2,1,0
10896,30,1907,652,304,544,16,6,88,668,6,89,51,101,95,152,591,998,3,3399,188,0,2,2,2,0
10897,7,524,442,244,305,14,16,103,456,11,68,45,75,79,120,452,756,6,4588,254,0,2,20,17,0
10898,474,10327,72,33,56,0,4,12,72,1,1,1,1,2,2,0,2,0,1,0,0,2,25,5,1
10899,474,10327,1454,835,1044,76,110,219,1530,17,275,158,296,292,454,2297,3718,9,34017,1889,1,2,25,5,1
10900,65,2998,1338,495,1086,10,64,173,1348,11,122,82,157,133,239,883,1686,7,11934,663,0,2,44,0,1
10901,473,10292,72,33,56,0,4,12,72,1,1,1,1,2,2,0,2,0,1,0,0,2,4,6,1
10902,473,10292,1454,835,1044,76,110,219,1530,17,275,158,296,292,454,2297,3718,9,34017,1889,1,2,4,6,1
10903,147,4716,1660,832,1314,41,38,274,1701,20,312,209,395,332,604,2671,5058,12,64042,3557,1,2,55,5,0
10904,147,4716,1057,646,719,113,100,145,1170,18,215,134,248,233,382,1740,3004,10,31186,1732,1,2,55,5,0
10905,170,3950,77,34,69,0,0,8,77,3,24,16,29,27,45,114,213,1,387,21,0,2,5,3,0
10906,170,3950,712,438,573,51,9,84,763,14,102,71,128,116,199,733,1364,8,11988,666,0,2,5,3,0
10907,146,4728,1660,832,1314,41,38,274,1701,20,312,209,395,332,604,2671,5058,12,64042,3557,1,2,57,5,1
10908,146,4728,1057,646,719,113,100,145,1170,18,215,134,248,233,382,1740,3004,10,31186,1732,1,2,57,5,1
10909,146,4685,1660,832,1314,41,38,274,1701,20,312,209,395,332,604,2671,5058,12,64042,3557,1,2,4,8,0
10910,146,4685,1057,646,719,113,100,145,1170,18,215,134,248,233,382,1740,3004,10,31186,1732,1,2,4,8,0
10911,172,3928,77,34,69,0,0,8,77,3,24,16,29,27,45,114,213,1,387,21,0,2,5,3,0
10912,172,3928,712,438,573,51,9,84,763,14,102,71,128,116,199,733,1364,8,11988,666,0,2,5,3,0
10913,146,4691,1660,832,1314,41,38,274,1701,20,312,209,395,332,604,2671,5058,12,64042,3557,1,2,6,4,0
10914,146,4691,1057,646,719,113,100,145,1170,18,215,134,248,233,382,1740,3004,10,31186,1732,1,2,6,4,0
10915,146,4691,1660,832,1314,41,38,274,1701,20,312,209,395,332,604,2671,5058,12,64042,3557,1,2,2,2,0
10916,146,4691,1057,646,719,113,100,145,1170,18,215,134,248,233,382,1740,3004,10,31186,1732,1,2,2,2,0
10917,146,4691,1660,832,1314,41,38,274,1701,20,312,209,395,332,604,2671,5058,12,64042,3557,1,2,55,5,0
10918,146,4691,1057,646,719,113,100,145,1170,18,215,134,248,233,382,1740,3004,10,31186,1732,1,2,55,5,0
10919,172,3928,77,34,69,0,0,8,77,3,24,16,29,27,45,114,213,1,387,21,0,2,5,3,0
10920,172,3928,712,438,573,51,9,84,763,14,102,71,128,116,199,733,1364,8,11988,666,0,2,5,3,0
10921,250,5035,1457,730,1242,11,6,188,1468,10,292,166,329,302,495,2424,4078,5,22973,1276,1,2,13,0,1
10922,250,5035,74,35,59,1,0,14,75,3,14,7,14,17,21,58,85,1,128,7,0,2,13,0,1
10923,250,5035,245,125,200,5,7,34,250,7,30,17,34,37,51,166,265,3,1053,58,0,2,13,0,1
10924,24,755,74,35,59,1,0,14,75,3,14,7,14,17,21,58,85,1,128,7,0,2,2,1,1
10925,24,755,245,125,200,5,7,34,250,7,30,17,34,37,51,166,265,3,1053,58,0,2,2,1,1
10926,68,1235,1020,354,843,12,15,144,1032,8,134,77,144,142,221,970,1580,4,6792,377,0,2,2,1,1
10927,21,574,1293,570,1093,25,15,163,1318,10,195,123,241,205,364,1516,2795,6,17273,959,0,2,5,1,1
10928,473,10297,72,33,56,0,4,12,72,1,1,1,1,2,2,0,2,0,1,0,0,2,2,1,1
10929,473,10297,1454,835,1044,76,110,219,1530,17,275,158,296,292,454,2297,3718,9,34017,1889,1,2,2,1,1
10930,166,3485,1943,715,1694,26,18,214,1969,12,185,120,237,197,357,1436,2721,7,20915,1161,0,2,3,5,1
10931,166,3485,1168,838,957,57,25,144,1225,19,348,224,416,367,640,3018,5452,11,61921,3440,1,2,3,5,1
10932,138,6100,139,89,101,2,0,35,141,7,54,34,62,61,96,330,569,4,2287,127,0,2,5,0,1
10933,138,6100,7,5,5,0,0,2,7,1,2,1,2,3,3,2,4,0,2,0,0,2,5,0,1
10934,90,1642,1178,367,1042,6,15,115,1184,9,94,51,95,103,146,644,976,4,4439,246,0,2,26,14,1
10935,90,1642,177,108,140,8,0,27,185,6,30,16,32,36,48,162,248,3,794,44,0,2,26,14,1
10936,48,2142,1178,367,1042,6,15,115,1184,9,94,51,95,103,146,644,976,4,4439,246,0,2,20,0,1
10937,68,1233,1020,354,843,12,15,144,1032,8,134,77,144,142,221,970,1580,4,6792,377,0,2,0,1,0
10938,21,572,1293,570,1093,25,15,163,1318,10,195,123,241,205,364,1516,2795,6,17273,959,0,2,0,1,0
10939,90,1642,1178,367,1042,6,15,115,1184,9,94,51,95,103,146,644,976,4,4439,246,0,2,26,14,0
10940,90,1642,177,108,140,8,0,27,185,6,30,16,32,36,48,162,248,3,794,44,0,2,26,14,0
10941,48,2142,1178,367,1042,6,15,115,1184,9,94,51,95,103,146,644,976,4,4439,246,0,2,20,0,0
10942,68,1230,1020,354,843,12,15,144,1032,8,134,77,144,142,221,970,1580,4,6792,377,0,2,11,8,1
10943,474,10313,72,33,56,0,4,12,72,1,1,1,1,2,2,0,2,0,1,0,0,2,24,15,1
10944,474,10313,1454,835,1044,76,110,219,1530,17,275,158,296,292,454,2297,3718,9,34017,1889,1,2,24,15,1
10945,18,440,386,256,301,16,9,68,402,4,59,35,69,63,104,355,621,2,1453,80,0,2,2,2,1
10946,18,440,264,131,164,11,41,46,275,6,38,22,40,44,62,214,338,3,1068,59,0,2,2,2,1
10947,90,1648,1178,367,1042,6,15,115,1184,9,94,51,95,103,146,644,976,4,4439,246,0,2,26,14,1
10948,90,1648,177,108,140,8,0,27,185,6,30,16,32,36,48,162,248,3,794,44,0,2,26,14,1
10949,13,436,442,244,305,14,16,103,456,11,68,45,75,79,120,452,756,6,4588,254,0,2,8,1,1
10950,13,436,182,102,99,11,40,35,193,3,11,6,11,14,17,42,64,1,97,5,0,2,8,1,1
10951,66,3113,1338,495,1086,10,64,173,1348,11,122,82,157,133,239,883,1686,7,11934,663,0,2,44,0,1
10952,137,6064,139,89,101,2,0,35,141,7,54,34,62,61,96,330,569,4,2287,127,0,2,38,0,1
10953,137,6064,7,5,5,0,0,2,7,1,2,1,2,3,3,2,4,0,2,0,0,2,38,0,1
10954,62,2551,1020,354,843,12,15,144,1032,8,134,77,144,142,221,970,1580,4,6792,377,0,2,55,0,1
10955,12,442,386,256,301,16,9,68,402,4,59,35,69,63,104,355,621,2,1453,80,0,2,8,4,1
10956,48,2142,1178,367,1042,6,15,115,1184,9,94,51,95,103,146,644,976,4,4439,246,0,2,20,0,1
10957,474,10299,72,33,56,0,4,12,72,1,1,1,1,2,2,0,2,0,1,0,0,2,12,8,1
10958,474,10299,1454,835,1044,76,110,219,1530,17,275,158,296,292,454,2297,3718,9,34017,1889,1,2,12,8,1
10959,37,1461,1098,241,925,5,10,155,1103,7,46,25,49,53,74,273,423,3,1580,87,0,2,10,5,1
10960,16,482,184,100,137,2,15,30,186,6,38,20,39,44,59,214,322,3,991,55,0,2,2,1,0
10961,16,482,103,65,74,8,5,16,111,7,17,9,17,24,26,89,119,3,417,23,0,2,2,1,0
10962,16,480,184,100,137,2,15,30,186,6,38,20,39,44,59,214,322,3,991,55,0,2,1,1,0
10963,16,480,103,65,74,8,5,16,111,7,17,9,17,24,26,89,119,3,417,23,0,2,1,1,0
10964,474,10299,72,33,56,0,4,12,72,1,1,1,1,2,2,0,2,0,1,0,0,2,12,8,0
10965,474,10299,1454,835,1044,76,110,219,1530,17,275,158,296,292,454,2297,3718,9,34017,1889,1,2,12,8,0
10966,37,1461,1098,241,925,5,10,155,1103,7,46,25,49,53,74,273,423,3,1580,87,0,2,10,5,0
10967,250,5035,1457,730,1242,11,6,188,1468,10,292,166,329,302,495,2424,4078,5,22973,1276,1,2,13,0,0
10968,250,5035,74,35,59,1,0,14,75,3,14,7,14,17,21,58,85,1,128,7,0,2,13,0,0
10969,250,5035,245,125,200,5,7,34,250,7,30,17,34,37,51,166,265,3,1053,58,0,2,13,0,0
10970,24,755,74,35,59,1,0,14,75,3,14,7,14,17,21,58,85,1,128,7,0,2,2,1,0
10971,24,755,245,125,200,5,7,34,250,7,30,17,34,37,51,166,265,3,1053,58,0,2,2,1,0
10972,68,1233,1020,354,843,12,15,144,1032,8,134,77,144,142,221,970,1580,4,6792,377,0,2,2,2,0
10973,16,480,184,100,137,2,15,30,186,6,38,20,39,44,59,214,322,3,991,55,0,2,3,2,0
10974,16,480,103,65,74,8,5,16,111,7,17,9,17,24,26,89,119,3,417,23,0,2,3,2,0
10975,21,572,1293,570,1093,25,15,163,1318,10,195,123,241,205,364,1516,2795,6,17273,959,0,2,5,2,0
10976,474,10304,72,33,56,0,4,12,72,1,1,1,1,2,2,0,2,0,1,0,0,2,2,1,0
10977,474,10304,1454,835,1044,76,110,219,1530,17,275,158,296,292,454,2297,3718,9,34017,1889,1,2,2,1,0
10978,166,3485,1943,715,1694,26,18,214,1969,12,185,120,237,197,357,1436,2721,7,20915,1161,0,2,3,5,0
10979,166,3485,1168,838,957,57,25,144,1225,19,348,224,416,367,640,3018,5452,11,61921,3440,1,2,3,5,0
10980,138,6100,139,89,101,2,0,35,141,7,54,34,62,61,96,330,569,4,2287,127,0,2,5,0,0
10981,138,6100,7,5,5,0,0,2,7,1,2,1,2,3,3,2,4,0,2,0,0,2,5,0,0
10982,293,5891,1457,730,1242,11,6,188,1468,10,292,166,329,302,495,2424,4078,5,22973,1276,1,2,12,0,0
10983,293,5891,74,35,59,1,0,14,75,3,14,7,14,17,21,58,85,1,128,7,0,2,12,0,0
10984,293,5891,245,125,200,5,7,34,250,7,30,17,34,37,51,166,265,3,1053,58,0,2,12,0,0
10985,23,754,74,35,59,1,0,14,75,3,14,7,14,17,21,58,85,1,128,7,0,2,2,1,0
10986,23,754,245,125,200,5,7,34,250,7,30,17,34,37,51,166,265,3,1053,58,0,2,2,1,0
10987,68,1233,1020,354,843,12,15,144,1032,8,134,77,144,142,221,970,1580,4,6792,377,0,2,2,2,0
10988,16,483,184,100,137,2,15,30,186,6,38,20,39,44,59,214,322,3,991,55,0,2,3,2,0
10989,16,483,103,65,74,8,5,16,111,7,17,9,17,24,26,89,119,3,417,23,0,2,3,2,0
10990,21,572,1293,570,1093,25,15,163,1318,10,195,123,241,205,364,1516,2795,6,17273,959,0,2,5,2,0
10991,475,10325,72,33,56,0,4,12,72,1,1,1,1,2,2,0,2,0,1,0,0,2,14,9,0
10992,475,10325,1454,835,1044,76,110,219,1530,17,275,158,296,292,454,2297,3718,9,34017,1889,1,2,14,9,0
10993,171,3530,1943,715,1694,26,18,214,1969,12,185,120,237,197,357,1436,2721,7,20915,1161,0,2,3,5,0
10994,171,3530,1168,838,957,57,25,144,1225,19,348,224,416,367,640,3018,5452,11,61921,3440,1,2,3,5,0
10995,138,6098,139,89,101,2,0,35,141,7,54,34,62,61,96,330,569,4,2287,127,0,2,5,0,0
10996,138,6098,7,5,5,0,0,2,7,1,2,1,2,3,3,2,4,0,2,0,0,2,5,0,0
10997,37,1461,1098,241,925,5,10,155,1103,7,46,25,49,53,74,273,423,3,1580,87,0,2,10,5,0
10998,295,5925,1457,730,1242,11,6,188,1468,10,292,166,329,302,495,2424,4078,5,22973,1276,1,2,3,0,1
10999,295,5925,74,35,59,1,0,14,75,3,14,7,14,17,21,58,85,1,128,7,0,2,3,0,1
11000,295,5925,245,125,200,5,7,34,250,7,30,17,34,37,51,166,265,3,1053,58,0,2,3,0,1
11001,34,2100,652,304,544,16,6,88,668,6,89,51,101,95,152,591,998,3,3399,188,0,2,41,0,1
11002,251,5055,1457,730,1242,11,6,188,1468,10,292,166,329,302,495,2424,4078,5,22973,1276,1,2,4,1,1
11003,251,5055,74,35,59,1,0,14,75,3,14,7,14,17,21,58,85,1,128,7,0,2,4,1,1
11004,251,5055,245,125,200,5,7,34,250,7,30,17,34,37,51,166,265,3,1053,58,0,2,4,1,1
11005,67,2827,1289,550,1043,56,32,155,1345,10,167,93,185,177,278,1266,2075,5,11498,638,0,2,16,0,1
11006,113,2501,1043,504,840,53,9,147,1096,9,180,112,198,189,310,1377,2344,4,11604,644,0,2,3,5,1
11007,113,2501,383,288,292,26,6,62,409,11,65,38,67,76,105,429,656,5,3719,206,0,2,3,5,1
11008,55,2166,1043,504,840,53,9,147,1096,9,180,112,198,189,310,1377,2344,4,11604,644,0,2,13,0,1
11009,55,2176,1043,504,840,53,9,147,1096,9,180,112,198,189,310,1377,2344,4,11604,644,0,2,4,4,1
11010,113,2501,1043,504,840,53,9,147,1096,9,180,112,198,189,310,1377,2344,4,11604,644,0,2,3,5,0
11011,113,2501,383,288,292,26,6,62,409,11,65,38,67,76,105,429,656,5,3719,206,0,2,3,5,0
11012,55,2176,1043,504,840,53,9,147,1096,9,180,112,198,189,310,1377,2344,4,11604,644,0,2,15,2,0
11013,39,719,127,75,83,2,11,30,129,4,14,7,14,18,21,61,87,2,175,9,0,2,7,1,0
11014,39,719,652,304,544,16,6,88,668,6,89,51,101,95,152,591,998,3,3399,188,0,2,7,1,0
11015,39,719,2,2,2,0,0,0,2,0,0,0,0,0,0,0,0,0,0,0,0,2,7,1,0
11016,39,719,8,5,5,0,0,3,8,0,0,0,0,0,0,0,0,0,0,0,0,2,7,1,0
11017,39,719,2,2,2,0,0,0,2,0,0,0,0,0,0,0,0,0,0,0,0,2,7,1,0
11018,39,719,14,8,8,0,0,6,14,0,0,0,0,0,0,0,0,0,0,0,0,2,7,1,0
11019,39,719,6,4,4,0,0,2,6,0,0,0,0,0,0,0,0,0,0,0,0,2,7,1,0
11020,39,719,6,4,4,0,0,2,6,1,2,1,2,3,3,2,4,0,2,0,0,2,7,1,0
11021,39,719,6,4,4,0,0,2,6,0,0,0,0,0,0,0,0,0,0,0,0,2,7,1,0
11022,39,719,7,5,5,0,0,2,7,0,0,0,0,0,0,0,0,0,0,0,0,2,7,1,0
11023,39,719,6,4,4,0,0,2,6,0,0,0,0,0,0,0,0,0,0,0,0,2,7,1,0
11024,39,719,10,6,6,0,0,4,10,0,0,0,0,0,0,0,0,0,0,0,0,2,7,1,0
11025,39,719,1,1,1,0,0,0,1,0,0,0,0,0,0,0,0,0,0,0,0,2,7,1,0
11026,39,719,1,1,1,0,0,0,1,0,0,0,0,0,0,0,0,0,0,0,0,2,7,1,0
11027,39,719,14,10,10,0,0,4,14,1,1,1,1,2,2,0,2,0,1,0,0,2,7,1,0
11028,39,719,46,26,30,3,0,12,49,3,6,3,6,9,9,20,28,1,42,2,0,2,7,1,0
11029,111,4263,1513,682,1277,25,13,200,1538,11,199,116,219,210,335,1557,2584,6,15641,868,0,2,2,1,0
11030,251,5055,1457,730,1242,11,6,188,1468,10,292,166,329,302,495,2424,4078,5,22973,1276,1,2,4,1,0
11031,251,5055,74,35,59,1,0,14,75,3,14,7,14,17,21,58,85,1,128,7,0,2,4,1,0
11032,251,5055,245,125,200,5,7,34,250,7,30,17,34,37,51,166,265,3,1053,58,0,2,4,1,0
11033,67,2827,1289,550,1043,56,32,155,1345,10,167,93,185,177,278,1266,2075,5,11498,638,0,2,16,0,0
11034,294,5911,1457,730,1242,11,6,188,1468,10,292,166,329,302,495,2424,4078,5,22973,1276,1,2,4,1,0
11035,294,5911,74,35,59,1,0,14,75,3,14,7,14,17,21,58,85,1,128,7,0,2,4,1,0
11036,294,5911,245,125,200,5,7,34,250,7,30,17,34,37,51,166,265,3,1053,58,0,2,4,1,0
11037,113,2501,1043,504,840,53,9,147,1096,9,180,112,198,189,310,1377,2344,4,11604,644,0,2,3,5,0
11038,113,2501,383,288,292,26,6,62,409,11,65,38,67,76,105,429,656,5,3719,206,0,2,3,5,0
11039,68,2865,1289,550,1043,56,32,155,1345,10,167,93,185,177,278,1266,2075,5,11498,638,0,2,16,0,0
11040,111,4260,1513,682,1277,25,13,200,1538,11,199,116,219,210,335,1557,2584,6,15641,868,0,2,2,1,0
11041,55,2176,1043,504,840,53,9,147,1096,9,180,112,198,189,310,1377,2344,4,11604,644,0,2,15,2,0
11042,216,4842,722,423,573,19,0,135,741,12,172,101,199,184,300,1320,2257,6,15668,870,0,2,4,1,0
11043,216,4842,1508,847,911,44,250,301,1552,14,148,88,169,162,257,1120,1886,7,15077,837,0,2,4,1,0
11044,111,4260,1513,682,1277,25,13,200,1538,11,199,116,219,210,335,1557,2584,6,15641,868,0,2,1,1,0
11045,20,625,42,7,35,4,0,5,46,1,2,1,2,3,3,2,4,0,2,0,0,2,2,1,0
11046,20,625,11,6,10,0,0,1,11,2,4,2,4,6,6,10,15,1,15,0,0,2,2,1,0
11047,296,5945,1457,730,1242,11,6,188,1468,10,292,166,329,302,495,2424,4078,5,22973,1276,1,2,3,0,0
11048,296,5945,74,35,59,1,0,14,75,3,14,7,14,17,21,58,85,1,128,7,0,2,3,0,0
11049,296,5945,245,125,200,5,7,34,250,7,30,17,34,37,51,166,265,3,1053,58,0,2,3,0,0
11050,34,2100,652,304,544,16,6,88,668,6,89,51,101,95,152,591,998,3,3399,188,0,2,41,0,0
11051,67,3186,1338,495,1086,10,64,173,1348,11,122,82,157,133,239,883,1686,7,11934,663,0,2,18,0,0
11052,68,1237,1020,354,843,12,15,144,1032,8,134,77,144,142,221,970,1580,4,6792,377,0,2,1,1,1
11053,68,1237,1020,354,843,12,15,144,1032,8,134,77,144,142,221,970,1580,4,6792,377,0,2,1,1,0
11054,67,3186,1338,495,1086,10,64,173,1348,11,122,82,157,133,239,883,1686,7,11934,663,0,2,18,0,0
11055,68,1237,1020,354,843,12,15,144,1032,8,134,77,144,142,221,970,1580,4,6792,377,0,2,1,1,0
11056,67,3186,1338,495,1086,10,64,173,1348,11,122,82,157,133,239,883,1686,7,11934,663,0,2,18,0,0
11057,112,2270,1513,682,1277,25,13,200,1538,11,199,116,219,210,335,1557,2584,6,15641,868,0,2,4,2,1
11058,112,2270,819,519,539,24,98,155,843,15,96,57,106,111,163,690,1107,8,9171,509,0,2,4,2,1
11059,112,4302,1513,682,1277,25,13,200,1538,11,199,116,219,210,335,1557,2584,6,15641,868,0,2,18,0,1
11060,112,4302,1513,682,1277,25,13,200,1538,11,199,116,219,210,335,1557,2584,6,15641,868,0,2,1,0,0
11061,112,2270,1513,682,1277,25,13,200,1538,11,199,116,219,210,335,1557,2584,6,15641,868,0,2,4,2,0
11062,112,2270,819,519,539,24,98,155,843,15,96,57,106,111,163,690,1107,8,9171,509,0,2,4,2,0
11063,112,4306,1513,682,1277,25,13,200,1538,11,199,116,219,210,335,1557,2584,6,15641,868,0,2,19,0,0
11064,112,2270,1513,682,1277,25,13,200,1538,11,199,116,219,210,335,1557,2584,6,15641,868,0,2,4,2,0
11065,112,2270,819,519,539,24,98,155,843,15,96,57,106,111,163,690,1107,8,9171,509,0,2,4,2,0
11066,112,4306,1513,682,1277,25,13,200,1538,11,199,116,219,210,335,1557,2584,6,15641,868,0,2,19,0,0
11067,480,10385,72,33,56,0,4,12,72,1,1,1,1,2,2,0,2,0,1,0,0,2,17,2,1
11068,480,10385,1454,835,1044,76,110,219,1530,17,275,158,296,292,454,2297,3718,9,34017,1889,1,2,17,2,1
11069,63,2600,1020,354,843,12,15,144,1032,8,134,77,144,142,221,970,1580,4,6792,377,0,2,18,0,1
11070,68,3245,1338,495,1086,10,64,173,1348,11,122,82,157,133,239,883,1686,7,11934,663,0,2,14,0,1
11071,68,3245,1338,495,1086,10,64,173,1348,11,122,82,157,133,239,883,1686,7,11934,663,0,2,14,0,0
11072,13,436,442,244,305,14,16,103,456,11,68,45,75,79,120,452,756,6,4588,254,0,2,1,1,1
11073,13,436,182,102,99,11,40,35,193,3,11,6,11,14,17,42,64,1,97,5,0,2,1,1,1
11074,8,551,442,244,305,14,16,103,456,11,68,45,75,79,120,452,756,6,4588,254,0,2,14,0,1
11075,13,436,442,244,305,14,16,103,456,11,68,45,75,79,120,452,756,6,4588,254,0,2,1,1,0
11076,13,436,182,102,99,11,40,35,193,3,11,6,11,14,17,42,64,1,97,5,0,2,1,1,0
11077,8,551,442,244,305,14,16,103,456,11,68,45,75,79,120,452,756,6,4588,254,0,2,14,0,0
11078,480,10385,72,33,56,0,4,12,72,1,1,1,1,2,2,0,2,0,1,0,0,2,14,15,1
11079,480,10385,1454,835,1044,76,110,219,1530,17,275,158,296,292,454,2297,3718,9,34017,1889,1,2,14,15,1
11080,36,810,386,256,301,16,9,68,402,4,59,35,69,63,104,355,621,2,1453,80,0,2,147,57,1
11081,36,810,264,131,164,11,41,46,275,6,38,22,40,44,62,214,338,3,1068,59,0,2,147,57,1
11082,11,230,256,139,192,9,7,47,265,4,23,12,24,27,36,112,171,2,357,19,0,2,0,1,1
11083,20,938,386,256,301,16,9,68,402,4,59,35,69,63,104,355,621,2,1453,80,0,2,136,52,1
11084,478,10389,72,33,56,0,4,12,72,1,1,1,1,2,2,0,2,0,1,0,0,2,17,5,1
11085,478,10389,1454,835,1044,76,110,219,1530,17,275,158,296,292,454,2297,3718,9,34017,1889,1,2,17,5,1
11086,70,3830,1782,648,1425,9,47,279,1791,8,171,97,189,179,286,1292,2140,4,9462,525,0,2,40,0,1
11087,476,10387,72,33,56,0,4,12,72,1,1,1,1,2,2,0,2,0,1,0,0,2,2,2,0
11088,476,10387,1454,835,1044,76,110,219,1530,17,275,158,296,292,454,2297,3718,9,34017,1889,1,2,2,2,0
11089,70,3830,1782,648,1425,9,47,279,1791,8,171,97,189,179,286,1292,2140,4,9462,525,0,2,6,5,0
11090,71,3863,1782,648,1425,9,47,279,1791,8,171,97,189,179,286,1292,2140,4,9462,525,0,2,19,0,0
11091,72,3886,1782,648,1425,9,47,279,1791,8,171,97,189,179,286,1292,2140,4,9462,525,0,2,5,18,1
11092,477,10406,72,33,56,0,4,12,72,1,1,1,1,2,2,0,2,0,1,0,0,2,12,11,0
11093,477,10406,1454,835,1044,76,110,219,1530,17,275,158,296,292,454,2297,3718,9,34017,1889,1,2,12,11,0
11094,72,3922,1782,648,1425,9,47,279,1791,8,171,97,189,179,286,1292,2140,4,9462,525,0,2,15,2,0
11095,477,10406,72,33,56,0,4,12,72,1,1,1,1,2,2,0,2,0,1,0,0,2,1,1,1
11096,477,10406,1454,835,1044,76,110,219,1530,17,275,158,296,292,454,2297,3718,9,34017,1889,1,2,1,1,1
11097,480,10385,72,33,56,0,4,12,72,1,1,1,1,2,2,0,2,0,1,0,0,2,14,15,0
11098,480,10385,1454,835,1044,76,110,219,1530,17,275,158,296,292,454,2297,3718,9,34017,1889,1,2,14,15,0
11099,36,810,386,256,301,16,9,68,402,4,59,35,69,63,104,355,621,2,1453,80,0,2,147,57,0
11100,36,810,264,131,164,11,41,46,275,6,38,22,40,44,62,214,338,3,1068,59,0,2,147,57,0
11101,11,230,256,139,192,9,7,47,265,4,23,12,24,27,36,112,171,2,357,19,0,2,0,1,0
11102,20,938,386,256,301,16,9,68,402,4,59,35,69,63,104,355,621,2,1453,80,0,2,136,52,0
11103,1,315,382,65,130,157,2,92,539,4,10,5,10,14,15,41,57,2,114,6,0,2,5,5,0
11104,20,942,386,256,301,16,9,68,402,4,59,35,69,63,104,355,621,2,1453,80,0,2,2,1,0
11105,1,315,382,65,130,157,2,92,539,4,10,5,10,14,15,41,57,2,114,6,0,2,5,5,0
11106,36,822,386,256,301,16,9,68,402,4,59,35,69,63,104,355,621,2,1453,80,0,2,6,2,1
11107,36,822,264,131,164,11,41,46,275,6,38,22,40,44,62,214,338,3,1068,59,0,2,6,2,1
11108,21,982,386,256,301,16,9,68,402,4,59,35,69,63,104,355,621,2,1453,80,0,2,6,0,1
11109,21,974,386,256,301,16,9,68,402,4,59,35,69,63,104,355,621,2,1453,80,0,2,13,4,1
11110,1,315,382,65,130,157,2,92,539,4,10,5,10,14,15,41,57,2,114,6,0,2,5,5,0
11111,486,10456,72,33,56,0,4,12,72,1,1,1,1,2,2,0,2,0,1,0,0,2,15,0,1
11112,486,10456,1454,835,1044,76,110,219,1530,17,275,158,296,292,454,2297,3718,9,34017,1889,1,2,15,0,1
11113,67,3655,1782,648,1425,9,47,279,1791,8,171,97,189,179,286,1292,2140,4,9462,525,0,2,15,3,1
11114,481,10401,72,33,56,0,4,12,72,1,1,1,1,2,2,0,2,0,1,0,0,2,7,4,1
11115,481,10401,1454,835,1044,76,110,219,1530,17,275,158,296,292,454,2297,3718,9,34017,1889,1,2,7,4,1
11116,66,3598,1782,648,1425,9,47,279,1791,8,171,97,189,179,286,1292,2140,4,9462,525,0,2,6,4,1
11117,481,10401,72,33,56,0,4,12,72,1,1,1,1,2,2,0,2,0,1,0,0,2,7,4,0
11118,481,10401,1454,835,1044,76,110,219,1530,17,275,158,296,292,454,2297,3718,9,34017,1889,1,2,7,4,0
11119,66,3598,1782,648,1425,9,47,279,1791,8,171,97,189,179,286,1292,2140,4,9462,525,0,2,6,4,0
11120,486,10459,72,33,56,0,4,12,72,1,1,1,1,2,2,0,2,0,1,0,0,2,4,3,0
11121,486,10459,1454,835,1044,76,110,219,1530,17,275,158,296,292,454,2297,3718,9,34017,1889,1,2,4,3,0
11122,486,10457,72,33,56,0,4,12,72,1,1,1,1,2,2,0,2,0,1,0,0,2,4,4,1
11123,486,10457,1454,835,1044,76,110,219,1530,17,275,158,296,292,454,2297,3718,9,34017,1889,1,2,4,4,1
11124,485,10457,72,33,56,0,4,12,72,1,1,1,1,2,2,0,2,0,1,0,0,2,6,6,1
11125,485,10457,1454,835,1044,76,110,219,1530,17,275,158,296,292,454,2297,3718,9,34017,1889,1,2,6,6,1
11126,483,10482,72,33,56,0,4,12,72,1,1,1,1,2,2,0,2,0,1,0,0,2,20,7,0
11127,483,10482,1454,835,1044,76,110,219,1530,17,275,158,296,292,454,2297,3718,9,34017,1889,1,2,20,7,0
11128,72,3951,1782,648,1425,9,47,279,1791,8,171,97,189,179,286,1292,2140,4,9462,525,0,2,60,0,0
11129,75,4081,1782,648,1425,9,47,279,1791,8,171,97,189,179,286,1292,2140,4,9462,525,0,2,61,1,0
11130,486,10473,72,33,56,0,4,12,72,1,1,1,1,2,2,0,2,0,1,0,0,2,16,0,0
11131,486,10473,1454,835,1044,76,110,219,1530,17,275,158,296,292,454,2297,3718,9,34017,1889,1,2,16,0,0
11132,67,3684,1782,648,1425,9,47,279,1791,8,171,97,189,179,286,1292,2140,4,9462,525,0,2,15,3,0
11133,21,656,424,94,331,4,0,89,428,1,5,5,5,6,10,11,25,0,12,0,0,2,46,0,1
11134,493,10575,72,33,56,0,4,12,72,1,1,1,1,2,2,0,2,0,1,0,0,2,31,6,1
11135,493,10575,1454,835,1044,76,110,219,1530,17,275,158,296,292,454,2297,3718,9,34017,1889,1,2,31,6,1
11136,493,10571,72,33,56,0,4,12,72,1,1,1,1,2,2,0,2,0,1,0,0,2,2,2,1
11137,493,10571,1454,835,1044,76,110,219,1530,17,275,158,296,292,454,2297,3718,9,34017,1889,1,2,2,2,1
11138,493,10571,72,33,56,0,4,12,72,1,1,1,1,2,2,0,2,0,1,0,0,2,33,8,0
11139,493,10571,1454,835,1044,76,110,219,1530,17,275,158,296,292,454,2297,3718,9,34017,1889,1,2,33,8,0
11140,21,656,424,94,331,4,0,89,428,1,5,5,5,6,10,11,25,0,12,0,0,2,46,0,0
11141,297,5964,1457,730,1242,11,6,188,1468,10,292,166,329,302,495,2424,4078,5,22973,1276,1,2,4,0,0
11142,297,5964,74,35,59,1,0,14,75,3,14,7,14,17,21,58,85,1,128,7,0,2,4,0,0
11143,297,5964,245,125,200,5,7,34,250,7,30,17,34,37,51,166,265,3,1053,58,0,2,4,0,0
11144,69,2885,1289,550,1043,56,32,155,1345,10,167,93,185,177,278,1266,2075,5,11498,638,0,2,5,0,0
11145,297,5964,1457,730,1242,11,6,188,1468,10,292,166,329,302,495,2424,4078,5,22973,1276,1,2,4,0,0
11146,297,5964,74,35,59,1,0,14,75,3,14,7,14,17,21,58,85,1,128,7,0,2,4,0,0
11147,297,5964,245,125,200,5,7,34,250,7,30,17,34,37,51,166,265,3,1053,58,0,2,4,0,0
11148,69,2885,1289,550,1043,56,32,155,1345,10,167,93,185,177,278,1266,2075,5,11498,638,0,2,5,0,0
11149,492,10563,72,33,56,0,4,12,72,1,1,1,1,2,2,0,2,0,1,0,0,2,1,1,1
11150,492,10563,1454,835,1044,76,110,219,1530,17,275,158,296,292,454,2297,3718,9,34017,1889,1,2,1,1,1
11151,68,3245,1338,495,1086,10,64,173,1348,11,122,82,157,133,239,883,1686,7,11934,663,0,2,11,1,1
11152,139,6127,139,89,101,2,0,35,141,7,54,34,62,61,96,330,569,4,2287,127,0,2,16,0,1
11153,139,6127,7,5,5,0,0,2,7,1,2,1,2,3,3,2,4,0,2,0,0,2,16,0,1
11154,492,10563,72,33,56,0,4,12,72,1,1,1,1,2,2,0,2,0,1,0,0,2,1,1,0
11155,492,10563,1454,835,1044,76,110,219,1530,17,275,158,296,292,454,2297,3718,9,34017,1889,1,2,1,1,0
11156,68,3245,1338,495,1086,10,64,173,1348,11,122,82,157,133,239,883,1686,7,11934,663,0,2,11,1,0
11157,139,6127,139,89,101,2,0,35,141,7,54,34,62,61,96,330,569,4,2287,127,0,2,16,0,0
11158,139,6127,7,5,5,0,0,2,7,1,2,1,2,3,3,2,4,0,2,0,0,2,16,0,0
11159,40,1253,1455,414,1257,16,76,112,1471,5,41,23,46,46,69,231,381,2,1069,59,0,2,76,8,1
11160,40,1253,669,365,481,22,61,110,691,15,103,63,122,118,185,747,1273,8,11311,628,0,2,76,8,1
11161,33,1397,1455,414,1257,16,76,112,1471,5,41,23,46,46,69,231,381,2,1069,59,0,2,44,0,1
11162,40,1249,1455,414,1257,16,76,112,1471,5,41,23,46,46,69,231,381,2,1069,59,0,2,13,8,0
11163,40,1249,669,365,481,22,61,110,691,15,103,63,122,118,185,747,1273,8,11311,628,0,2,13,8,0
11164,33,1398,1455,414,1257,16,76,112,1471,5,41,23,46,46,69,231,381,2,1069,59,0,2,6,5,0
11165,20,625,42,7,35,4,0,5,46,1,2,1,2,3,3,2,4,0,2,0,0,2,2,1,0
11166,20,625,11,6,10,0,0,1,11,2,4,2,4,6,6,10,15,1,15,0,0,2,2,1,0
11167,40,1249,1455,414,1257,16,76,112,1471,5,41,23,46,46,69,231,381,2,1069,59,0,2,81,8,0
11168,40,1249,669,365,481,22,61,110,691,15,103,63,122,118,185,747,1273,8,11311,628,0,2,81,8,0
11169,33,1398,1455,414,1257,16,76,112,1471,5,41,23,46,46,69,231,381,2,1069,59,0,2,45,0,0
11170,172,3537,1943,715,1694,26,18,214,1969,12,185,120,237,197,357,1436,2721,7,20915,1161,0,2,7,2,0
11171,172,3537,1168,838,957,57,25,144,1225,19,348,224,416,367,640,3018,5452,11,61921,3440,1,2,7,2,0
11172,172,3541,1943,715,1694,26,18,214,1969,12,185,120,237,197,357,1436,2721,7,20915,1161,0,2,1,1,0
11173,172,3541,1168,838,957,57,25,144,1225,19,348,224,416,367,640,3018,5452,11,61921,3440,1,2,1,1,0
11174,173,3552,1943,715,1694,26,18,214,1969,12,185,120,237,197,357,1436,2721,7,20915,1161,0,2,18,12,1
11175,173,3552,1168,838,957,57,25,144,1225,19,348,224,416,367,640,3018,5452,11,61921,3440,1,2,18,12,1
11176,65,3354,1943,715,1694,26,18,214,1969,12,185,120,237,197,357,1436,2721,7,20915,1161,0,2,20,2,1
11177,171,3978,77,34,69,0,0,8,77,3,24,16,29,27,45,114,213,1,387,21,0,2,5,0,1
11178,171,3978,712,438,573,51,9,84,763,14,102,71,128,116,199,733,1364,8,11988,666,0,2,5,0,1
11179,171,3550,1943,715,1694,26,18,214,1969,12,185,120,237,197,357,1436,2721,7,20915,1161,0,2,7,2,1
11180,171,3550,1168,838,957,57,25,144,1225,19,348,224,416,367,640,3018,5452,11,61921,3440,1,2,7,2,1
11181,69,2894,1289,550,1043,56,32,155,1345,10,167,93,185,177,278,1266,2075,5,11498,638,0,2,9,7,1
11182,68,3251,1338,495,1086,10,64,173,1348,11,122,82,157,133,239,883,1686,7,11934,663,0,2,3,1,1
11183,135,3518,1660,832,1314,41,38,274,1701,20,312,209,395,332,604,2671,5058,12,64042,3557,1,2,3,2,1
11184,112,4312,1513,682,1277,25,13,200,1538,11,199,116,219,210,335,1557,2584,6,15641,868,0,2,2,1,1
11185,53,2988,1296,573,1062,40,33,157,1336,8,201,118,231,209,349,1561,2689,4,12365,686,0,2,5,5,1
11186,48,2372,1457,730,1242,11,6,188,1468,10,292,166,329,302,495,2424,4078,5,22973,1276,1,2,2,1,1
11187,34,2121,652,304,544,16,6,88,668,6,89,51,101,95,152,591,998,3,3399,188,0,2,5,1,1
11188,8,265,74,35,59,1,0,14,75,3,14,7,14,17,21,58,85,1,128,7,0,2,4,3,1
11189,41,2667,1523,757,1297,19,12,193,1542,12,193,117,230,205,347,1508,2664,7,19053,1058,0,2,2,1,1
11190,31,1715,384,251,317,7,8,52,391,11,70,44,84,81,128,467,811,6,5355,297,0,2,2,1,1
11191,56,2276,1043,504,840,53,9,147,1096,9,180,112,198,189,310,1377,2344,4,11604,644,0,2,21,0,1
11192,24,967,373,158,315,8,0,51,381,5,76,44,79,81,123,486,779,2,2026,112,0,2,3,1,1
11193,63,3221,1943,715,1694,26,18,214,1969,12,185,120,237,197,357,1436,2721,7,20915,1161,0,2,2,1,1
11194,37,1467,1098,241,925,5,10,155,1103,7,46,25,49,53,74,273,423,3,1580,87,0,2,3,2,1
11195,171,3978,77,34,69,0,0,8,77,3,24,16,29,27,45,114,213,1,387,21,0,2,8,8,0
11196,171,3978,712,438,573,51,9,84,763,14,102,71,128,116,199,733,1364,8,11988,666,0,2,8,8,0
11197,53,1539,1523,757,1297,19,12,193,1542,12,193,117,230,205,347,1508,2664,7,19053,1058,0,2,21,0,1
11198,53,1539,701,378,504,33,58,109,734,13,110,68,126,123,194,794,1346,7,10027,557,0,2,21,0,1
11199,42,2710,1523,757,1297,19,12,193,1542,12,193,117,230,205,347,1508,2664,7,19053,1058,0,2,10,1,1
11200,56,2276,1043,504,840,53,9,147,1096,9,180,112,198,189,310,1377,2344,4,11604,644,0,2,2,2,0
11201,173,3552,1943,715,1694,26,18,214,1969,12,185,120,237,197,357,1436,2721,7,20915,1161,0,2,18,7,0
11202,173,3552,1168,838,957,57,25,144,1225,19,348,224,416,367,640,3018,5452,11,61921,3440,1,2,18,7,0
11203,65,3354,1943,715,1694,26,18,214,1969,12,185,120,237,197,357,1436,2721,7,20915,1161,0,2,20,2,0
11204,171,3978,77,34,69,0,0,8,77,3,24,16,29,27,45,114,213,1,387,21,0,2,10,5,0
11205,171,3978,712,438,573,51,9,84,763,14,102,71,128,116,199,733,1364,8,11988,666,0,2,10,5,0
11206,173,3572,1943,715,1694,26,18,214,1969,12,185,120,237,197,357,1436,2721,7,20915,1161,0,2,7,2,0
11207,173,3572,1168,838,957,57,25,144,1225,19,348,224,416,367,640,3018,5452,11,61921,3440,1,2,7,2,0
11208,69,2894,1289,550,1043,56,32,155,1345,10,167,93,185,177,278,1266,2075,5,11498,638,0,2,9,7,0
11209,68,3251,1338,495,1086,10,64,173,1348,11,122,82,157,133,239,883,1686,7,11934,663,0,2,3,1,0
11210,135,3518,1660,832,1314,41,38,274,1701,20,312,209,395,332,604,2671,5058,12,64042,3557,1,2,3,2,0
11211,112,4312,1513,682,1277,25,13,200,1538,11,199,116,219,210,335,1557,2584,6,15641,868,0,2,2,1,0
11212,53,2988,1296,573,1062,40,33,157,1336,8,201,118,231,209,349,1561,2689,4,12365,686,0,2,5,5,0
11213,48,2372,1457,730,1242,11,6,188,1468,10,292,166,329,302,495,2424,4078,5,22973,1276,1,2,2,1,0
11214,34,2121,652,304,544,16,6,88,668,6,89,51,101,95,152,591,998,3,3399,188,0,2,5,1,0
11215,8,265,74,35,59,1,0,14,75,3,14,7,14,17,21,58,85,1,128,7,0,2,4,3,0
11216,41,2667,1523,757,1297,19,12,193,1542,12,193,117,230,205,347,1508,2664,7,19053,1058,0,2,2,1,0
11217,31,1715,384,251,317,7,8,52,391,11,70,44,84,81,128,467,811,6,5355,297,0,2,2,1,0
11218,56,2276,1043,504,840,53,9,147,1096,9,180,112,198,189,310,1377,2344,4,11604,644,0,2,23,2,0
11219,24,967,373,158,315,8,0,51,381,5,76,44,79,81,123,486,779,2,2026,112,0,2,3,1,0
11220,65,3360,1943,715,1694,26,18,214,1969,12,185,120,237,197,357,1436,2721,7,20915,1161,0,2,2,1,0
11221,37,1467,1098,241,925,5,10,155,1103,7,46,25,49,53,74,273,423,3,1580,87,0,2,3,2,0
11222,52,1519,1523,757,1297,19,12,193,1542,12,193,117,230,205,347,1508,2664,7,19053,1058,0,2,8,12,1
11223,52,1519,701,378,504,33,58,109,734,13,110,68,126,123,194,794,1346,7,10027,557,0,2,8,12,1
11224,42,2710,1523,757,1297,19,12,193,1542,12,193,117,230,205,347,1508,2664,7,19053,1058,0,2,2,3,1
11225,477,10406,72,33,56,0,4,12,72,1,1,1,1,2,2,0,2,0,1,0,0,2,4,5,1
11226,477,10406,1454,835,1044,76,110,219,1530,17,275,158,296,292,454,2297,3718,9,34017,1889,1,2,4,5,1
11227,72,3900,1782,648,1425,9,47,279,1791,8,171,97,189,179,286,1292,2140,4,9462,525,0,2,2,3,1
11228,52,1550,1523,757,1297,19,12,193,1542,12,193,117,230,205,347,1508,2664,7,19053,1058,0,2,12,6,1
11229,52,1550,701,378,504,33,58,109,734,13,110,68,126,123,194,794,1346,7,10027,557,0,2,12,6,1
11230,42,2720,1523,757,1297,19,12,193,1542,12,193,117,230,205,347,1508,2664,7,19053,1058,0,2,2,1,1
11231,52,1550,1523,757,1297,19,12,193,1542,12,193,117,230,205,347,1508,2664,7,19053,1058,0,2,24,1,0
11232,52,1550,701,378,504,33,58,109,734,13,110,68,126,123,194,794,1346,7,10027,557,0,2,24,1,0
11233,42,2727,1523,757,1297,19,12,193,1542,12,193,117,230,205,347,1508,2664,7,19053,1058,0,2,10,1,0
11234,112,2270,1513,682,1277,25,13,200,1538,11,199,116,219,210,335,1557,2584,6,15641,868,0,2,4,2,0
11235,112,2270,819,519,539,24,98,155,843,15,96,57,106,111,163,690,1107,8,9171,509,0,2,4,2,0
11236,297,5964,1457,730,1242,11,6,188,1468,10,292,166,329,302,495,2424,4078,5,22973,1276,1,2,7,0,0
11237,297,5964,74,35,59,1,0,14,75,3,14,7,14,17,21,58,85,1,128,7,0,2,7,0,0
11238,297,5964,245,125,200,5,7,34,250,7,30,17,34,37,51,166,265,3,1053,58,0,2,7,0,0
11239,40,1249,1455,414,1257,16,76,112,1471,5,41,23,46,46,69,231,381,2,1069,59,0,2,81,8,0
11240,40,1249,669,365,481,22,61,110,691,15,103,63,122,118,185,747,1273,8,11311,628,0,2,81,8,0
11241,52,1550,1523,757,1297,19,12,193,1542,12,193,117,230,205,347,1508,2664,7,19053,1058,0,2,24,1,0
11242,52,1550,701,378,504,33,58,109,734,13,110,68,126,123,194,794,1346,7,10027,557,0,2,24,1,0
11243,171,3978,77,34,69,0,0,8,77,3,24,16,29,27,45,114,213,1,387,21,0,2,10,5,0
11244,171,3978,712,438,573,51,9,84,763,14,102,71,128,116,199,733,1364,8,11988,666,0,2,10,5,0
11245,68,1237,1020,354,843,12,15,144,1032,8,134,77,144,142,221,970,1580,4,6792,377,0,2,1,1,0
11246,494,10644,72,33,56,0,4,12,72,1,1,1,1,2,2,0,2,0,1,0,0,2,86,28,0
11247,494,10644,1454,835,1044,76,110,219,1530,17,275,158,296,292,454,2297,3718,9,34017,1889,1,2,86,28,0
11248,36,822,386,256,301,16,9,68,402,4,59,35,69,63,104,355,621,2,1453,80,0,2,151,57,0
11249,36,822,264,131,164,11,41,46,275,6,38,22,40,44,62,214,338,3,1068,59,0,2,151,57,0
11250,173,3572,1943,715,1694,26,18,214,1969,12,185,120,237,197,357,1436,2721,7,20915,1161,0,2,25,9,0
11251,173,3572,1168,838,957,57,25,144,1225,19,348,224,416,367,640,3018,5452,11,61921,3440,1,2,25,9,0
11252,13,436,442,244,305,14,16,103,456,11,68,45,75,79,120,452,756,6,4588,254,0,2,1,1,0
11253,13,436,182,102,99,11,40,35,193,3,11,6,11,14,17,42,64,1,97,5,0,2,1,1,0
11254,1,315,382,65,130,157,2,92,539,4,10,5,10,14,15,41,57,2,114,6,0,2,5,5,0
11255,20,625,42,7,35,4,0,5,46,1,2,1,2,3,3,2,4,0,2,0,0,2,2,1,0
11256,20,625,11,6,10,0,0,1,11,2,4,2,4,6,6,10,15,1,15,0,0,2,2,1,0
11257,69,2894,1289,550,1043,56,32,155,1345,10,167,93,185,177,278,1266,2075,5,11498,638,0,2,14,7,0
11258,68,3251,1338,495,1086,10,64,173,1348,11,122,82,157,133,239,883,1686,7,11934,663,0,2,46,2,0
11259,139,6127,139,89,101,2,0,35,141,7,54,34,62,61,96,330,569,4,2287,127,0,2,16,0,0
11260,139,6127,7,5,5,0,0,2,7,1,2,1,2,3,3,2,4,0,2,0,0,2,16,0,0
11261,73,4015,1782,648,1425,9,47,279,1791,8,171,97,189,179,286,1292,2140,4,9462,525,0,2,21,7,0
11262,11,230,256,139,192,9,7,47,265,4,23,12,24,27,36,112,171,2,357,19,0,2,0,1,0
11263,135,3518,1660,832,1314,41,38,274,1701,20,312,209,395,332,604,2671,5058,12,64042,3557,1,2,3,2,0
11264,112,4312,1513,682,1277,25,13,200,1538,11,199,116,219,210,335,1557,2584,6,15641,868,0,2,21,1,0
11265,53,2988,1296,573,1062,40,33,157,1336,8,201,118,231,209,349,1561,2689,4,12365,686,0,2,5,5,0
11266,48,2372,1457,730,1242,11,6,188,1468,10,292,166,329,302,495,2424,4078,5,22973,1276,1,2,2,1,0
11267,34,2121,652,304,544,16,6,88,668,6,89,51,101,95,152,591,998,3,3399,188,0,2,46,1,0
11268,33,1398,1455,414,1257,16,76,112,1471,5,41,23,46,46,69,231,381,2,1069,59,0,2,45,0,0
11269,8,265,74,35,59,1,0,14,75,3,14,7,14,17,21,58,85,1,128,7,0,2,4,3,0
11270,42,2727,1523,757,1297,19,12,193,1542,12,193,117,230,205,347,1508,2664,7,19053,1058,0,2,12,2,0
11271,63,2600,1020,354,843,12,15,144,1032,8,134,77,144,142,221,970,1580,4,6792,377,0,2,18,0,0
11272,21,656,424,94,331,4,0,89,428,1,5,5,5,6,10,11,25,0,12,0,0,2,46,0,0
11273,31,1715,384,251,317,7,8,52,391,11,70,44,84,81,128,467,811,6,5355,297,0,2,2,1,0
11274,21,974,386,256,301,16,9,68,402,4,59,35,69,63,104,355,621,2,1453,80,0,2,150,50,0
11275,56,2276,1043,504,840,53,9,147,1096,9,180,112,198,189,310,1377,2344,4,11604,644,0,2,23,2,0
11276,24,967,373,158,315,8,0,51,381,5,76,44,79,81,123,486,779,2,2026,112,0,2,3,1,0
11277,65,3360,1943,715,1694,26,18,214,1969,12,185,120,237,197,357,1436,2721,7,20915,1161,0,2,22,3,0
11278,8,551,442,244,305,14,16,103,456,11,68,45,75,79,120,452,756,6,4588,254,0,2,14,0,0
11279,37,1467,1098,241,925,5,10,155,1103,7,46,25,49,53,74,273,423,3,1580,87,0,2,3,2,0
11280,297,5968,1457,730,1242,11,6,188,1468,10,292,166,329,302,495,2424,4078,5,22973,1276,1,2,6,4,1
11281,297,5968,74,35,59,1,0,14,75,3,14,7,14,17,21,58,85,1,128,7,0,2,6,4,1
11282,297,5968,245,125,200,5,7,34,250,7,30,17,34,37,51,166,265,3,1053,58,0,2,6,4,1
11283,52,2502,1457,730,1242,11,6,188,1468,10,292,166,329,302,495,2424,4078,5,22973,1276,1,2,25,0,1
11284,37,2209,334,251,279,10,4,40,344,5,127,74,143,132,217,899,1528,2,4303,239,0,2,3,1,1
11285,297,5968,1457,730,1242,11,6,188,1468,10,292,166,329,302,495,2424,4078,5,22973,1276,1,2,6,4,0
11286,297,5968,74,35,59,1,0,14,75,3,14,7,14,17,21,58,85,1,128,7,0,2,6,4,0
11287,297,5968,245,125,200,5,7,34,250,7,30,17,34,37,51,166,265,3,1053,58,0,2,6,4,0
11288,52,2502,1457,730,1242,11,6,188,1468,10,292,166,329,302,495,2424,4078,5,22973,1276,1,2,25,0,0
11289,37,2209,334,251,279,10,4,40,344,5,127,74,143,132,217,899,1528,2,4303,239,0,2,3,1,0
11290,46,522,647,139,84,35,284,233,682,0,0,0,0,0,0,0,0,0,0,0,0,2,9,2,1
11291,298,5985,1457,730,1242,11,6,188,1468,10,292,166,329,302,495,2424,4078,5,22973,1276,1,2,12,5,1
11292,298,5985,74,35,59,1,0,14,75,3,14,7,14,17,21,58,85,1,128,7,0,2,12,5,1
11293,298,5985,245,125,200,5,7,34,250,7,30,17,34,37,51,166,265,3,1053,58,0,2,12,5,1
11294,38,2255,334,251,279,10,4,40,344,5,127,74,143,132,217,899,1528,2,4303,239,0,2,9,2,1
11295,216,4842,722,423,573,19,0,135,741,12,172,101,199,184,300,1320,2257,6,15668,870,0,2,1,1,1
11296,216,4842,1508,847,911,44,250,301,1552,14,148,88,169,162,257,1120,1886,7,15077,837,0,2,1,1,1
11297,173,3589,1943,715,1694,26,18,214,1969,12,185,120,237,197,357,1436,2721,7,20915,1161,0,2,4,2,1
11298,173,3589,1168,838,957,57,25,144,1225,19,348,224,416,367,640,3018,5452,11,61921,3440,1,2,4,2,1
11299,52,2502,1457,730,1242,11,6,188,1468,10,292,166,329,302,495,2424,4078,5,22973,1276,1,2,2,2,1
11300,65,3360,1943,715,1694,26,18,214,1969,12,185,120,237,197,357,1436,2721,7,20915,1161,0,2,3,2,1
11301,297,5964,1457,730,1242,11,6,188,1468,10,292,166,329,302,495,2424,4078,5,22973,1276,1,2,4,0,0
11302,297,5964,74,35,59,1,0,14,75,3,14,7,14,17,21,58,85,1,128,7,0,2,4,0,0
11303,297,5964,245,125,200,5,7,34,250,7,30,17,34,37,51,166,265,3,1053,58,0,2,4,0,0
11304,40,1249,1455,414,1257,16,76,112,1471,5,41,23,46,46,69,231,381,2,1069,59,0,2,81,8,0
11305,40,1249,669,365,481,22,61,110,691,15,103,63,122,118,185,747,1273,8,11311,628,0,2,81,8,0
11306,52,1550,1523,757,1297,19,12,193,1542,12,193,117,230,205,347,1508,2664,7,19053,1058,0,2,24,1,0
11307,52,1550,701,378,504,33,58,109,734,13,110,68,126,123,194,794,1346,7,10027,557,0,2,24,1,0
11308,171,3978,77,34,69,0,0,8,77,3,24,16,29,27,45,114,213,1,387,21,0,2,10,5,0
11309,171,3978,712,438,573,51,9,84,763,14,102,71,128,116,199,733,1364,8,11988,666,0,2,10,5,0
11310,494,10644,72,33,56,0,4,12,72,1,1,1,1,2,2,0,2,0,1,0,0,2,54,14,0
11311,494,10644,1454,835,1044,76,110,219,1530,17,275,158,296,292,454,2297,3718,9,34017,1889,1,2,54,14,0
11312,173,3572,1943,715,1694,26,18,214,1969,12,185,120,237,197,357,1436,2721,7,20915,1161,0,2,25,9,0
11313,173,3572,1168,838,957,57,25,144,1225,19,348,224,416,367,640,3018,5452,11,61921,3440,1,2,25,9,0
11314,20,625,42,7,35,4,0,5,46,1,2,1,2,3,3,2,4,0,2,0,0,2,2,1,0
11315,20,625,11,6,10,0,0,1,11,2,4,2,4,6,6,10,15,1,15,0,0,2,2,1,0
11316,69,2894,1289,550,1043,56,32,155,1345,10,167,93,185,177,278,1266,2075,5,11498,638,0,2,14,7,0
11317,68,3251,1338,495,1086,10,64,173,1348,11,122,82,157,133,239,883,1686,7,11934,663,0,2,14,2,0
11318,139,6127,139,89,101,2,0,35,141,7,54,34,62,61,96,330,569,4,2287,127,0,2,16,0,0
11319,139,6127,7,5,5,0,0,2,7,1,2,1,2,3,3,2,4,0,2,0,0,2,16,0,0
11320,76,4145,1782,648,1425,9,47,279,1791,8,171,97,189,179,286,1292,2140,4,9462,525,0,2,17,6,0
11321,135,3518,1660,832,1314,41,38,274,1701,20,312,209,395,332,604,2671,5058,12,64042,3557,1,2,3,2,0
11322,112,4312,1513,682,1277,25,13,200,1538,11,199,116,219,210,335,1557,2584,6,15641,868,0,2,2,1,0
11323,53,2988,1296,573,1062,40,33,157,1336,8,201,118,231,209,349,1561,2689,4,12365,686,0,2,5,5,0
11324,48,2372,1457,730,1242,11,6,188,1468,10,292,166,329,302,495,2424,4078,5,22973,1276,1,2,2,1,0
11325,34,2121,652,304,544,16,6,88,668,6,89,51,101,95,152,591,998,3,3399,188,0,2,5,1,0
11326,33,1398,1455,414,1257,16,76,112,1471,5,41,23,46,46,69,231,381,2,1069,59,0,2,45,0,0
11327,8,265,74,35,59,1,0,14,75,3,14,7,14,17,21,58,85,1,128,7,0,2,4,3,0
11328,42,2727,1523,757,1297,19,12,193,1542,12,193,117,230,205,347,1508,2664,7,19053,1058,0,2,12,2,0
11329,21,656,424,94,331,4,0,89,428,1,5,5,5,6,10,11,25,0,12,0,0,2,46,0,0
11330,31,1715,384,251,317,7,8,52,391,11,70,44,84,81,128,467,811,6,5355,297,0,2,2,1,0
11331,56,2276,1043,504,840,53,9,147,1096,9,180,112,198,189,310,1377,2344,4,11604,644,0,2,23,2,0
11332,24,967,373,158,315,8,0,51,381,5,76,44,79,81,123,486,779,2,2026,112,0,2,3,1,0
11333,65,3360,1943,715,1694,26,18,214,1969,12,185,120,237,197,357,1436,2721,7,20915,1161,0,2,22,3,0
11334,37,1467,1098,241,925,5,10,155,1103,7,46,25,49,53,74,273,423,3,1580,87,0,2,3,2,0
11335,33,678,2,2,2,0,0,0,2,0,0,0,0,0,0,0,0,0,0,0,0,2,5,2,1
11336,33,678,99,48,90,1,3,5,100,0,0,0,0,0,0,0,0,0,0,0,0,2,5,2,1
11337,33,678,8,5,5,2,0,1,10,0,0,0,0,0,0,0,0,0,0,0,0,2,5,2,1
11338,33,678,1217,716,841,84,126,174,1301,14,185,118,215,199,333,1446,2542,8,20687,1149,0,2,5,2,1
11339,33,678,160,89,115,0,13,31,160,7,15,11,17,22,28,78,124,3,495,27,0,2,5,2,1
11340,33,678,10,10,9,9,0,0,19,0,0,0,0,0,0,0,0,0,0,0,0,2,5,2,1
11341,33,678,173,84,99,8,29,36,181,5,12,7,13,17,20,54,81,2,221,12,0,2,5,2,1
11342,33,678,3,1,1,3,0,0,6,0,0,0,0,0,0,0,0,0,0,0,0,2,5,2,1
11343,72,2658,1450,624,1228,12,26,181,1462,14,306,186,354,320,540,2580,4493,8,36391,2021,1,2,6,1,1
11344,33,678,2,2,2,0,0,0,2,0,0,0,0,0,0,0,0,0,0,0,0,2,5,2,0
11345,33,678,99,48,90,1,3,5,100,0,0,0,0,0,0,0,0,0,0,0,0,2,5,2,0
11346,33,678,8,5,5,2,0,1,10,0,0,0,0,0,0,0,0,0,0,0,0,2,5,2,0
11347,33,678,1217,716,841,84,126,174,1301,14,185,118,215,199,333,1446,2542,8,20687,1149,0,2,5,2,0
11348,33,678,160,89,115,0,13,31,160,7,15,11,17,22,28,78,124,3,495,27,0,2,5,2,0
11349,33,678,10,10,9,9,0,0,19,0,0,0,0,0,0,0,0,0,0,0,0,2,5,2,0
11350,33,678,173,84,99,8,29,36,181,5,12,7,13,17,20,54,81,2,221,12,0,2,5,2,0
11351,33,678,3,1,1,3,0,0,6,0,0,0,0,0,0,0,0,0,0,0,0,2,5,2,0
11352,72,2658,1450,624,1228,12,26,181,1462,14,306,186,354,320,540,2580,4493,8,36391,2021,1,2,6,1,0
11353,494,10644,72,33,56,0,4,12,72,1,1,1,1,2,2,0,2,0,1,0,0,2,23,11,0
11354,494,10644,1454,835,1044,76,110,219,1530,17,275,158,296,292,454,2297,3718,9,34017,1889,1,2,23,11,0
11355,76,4145,1782,648,1425,9,47,279,1791,8,171,97,189,179,286,1292,2140,4,9462,525,0,2,122,3,0
11356,298,5985,1457,730,1242,11,6,188,1468,10,292,166,329,302,495,2424,4078,5,22973,1276,1,2,12,5,0
11357,298,5985,74,35,59,1,0,14,75,3,14,7,14,17,21,58,85,1,128,7,0,2,12,5,0
11358,298,5985,245,125,200,5,7,34,250,7,30,17,34,37,51,166,265,3,1053,58,0,2,12,5,0
11359,38,2255,334,251,279,10,4,40,344,5,127,74,143,132,217,899,1528,2,4303,239,0,2,9,2,0
11360,44,872,447,308,343,6,5,95,453,7,96,59,111,103,170,651,1136,4,4600,255,0,2,11,1,1
11361,44,872,322,174,179,16,74,51,338,10,41,26,46,51,72,252,408,5,2291,127,0,2,11,1,1
11362,44,872,447,308,343,6,5,95,453,7,96,59,111,103,170,651,1136,4,4600,255,0,2,1,1,0
11363,44,872,322,174,179,16,74,51,338,10,41,26,46,51,72,252,408,5,2291,127,0,2,1,1,0
11364,498,10692,72,33,56,0,4,12,72,1,1,1,1,2,2,0,2,0,1,0,0,2,4,1,1
11365,498,10692,1454,835,1044,76,110,219,1530,17,275,158,296,292,454,2297,3718,9,34017,1889,1,2,4,1,1
11366,140,6179,139,89,101,2,0,35,141,7,54,34,62,61,96,330,569,4,2287,127,0,2,16,0,1
11367,140,6179,7,5,5,0,0,2,7,1,2,1,2,3,3,2,4,0,2,0,0,2,16,0,1
11368,140,6180,139,89,101,2,0,35,141,7,54,34,62,61,96,330,569,4,2287,127,0,2,4,0,0
11369,140,6180,7,5,5,0,0,2,7,1,2,1,2,3,3,2,4,0,2,0,0,2,4,0,0
11370,498,10692,72,33,56,0,4,12,72,1,1,1,1,2,2,0,2,0,1,0,0,2,4,1,0
11371,498,10692,1454,835,1044,76,110,219,1530,17,275,158,296,292,454,2297,3718,9,34017,1889,1,2,4,1,0
11372,140,6180,139,89,101,2,0,35,141,7,54,34,62,61,96,330,569,4,2287,127,0,2,20,0,0
11373,140,6180,7,5,5,0,0,2,7,1,2,1,2,3,3,2,4,0,2,0,0,2,20,0,0
11374,301,6070,1457,730,1242,11,6,188,1468,10,292,166,329,302,495,2424,4078,5,22973,1276,1,2,32,10,1
11375,301,6070,74,35,59,1,0,14,75,3,14,7,14,17,21,58,85,1,128,7,0,2,32,10,1
11376,301,6070,245,125,200,5,7,34,250,7,30,17,34,37,51,166,265,3,1053,58,0,2,32,10,1
11377,23,771,74,35,59,1,0,14,75,3,14,7,14,17,21,58,85,1,128,7,0,2,5,6,1
11378,23,771,245,125,200,5,7,34,250,7,30,17,34,37,51,166,265,3,1053,58,0,2,5,6,1
11379,44,872,447,308,343,6,5,95,453,7,96,59,111,103,170,651,1136,4,4600,255,0,2,11,1,0
11380,44,872,322,174,179,16,74,51,338,10,41,26,46,51,72,252,408,5,2291,127,0,2,11,1,0
11381,43,1300,1455,414,1257,16,76,112,1471,5,41,23,46,46,69,231,381,2,1069,59,0,2,12,0,1
11382,43,1300,669,365,481,22,61,110,691,15,103,63,122,118,185,747,1273,8,11311,628,0,2,12,0,1
11383,39,1553,1455,414,1257,16,76,112,1471,5,41,23,46,46,69,231,381,2,1069,59,0,2,47,0,1
11384,216,4842,722,423,573,19,0,135,741,12,172,101,199,184,300,1320,2257,6,15668,870,0,2,1,1,0
11385,216,4842,1508,847,911,44,250,301,1552,14,148,88,169,162,257,1120,1886,7,15077,837,0,2,1,1,0
11386,173,3589,1943,715,1694,26,18,214,1969,12,185,120,237,197,357,1436,2721,7,20915,1161,0,2,4,2,0
11387,173,3589,1168,838,957,57,25,144,1225,19,348,224,416,367,640,3018,5452,11,61921,3440,1,2,4,2,0
11388,52,2502,1457,730,1242,11,6,188,1468,10,292,166,329,302,495,2424,4078,5,22973,1276,1,2,2,2,0
11389,65,3360,1943,715,1694,26,18,214,1969,12,185,120,237,197,357,1436,2721,7,20915,1161,0,2,3,2,0
11390,43,1300,1455,414,1257,16,76,112,1471,5,41,23,46,46,69,231,381,2,1069,59,0,2,12,0,0
11391,43,1300,669,365,481,22,61,110,691,15,103,63,122,118,185,747,1273,8,11311,628,0,2,12,0,0
11392,39,1553,1455,414,1257,16,76,112,1471,5,41,23,46,46,69,231,381,2,1069,59,0,2,47,0,0
11393,297,5985,1457,730,1242,11,6,188,1468,10,292,166,329,302,495,2424,4078,5,22973,1276,1,2,13,27,1
11394,297,5985,74,35,59,1,0,14,75,3,14,7,14,17,21,58,85,1,128,7,0,2,13,27,1
11395,297,5985,245,125,200,5,7,34,250,7,30,17,34,37,51,166,265,3,1053,58,0,2,13,27,1
11396,46,529,647,139,84,35,284,233,682,0,0,0,0,0,0,0,0,0,0,0,0,2,2,0,1
11397,171,3985,77,34,69,0,0,8,77,3,24,16,29,27,45,114,213,1,387,21,0,2,3,5,1
11398,171,3985,712,438,573,51,9,84,763,14,102,71,128,116,199,733,1364,8,11988,666,0,2,3,5,1
11399,32,1735,384,251,317,7,8,52,391,11,70,44,84,81,128,467,811,6,5355,297,0,2,10,3,1
11400,298,6002,1457,730,1242,11,6,188,1468,10,292,166,329,302,495,2424,4078,5,22973,1276,1,2,21,13,0
11401,298,6002,74,35,59,1,0,14,75,3,14,7,14,17,21,58,85,1,128,7,0,2,21,13,0
11402,298,6002,245,125,200,5,7,34,250,7,30,17,34,37,51,166,265,3,1053,58,0,2,21,13,0
11403,23,771,74,35,59,1,0,14,75,3,14,7,14,17,21,58,85,1,128,7,0,2,5,6,0
11404,23,771,245,125,200,5,7,34,250,7,30,17,34,37,51,166,265,3,1053,58,0,2,5,6,0
11405,46,529,647,139,84,35,284,233,682,0,0,0,0,0,0,0,0,0,0,0,0,2,2,0,0
11406,171,3985,77,34,69,0,0,8,77,3,24,16,29,27,45,114,213,1,387,21,0,2,3,5,0
11407,171,3985,712,438,573,51,9,84,763,14,102,71,128,116,199,733,1364,8,11988,666,0,2,3,5,0
11408,32,1735,384,251,317,7,8,52,391,11,70,44,84,81,128,467,811,6,5355,297,0,2,10,3,0
11409,298,6004,1457,730,1242,11,6,188,1468,10,292,166,329,302,495,2424,4078,5,22973,1276,1,2,1,1,1
11410,298,6004,74,35,59,1,0,14,75,3,14,7,14,17,21,58,85,1,128,7,0,2,1,1,1
11411,298,6004,245,125,200,5,7,34,250,7,30,17,34,37,51,166,265,3,1053,58,0,2,1,1,1
11412,46,531,647,139,84,35,284,233,682,0,0,0,0,0,0,0,0,0,0,0,0,2,1,1,1
11413,498,10696,72,33,56,0,4,12,72,1,1,1,1,2,2,0,2,0,1,0,0,2,1,1,1
11414,498,10696,1454,835,1044,76,110,219,1530,17,275,158,296,292,454,2297,3718,9,34017,1889,1,2,1,1,1
11415,173,3593,1943,715,1694,26,18,214,1969,12,185,120,237,197,357,1436,2721,7,20915,1161,0,2,2,1,1
11416,173,3593,1168,838,957,57,25,144,1225,19,348,224,416,367,640,3018,5452,11,61921,3440,1,2,2,1,1
11417,20,625,42,7,35,4,0,5,46,1,2,1,2,3,3,2,4,0,2,0,0,2,2,2,1
11418,20,625,11,6,10,0,0,1,11,2,4,2,4,6,6,10,15,1,15,0,0,2,2,2,1
11419,65,3364,1943,715,1694,26,18,214,1969,12,185,120,237,197,357,1436,2721,7,20915,1161,0,2,1,1,1
11420,173,3542,1943,715,1694,26,18,214,1969,12,185,120,237,197,357,1436,2721,7,20915,1161,0,2,3,1,0
11421,173,3542,1168,838,957,57,25,144,1225,19,348,224,416,367,640,3018,5452,11,61921,3440,1,2,3,1,0
11422,173,3542,1943,715,1694,26,18,214,1969,12,185,120,237,197,357,1436,2721,7,20915,1161,0,2,1,1,1
11423,173,3542,1168,838,957,57,25,144,1225,19,348,224,416,367,640,3018,5452,11,61921,3440,1,2,1,1,1
11424,50,2216,1178,367,1042,6,15,115,1184,9,94,51,95,103,146,644,976,4,4439,246,0,2,37,0,1
11425,175,3601,1943,715,1694,26,18,214,1969,12,185,120,237,197,357,1436,2721,7,20915,1161,0,2,4,2,0
11426,175,3601,1168,838,957,57,25,144,1225,19,348,224,416,367,640,3018,5452,11,61921,3440,1,2,4,2,0
11427,50,2216,1178,367,1042,6,15,115,1184,9,94,51,95,103,146,644,976,4,4439,246,0,2,37,0,0
11428,54,1131,996,429,845,24,10,117,1020,7,76,50,88,83,138,494,879,4,3565,198,0,0,214,0,1
11429,54,1131,456,277,329,12,42,72,468,13,85,50,97,98,147,592,972,7,7212,400,0,0,214,0,1
11430,298,6002,1457,730,1242,11,6,188,1468,10,292,166,329,302,495,2424,4078,5,22973,1276,1,2,1,1,1
11431,298,6002,74,35,59,1,0,14,75,3,14,7,14,17,21,58,85,1,128,7,0,2,1,1,1
11432,298,6002,245,125,200,5,7,34,250,7,30,17,34,37,51,166,265,3,1053,58,0,2,1,1,1
11433,54,1134,996,429,845,24,10,117,1020,7,76,50,88,83,138,494,879,4,3565,198,0,2,2,2,0
11434,54,1134,456,277,329,12,42,72,468,13,85,50,97,98,147,592,972,7,7212,400,0,2,2,2,0
11435,55,1150,996,429,845,24,10,117,1020,7,76,50,88,83,138,494,879,4,3565,198,0,2,4,0,1
11436,55,1150,456,277,329,12,42,72,468,13,85,50,97,98,147,592,972,7,7212,400,0,2,4,0,1
11437,55,1150,996,429,845,24,10,117,1020,7,76,50,88,83,138,494,879,4,3565,198,0,2,1,0,1
11438,55,1150,456,277,329,12,42,72,468,13,85,50,97,98,147,592,972,7,7212,400,0,2,1,0,1
11439,172,3983,77,34,69,0,0,8,77,3,24,16,29,27,45,114,213,1,387,21,0,2,7,6,1
11440,172,3983,712,438,573,51,9,84,763,14,102,71,128,116,199,733,1364,8,11988,666,0,2,7,6,1
11441,68,3251,1338,495,1086,10,64,173,1348,11,122,82,157,133,239,883,1686,7,11934,663,0,2,1,1,0
11442,65,3360,1943,715,1694,26,18,214,1969,12,185,120,237,197,357,1436,2721,7,20915,1161,0,2,0,1,0
11443,44,872,447,308,343,6,5,95,453,7,96,59,111,103,170,651,1136,4,4600,255,0,2,2,2,0
11444,44,872,322,174,179,16,74,51,338,10,41,26,46,51,72,252,408,5,2291,127,0,2,2,2,0
11445,44,876,447,308,343,6,5,95,453,7,96,59,111,103,170,651,1136,4,4600,255,0,2,4,3,0
11446,44,876,322,174,179,16,74,51,338,10,41,26,46,51,72,252,408,5,2291,127,0,2,4,3,0
11447,44,876,447,308,343,6,5,95,453,7,96,59,111,103,170,651,1136,4,4600,255,0,2,4,3,0
11448,44,876,322,174,179,16,74,51,338,10,41,26,46,51,72,252,408,5,2291,127,0,2,4,3,0
11449,44,876,447,308,343,6,5,95,453,7,96,59,111,103,170,651,1136,4,4600,255,0,2,4,3,0
11450,44,876,322,174,179,16,74,51,338,10,41,26,46,51,72,252,408,5,2291,127,0,2,4,3,0
11451,175,3605,1943,715,1694,26,18,214,1969,12,185,120,237,197,357,1436,2721,7,20915,1161,0,2,4,2,0
11452,175,3605,1168,838,957,57,25,144,1225,19,348,224,416,367,640,3018,5452,11,61921,3440,1,2,4,2,0
11453,50,2216,1178,367,1042,6,15,115,1184,9,94,51,95,103,146,644,976,4,4439,246,0,2,37,0,0
11454,172,3983,77,34,69,0,0,8,77,3,24,16,29,27,45,114,213,1,387,21,0,2,7,6,0
11455,172,3983,712,438,573,51,9,84,763,14,102,71,128,116,199,733,1364,8,11988,666,0,2,7,6,0
11456,298,6004,1457,730,1242,11,6,188,1468,10,292,166,329,302,495,2424,4078,5,22973,1276,1,2,1,1,0
11457,298,6004,74,35,59,1,0,14,75,3,14,7,14,17,21,58,85,1,128,7,0,2,1,1,0
11458,298,6004,245,125,200,5,7,34,250,7,30,17,34,37,51,166,265,3,1053,58,0,2,1,1,0
11459,46,531,647,139,84,35,284,233,682,0,0,0,0,0,0,0,0,0,0,0,0,2,1,1,0
11460,498,10696,72,33,56,0,4,12,72,1,1,1,1,2,2,0,2,0,1,0,0,2,1,1,0
11461,498,10696,1454,835,1044,76,110,219,1530,17,275,158,296,292,454,2297,3718,9,34017,1889,1,2,1,1,0
11462,175,3605,1943,715,1694,26,18,214,1969,12,185,120,237,197,357,1436,2721,7,20915,1161,0,2,2,1,0
11463,175,3605,1168,838,957,57,25,144,1225,19,348,224,416,367,640,3018,5452,11,61921,3440,1,2,2,1,0
11464,20,625,42,7,35,4,0,5,46,1,2,1,2,3,3,2,4,0,2,0,0,2,2,2,0
11465,20,625,11,6,10,0,0,1,11,2,4,2,4,6,6,10,15,1,15,0,0,2,2,2,0
11466,65,3364,1943,715,1694,26,18,214,1969,12,185,120,237,197,357,1436,2721,7,20915,1161,0,2,1,1,0
11467,172,3983,77,34,69,0,0,8,77,3,24,16,29,27,45,114,213,1,387,21,0,2,7,6,0
11468,172,3983,712,438,573,51,9,84,763,14,102,71,128,116,199,733,1364,8,11988,666,0,2,7,6,0
11469,115,2526,1043,504,840,53,9,147,1096,9,180,112,198,189,310,1377,2344,4,11604,644,0,2,11,5,1
11470,115,2526,383,288,292,26,6,62,409,11,65,38,67,76,105,429,656,5,3719,206,0,2,11,5,1
11471,55,2176,1043,504,840,53,9,147,1096,9,180,112,198,189,310,1377,2344,4,11604,644,0,2,1,1,1
11472,115,2524,1043,504,840,53,9,147,1096,9,180,112,198,189,310,1377,2344,4,11604,644,0,2,0,1,0
11473,115,2524,383,288,292,26,6,62,409,11,65,38,67,76,105,429,656,5,3719,206,0,2,0,1,0
11474,115,2524,1043,504,840,53,9,147,1096,9,180,112,198,189,310,1377,2344,4,11604,644,0,2,10,5,0
11475,115,2524,383,288,292,26,6,62,409,11,65,38,67,76,105,429,656,5,3719,206,0,2,10,5,0
11476,55,2176,1043,504,840,53,9,147,1096,9,180,112,198,189,310,1377,2344,4,11604,644,0,2,1,1,0
11477,115,2524,1043,504,840,53,9,147,1096,9,180,112,198,189,310,1377,2344,4,11604,644,0,2,10,5,0
11478,115,2524,383,288,292,26,6,62,409,11,65,38,67,76,105,429,656,5,3719,206,0,2,10,5,0
11479,503,10795,72,33,56,0,4,12,72,1,1,1,1,2,2,0,2,0,1,0,0,2,23,3,1
11480,503,10795,1454,835,1044,76,110,219,1530,17,275,158,296,292,454,2297,3718,9,34017,1889,1,2,23,3,1
11481,57,2317,1043,504,840,53,9,147,1096,9,180,112,198,189,310,1377,2344,4,11604,644,0,2,4,1,1
11482,503,10792,72,33,56,0,4,12,72,1,1,1,1,2,2,0,2,0,1,0,0,2,1,1,0
11483,503,10792,1454,835,1044,76,110,219,1530,17,275,158,296,292,454,2297,3718,9,34017,1889,1,2,1,1,0
11484,503,10791,72,33,56,0,4,12,72,1,1,1,1,2,2,0,2,0,1,0,0,2,1,1,0
11485,503,10791,1454,835,1044,76,110,219,1530,17,275,158,296,292,454,2297,3718,9,34017,1889,1,2,1,1,0
11486,115,2524,1043,504,840,53,9,147,1096,9,180,112,198,189,310,1377,2344,4,11604,644,0,2,10,5,0
11487,115,2524,383,288,292,26,6,62,409,11,65,38,67,76,105,429,656,5,3719,206,0,2,10,5,0
11488,503,10797,72,33,56,0,4,12,72,1,1,1,1,2,2,0,2,0,1,0,0,2,2,1,0
11489,503,10797,1454,835,1044,76,110,219,1530,17,275,158,296,292,454,2297,3718,9,34017,1889,1,2,2,1,0
11490,76,4181,1782,648,1425,9,47,279,1791,8,171,97,189,179,286,1292,2140,4,9462,525,0,2,4,0,0
11491,501,10735,72,33,56,0,4,12,72,1,1,1,1,2,2,0,2,0,1,0,0,2,4,12,1
11492,501,10735,1454,835,1044,76,110,219,1530,17,275,158,296,292,454,2297,3718,9,34017,1889,1,2,4,12,1
11493,14,449,442,244,305,14,16,103,456,11,68,45,75,79,120,452,756,6,4588,254,0,2,5,1,0
11494,14,449,182,102,99,11,40,35,193,3,11,6,11,14,17,42,64,1,97,5,0,2,5,1,0
11495,9,601,442,244,305,14,16,103,456,11,68,45,75,79,120,452,756,6,4588,254,0,2,16,1,0
11496,15,453,442,244,305,14,16,103,456,11,68,45,75,79,120,452,756,6,4588,254,0,2,13,6,1
11497,15,453,182,102,99,11,40,35,193,3,11,6,11,14,17,42,64,1,97,5,0,2,13,6,1
11498,10,640,442,244,305,14,16,103,456,11,68,45,75,79,120,452,756,6,4588,254,0,2,10,0,1
11499,10,663,442,244,305,14,16,103,456,11,68,45,75,79,120,452,756,6,4588,254,0,2,4,1,0
11500,55,1150,996,429,845,24,10,117,1020,7,76,50,88,83,138,494,879,4,3565,198,0,2,7,7,1
11501,55,1150,456,277,329,12,42,72,468,13,85,50,97,98,147,592,972,7,7212,400,0,2,7,7,1
11502,16,464,442,244,305,14,16,103,456,11,68,45,75,79,120,452,756,6,4588,254,0,2,10,7,0
11503,16,464,182,102,99,11,40,35,193,3,11,6,11,14,17,42,64,1,97,5,0,2,10,7,0
11504,10,663,442,244,305,14,16,103,456,11,68,45,75,79,120,452,756,6,4588,254,0,2,1,1,0
11505,55,1150,996,429,845,24,10,117,1020,7,76,50,88,83,138,494,879,4,3565,198,0,0,219,0,0
11506,55,1150,456,277,329,12,42,72,468,13,85,50,97,98,147,592,972,7,7212,400,0,0,219,0,0
11507,298,6004,1457,730,1242,11,6,188,1468,10,292,166,329,302,495,2424,4078,5,22973,1276,1,2,1,1,0
11508,298,6004,74,35,59,1,0,14,75,3,14,7,14,17,21,58,85,1,128,7,0,2,1,1,0
11509,298,6004,245,125,200,5,7,34,250,7,30,17,34,37,51,166,265,3,1053,58,0,2,1,1,0
11510,44,876,447,308,343,6,5,95,453,7,96,59,111,103,170,651,1136,4,4600,255,0,2,2,2,0
11511,44,876,322,174,179,16,74,51,338,10,41,26,46,51,72,252,408,5,2291,127,0,2,2,2,0
11512,68,3251,1338,495,1086,10,64,173,1348,11,122,82,157,133,239,883,1686,7,11934,663,0,2,1,1,0
11513,65,3364,1943,715,1694,26,18,214,1969,12,185,120,237,197,357,1436,2721,7,20915,1161,0,2,0,1,0
11514,16,464,442,244,305,14,16,103,456,11,68,45,75,79,120,452,756,6,4588,254,0,2,18,4,0
11515,16,464,182,102,99,11,40,35,193,3,11,6,11,14,17,42,64,1,97,5,0,2,18,4,0
11516,10,663,442,244,305,14,16,103,456,11,68,45,75,79,120,452,756,6,4588,254,0,2,29,1,0
11517,498,10733,72,33,56,0,4,12,72,1,1,1,1,2,2,0,2,0,1,0,0,2,8,1,1
11518,498,10733,1454,835,1044,76,110,219,1530,17,275,158,296,292,454,2297,3718,9,34017,1889,1,2,8,1,1
11519,68,3269,1338,495,1086,10,64,173,1348,11,122,82,157,133,239,883,1686,7,11934,663,0,2,6,4,1
11520,77,4224,1782,648,1425,9,47,279,1791,8,171,97,189,179,286,1292,2140,4,9462,525,0,2,14,4,1
11521,498,10733,72,33,56,0,4,12,72,1,1,1,1,2,2,0,2,0,1,0,0,2,8,1,0
11522,498,10733,1454,835,1044,76,110,219,1530,17,275,158,296,292,454,2297,3718,9,34017,1889,1,2,8,1,0
11523,68,3269,1338,495,1086,10,64,173,1348,11,122,82,157,133,239,883,1686,7,11934,663,0,2,6,4,0
11524,20,617,42,7,35,4,0,5,46,1,2,1,2,3,3,2,4,0,2,0,0,2,1,2,1
11525,20,617,11,6,10,0,0,1,11,2,4,2,4,6,6,10,15,1,15,0,0,2,1,2,1
11526,20,617,42,7,35,4,0,5,46,1,2,1,2,3,3,2,4,0,2,0,0,2,1,2,0
11527,20,617,11,6,10,0,0,1,11,2,4,2,4,6,6,10,15,1,15,0,0,2,1,2,0
11528,20,617,42,7,35,4,0,5,46,1,2,1,2,3,3,2,4,0,2,0,0,2,1,1,0
11529,20,617,11,6,10,0,0,1,11,2,4,2,4,6,6,10,15,1,15,0,0,2,1,1,0
11530,501,10772,72,33,56,0,4,12,72,1,1,1,1,2,2,0,2,0,1,0,0,2,16,3,0
11531,501,10772,1454,835,1044,76,110,219,1530,17,275,158,296,292,454,2297,3718,9,34017,1889,1,2,16,3,0
11532,77,4224,1782,648,1425,9,47,279,1791,8,171,97,189,179,286,1292,2140,4,9462,525,0,2,14,0,0
11533,57,2317,1043,504,840,53,9,147,1096,9,180,112,198,189,310,1377,2344,4,11604,644,0,2,4,1,0
11534,20,617,42,7,35,4,0,5,46,1,2,1,2,3,3,2,4,0,2,0,0,2,1,1,1
11535,20,617,11,6,10,0,0,1,11,2,4,2,4,6,6,10,15,1,15,0,0,2,1,1,1
11536,20,617,42,7,35,4,0,5,46,1,2,1,2,3,3,2,4,0,2,0,0,2,1,1,0
11537,20,617,11,6,10,0,0,1,11,2,4,2,4,6,6,10,15,1,15,0,0,2,1,1,0
11538,54,1579,1523,757,1297,19,12,193,1542,12,193,117,230,205,347,1508,2664,7,19053,1058,0,2,9,1,1
11539,54,1579,701,378,504,33,58,109,734,13,110,68,126,123,194,794,1346,7,10027,557,0,2,9,1,1
11540,42,2753,1523,757,1297,19,12,193,1542,12,193,117,230,205,347,1508,2664,7,19053,1058,0,2,3,1,1
11541,54,1579,1523,757,1297,19,12,193,1542,12,193,117,230,205,347,1508,2664,7,19053,1058,0,2,9,1,0
11542,54,1579,701,378,504,33,58,109,734,13,110,68,126,123,194,794,1346,7,10027,557,0,2,9,1,0
11543,42,2753,1523,757,1297,19,12,193,1542,12,193,117,230,205,347,1508,2664,7,19053,1058,0,2,3,1,0
11544,88,1927,477,336,357,30,23,73,507,16,194,134,250,210,384,1538,2962,10,30538,1696,0,2,8,1,0
11545,74,2691,1450,624,1228,12,26,181,1462,14,306,186,354,320,540,2580,4493,8,36391,2021,1,2,11,0,0
11546,90,1940,477,336,357,30,23,73,507,16,194,134,250,210,384,1538,2962,10,30538,1696,0,2,9,7,1
11547,16,468,442,244,305,14,16,103,456,11,68,45,75,79,120,452,756,6,4588,254,0,2,1,1,1
11548,16,468,182,102,99,11,40,35,193,3,11,6,11,14,17,42,64,1,97,5,0,2,1,1,1
11549,12,822,442,244,305,14,16,103,456,11,68,45,75,79,120,452,756,6,4588,254,0,2,34,0,1
11550,16,468,442,244,305,14,16,103,456,11,68,45,75,79,120,452,756,6,4588,254,0,2,1,1,0
11551,16,468,182,102,99,11,40,35,193,3,11,6,11,14,17,42,64,1,97,5,0,2,1,1,0
11552,12,822,442,244,305,14,16,103,456,11,68,45,75,79,120,452,756,6,4588,254,0,2,34,0,0
11553,46,531,647,139,84,35,284,233,682,0,0,0,0,0,0,0,0,0,0,0,0,2,9,2,0
11554,37,841,386,256,301,16,9,68,402,4,59,35,69,63,104,355,621,2,1453,80,0,2,10,1,1
11555,37,841,264,131,164,11,41,46,275,6,38,22,40,44,62,214,338,3,1068,59,0,2,10,1,1
11556,23,1031,386,256,301,16,9,68,402,4,59,35,69,63,104,355,621,2,1453,80,0,2,11,0,1
11557,37,831,386,256,301,16,9,68,402,4,59,35,69,63,104,355,621,2,1453,80,0,2,1,2,1
11558,37,831,264,131,164,11,41,46,275,6,38,22,40,44,62,214,338,3,1068,59,0,2,1,2,1
11559,90,1940,477,336,357,30,23,73,507,16,194,134,250,210,384,1538,2962,10,30538,1696,0,2,10,1,0
11560,74,2691,1450,624,1228,12,26,181,1462,14,306,186,354,320,540,2580,4493,8,36391,2021,1,2,11,0,0
11561,90,1940,477,336,357,30,23,73,507,16,194,134,250,210,384,1538,2962,10,30538,1696,0,2,10,1,0
11562,74,2691,1450,624,1228,12,26,181,1462,14,306,186,354,320,540,2580,4493,8,36391,2021,1,2,11,0,0
11563,37,831,386,256,301,16,9,68,402,4,59,35,69,63,104,355,621,2,1453,80,0,2,10,2,0
11564,37,831,264,131,164,11,41,46,275,6,38,22,40,44,62,214,338,3,1068,59,0,2,10,2,0
11565,23,1031,386,256,301,16,9,68,402,4,59,35,69,63,104,355,621,2,1453,80,0,2,11,0,0
11566,57,1218,996,429,845,24,10,117,1020,7,76,50,88,83,138,494,879,4,3565,198,0,2,16,4,1
11567,57,1218,456,277,329,12,42,72,468,13,85,50,97,98,147,592,972,7,7212,400,0,2,16,4,1
11568,480,10385,72,33,56,0,4,12,72,1,1,1,1,2,2,0,2,0,1,0,0,2,1,1,0
11569,480,10385,1454,835,1044,76,110,219,1530,17,275,158,296,292,454,2297,3718,9,34017,1889,1,2,1,1,0
11570,501,10772,72,33,56,0,4,12,72,1,1,1,1,2,2,0,2,0,1,0,0,2,1,1,0
11571,501,10772,1454,835,1044,76,110,219,1530,17,275,158,296,292,454,2297,3718,9,34017,1889,1,2,1,1,0
11572,57,1218,996,429,845,24,10,117,1020,7,76,50,88,83,138,494,879,4,3565,198,0,2,1,1,1
11573,57,1218,456,277,329,12,42,72,468,13,85,50,97,98,147,592,972,7,7212,400,0,2,1,1,1
11574,112,2270,1513,682,1277,25,13,200,1538,11,199,116,219,210,335,1557,2584,6,15641,868,0,2,2,2,1
11575,112,2270,819,519,539,24,98,155,843,15,96,57,106,111,163,690,1107,8,9171,509,0,2,2,2,1
11576,115,2524,1043,504,840,53,9,147,1096,9,180,112,198,189,310,1377,2344,4,11604,644,0,2,1,1,1
11577,115,2524,383,288,292,26,6,62,409,11,65,38,67,76,105,429,656,5,3719,206,0,2,1,1,1
11578,57,1218,996,429,845,24,10,117,1020,7,76,50,88,83,138,494,879,4,3565,198,0,2,16,4,0
11579,57,1218,456,277,329,12,42,72,468,13,85,50,97,98,147,592,972,7,7212,400,0,2,16,4,0
11580,508,10878,72,33,56,0,4,12,72,1,1,1,1,2,2,0,2,0,1,0,0,2,43,1,1
11581,508,10878,1454,835,1044,76,110,219,1530,17,275,158,296,292,454,2297,3718,9,34017,1889,1,2,43,1,1
11582,77,4244,1782,648,1425,9,47,279,1791,8,171,97,189,179,286,1292,2140,4,9462,525,0,2,10,6,1
11583,57,1219,996,429,845,24,10,117,1020,7,76,50,88,83,138,494,879,4,3565,198,0,2,12,0,1
11584,57,1219,456,277,329,12,42,72,468,13,85,50,97,98,147,592,972,7,7212,400,0,2,12,0,1
11585,175,3605,1943,715,1694,26,18,214,1969,12,185,120,237,197,357,1436,2721,7,20915,1161,0,2,1,1,0
11586,175,3605,1168,838,957,57,25,144,1225,19,348,224,416,367,640,3018,5452,11,61921,3440,1,2,1,1,0
11587,175,3605,1943,715,1694,26,18,214,1969,12,185,120,237,197,357,1436,2721,7,20915,1161,0,2,1,1,0
11588,175,3605,1168,838,957,57,25,144,1225,19,348,224,416,367,640,3018,5452,11,61921,3440,1,2,1,1,0
11589,57,1219,996,429,845,24,10,117,1020,7,76,50,88,83,138,494,879,4,3565,198,0,2,12,0,0
11590,57,1219,456,277,329,12,42,72,468,13,85,50,97,98,147,592,972,7,7212,400,0,2,12,0,0
11591,508,10878,72,33,56,0,4,12,72,1,1,1,1,2,2,0,2,0,1,0,0,2,43,1,0
11592,508,10878,1454,835,1044,76,110,219,1530,17,275,158,296,292,454,2297,3718,9,34017,1889,1,2,43,1,0
11593,77,4244,1782,648,1425,9,47,279,1791,8,171,97,189,179,286,1292,2140,4,9462,525,0,2,10,6,0
11594,57,1219,996,429,845,24,10,117,1020,7,76,50,88,83,138,494,879,4,3565,198,0,2,28,4,0
11595,57,1219,456,277,329,12,42,72,468,13,85,50,97,98,147,592,972,7,7212,400,0,2,28,4,0
11596,508,10878,72,33,56,0,4,12,72,1,1,1,1,2,2,0,2,0,1,0,0,2,44,2,0
11597,508,10878,1454,835,1044,76,110,219,1530,17,275,158,296,292,454,2297,3718,9,34017,1889,1,2,44,2,0
11598,175,3605,1943,715,1694,26,18,214,1969,12,185,120,237,197,357,1436,2721,7,20915,1161,0,2,1,1,0
11599,175,3605,1168,838,957,57,25,144,1225,19,348,224,416,367,640,3018,5452,11,61921,3440,1,2,1,1,0
11600,77,4244,1782,648,1425,9,47,279,1791,8,171,97,189,179,286,1292,2140,4,9462,525,0,2,10,6,0
11601,56,1686,1523,757,1297,19,12,193,1542,12,193,117,230,205,347,1508,2664,7,19053,1058,0,2,60,16,1
11602,56,1686,701,378,504,33,58,109,734,13,110,68,126,123,194,794,1346,7,10027,557,0,2,60,16,1
11603,45,2836,1523,757,1297,19,12,193,1542,12,193,117,230,205,347,1508,2664,7,19053,1058,0,2,25,0,1
11604,56,1686,1523,757,1297,19,12,193,1542,12,193,117,230,205,347,1508,2664,7,19053,1058,0,2,60,16,0
11605,56,1686,701,378,504,33,58,109,734,13,110,68,126,123,194,794,1346,7,10027,557,0,2,60,16,0
11606,45,2836,1523,757,1297,19,12,193,1542,12,193,117,230,205,347,1508,2664,7,19053,1058,0,2,25,0,0
11607,56,1686,1523,757,1297,19,12,193,1542,12,193,117,230,205,347,1508,2664,7,19053,1058,0,2,60,16,0
11608,56,1686,701,378,504,33,58,109,734,13,110,68,126,123,194,794,1346,7,10027,557,0,2,60,16,0
11609,45,2836,1523,757,1297,19,12,193,1542,12,193,117,230,205,347,1508,2664,7,19053,1058,0,2,25,0,0
11610,299,6014,1457,730,1242,11,6,188,1468,10,292,166,329,302,495,2424,4078,5,22973,1276,1,2,6,0,1
11611,299,6014,74,35,59,1,0,14,75,3,14,7,14,17,21,58,85,1,128,7,0,2,6,0,1
11612,299,6014,245,125,200,5,7,34,250,7,30,17,34,37,51,166,265,3,1053,58,0,2,6,0,1
11613,35,2152,652,304,544,16,6,88,668,6,89,51,101,95,152,591,998,3,3399,188,0,2,16,0,1
11614,508,10878,72,33,56,0,4,12,72,1,1,1,1,2,2,0,2,0,1,0,0,2,2,2,1
11615,508,10878,1454,835,1044,76,110,219,1530,17,275,158,296,292,454,2297,3718,9,34017,1889,1,2,2,2,1
11616,297,5993,1457,730,1242,11,6,188,1468,10,292,166,329,302,495,2424,4078,5,22973,1276,1,2,3,9,1
11617,297,5993,74,35,59,1,0,14,75,3,14,7,14,17,21,58,85,1,128,7,0,2,3,9,1
11618,297,5993,245,125,200,5,7,34,250,7,30,17,34,37,51,166,265,3,1053,58,0,2,3,9,1
11619,297,5993,1457,730,1242,11,6,188,1468,10,292,166,329,302,495,2424,4078,5,22973,1276,1,2,8,8,0
11620,297,5993,74,35,59,1,0,14,75,3,14,7,14,17,21,58,85,1,128,7,0,2,8,8,0
11621,297,5993,245,125,200,5,7,34,250,7,30,17,34,37,51,166,265,3,1053,58,0,2,8,8,0
11622,508,10878,72,33,56,0,4,12,72,1,1,1,1,2,2,0,2,0,1,0,0,2,2,2,0
11623,508,10878,1454,835,1044,76,110,219,1530,17,275,158,296,292,454,2297,3718,9,34017,1889,1,2,2,2,0
11624,35,2152,652,304,544,16,6,88,668,6,89,51,101,95,152,591,998,3,3399,188,0,2,16,0,0
11625,36,829,386,256,301,16,9,68,402,4,59,35,69,63,104,355,621,2,1453,80,0,2,2,1,1
11626,36,829,264,131,164,11,41,46,275,6,38,22,40,44,62,214,338,3,1068,59,0,2,2,1,1
11627,22,1003,386,256,301,16,9,68,402,4,59,35,69,63,104,355,621,2,1453,80,0,2,6,3,1
11628,24,1062,386,256,301,16,9,68,402,4,59,35,69,63,104,355,621,2,1453,80,0,2,8,0,1
11629,36,829,386,256,301,16,9,68,402,4,59,35,69,63,104,355,621,2,1453,80,0,2,2,1,0
11630,36,829,264,131,164,11,41,46,275,6,38,22,40,44,62,214,338,3,1068,59,0,2,2,1,0
11631,24,1062,386,256,301,16,9,68,402,4,59,35,69,63,104,355,621,2,1453,80,0,2,14,3,0
11632,23,760,74,35,59,1,0,14,75,3,14,7,14,17,21,58,85,1,128,7,0,2,1,1,0
11633,23,760,245,125,200,5,7,34,250,7,30,17,34,37,51,166,265,3,1053,58,0,2,1,1,0
11634,24,810,74,35,59,1,0,14,75,3,14,7,14,17,21,58,85,1,128,7,0,2,12,2,0
11635,24,810,245,125,200,5,7,34,250,7,30,17,34,37,51,166,265,3,1053,58,0,2,12,2,0
11636,297,5997,1457,730,1242,11,6,188,1468,10,292,166,329,302,495,2424,4078,5,22973,1276,1,2,1,0,1
11637,297,5997,74,35,59,1,0,14,75,3,14,7,14,17,21,58,85,1,128,7,0,2,1,0,1
11638,297,5997,245,125,200,5,7,34,250,7,30,17,34,37,51,166,265,3,1053,58,0,2,1,0,1
11639,35,1821,384,251,317,7,8,52,391,11,70,44,84,81,128,467,811,6,5355,297,0,2,17,0,1
11640,297,5997,1457,730,1242,11,6,188,1468,10,292,166,329,302,495,2424,4078,5,22973,1276,1,2,1,0,0
11641,297,5997,74,35,59,1,0,14,75,3,14,7,14,17,21,58,85,1,128,7,0,2,1,0,0
11642,297,5997,245,125,200,5,7,34,250,7,30,17,34,37,51,166,265,3,1053,58,0,2,1,0,0
11643,35,1821,384,251,317,7,8,52,391,11,70,44,84,81,128,467,811,6,5355,297,0,2,17,0,0
11644,112,2270,1513,682,1277,25,13,200,1538,11,199,116,219,210,335,1557,2584,6,15641,868,0,2,2,2,0
11645,112,2270,819,519,539,24,98,155,843,15,96,57,106,111,163,690,1107,8,9171,509,0,2,2,2,0
11646,115,2524,1043,504,840,53,9,147,1096,9,180,112,198,189,310,1377,2344,4,11604,644,0,2,1,1,0
11647,115,2524,383,288,292,26,6,62,409,11,65,38,67,76,105,429,656,5,3719,206,0,2,1,1,0
11648,219,4876,722,423,573,19,0,135,741,12,172,101,199,184,300,1320,2257,6,15668,870,0,2,14,0,1
11649,219,4876,1508,847,911,44,250,301,1552,14,148,88,169,162,257,1120,1886,7,15077,837,0,2,14,0,1
11650,219,4876,722,423,573,19,0,135,741,12,172,101,199,184,300,1320,2257,6,15668,870,0,2,14,0,0
11651,219,4876,1508,847,911,44,250,301,1552,14,148,88,169,162,257,1120,1886,7,15077,837,0,2,14,0,0
11652,112,2270,1513,682,1277,25,13,200,1538,11,199,116,219,210,335,1557,2584,6,15641,868,0,2,2,2,0
11653,112,2270,819,519,539,24,98,155,843,15,96,57,106,111,163,690,1107,8,9171,509,0,2,2,2,0
11654,297,5997,1457,730,1242,11,6,188,1468,10,292,166,329,302,495,2424,4078,5,22973,1276,1,2,9,8,0
11655,297,5997,74,35,59,1,0,14,75,3,14,7,14,17,21,58,85,1,128,7,0,2,9,8,0
11656,297,5997,245,125,200,5,7,34,250,7,30,17,34,37,51,166,265,3,1053,58,0,2,9,8,0
11657,219,4876,722,423,573,19,0,135,741,12,172,101,199,184,300,1320,2257,6,15668,870,0,2,14,0,0
11658,219,4876,1508,847,911,44,250,301,1552,14,148,88,169,162,257,1120,1886,7,15077,837,0,2,14,0,0
11659,508,10878,72,33,56,0,4,12,72,1,1,1,1,2,2,0,2,0,1,0,0,2,2,2,0
11660,508,10878,1454,835,1044,76,110,219,1530,17,275,158,296,292,454,2297,3718,9,34017,1889,1,2,2,2,0
11661,37,838,386,256,301,16,9,68,402,4,59,35,69,63,104,355,621,2,1453,80,0,2,2,1,0
11662,37,838,264,131,164,11,41,46,275,6,38,22,40,44,62,214,338,3,1068,59,0,2,2,1,0
11663,115,2524,1043,504,840,53,9,147,1096,9,180,112,198,189,310,1377,2344,4,11604,644,0,2,1,1,0
11664,115,2524,383,288,292,26,6,62,409,11,65,38,67,76,105,429,656,5,3719,206,0,2,1,1,0
11665,35,2152,652,304,544,16,6,88,668,6,89,51,101,95,152,591,998,3,3399,188,0,2,16,0,0
11666,35,1821,384,251,317,7,8,52,391,11,70,44,84,81,128,467,811,6,5355,297,0,2,17,0,0
11667,26,1119,386,256,301,16,9,68,402,4,59,35,69,63,104,355,621,2,1453,80,0,2,14,3,0
11668,14,811,442,244,305,14,16,103,456,11,68,45,75,79,120,452,756,6,4588,254,0,2,12,11,0
11669,14,811,442,244,305,14,16,103,456,11,68,45,75,79,120,452,756,6,4588,254,0,2,12,11,0
11670,508,10878,72,33,56,0,4,12,72,1,1,1,1,2,2,0,2,0,1,0,0,2,1,1,1
11671,508,10878,1454,835,1044,76,110,219,1530,17,275,158,296,292,454,2297,3718,9,34017,1889,1,2,1,1,1
11672,79,4325,1782,648,1425,9,47,279,1791,8,171,97,189,179,286,1292,2140,4,9462,525,0,2,19,0,1
11673,509,10885,72,33,56,0,4,12,72,1,1,1,1,2,2,0,2,0,1,0,0,2,9,5,1
11674,509,10885,1454,835,1044,76,110,219,1530,17,275,158,296,292,454,2297,3718,9,34017,1889,1,2,9,5,1
11675,81,4395,1782,648,1425,9,47,279,1791,8,171,97,189,179,286,1292,2140,4,9462,525,0,2,17,0,1
11676,508,10886,72,33,56,0,4,12,72,1,1,1,1,2,2,0,2,0,1,0,0,2,4,1,0
11677,508,10886,1454,835,1044,76,110,219,1530,17,275,158,296,292,454,2297,3718,9,34017,1889,1,2,4,1,0
11678,71,3403,1338,495,1086,10,64,173,1348,11,122,82,157,133,239,883,1686,7,11934,663,0,2,48,0,0
11679,57,1219,996,429,845,24,10,117,1020,7,76,50,88,83,138,494,879,4,3565,198,0,2,2,2,0
11680,57,1219,456,277,329,12,42,72,468,13,85,50,97,98,147,592,972,7,7212,400,0,2,2,2,0
11681,57,1219,996,429,845,24,10,117,1020,7,76,50,88,83,138,494,879,4,3565,198,0,2,2,2,0
11682,57,1219,456,277,329,12,42,72,468,13,85,50,97,98,147,592,972,7,7212,400,0,2,2,2,0
11683,509,10885,72,33,56,0,4,12,72,1,1,1,1,2,2,0,2,0,1,0,0,2,3,2,1
11684,509,10885,1454,835,1044,76,110,219,1530,17,275,158,296,292,454,2297,3718,9,34017,1889,1,2,3,2,1
11685,510,10903,72,33,56,0,4,12,72,1,1,1,1,2,2,0,2,0,1,0,0,2,7,3,0
11686,510,10903,1454,835,1044,76,110,219,1530,17,275,158,296,292,454,2297,3718,9,34017,1889,1,2,7,3,0
11687,71,3404,1338,495,1086,10,64,173,1348,11,122,82,157,133,239,883,1686,7,11934,663,0,2,1,1,0
11688,510,10903,72,33,56,0,4,12,72,1,1,1,1,2,2,0,2,0,1,0,0,2,7,0,0
11689,510,10903,1454,835,1044,76,110,219,1530,17,275,158,296,292,454,2297,3718,9,34017,1889,1,2,7,0,0
11690,71,3404,1338,495,1086,10,64,173,1348,11,122,82,157,133,239,883,1686,7,11934,663,0,2,48,0,0
11691,57,1219,996,429,845,24,10,117,1020,7,76,50,88,83,138,494,879,4,3565,198,0,2,2,2,0
11692,57,1219,456,277,329,12,42,72,468,13,85,50,97,98,147,592,972,7,7212,400,0,2,2,2,0
11693,511,10910,72,33,56,0,4,12,72,1,1,1,1,2,2,0,2,0,1,0,0,2,7,0,0
11694,511,10910,1454,835,1044,76,110,219,1530,17,275,158,296,292,454,2297,3718,9,34017,1889,1,2,7,0,0
11695,71,3404,1338,495,1086,10,64,173,1348,11,122,82,157,133,239,883,1686,7,11934,663,0,2,48,0,0
11696,24,810,74,35,59,1,0,14,75,3,14,7,14,17,21,58,85,1,128,7,0,2,13,3,0
11697,24,810,245,125,200,5,7,34,250,7,30,17,34,37,51,166,265,3,1053,58,0,2,13,3,0
11698,511,10910,72,33,56,0,4,12,72,1,1,1,1,2,2,0,2,0,1,0,0,2,12,7,0
11699,511,10910,1454,835,1044,76,110,219,1530,17,275,158,296,292,454,2297,3718,9,34017,1889,1,2,12,7,0
11700,81,4395,1782,648,1425,9,47,279,1791,8,171,97,189,179,286,1292,2140,4,9462,525,0,2,36,0,0
11701,511,10910,72,33,56,0,4,12,72,1,1,1,1,2,2,0,2,0,1,0,0,2,22,0,1
11702,511,10910,1454,835,1044,76,110,219,1530,17,275,158,296,292,454,2297,3718,9,34017,1889,1,2,22,0,1
11703,511,10910,72,33,56,0,4,12,72,1,1,1,1,2,2,0,2,0,1,0,0,2,1,1,1
11704,511,10910,1454,835,1044,76,110,219,1530,17,275,158,296,292,454,2297,3718,9,34017,1889,1,2,1,1,1
11705,511,10910,72,33,56,0,4,12,72,1,1,1,1,2,2,0,2,0,1,0,0,2,19,19,1
11706,511,10910,1454,835,1044,76,110,219,1530,17,275,158,296,292,454,2297,3718,9,34017,1889,1,2,19,19,1
11707,91,1678,1178,367,1042,6,15,115,1184,9,94,51,95,103,146,644,976,4,4439,246,0,2,10,4,0
11708,91,1678,177,108,140,8,0,27,185,6,30,16,32,36,48,162,248,3,794,44,0,2,10,4,0
11709,112,4312,1513,682,1277,25,13,200,1538,11,199,116,219,210,335,1557,2584,6,15641,868,0,2,0,1,0
11710,53,2322,1178,367,1042,6,15,115,1184,9,94,51,95,103,146,644,976,4,4439,246,0,2,42,1,0
11711,92,1699,1178,367,1042,6,15,115,1184,9,94,51,95,103,146,644,976,4,4439,246,0,2,6,4,0
11712,92,1699,177,108,140,8,0,27,185,6,30,16,32,36,48,162,248,3,794,44,0,2,6,4,0
11713,54,2355,1178,367,1042,6,15,115,1184,9,94,51,95,103,146,644,976,4,4439,246,0,2,16,0,0
11714,55,2386,1178,367,1042,6,15,115,1184,9,94,51,95,103,146,644,976,4,4439,246,0,2,19,4,0
11715,92,1702,1178,367,1042,6,15,115,1184,9,94,51,95,103,146,644,976,4,4439,246,0,2,1,1,0
11716,92,1702,177,108,140,8,0,27,185,6,30,16,32,36,48,162,248,3,794,44,0,2,1,1,0
11717,55,2395,1178,367,1042,6,15,115,1184,9,94,51,95,103,146,644,976,4,4439,246,0,2,3,3,0
11718,91,1695,1178,367,1042,6,15,115,1184,9,94,51,95,103,146,644,976,4,4439,246,0,2,2,3,0
11719,91,1695,177,108,140,8,0,27,185,6,30,16,32,36,48,162,248,3,794,44,0,2,2,3,0
11720,55,2401,1178,367,1042,6,15,115,1184,9,94,51,95,103,146,644,976,4,4439,246,0,2,5,2,0
11721,94,1739,1178,367,1042,6,15,115,1184,9,94,51,95,103,146,644,976,4,4439,246,0,2,18,9,1
11722,94,1739,177,108,140,8,0,27,185,6,30,16,32,36,48,162,248,3,794,44,0,2,18,9,1
11723,56,2436,1178,367,1042,6,15,115,1184,9,94,51,95,103,146,644,976,4,4439,246,0,2,13,0,1
11724,94,1739,1178,367,1042,6,15,115,1184,9,94,51,95,103,146,644,976,4,4439,246,0,2,6,0,0
11725,94,1739,177,108,140,8,0,27,185,6,30,16,32,36,48,162,248,3,794,44,0,2,6,0,0
11726,56,2436,1178,367,1042,6,15,115,1184,9,94,51,95,103,146,644,976,4,4439,246,0,2,1,0,0
11727,94,1736,1178,367,1042,6,15,115,1184,9,94,51,95,103,146,644,976,4,4439,246,0,2,1,1,1
11728,94,1736,177,108,140,8,0,27,185,6,30,16,32,36,48,162,248,3,794,44,0,2,1,1,1
11729,56,2424,1178,367,1042,6,15,115,1184,9,94,51,95,103,146,644,976,4,4439,246,0,2,4,4,1
11730,56,2424,1178,367,1042,6,15,115,1184,9,94,51,95,103,146,644,976,4,4439,246,0,2,0,4,0
11731,56,2424,1178,367,1042,6,15,115,1184,9,94,51,95,103,146,644,976,4,4439,246,0,2,1,1,0
11732,56,2424,1178,367,1042,6,15,115,1184,9,94,51,95,103,146,644,976,4,4439,246,0,2,2,2,0
11733,94,1737,1178,367,1042,6,15,115,1184,9,94,51,95,103,146,644,976,4,4439,246,0,2,1,1,1
11734,94,1737,177,108,140,8,0,27,185,6,30,16,32,36,48,162,248,3,794,44,0,2,1,1,1
11735,56,2421,1178,367,1042,6,15,115,1184,9,94,51,95,103,146,644,976,4,4439,246,0,2,1,1,1
11736,45,1334,1455,414,1257,16,76,112,1471,5,41,23,46,46,69,231,381,2,1069,59,0,2,21,8,1
11737,45,1334,669,365,481,22,61,110,691,15,103,63,122,118,185,747,1273,8,11311,628,0,2,21,8,1
11738,44,1867,1455,414,1257,16,76,112,1471,5,41,23,46,46,69,231,381,2,1069,59,0,2,120,33,1
11739,511,10910,72,33,56,0,4,12,72,1,1,1,1,2,2,0,2,0,1,0,0,2,21,21,1
11740,511,10910,1454,835,1044,76,110,219,1530,17,275,158,296,292,454,2297,3718,9,34017,1889,1,2,21,21,1
11741,511,10910,72,33,56,0,4,12,72,1,1,1,1,2,2,0,2,0,1,0,0,2,21,21,0
11742,511,10910,1454,835,1044,76,110,219,1530,17,275,158,296,292,454,2297,3718,9,34017,1889,1,2,21,21,0
11743,72,3434,1338,495,1086,10,64,173,1348,11,122,82,157,133,239,883,1686,7,11934,663,0,2,10,0,0
11744,55,2732,1457,730,1242,11,6,188,1468,10,292,166,329,302,495,2424,4078,5,22973,1276,1,2,45,0,1
11745,297,6005,1457,730,1242,11,6,188,1468,10,292,166,329,302,495,2424,4078,5,22973,1276,1,2,3,3,0
11746,297,6005,74,35,59,1,0,14,75,3,14,7,14,17,21,58,85,1,128,7,0,2,3,3,0
11747,297,6005,245,125,200,5,7,34,250,7,30,17,34,37,51,166,265,3,1053,58,0,2,3,3,0
11748,55,2710,1457,730,1242,11,6,188,1468,10,292,166,329,302,495,2424,4078,5,22973,1276,1,2,0,2,0
11749,298,6078,1457,730,1242,11,6,188,1468,10,292,166,329,302,495,2424,4078,5,22973,1276,1,2,16,14,1
11750,298,6078,74,35,59,1,0,14,75,3,14,7,14,17,21,58,85,1,128,7,0,2,16,14,1
11751,298,6078,245,125,200,5,7,34,250,7,30,17,34,37,51,166,265,3,1053,58,0,2,16,14,1
11752,55,2794,1457,730,1242,11,6,188,1468,10,292,166,329,302,495,2424,4078,5,22973,1276,1,2,23,9,1
11753,55,2827,1457,730,1242,11,6,188,1468,10,292,166,329,302,495,2424,4078,5,22973,1276,1,2,6,0,1
11754,298,6078,1457,730,1242,11,6,188,1468,10,292,166,329,302,495,2424,4078,5,22973,1276,1,2,18,16,0
11755,298,6078,74,35,59,1,0,14,75,3,14,7,14,17,21,58,85,1,128,7,0,2,18,16,0
11756,298,6078,245,125,200,5,7,34,250,7,30,17,34,37,51,166,265,3,1053,58,0,2,18,16,0
11757,55,2827,1457,730,1242,11,6,188,1468,10,292,166,329,302,495,2424,4078,5,22973,1276,1,2,63,0,0
11758,512,10947,72,33,56,0,4,12,72,1,1,1,1,2,2,0,2,0,1,0,0,2,10,1,1
11759,512,10947,1454,835,1044,76,110,219,1530,17,275,158,296,292,454,2297,3718,9,34017,1889,1,2,10,1,1
11760,512,10947,72,33,56,0,4,12,72,1,1,1,1,2,2,0,2,0,1,0,0,2,10,1,0
11761,512,10947,1454,835,1044,76,110,219,1530,17,275,158,296,292,454,2297,3718,9,34017,1889,1,2,10,1,0
11762,72,3434,1338,495,1086,10,64,173,1348,11,122,82,157,133,239,883,1686,7,11934,663,0,2,10,0,0
11763,45,1334,1455,414,1257,16,76,112,1471,5,41,23,46,46,69,231,381,2,1069,59,0,2,21,8,0
11764,45,1334,669,365,481,22,61,110,691,15,103,63,122,118,185,747,1273,8,11311,628,0,2,21,8,0
11765,44,1867,1455,414,1257,16,76,112,1471,5,41,23,46,46,69,231,381,2,1069,59,0,2,120,33,0
11766,513,10957,72,33,56,0,4,12,72,1,1,1,1,2,2,0,2,0,1,0,0,2,5,2,1
11767,513,10957,1454,835,1044,76,110,219,1530,17,275,158,296,292,454,2297,3718,9,34017,1889,1,2,5,2,1
11768,73,3470,1338,495,1086,10,64,173,1348,11,122,82,157,133,239,883,1686,7,11934,663,0,2,24,0,1
11769,513,10957,72,33,56,0,4,12,72,1,1,1,1,2,2,0,2,0,1,0,0,2,5,2,0
11770,513,10957,1454,835,1044,76,110,219,1530,17,275,158,296,292,454,2297,3718,9,34017,1889,1,2,5,2,0
11771,73,3470,1338,495,1086,10,64,173,1348,11,122,82,157,133,239,883,1686,7,11934,663,0,2,24,0,0
11772,513,10965,72,33,56,0,4,12,72,1,1,1,1,2,2,0,2,0,1,0,0,2,5,2,1
11773,513,10965,1454,835,1044,76,110,219,1530,17,275,158,296,292,454,2297,3718,9,34017,1889,1,2,5,2,1
11774,75,3563,1338,495,1086,10,64,173,1348,11,122,82,157,133,239,883,1686,7,11934,663,0,2,30,6,1
11775,513,10965,72,33,56,0,4,12,72,1,1,1,1,2,2,0,2,0,1,0,0,2,5,2,0
11776,513,10965,1454,835,1044,76,110,219,1530,17,275,158,296,292,454,2297,3718,9,34017,1889,1,2,5,2,0
11777,75,3563,1338,495,1086,10,64,173,1348,11,122,82,157,133,239,883,1686,7,11934,663,0,2,30,6,0
11778,147,4720,1660,832,1314,41,38,274,1701,20,312,209,395,332,604,2671,5058,12,64042,3557,1,2,1,1,0
11779,147,4720,1057,646,719,113,100,145,1170,18,215,134,248,233,382,1740,3004,10,31186,1732,1,2,1,1,0
11780,172,3983,77,34,69,0,0,8,77,3,24,16,29,27,45,114,213,1,387,21,0,2,0,6,0
11781,172,3983,712,438,573,51,9,84,763,14,102,71,128,116,199,733,1364,8,11988,666,0,2,0,6,0
11782,172,3983,77,34,69,0,0,8,77,3,24,16,29,27,45,114,213,1,387,21,0,2,0,6,0
11783,172,3983,712,438,573,51,9,84,763,14,102,71,128,116,199,733,1364,8,11988,666,0,2,0,6,0
11784,175,3619,1943,715,1694,26,18,214,1969,12,185,120,237,197,357,1436,2721,7,20915,1161,0,2,2,1,0
11785,175,3619,1168,838,957,57,25,144,1225,19,348,224,416,367,640,3018,5452,11,61921,3440,1,2,2,1,0
11786,175,3619,1943,715,1694,26,18,214,1969,12,185,120,237,197,357,1436,2721,7,20915,1161,0,2,2,1,0
11787,175,3619,1168,838,957,57,25,144,1225,19,348,224,416,367,640,3018,5452,11,61921,3440,1,2,2,1,0
11788,147,4720,1660,832,1314,41,38,274,1701,20,312,209,395,332,604,2671,5058,12,64042,3557,1,2,1,1,0
11789,147,4720,1057,646,719,113,100,145,1170,18,215,134,248,233,382,1740,3004,10,31186,1732,1,2,1,1,0
11790,51,1053,1098,241,925,5,10,155,1103,7,46,25,49,53,74,273,423,3,1580,87,0,2,1,0,1
11791,51,1053,282,202,222,14,2,44,296,8,42,24,43,50,67,250,378,4,1548,86,0,2,1,0,1
11792,38,1499,1098,241,925,5,10,155,1103,7,46,25,49,53,74,273,423,3,1580,87,0,2,13,0,1
11793,51,1053,1098,241,925,5,10,155,1103,7,46,25,49,53,74,273,423,3,1580,87,0,2,10,1,1
11794,51,1053,282,202,222,14,2,44,296,8,42,24,43,50,67,250,378,4,1548,86,0,2,10,1,1
11795,38,1508,1098,241,925,5,10,155,1103,7,46,25,49,53,74,273,423,3,1580,87,0,2,1,0,1
11796,53,1075,1098,241,925,5,10,155,1103,7,46,25,49,53,74,273,423,3,1580,87,0,2,14,10,0
11797,53,1075,282,202,222,14,2,44,296,8,42,24,43,50,67,250,378,4,1548,86,0,2,14,10,0
11798,38,1508,1098,241,925,5,10,155,1103,7,46,25,49,53,74,273,423,3,1580,87,0,2,7,5,0
11799,53,1075,1098,241,925,5,10,155,1103,7,46,25,49,53,74,273,423,3,1580,87,0,2,14,0,0
11800,53,1075,282,202,222,14,2,44,296,8,42,24,43,50,67,250,378,4,1548,86,0,2,14,0,0
11801,38,1508,1098,241,925,5,10,155,1103,7,46,25,49,53,74,273,423,3,1580,87,0,2,16,0,0
11802,46,531,647,139,84,35,284,233,682,0,0,0,0,0,0,0,0,0,0,0,0,2,3,1,0
11803,46,532,647,139,84,35,284,233,682,0,0,0,0,0,0,0,0,0,0,0,0,2,4,1,1
11804,21,574,1293,570,1093,25,15,163,1318,10,195,123,241,205,364,1516,2795,6,17273,959,0,2,1,2,1
11805,32,1211,1293,570,1093,25,15,163,1318,10,195,123,241,205,364,1516,2795,6,17273,959,0,2,5,1,1
11806,46,532,647,139,84,35,284,233,682,0,0,0,0,0,0,0,0,0,0,0,0,2,7,2,0
11807,21,574,1293,570,1093,25,15,163,1318,10,195,123,241,205,364,1516,2795,6,17273,959,0,2,1,2,0
11808,32,1211,1293,570,1093,25,15,163,1318,10,195,123,241,205,364,1516,2795,6,17273,959,0,2,5,1,0
11809,46,531,647,139,84,35,284,233,682,0,0,0,0,0,0,0,0,0,0,0,0,2,3,1,1
11810,38,889,386,256,301,16,9,68,402,4,59,35,69,63,104,355,621,2,1453,80,0,2,20,9,1
11811,38,889,264,131,164,11,41,46,275,6,38,22,40,44,62,214,338,3,1068,59,0,2,20,9,1
11812,40,935,386,256,301,16,9,68,402,4,59,35,69,63,104,355,621,2,1453,80,0,2,25,15,1
11813,40,935,264,131,164,11,41,46,275,6,38,22,40,44,62,214,338,3,1068,59,0,2,25,15,1
11814,27,1123,386,256,301,16,9,68,402,4,59,35,69,63,104,355,621,2,1453,80,0,2,44,23,1
11815,40,935,386,256,301,16,9,68,402,4,59,35,69,63,104,355,621,2,1453,80,0,2,29,8,0
11816,40,935,264,131,164,11,41,46,275,6,38,22,40,44,62,214,338,3,1068,59,0,2,29,8,0
11817,27,1123,386,256,301,16,9,68,402,4,59,35,69,63,104,355,621,2,1453,80,0,2,44,23,0
11818,16,491,184,100,137,2,15,30,186,6,38,20,39,44,59,214,322,3,991,55,0,2,1,1,1
11819,16,491,103,65,74,8,5,16,111,7,17,9,17,24,26,89,119,3,417,23,0,2,1,1,1
11820,16,487,184,100,137,2,15,30,186,6,38,20,39,44,59,214,322,3,991,55,0,2,1,1,0
11821,16,487,103,65,74,8,5,16,111,7,17,9,17,24,26,89,119,3,417,23,0,2,1,1,0
11822,11,386,184,100,137,2,15,30,186,6,38,20,39,44,59,214,322,3,991,55,0,2,3,3,0
11823,513,10973,72,33,56,0,4,12,72,1,1,1,1,2,2,0,2,0,1,0,0,2,3,2,1
11824,513,10973,1454,835,1044,76,110,219,1530,17,275,158,296,292,454,2297,3718,9,34017,1889,1,2,3,2,1
11825,76,3610,1338,495,1086,10,64,173,1348,11,122,82,157,133,239,883,1686,7,11934,663,0,2,15,0,1
11826,513,10967,72,33,56,0,4,12,72,1,1,1,1,2,2,0,2,0,1,0,0,2,4,1,0
11827,513,10967,1454,835,1044,76,110,219,1530,17,275,158,296,292,454,2297,3718,9,34017,1889,1,2,4,1,0
11828,32,933,465,148,393,5,8,60,470,4,31,20,31,35,51,161,261,2,523,29,0,2,29,0,0
11829,32,933,16,12,9,0,0,6,16,1,2,1,2,3,3,2,4,0,2,0,0,2,29,0,0
11830,513,10973,72,33,56,0,4,12,72,1,1,1,1,2,2,0,2,0,1,0,0,2,3,2,0
11831,513,10973,1454,835,1044,76,110,219,1530,17,275,158,296,292,454,2297,3718,9,34017,1889,1,2,3,2,0
11832,76,3610,1338,495,1086,10,64,173,1348,11,122,82,157,133,239,883,1686,7,11934,663,0,2,15,0,0
11833,513,10975,72,33,56,0,4,12,72,1,1,1,1,2,2,0,2,0,1,0,0,2,4,1,0
11834,513,10975,1454,835,1044,76,110,219,1530,17,275,158,296,292,454,2297,3718,9,34017,1889,1,2,4,1,0
11835,32,933,465,148,393,5,8,60,470,4,31,20,31,35,51,161,261,2,523,29,0,2,29,0,0
11836,32,933,16,12,9,0,0,6,16,1,2,1,2,3,3,2,4,0,2,0,0,2,29,0,0
11837,176,3627,1943,715,1694,26,18,214,1969,12,185,120,237,197,357,1436,2721,7,20915,1161,0,2,5,1,0
11838,176,3627,1168,838,957,57,25,144,1225,19,348,224,416,367,640,3018,5452,11,61921,3440,1,2,5,1,0
11839,65,3364,1943,715,1694,26,18,214,1969,12,185,120,237,197,357,1436,2721,7,20915,1161,0,2,2,2,0
11840,176,3627,1943,715,1694,26,18,214,1969,12,185,120,237,197,357,1436,2721,7,20915,1161,0,2,5,1,0
11841,176,3627,1168,838,957,57,25,144,1225,19,348,224,416,367,640,3018,5452,11,61921,3440,1,2,5,1,0
11842,65,3364,1943,715,1694,26,18,214,1969,12,185,120,237,197,357,1436,2721,7,20915,1161,0,2,2,2,0
11843,176,3627,1943,715,1694,26,18,214,1969,12,185,120,237,197,357,1436,2721,7,20915,1161,0,2,1,1,0
11844,176,3627,1168,838,957,57,25,144,1225,19,348,224,416,367,640,3018,5452,11,61921,3440,1,2,1,1,0
11845,65,3364,1943,715,1694,26,18,214,1969,12,185,120,237,197,357,1436,2721,7,20915,1161,0,2,2,2,0
11846,176,3627,1943,715,1694,26,18,214,1969,12,185,120,237,197,357,1436,2721,7,20915,1161,0,2,1,1,0
11847,176,3627,1168,838,957,57,25,144,1225,19,348,224,416,367,640,3018,5452,11,61921,3440,1,2,1,1,0
11848,65,3364,1943,715,1694,26,18,214,1969,12,185,120,237,197,357,1436,2721,7,20915,1161,0,2,2,2,0
11849,115,2524,1043,504,840,53,9,147,1096,9,180,112,198,189,310,1377,2344,4,11604,644,0,2,1,1,0
11850,115,2524,383,288,292,26,6,62,409,11,65,38,67,76,105,429,656,5,3719,206,0,2,1,1,0
11851,115,2524,1043,504,840,53,9,147,1096,9,180,112,198,189,310,1377,2344,4,11604,644,0,2,1,1,0
11852,115,2524,383,288,292,26,6,62,409,11,65,38,67,76,105,429,656,5,3719,206,0,2,1,1,0
11853,16,491,184,100,137,2,15,30,186,6,38,20,39,44,59,214,322,3,991,55,0,2,1,1,1
11854,16,491,103,65,74,8,5,16,111,7,17,9,17,24,26,89,119,3,417,23,0,2,1,1,1
11855,11,394,184,100,137,2,15,30,186,6,38,20,39,44,59,214,322,3,991,55,0,2,3,2,1
11856,513,10975,72,33,56,0,4,12,72,1,1,1,1,2,2,0,2,0,1,0,0,2,7,3,0
11857,513,10975,1454,835,1044,76,110,219,1530,17,275,158,296,292,454,2297,3718,9,34017,1889,1,2,7,3,0
11858,115,2524,1043,504,840,53,9,147,1096,9,180,112,198,189,310,1377,2344,4,11604,644,0,2,1,1,0
11859,115,2524,383,288,292,26,6,62,409,11,65,38,67,76,105,429,656,5,3719,206,0,2,1,1,0
11860,176,3627,1943,715,1694,26,18,214,1969,12,185,120,237,197,357,1436,2721,7,20915,1161,0,2,5,1,0
11861,176,3627,1168,838,957,57,25,144,1225,19,348,224,416,367,640,3018,5452,11,61921,3440,1,2,5,1,0
11862,76,3610,1338,495,1086,10,64,173,1348,11,122,82,157,133,239,883,1686,7,11934,663,0,2,15,0,0
11863,32,933,465,148,393,5,8,60,470,4,31,20,31,35,51,161,261,2,523,29,0,2,29,0,0
11864,32,933,16,12,9,0,0,6,16,1,2,1,2,3,3,2,4,0,2,0,0,2,29,0,0
11865,65,3364,1943,715,1694,26,18,214,1969,12,185,120,237,197,357,1436,2721,7,20915,1161,0,2,2,2,0
11866,16,491,184,100,137,2,15,30,186,6,38,20,39,44,59,214,322,3,991,55,0,2,2,2,0
11867,16,491,103,65,74,8,5,16,111,7,17,9,17,24,26,89,119,3,417,23,0,2,2,2,0
11868,11,394,184,100,137,2,15,30,186,6,38,20,39,44,59,214,322,3,991,55,0,2,6,5,0
11869,17,510,184,100,137,2,15,30,186,6,38,20,39,44,59,214,322,3,991,55,0,2,9,5,1
11870,17,510,103,65,74,8,5,16,111,7,17,9,17,24,26,89,119,3,417,23,0,2,9,5,1
11871,12,475,184,100,137,2,15,30,186,6,38,20,39,44,59,214,322,3,991,55,0,2,31,4,1
11872,17,510,184,100,137,2,15,30,186,6,38,20,39,44,59,214,322,3,991,55,0,2,9,5,0
11873,17,510,103,65,74,8,5,16,111,7,17,9,17,24,26,89,119,3,417,23,0,2,9,5,0
11874,12,475,184,100,137,2,15,30,186,6,38,20,39,44,59,214,322,3,991,55,0,2,31,4,0
11875,56,1686,1523,757,1297,19,12,193,1542,12,193,117,230,205,347,1508,2664,7,19053,1058,0,2,54,35,0
11876,56,1686,701,378,504,33,58,109,734,13,110,68,126,123,194,794,1346,7,10027,557,0,2,54,35,0
11877,56,1686,1523,757,1297,19,12,193,1542,12,193,117,230,205,347,1508,2664,7,19053,1058,0,2,3,3,0
11878,56,1686,701,378,504,33,58,109,734,13,110,68,126,123,194,794,1346,7,10027,557,0,2,3,3,0
11879,45,2836,1523,757,1297,19,12,193,1542,12,193,117,230,205,347,1508,2664,7,19053,1058,0,2,87,71,0
11880,58,2876,1523,757,1297,19,12,193,1542,12,193,117,230,205,347,1508,2664,7,19053,1058,0,2,204,166,1
11881,58,2876,1523,757,1297,19,12,193,1542,12,193,117,230,205,347,1508,2664,7,19053,1058,0,2,6,1,1
11882,61,1745,1523,757,1297,19,12,193,1542,12,193,117,230,205,347,1508,2664,7,19053,1058,0,2,42,32,0
11883,61,1745,701,378,504,33,58,109,734,13,110,68,126,123,194,794,1346,7,10027,557,0,2,42,32,0
11884,60,2900,1523,757,1297,19,12,193,1542,12,193,117,230,205,347,1508,2664,7,19053,1058,0,2,6,1,0
11885,61,1734,1523,757,1297,19,12,193,1542,12,193,117,230,205,347,1508,2664,7,19053,1058,0,2,0,1,0
11886,61,1734,701,378,504,33,58,109,734,13,110,68,126,123,194,794,1346,7,10027,557,0,2,0,1,0
11887,64,1801,1523,757,1297,19,12,193,1542,12,193,117,230,205,347,1508,2664,7,19053,1058,0,2,52,34,1
11888,64,1801,701,378,504,33,58,109,734,13,110,68,126,123,194,794,1346,7,10027,557,0,2,52,34,1
11889,64,1790,1523,757,1297,19,12,193,1542,12,193,117,230,205,347,1508,2664,7,19053,1058,0,2,2,2,0
11890,64,1790,701,378,504,33,58,109,734,13,110,68,126,123,194,794,1346,7,10027,557,0,2,2,2,0
11891,65,1814,1523,757,1297,19,12,193,1542,12,193,117,230,205,347,1508,2664,7,19053,1058,0,2,7,3,0
11892,65,1814,701,378,504,33,58,109,734,13,110,68,126,123,194,794,1346,7,10027,557,0,2,7,3,0
11893,61,2932,1523,757,1297,19,12,193,1542,12,193,117,230,205,347,1508,2664,7,19053,1058,0,2,6,2,0
11894,65,1825,1523,757,1297,19,12,193,1542,12,193,117,230,205,347,1508,2664,7,19053,1058,0,2,120,118,1
11895,65,1825,701,378,504,33,58,109,734,13,110,68,126,123,194,794,1346,7,10027,557,0,2,120,118,1
11896,61,2942,1523,757,1297,19,12,193,1542,12,193,117,230,205,347,1508,2664,7,19053,1058,0,2,13,12,1
11897,65,1835,1523,757,1297,19,12,193,1542,12,193,117,230,205,347,1508,2664,7,19053,1058,0,2,3,3,0
11898,65,1835,701,378,504,33,58,109,734,13,110,68,126,123,194,794,1346,7,10027,557,0,2,3,3,0
11899,61,2937,1523,757,1297,19,12,193,1542,12,193,117,230,205,347,1508,2664,7,19053,1058,0,2,1,1,0
11900,67,1895,1523,757,1297,19,12,193,1542,12,193,117,230,205,347,1508,2664,7,19053,1058,0,2,8,0,0
11901,67,1895,701,378,504,33,58,109,734,13,110,68,126,123,194,794,1346,7,10027,557,0,2,8,0,0
11902,62,2941,1523,757,1297,19,12,193,1542,12,193,117,230,205,347,1508,2664,7,19053,1058,0,2,1,1,0
11903,67,1895,1523,757,1297,19,12,193,1542,12,193,117,230,205,347,1508,2664,7,19053,1058,0,2,14,14,1
11904,67,1895,701,378,504,33,58,109,734,13,110,68,126,123,194,794,1346,7,10027,557,0,2,14,14,1
11905,67,1895,1523,757,1297,19,12,193,1542,12,193,117,230,205,347,1508,2664,7,19053,1058,0,2,1,2,0
11906,67,1895,701,378,504,33,58,109,734,13,110,68,126,123,194,794,1346,7,10027,557,0,2,1,2,0
11907,67,1895,1523,757,1297,19,12,193,1542,12,193,117,230,205,347,1508,2664,7,19053,1058,0,2,7,7,0
11908,67,1895,701,378,504,33,58,109,734,13,110,68,126,123,194,794,1346,7,10027,557,0,2,7,7,0
11909,63,2994,1523,757,1297,19,12,193,1542,12,193,117,230,205,347,1508,2664,7,19053,1058,0,2,11,0,1
11910,67,1914,1523,757,1297,19,12,193,1542,12,193,117,230,205,347,1508,2664,7,19053,1058,0,2,13,7,1
11911,67,1914,701,378,504,33,58,109,734,13,110,68,126,123,194,794,1346,7,10027,557,0,2,13,7,1
11912,64,3043,1523,757,1297,19,12,193,1542,12,193,117,230,205,347,1508,2664,7,19053,1058,0,2,14,2,1
11913,67,1914,1523,757,1297,19,12,193,1542,12,193,117,230,205,347,1508,2664,7,19053,1058,0,2,213,148,0
11914,67,1914,701,378,504,33,58,109,734,13,110,68,126,123,194,794,1346,7,10027,557,0,2,213,148,0
11915,64,3043,1523,757,1297,19,12,193,1542,12,193,117,230,205,347,1508,2664,7,19053,1058,0,2,239,147,0
11916,116,2530,1043,504,840,53,9,147,1096,9,180,112,198,189,310,1377,2344,4,11604,644,0,2,5,1,1
11917,116,2530,383,288,292,26,6,62,409,11,65,38,67,76,105,429,656,5,3719,206,0,2,5,1,1
11918,95,1752,1178,367,1042,6,15,115,1184,9,94,51,95,103,146,644,976,4,4439,246,0,2,3,0,1
11919,95,1752,177,108,140,8,0,27,185,6,30,16,32,36,48,162,248,3,794,44,0,2,3,0,1
11920,180,3684,1943,715,1694,26,18,214,1969,12,185,120,237,197,357,1436,2721,7,20915,1161,0,2,16,1,1
11921,180,3684,1168,838,957,57,25,144,1225,19,348,224,416,367,640,3018,5452,11,61921,3440,1,2,16,1,1
11922,147,4720,1660,832,1314,41,38,274,1701,20,312,209,395,332,604,2671,5058,12,64042,3557,1,2,1,1,0
11923,147,4720,1057,646,719,113,100,145,1170,18,215,134,248,233,382,1740,3004,10,31186,1732,1,2,1,1,0
11924,57,1219,996,429,845,24,10,117,1020,7,76,50,88,83,138,494,879,4,3565,198,0,2,2,2,0
11925,57,1219,456,277,329,12,42,72,468,13,85,50,97,98,147,592,972,7,7212,400,0,2,2,2,0
11926,45,1334,1455,414,1257,16,76,112,1471,5,41,23,46,46,69,231,381,2,1069,59,0,2,21,8,0
11927,45,1334,669,365,481,22,61,110,691,15,103,63,122,118,185,747,1273,8,11311,628,0,2,21,8,0
11928,24,810,74,35,59,1,0,14,75,3,14,7,14,17,21,58,85,1,128,7,0,2,13,3,0
11929,24,810,245,125,200,5,7,34,250,7,30,17,34,37,51,166,265,3,1053,58,0,2,13,3,0
11930,67,1914,1523,757,1297,19,12,193,1542,12,193,117,230,205,347,1508,2664,7,19053,1058,0,2,213,148,0
11931,67,1914,701,378,504,33,58,109,734,13,110,68,126,123,194,794,1346,7,10027,557,0,2,213,148,0
11932,172,3983,77,34,69,0,0,8,77,3,24,16,29,27,45,114,213,1,387,21,0,2,0,6,0
11933,172,3983,712,438,573,51,9,84,763,14,102,71,128,116,199,733,1364,8,11988,666,0,2,0,6,0
11934,17,510,184,100,137,2,15,30,186,6,38,20,39,44,59,214,322,3,991,55,0,2,9,5,0
11935,17,510,103,65,74,8,5,16,111,7,17,9,17,24,26,89,119,3,417,23,0,2,9,5,0
11936,513,10975,72,33,56,0,4,12,72,1,1,1,1,2,2,0,2,0,1,0,0,2,67,14,0
11937,513,10975,1454,835,1044,76,110,219,1530,17,275,158,296,292,454,2297,3718,9,34017,1889,1,2,67,14,0
11938,41,944,386,256,301,16,9,68,402,4,59,35,69,63,104,355,621,2,1453,80,0,2,29,8,0
11939,41,944,264,131,164,11,41,46,275,6,38,22,40,44,62,214,338,3,1068,59,0,2,29,8,0
11940,115,2524,1043,504,840,53,9,147,1096,9,180,112,198,189,310,1377,2344,4,11604,644,0,2,1,1,0
11941,115,2524,383,288,292,26,6,62,409,11,65,38,67,76,105,429,656,5,3719,206,0,2,1,1,0
11942,176,3627,1943,715,1694,26,18,214,1969,12,185,120,237,197,357,1436,2721,7,20915,1161,0,2,7,2,0
11943,176,3627,1168,838,957,57,25,144,1225,19,348,224,416,367,640,3018,5452,11,61921,3440,1,2,7,2,0
11944,53,1075,1098,241,925,5,10,155,1103,7,46,25,49,53,74,273,423,3,1580,87,0,2,14,0,0
11945,53,1075,282,202,222,14,2,44,296,8,42,24,43,50,67,250,378,4,1548,86,0,2,14,0,0
11946,76,3610,1338,495,1086,10,64,173,1348,11,122,82,157,133,239,883,1686,7,11934,663,0,2,121,0,0
11947,32,933,465,148,393,5,8,60,470,4,31,20,31,35,51,161,261,2,523,29,0,2,29,0,0
11948,32,933,16,12,9,0,0,6,16,1,2,1,2,3,3,2,4,0,2,0,0,2,29,0,0
11949,81,4395,1782,648,1425,9,47,279,1791,8,171,97,189,179,286,1292,2140,4,9462,525,0,2,36,0,0
11950,44,1867,1455,414,1257,16,76,112,1471,5,41,23,46,46,69,231,381,2,1069,59,0,2,120,33,0
11951,64,3043,1523,757,1297,19,12,193,1542,12,193,117,230,205,347,1508,2664,7,19053,1058,0,2,239,147,0
11952,12,475,184,100,137,2,15,30,186,6,38,20,39,44,59,214,322,3,991,55,0,2,37,9,0
11953,29,1180,386,256,301,16,9,68,402,4,59,35,69,63,104,355,621,2,1453,80,0,2,43,23,0
11954,65,3364,1943,715,1694,26,18,214,1969,12,185,120,237,197,357,1436,2721,7,20915,1161,0,2,2,2,0
11955,14,811,442,244,305,14,16,103,456,11,68,45,75,79,120,452,756,6,4588,254,0,2,12,11,0
11956,38,1508,1098,241,925,5,10,155,1103,7,46,25,49,53,74,273,423,3,1580,87,0,2,16,0,0
11957,29,1184,386,256,301,16,9,68,402,4,59,35,69,63,104,355,621,2,1453,80,0,2,2,2,1
11958,40,938,386,256,301,16,9,68,402,4,59,35,69,63,104,355,621,2,1453,80,0,2,1,1,1
11959,40,938,264,131,164,11,41,46,275,6,38,22,40,44,62,214,338,3,1068,59,0,2,1,1,1
11960,27,1135,386,256,301,16,9,68,402,4,59,35,69,63,104,355,621,2,1453,80,0,2,5,4,1
11961,68,3477,1943,715,1694,26,18,214,1969,12,185,120,237,197,357,1436,2721,7,20915,1161,0,2,25,0,0
11962,68,3495,1943,715,1694,26,18,214,1969,12,185,120,237,197,357,1436,2721,7,20915,1161,0,2,2,0,0
11963,40,938,386,256,301,16,9,68,402,4,59,35,69,63,104,355,621,2,1453,80,0,2,1,1,0
11964,40,938,264,131,164,11,41,46,275,6,38,22,40,44,62,214,338,3,1068,59,0,2,1,1,0
11965,27,1135,386,256,301,16,9,68,402,4,59,35,69,63,104,355,621,2,1453,80,0,2,5,4,0
11966,116,2530,1043,504,840,53,9,147,1096,9,180,112,198,189,310,1377,2344,4,11604,644,0,2,5,1,0
11967,116,2530,383,288,292,26,6,62,409,11,65,38,67,76,105,429,656,5,3719,206,0,2,5,1,0
11968,95,1752,1178,367,1042,6,15,115,1184,9,94,51,95,103,146,644,976,4,4439,246,0,2,3,0,0
11969,95,1752,177,108,140,8,0,27,185,6,30,16,32,36,48,162,248,3,794,44,0,2,3,0,0
11970,180,3684,1943,715,1694,26,18,214,1969,12,185,120,237,197,357,1436,2721,7,20915,1161,0,2,16,1,0
11971,180,3684,1168,838,957,57,25,144,1225,19,348,224,416,367,640,3018,5452,11,61921,3440,1,2,16,1,0
11972,68,3495,1943,715,1694,26,18,214,1969,12,185,120,237,197,357,1436,2721,7,20915,1161,0,2,27,0,0
11973,513,10978,72,33,56,0,4,12,72,1,1,1,1,2,2,0,2,0,1,0,0,2,1,1,0
11974,513,10978,1454,835,1044,76,110,219,1530,17,275,158,296,292,454,2297,3718,9,34017,1889,1,2,1,1,0
11975,147,4720,1660,832,1314,41,38,274,1701,20,312,209,395,332,604,2671,5058,12,64042,3557,1,2,1,1,0
11976,147,4720,1057,646,719,113,100,145,1170,18,215,134,248,233,382,1740,3004,10,31186,1732,1,2,1,1,0
11977,57,1219,996,429,845,24,10,117,1020,7,76,50,88,83,138,494,879,4,3565,198,0,2,2,2,0
11978,57,1219,456,277,329,12,42,72,468,13,85,50,97,98,147,592,972,7,7212,400,0,2,2,2,0
11979,45,1334,1455,414,1257,16,76,112,1471,5,41,23,46,46,69,231,381,2,1069,59,0,2,21,8,0
11980,45,1334,669,365,481,22,61,110,691,15,103,63,122,118,185,747,1273,8,11311,628,0,2,21,8,0
11981,24,810,74,35,59,1,0,14,75,3,14,7,14,17,21,58,85,1,128,7,0,2,13,3,0
11982,24,810,245,125,200,5,7,34,250,7,30,17,34,37,51,166,265,3,1053,58,0,2,13,3,0
11983,67,1914,1523,757,1297,19,12,193,1542,12,193,117,230,205,347,1508,2664,7,19053,1058,0,2,213,148,0
11984,67,1914,701,378,504,33,58,109,734,13,110,68,126,123,194,794,1346,7,10027,557,0,2,213,148,0
11985,172,3983,77,34,69,0,0,8,77,3,24,16,29,27,45,114,213,1,387,21,0,2,0,6,0
11986,172,3983,712,438,573,51,9,84,763,14,102,71,128,116,199,733,1364,8,11988,666,0,2,0,6,0
11987,17,510,184,100,137,2,15,30,186,6,38,20,39,44,59,214,322,3,991,55,0,2,9,5,0
11988,17,510,103,65,74,8,5,16,111,7,17,9,17,24,26,89,119,3,417,23,0,2,9,5,0
11989,513,10975,72,33,56,0,4,12,72,1,1,1,1,2,2,0,2,0,1,0,0,2,67,14,0
11990,513,10975,1454,835,1044,76,110,219,1530,17,275,158,296,292,454,2297,3718,9,34017,1889,1,2,67,14,0
11991,41,944,386,256,301,16,9,68,402,4,59,35,69,63,104,355,621,2,1453,80,0,2,29,8,0
11992,41,944,264,131,164,11,41,46,275,6,38,22,40,44,62,214,338,3,1068,59,0,2,29,8,0
11993,116,2530,1043,504,840,53,9,147,1096,9,180,112,198,189,310,1377,2344,4,11604,644,0,2,1,1,0
11994,116,2530,383,288,292,26,6,62,409,11,65,38,67,76,105,429,656,5,3719,206,0,2,1,1,0
11995,181,3706,1943,715,1694,26,18,214,1969,12,185,120,237,197,357,1436,2721,7,20915,1161,0,2,7,2,0
11996,181,3706,1168,838,957,57,25,144,1225,19,348,224,416,367,640,3018,5452,11,61921,3440,1,2,7,2,0
11997,53,1075,1098,241,925,5,10,155,1103,7,46,25,49,53,74,273,423,3,1580,87,0,2,14,0,0
11998,53,1075,282,202,222,14,2,44,296,8,42,24,43,50,67,250,378,4,1548,86,0,2,14,0,0
11999,76,3610,1338,495,1086,10,64,173,1348,11,122,82,157,133,239,883,1686,7,11934,663,0,2,121,0,0
12000,32,933,465,148,393,5,8,60,470,4,31,20,31,35,51,161,261,2,523,29,0,2,29,0,0
12001,32,933,16,12,9,0,0,6,16,1,2,1,2,3,3,2,4,0,2,0,0,2,29,0,0
12002,81,4395,1782,648,1425,9,47,279,1791,8,171,97,189,179,286,1292,2140,4,9462,525,0,2,36,0,0
12003,44,1867,1455,414,1257,16,76,112,1471,5,41,23,46,46,69,231,381,2,1069,59,0,2,120,33,0
12004,64,3043,1523,757,1297,19,12,193,1542,12,193,117,230,205,347,1508,2664,7,19053,1058,0,2,239,147,0
12005,12,475,184,100,137,2,15,30,186,6,38,20,39,44,59,214,322,3,991,55,0,2,37,9,0
12006,29,1184,386,256,301,16,9,68,402,4,59,35,69,63,104,355,621,2,1453,80,0,2,45,25,0
12007,68,3495,1943,715,1694,26,18,214,1969,12,185,120,237,197,357,1436,2721,7,20915,1161,0,2,2,2,0
12008,14,811,442,244,305,14,16,103,456,11,68,45,75,79,120,452,756,6,4588,254,0,2,12,11,0
12009,38,1508,1098,241,925,5,10,155,1103,7,46,25,49,53,74,273,423,3,1580,87,0,2,16,0,0
12010,41,947,386,256,301,16,9,68,402,4,59,35,69,63,104,355,621,2,1453,80,0,2,1,1,0
12011,41,947,264,131,164,11,41,46,275,6,38,22,40,44,62,214,338,3,1068,59,0,2,1,1,0
12012,29,1196,386,256,301,16,9,68,402,4,59,35,69,63,104,355,621,2,1453,80,0,2,5,4,0
12013,77,3648,1338,495,1086,10,64,173,1348,11,122,82,157,133,239,883,1686,7,11934,663,0,2,16,0,1
12014,77,3648,1338,495,1086,10,64,173,1348,11,122,82,157,133,239,883,1686,7,11934,663,0,2,1,1,0
12015,147,4720,1660,832,1314,41,38,274,1701,20,312,209,395,332,604,2671,5058,12,64042,3557,1,2,1,1,0
12016,147,4720,1057,646,719,113,100,145,1170,18,215,134,248,233,382,1740,3004,10,31186,1732,1,2,1,1,0
12017,57,1219,996,429,845,24,10,117,1020,7,76,50,88,83,138,494,879,4,3565,198,0,2,2,2,0
12018,57,1219,456,277,329,12,42,72,468,13,85,50,97,98,147,592,972,7,7212,400,0,2,2,2,0
12019,45,1334,1455,414,1257,16,76,112,1471,5,41,23,46,46,69,231,381,2,1069,59,0,2,21,8,0
12020,45,1334,669,365,481,22,61,110,691,15,103,63,122,118,185,747,1273,8,11311,628,0,2,21,8,0
12021,24,810,74,35,59,1,0,14,75,3,14,7,14,17,21,58,85,1,128,7,0,2,13,3,0
12022,24,810,245,125,200,5,7,34,250,7,30,17,34,37,51,166,265,3,1053,58,0,2,13,3,0
12023,67,1914,1523,757,1297,19,12,193,1542,12,193,117,230,205,347,1508,2664,7,19053,1058,0,2,213,148,0
12024,67,1914,701,378,504,33,58,109,734,13,110,68,126,123,194,794,1346,7,10027,557,0,2,213,148,0
12025,172,3983,77,34,69,0,0,8,77,3,24,16,29,27,45,114,213,1,387,21,0,2,0,6,0
12026,172,3983,712,438,573,51,9,84,763,14,102,71,128,116,199,733,1364,8,11988,666,0,2,0,6,0
12027,17,510,184,100,137,2,15,30,186,6,38,20,39,44,59,214,322,3,991,55,0,2,9,5,0
12028,17,510,103,65,74,8,5,16,111,7,17,9,17,24,26,89,119,3,417,23,0,2,9,5,0
12029,513,10975,72,33,56,0,4,12,72,1,1,1,1,2,2,0,2,0,1,0,0,2,67,14,0
12030,513,10975,1454,835,1044,76,110,219,1530,17,275,158,296,292,454,2297,3718,9,34017,1889,1,2,67,14,0
12031,41,947,386,256,301,16,9,68,402,4,59,35,69,63,104,355,621,2,1453,80,0,2,29,8,0
12032,41,947,264,131,164,11,41,46,275,6,38,22,40,44,62,214,338,3,1068,59,0,2,29,8,0
12033,116,2530,1043,504,840,53,9,147,1096,9,180,112,198,189,310,1377,2344,4,11604,644,0,2,1,1,0
12034,116,2530,383,288,292,26,6,62,409,11,65,38,67,76,105,429,656,5,3719,206,0,2,1,1,0
12035,181,3706,1943,715,1694,26,18,214,1969,12,185,120,237,197,357,1436,2721,7,20915,1161,0,2,7,2,0
12036,181,3706,1168,838,957,57,25,144,1225,19,348,224,416,367,640,3018,5452,11,61921,3440,1,2,7,2,0
12037,53,1075,1098,241,925,5,10,155,1103,7,46,25,49,53,74,273,423,3,1580,87,0,2,14,0,0
12038,53,1075,282,202,222,14,2,44,296,8,42,24,43,50,67,250,378,4,1548,86,0,2,14,0,0
12039,76,3610,1338,495,1086,10,64,173,1348,11,122,82,157,133,239,883,1686,7,11934,663,0,2,121,0,0
12040,32,933,465,148,393,5,8,60,470,4,31,20,31,35,51,161,261,2,523,29,0,2,29,0,0
12041,32,933,16,12,9,0,0,6,16,1,2,1,2,3,3,2,4,0,2,0,0,2,29,0,0
12042,81,4395,1782,648,1425,9,47,279,1791,8,171,97,189,179,286,1292,2140,4,9462,525,0,2,36,0,0
12043,44,1867,1455,414,1257,16,76,112,1471,5,41,23,46,46,69,231,381,2,1069,59,0,2,120,33,0
12044,64,3043,1523,757,1297,19,12,193,1542,12,193,117,230,205,347,1508,2664,7,19053,1058,0,2,239,147,0
12045,12,475,184,100,137,2,15,30,186,6,38,20,39,44,59,214,322,3,991,55,0,2,37,9,0
12046,29,1196,386,256,301,16,9,68,402,4,59,35,69,63,104,355,621,2,1453,80,0,2,46,25,0
12047,68,3495,1943,715,1694,26,18,214,1969,12,185,120,237,197,357,1436,2721,7,20915,1161,0,2,2,2,0
12048,14,811,442,244,305,14,16,103,456,11,68,45,75,79,120,452,756,6,4588,254,0,2,12,11,0
12049,38,1508,1098,241,925,5,10,155,1103,7,46,25,49,53,74,273,423,3,1580,87,0,2,16,0,0
12050,77,3658,1338,495,1086,10,64,173,1348,11,122,82,157,133,239,883,1686,7,11934,663,0,2,1,0,0
12051,77,3658,1338,495,1086,10,64,173,1348,11,122,82,157,133,239,883,1686,7,11934,663,0,2,1,1,0
12052,77,3659,1338,495,1086,10,64,173,1348,11,122,82,157,133,239,883,1686,7,11934,663,0,2,6,0,0
12053,513,10978,72,33,56,0,4,12,72,1,1,1,1,2,2,0,2,0,1,0,0,2,1,1,0
12054,513,10978,1454,835,1044,76,110,219,1530,17,275,158,296,292,454,2297,3718,9,34017,1889,1,2,1,1,0
12055,77,3659,1338,495,1086,10,64,173,1348,11,122,82,157,133,239,883,1686,7,11934,663,0,2,23,0,0
12056,513,10978,72,33,56,0,4,12,72,1,1,1,1,2,2,0,2,0,1,0,0,2,1,1,0
12057,513,10978,1454,835,1044,76,110,219,1530,17,275,158,296,292,454,2297,3718,9,34017,1889,1,2,1,1,0
12058,77,3659,1338,495,1086,10,64,173,1348,11,122,82,157,133,239,883,1686,7,11934,663,0,2,23,0,0
12059,513,10978,72,33,56,0,4,12,72,1,1,1,1,2,2,0,2,0,1,0,0,2,1,1,0
12060,513,10978,1454,835,1044,76,110,219,1530,17,275,158,296,292,454,2297,3718,9,34017,1889,1,2,1,1,0
12061,77,3659,1338,495,1086,10,64,173,1348,11,122,82,157,133,239,883,1686,7,11934,663,0,2,23,0,0
12062,46,531,647,139,84,35,284,233,682,0,0,0,0,0,0,0,0,0,0,0,0,2,2,3,0
12063,46,531,647,139,84,35,284,233,682,0,0,0,0,0,0,0,0,0,0,0,0,2,2,3,0
12064,69,1963,1523,757,1297,19,12,193,1542,12,193,117,230,205,347,1508,2664,7,19053,1058,0,2,10,6,0
12065,69,1963,701,378,504,33,58,109,734,13,110,68,126,123,194,794,1346,7,10027,557,0,2,10,6,0
12066,65,3107,1523,757,1297,19,12,193,1542,12,193,117,230,205,347,1508,2664,7,19053,1058,0,2,41,4,0
12067,9,220,19,8,11,5,0,4,24,2,5,3,6,7,9,13,25,1,30,1,0,2,0,3,1
12068,9,220,102,59,69,5,3,24,107,6,22,15,28,28,43,113,206,3,789,43,0,2,0,3,1
12069,9,220,106,40,36,3,49,17,109,8,17,13,23,25,36,93,167,5,904,50,0,2,0,3,1
12070,69,2867,1289,550,1043,56,32,155,1345,10,167,93,185,177,278,1266,2075,5,11498,638,0,2,0,3,1
12071,23,594,102,59,69,5,3,24,107,6,22,15,28,28,43,113,206,3,789,43,0,2,0,4,1
12072,74,2661,1450,624,1228,12,26,181,1462,14,306,186,354,320,540,2580,4493,8,36391,2021,1,2,1,8,1
12073,63,2582,1020,354,843,12,15,144,1032,8,134,77,144,142,221,970,1580,4,6792,377,0,2,0,2,1
12074,21,647,424,94,331,4,0,89,428,1,5,5,5,6,10,11,25,0,12,0,0,2,0,1,1
12075,38,2201,334,251,279,10,4,40,344,5,127,74,143,132,217,899,1528,2,4303,239,0,2,0,6,1
12076,9,220,19,8,11,5,0,4,24,2,5,3,6,7,9,13,25,1,30,1,0,2,0,3,0
12077,9,220,102,59,69,5,3,24,107,6,22,15,28,28,43,113,206,3,789,43,0,2,0,3,0
12078,9,220,106,40,36,3,49,17,109,8,17,13,23,25,36,93,167,5,904,50,0,2,0,3,0
12079,69,2867,1289,550,1043,56,32,155,1345,10,167,93,185,177,278,1266,2075,5,11498,638,0,2,0,3,0
12080,23,594,102,59,69,5,3,24,107,6,22,15,28,28,43,113,206,3,789,43,0,2,0,4,0
12081,74,2661,1450,624,1228,12,26,181,1462,14,306,186,354,320,540,2580,4493,8,36391,2021,1,2,1,8,0
12082,63,2582,1020,354,843,12,15,144,1032,8,134,77,144,142,221,970,1580,4,6792,377,0,2,0,2,0
12083,21,647,424,94,331,4,0,89,428,1,5,5,5,6,10,11,25,0,12,0,0,2,0,1,0
12084,38,2201,334,251,279,10,4,40,344,5,127,74,143,132,217,899,1528,2,4303,239,0,2,0,6,0
12085,68,3173,1523,757,1297,19,12,193,1542,12,193,117,230,205,347,1508,2664,7,19053,1058,0,2,27,10,0
12086,68,3179,1523,757,1297,19,12,193,1542,12,193,117,230,205,347,1508,2664,7,19053,1058,0,2,3,0,0
12087,114,2289,1513,682,1277,25,13,200,1538,11,199,116,219,210,335,1557,2584,6,15641,868,0,2,8,0,0
12088,114,2289,819,519,539,24,98,155,843,15,96,57,106,111,163,690,1107,8,9171,509,0,2,8,0,0
12089,114,2287,1513,682,1277,25,13,200,1538,11,199,116,219,210,335,1557,2584,6,15641,868,0,2,26,8,1
12090,114,2287,819,519,539,24,98,155,843,15,96,57,106,111,163,690,1107,8,9171,509,0,2,26,8,1
12091,115,2299,1513,682,1277,25,13,200,1538,11,199,116,219,210,335,1557,2584,6,15641,868,0,2,5,3,1
12092,115,2299,819,519,539,24,98,155,843,15,96,57,106,111,163,690,1107,8,9171,509,0,2,5,3,1
12093,115,2299,1513,682,1277,25,13,200,1538,11,199,116,219,210,335,1557,2584,6,15641,868,0,2,1,1,0
12094,115,2299,819,519,539,24,98,155,843,15,96,57,106,111,163,690,1107,8,9171,509,0,2,1,1,0
12095,115,2299,1513,682,1277,25,13,200,1538,11,199,116,219,210,335,1557,2584,6,15641,868,0,2,28,0,0
12096,115,2299,819,519,539,24,98,155,843,15,96,57,106,111,163,690,1107,8,9171,509,0,2,28,0,0
12097,48,975,447,308,343,6,5,95,453,7,96,59,111,103,170,651,1136,4,4600,255,0,2,21,1,1
12098,48,975,322,174,179,16,74,51,338,10,41,26,46,51,72,252,408,5,2291,127,0,2,21,1,1
12099,36,1591,447,308,343,6,5,95,453,7,96,59,111,103,170,651,1136,4,4600,255,0,2,17,0,1
12100,48,975,447,308,343,6,5,95,453,7,96,59,111,103,170,651,1136,4,4600,255,0,2,21,1,0
12101,48,975,322,174,179,16,74,51,338,10,41,26,46,51,72,252,408,5,2291,127,0,2,21,1,0
12102,36,1591,447,308,343,6,5,95,453,7,96,59,111,103,170,651,1136,4,4600,255,0,2,17,0,0
12103,49,1414,1455,414,1257,16,76,112,1471,5,41,23,46,46,69,231,381,2,1069,59,0,2,39,21,1
12104,49,1414,669,365,481,22,61,110,691,15,103,63,122,118,185,747,1273,8,11311,628,0,2,39,21,1
12105,47,2014,1455,414,1257,16,76,112,1471,5,41,23,46,46,69,231,381,2,1069,59,0,2,46,1,1
12106,48,973,447,308,343,6,5,95,453,7,96,59,111,103,170,651,1136,4,4600,255,0,2,6,7,1
12107,48,973,322,174,179,16,74,51,338,10,41,26,46,51,72,252,408,5,2291,127,0,2,6,7,1
12108,48,1368,1455,414,1257,16,76,112,1471,5,41,23,46,46,69,231,381,2,1069,59,0,2,12,3,0
12109,48,1368,669,365,481,22,61,110,691,15,103,63,122,118,185,747,1273,8,11311,628,0,2,12,3,0
12110,49,1371,1455,414,1257,16,76,112,1471,5,41,23,46,46,69,231,381,2,1069,59,0,2,2,2,1
12111,49,1371,669,365,481,22,61,110,691,15,103,63,122,118,185,747,1273,8,11311,628,0,2,2,2,1
12112,46,1984,1455,414,1257,16,76,112,1471,5,41,23,46,46,69,231,381,2,1069,59,0,2,32,2,1
12113,49,1371,1455,414,1257,16,76,112,1471,5,41,23,46,46,69,231,381,2,1069,59,0,2,12,3,0
12114,49,1371,669,365,481,22,61,110,691,15,103,63,122,118,185,747,1273,8,11311,628,0,2,12,3,0
12115,46,1984,1455,414,1257,16,76,112,1471,5,41,23,46,46,69,231,381,2,1069,59,0,2,32,2,0
12116,48,973,447,308,343,6,5,95,453,7,96,59,111,103,170,651,1136,4,4600,255,0,2,6,7,0
12117,48,973,322,174,179,16,74,51,338,10,41,26,46,51,72,252,408,5,2291,127,0,2,6,7,0
12118,53,1451,1455,414,1257,16,76,112,1471,5,41,23,46,46,69,231,381,2,1069,59,0,2,39,21,0
12119,53,1451,669,365,481,22,61,110,691,15,103,63,122,118,185,747,1273,8,11311,628,0,2,39,21,0
12120,49,2131,1455,414,1257,16,76,112,1471,5,41,23,46,46,69,231,381,2,1069,59,0,2,45,0,0
12121,115,2299,1513,682,1277,25,13,200,1538,11,199,116,219,210,335,1557,2584,6,15641,868,0,2,28,0,0
12122,115,2299,819,519,539,24,98,155,843,15,96,57,106,111,163,690,1107,8,9171,509,0,2,28,0,0
12123,46,532,647,139,84,35,284,233,682,0,0,0,0,0,0,0,0,0,0,0,0,2,2,3,0
12124,69,1963,1523,757,1297,19,12,193,1542,12,193,117,230,205,347,1508,2664,7,19053,1058,0,2,10,6,0
12125,69,1963,701,378,504,33,58,109,734,13,110,68,126,123,194,794,1346,7,10027,557,0,2,10,6,0
12126,48,973,447,308,343,6,5,95,453,7,96,59,111,103,170,651,1136,4,4600,255,0,2,27,8,0
12127,48,973,322,174,179,16,74,51,338,10,41,26,46,51,72,252,408,5,2291,127,0,2,27,8,0
12128,68,3179,1523,757,1297,19,12,193,1542,12,193,117,230,205,347,1508,2664,7,19053,1058,0,2,63,6,0
12129,36,1591,447,308,343,6,5,95,453,7,96,59,111,103,170,651,1136,4,4600,255,0,2,17,0,0
12130,176,3627,1943,715,1694,26,18,214,1969,12,185,120,237,197,357,1436,2721,7,20915,1161,0,2,1,1,1
12131,176,3627,1168,838,957,57,25,144,1225,19,348,224,416,367,640,3018,5452,11,61921,3440,1,2,1,1,1
12132,66,3398,1943,715,1694,26,18,214,1969,12,185,120,237,197,357,1436,2721,7,20915,1161,0,2,17,0,1
12133,176,3627,1943,715,1694,26,18,214,1969,12,185,120,237,197,357,1436,2721,7,20915,1161,0,2,1,1,0
12134,176,3627,1168,838,957,57,25,144,1225,19,348,224,416,367,640,3018,5452,11,61921,3440,1,2,1,1,0
12135,66,3398,1943,715,1694,26,18,214,1969,12,185,120,237,197,357,1436,2721,7,20915,1161,0,2,17,0,0
12136,181,3706,1943,715,1694,26,18,214,1969,12,185,120,237,197,357,1436,2721,7,20915,1161,0,2,1,2,0
12137,181,3706,1168,838,957,57,25,144,1225,19,348,224,416,367,640,3018,5452,11,61921,3440,1,2,1,2,0
12138,69,3529,1943,715,1694,26,18,214,1969,12,185,120,237,197,357,1436,2721,7,20915,1161,0,2,17,0,0
12139,45,1324,1455,414,1257,16,76,112,1471,5,41,23,46,46,69,231,381,2,1069,59,0,2,7,7,1
12140,45,1324,669,365,481,22,61,110,691,15,103,63,122,118,185,747,1273,8,11311,628,0,2,7,7,1
12141,46,1976,1455,414,1257,16,76,112,1471,5,41,23,46,46,69,231,381,2,1069,59,0,2,59,1,1
12142,21,592,1293,570,1093,25,15,163,1318,10,195,123,241,205,364,1516,2795,6,17273,959,0,2,3,1,1
12143,34,1287,1293,570,1093,25,15,163,1318,10,195,123,241,205,364,1516,2795,6,17273,959,0,2,16,0,1
12144,21,592,1293,570,1093,25,15,163,1318,10,195,123,241,205,364,1516,2795,6,17273,959,0,2,3,1,0
12145,34,1287,1293,570,1093,25,15,163,1318,10,195,123,241,205,364,1516,2795,6,17273,959,0,2,16,0,0
12146,45,1324,1455,414,1257,16,76,112,1471,5,41,23,46,46,69,231,381,2,1069,59,0,2,7,7,0
12147,45,1324,669,365,481,22,61,110,691,15,103,63,122,118,185,747,1273,8,11311,628,0,2,7,7,0
12148,46,1976,1455,414,1257,16,76,112,1471,5,41,23,46,46,69,231,381,2,1069,59,0,2,59,1,0
12149,36,711,2,2,2,0,0,0,2,0,0,0,0,0,0,0,0,0,0,0,0,2,11,2,1
12150,36,711,99,48,90,1,3,5,100,0,0,0,0,0,0,0,0,0,0,0,0,2,11,2,1
12151,36,711,8,5,5,2,0,1,10,0,0,0,0,0,0,0,0,0,0,0,0,2,11,2,1
12152,36,711,1217,716,841,84,126,174,1301,14,185,118,215,199,333,1446,2542,8,20687,1149,0,2,11,2,1
12153,36,711,160,89,115,0,13,31,160,7,15,11,17,22,28,78,124,3,495,27,0,2,11,2,1
12154,36,711,10,10,9,9,0,0,19,0,0,0,0,0,0,0,0,0,0,0,0,2,11,2,1
12155,36,711,173,84,99,8,29,36,181,5,12,7,13,17,20,54,81,2,221,12,0,2,11,2,1
12156,36,711,3,1,1,3,0,0,6,0,0,0,0,0,0,0,0,0,0,0,0,2,11,2,1
12157,74,2699,1450,624,1228,12,26,181,1462,14,306,186,354,320,540,2580,4493,8,36391,2021,1,2,8,1,1
12158,36,711,2,2,2,0,0,0,2,0,0,0,0,0,0,0,0,0,0,0,0,2,11,2,0
12159,36,711,99,48,90,1,3,5,100,0,0,0,0,0,0,0,0,0,0,0,0,2,11,2,0
12160,36,711,8,5,5,2,0,1,10,0,0,0,0,0,0,0,0,0,0,0,0,2,11,2,0
12161,36,711,1217,716,841,84,126,174,1301,14,185,118,215,199,333,1446,2542,8,20687,1149,0,2,11,2,0
12162,36,711,160,89,115,0,13,31,160,7,15,11,17,22,28,78,124,3,495,27,0,2,11,2,0
12163,36,711,10,10,9,9,0,0,19,0,0,0,0,0,0,0,0,0,0,0,0,2,11,2,0
12164,36,711,173,84,99,8,29,36,181,5,12,7,13,17,20,54,81,2,221,12,0,2,11,2,0
12165,36,711,3,1,1,3,0,0,6,0,0,0,0,0,0,0,0,0,0,0,0,2,11,2,0
12166,74,2699,1450,624,1228,12,26,181,1462,14,306,186,354,320,540,2580,4493,8,36391,2021,1,2,8,1,0
12167,33,678,2,2,2,0,0,0,2,0,0,0,0,0,0,0,0,0,0,0,0,2,2,2,1
12168,33,678,99,48,90,1,3,5,100,0,0,0,0,0,0,0,0,0,0,0,0,2,2,2,1
12169,33,678,8,5,5,2,0,1,10,0,0,0,0,0,0,0,0,0,0,0,0,2,2,2,1
12170,33,678,1217,716,841,84,126,174,1301,14,185,118,215,199,333,1446,2542,8,20687,1149,0,2,2,2,1
12171,33,678,160,89,115,0,13,31,160,7,15,11,17,22,28,78,124,3,495,27,0,2,2,2,1
12172,33,678,10,10,9,9,0,0,19,0,0,0,0,0,0,0,0,0,0,0,0,2,2,2,1
12173,33,678,173,84,99,8,29,36,181,5,12,7,13,17,20,54,81,2,221,12,0,2,2,2,1
12174,33,678,3,1,1,3,0,0,6,0,0,0,0,0,0,0,0,0,0,0,0,2,2,2,1
12175,90,1940,477,336,357,30,23,73,507,16,194,134,250,210,384,1538,2962,10,30538,1696,0,2,3,4,1
12176,513,10978,72,33,56,0,4,12,72,1,1,1,1,2,2,0,2,0,1,0,0,2,6,4,1
12177,513,10978,1454,835,1044,76,110,219,1530,17,275,158,296,292,454,2297,3718,9,34017,1889,1,2,6,4,1
12178,53,1075,1098,241,925,5,10,155,1103,7,46,25,49,53,74,273,423,3,1580,87,0,2,4,3,1
12179,53,1075,282,202,222,14,2,44,296,8,42,24,43,50,67,250,378,4,1548,86,0,2,4,3,1
12180,33,678,2,2,2,0,0,0,2,0,0,0,0,0,0,0,0,0,0,0,0,2,2,2,0
12181,33,678,99,48,90,1,3,5,100,0,0,0,0,0,0,0,0,0,0,0,0,2,2,2,0
12182,33,678,8,5,5,2,0,1,10,0,0,0,0,0,0,0,0,0,0,0,0,2,2,2,0
12183,33,678,1217,716,841,84,126,174,1301,14,185,118,215,199,333,1446,2542,8,20687,1149,0,2,2,2,0
12184,33,678,160,89,115,0,13,31,160,7,15,11,17,22,28,78,124,3,495,27,0,2,2,2,0
12185,33,678,10,10,9,9,0,0,19,0,0,0,0,0,0,0,0,0,0,0,0,2,2,2,0
12186,33,678,173,84,99,8,29,36,181,5,12,7,13,17,20,54,81,2,221,12,0,2,2,2,0
12187,33,678,3,1,1,3,0,0,6,0,0,0,0,0,0,0,0,0,0,0,0,2,2,2,0
12188,90,1940,477,336,357,30,23,73,507,16,194,134,250,210,384,1538,2962,10,30538,1696,0,2,3,4,0
12189,513,10978,72,33,56,0,4,12,72,1,1,1,1,2,2,0,2,0,1,0,0,2,6,4,0
12190,513,10978,1454,835,1044,76,110,219,1530,17,275,158,296,292,454,2297,3718,9,34017,1889,1,2,6,4,0
12191,53,1075,1098,241,925,5,10,155,1103,7,46,25,49,53,74,273,423,3,1580,87,0,2,4,3,0
12192,53,1075,282,202,222,14,2,44,296,8,42,24,43,50,67,250,378,4,1548,86,0,2,4,3,0
12193,69,1969,1523,757,1297,19,12,193,1542,12,193,117,230,205,347,1508,2664,7,19053,1058,0,2,1,0,1
12194,69,1969,701,378,504,33,58,109,734,13,110,68,126,123,194,794,1346,7,10027,557,0,2,1,0,1
12195,70,3287,1523,757,1297,19,12,193,1542,12,193,117,230,205,347,1508,2664,7,19053,1058,0,2,29,0,1
12196,69,1969,1523,757,1297,19,12,193,1542,12,193,117,230,205,347,1508,2664,7,19053,1058,0,2,1,0,0
12197,69,1969,701,378,504,33,58,109,734,13,110,68,126,123,194,794,1346,7,10027,557,0,2,1,0,0
12198,70,3287,1523,757,1297,19,12,193,1542,12,193,117,230,205,347,1508,2664,7,19053,1058,0,2,29,0,0
12199,36,711,2,2,2,0,0,0,2,0,0,0,0,0,0,0,0,0,0,0,0,2,3,3,1
12200,36,711,99,48,90,1,3,5,100,0,0,0,0,0,0,0,0,0,0,0,0,2,3,3,1
12201,36,711,8,5,5,2,0,1,10,0,0,0,0,0,0,0,0,0,0,0,0,2,3,3,1
12202,36,711,1217,716,841,84,126,174,1301,14,185,118,215,199,333,1446,2542,8,20687,1149,0,2,3,3,1
12203,36,711,160,89,115,0,13,31,160,7,15,11,17,22,28,78,124,3,495,27,0,2,3,3,1
12204,36,711,10,10,9,9,0,0,19,0,0,0,0,0,0,0,0,0,0,0,0,2,3,3,1
12205,36,711,173,84,99,8,29,36,181,5,12,7,13,17,20,54,81,2,221,12,0,2,3,3,1
12206,36,711,3,1,1,3,0,0,6,0,0,0,0,0,0,0,0,0,0,0,0,2,3,3,1
12207,90,1940,477,336,357,30,23,73,507,16,194,134,250,210,384,1538,2962,10,30538,1696,0,2,3,4,1
12208,53,1441,1455,414,1257,16,76,112,1471,5,41,23,46,46,69,231,381,2,1069,59,0,2,7,7,1
12209,53,1441,669,365,481,22,61,110,691,15,103,63,122,118,185,747,1273,8,11311,628,0,2,7,7,1
12210,69,1969,1523,757,1297,19,12,193,1542,12,193,117,230,205,347,1508,2664,7,19053,1058,0,2,1,0,1
12211,69,1969,701,378,504,33,58,109,734,13,110,68,126,123,194,794,1346,7,10027,557,0,2,1,0,1
12212,21,594,1293,570,1093,25,15,163,1318,10,195,123,241,205,364,1516,2795,6,17273,959,0,2,3,1,1
12213,513,10978,72,33,56,0,4,12,72,1,1,1,1,2,2,0,2,0,1,0,0,2,6,4,1
12214,513,10978,1454,835,1044,76,110,219,1530,17,275,158,296,292,454,2297,3718,9,34017,1889,1,2,6,4,1
12215,53,1075,1098,241,925,5,10,155,1103,7,46,25,49,53,74,273,423,3,1580,87,0,2,4,3,1
12216,53,1075,282,202,222,14,2,44,296,8,42,24,43,50,67,250,378,4,1548,86,0,2,4,3,1
12217,51,2240,1455,414,1257,16,76,112,1471,5,41,23,46,46,69,231,381,2,1069,59,0,2,58,0,1
12218,70,3287,1523,757,1297,19,12,193,1542,12,193,117,230,205,347,1508,2664,7,19053,1058,0,2,29,0,1
12219,34,1287,1293,570,1093,25,15,163,1318,10,195,123,241,205,364,1516,2795,6,17273,959,0,2,16,0,1
12220,36,711,2,2,2,0,0,0,2,0,0,0,0,0,0,0,0,0,0,0,0,2,3,3,0
12221,36,711,99,48,90,1,3,5,100,0,0,0,0,0,0,0,0,0,0,0,0,2,3,3,0
12222,36,711,8,5,5,2,0,1,10,0,0,0,0,0,0,0,0,0,0,0,0,2,3,3,0
12223,36,711,1217,716,841,84,126,174,1301,14,185,118,215,199,333,1446,2542,8,20687,1149,0,2,3,3,0
12224,36,711,160,89,115,0,13,31,160,7,15,11,17,22,28,78,124,3,495,27,0,2,3,3,0
12225,36,711,10,10,9,9,0,0,19,0,0,0,0,0,0,0,0,0,0,0,0,2,3,3,0
12226,36,711,173,84,99,8,29,36,181,5,12,7,13,17,20,54,81,2,221,12,0,2,3,3,0
12227,36,711,3,1,1,3,0,0,6,0,0,0,0,0,0,0,0,0,0,0,0,2,3,3,0
12228,90,1940,477,336,357,30,23,73,507,16,194,134,250,210,384,1538,2962,10,30538,1696,0,2,3,4,0
12229,53,1441,1455,414,1257,16,76,112,1471,5,41,23,46,46,69,231,381,2,1069,59,0,2,7,7,0
12230,53,1441,669,365,481,22,61,110,691,15,103,63,122,118,185,747,1273,8,11311,628,0,2,7,7,0
12231,69,1969,1523,757,1297,19,12,193,1542,12,193,117,230,205,347,1508,2664,7,19053,1058,0,2,1,0,0
12232,69,1969,701,378,504,33,58,109,734,13,110,68,126,123,194,794,1346,7,10027,557,0,2,1,0,0
12233,21,594,1293,570,1093,25,15,163,1318,10,195,123,241,205,364,1516,2795,6,17273,959,0,2,3,1,0
12234,513,10978,72,33,56,0,4,12,72,1,1,1,1,2,2,0,2,0,1,0,0,2,6,4,0
12235,513,10978,1454,835,1044,76,110,219,1530,17,275,158,296,292,454,2297,3718,9,34017,1889,1,2,6,4,0
12236,53,1075,1098,241,925,5,10,155,1103,7,46,25,49,53,74,273,423,3,1580,87,0,2,4,3,0
12237,53,1075,282,202,222,14,2,44,296,8,42,24,43,50,67,250,378,4,1548,86,0,2,4,3,0
12238,51,2240,1455,414,1257,16,76,112,1471,5,41,23,46,46,69,231,381,2,1069,59,0,2,58,0,0
12239,70,3287,1523,757,1297,19,12,193,1542,12,193,117,230,205,347,1508,2664,7,19053,1058,0,2,29,0,0
12240,34,1287,1293,570,1093,25,15,163,1318,10,195,123,241,205,364,1516,2795,6,17273,959,0,2,16,0,0
12241,48,973,447,308,343,6,5,95,453,7,96,59,111,103,170,651,1136,4,4600,255,0,2,7,7,0
12242,48,973,322,174,179,16,74,51,338,10,41,26,46,51,72,252,408,5,2291,127,0,2,7,7,0
12243,36,1591,447,308,343,6,5,95,453,7,96,59,111,103,170,651,1136,4,4600,255,0,2,27,5,0
12244,45,912,447,308,343,6,5,95,453,7,96,59,111,103,170,651,1136,4,4600,255,0,2,37,40,1
12245,45,912,322,174,179,16,74,51,338,10,41,26,46,51,72,252,408,5,2291,127,0,2,37,40,1
12246,38,1622,447,308,343,6,5,95,453,7,96,59,111,103,170,651,1136,4,4600,255,0,2,8,0,1
12247,46,940,447,308,343,6,5,95,453,7,96,59,111,103,170,651,1136,4,4600,255,0,2,15,9,1
12248,46,940,322,174,179,16,74,51,338,10,41,26,46,51,72,252,408,5,2291,127,0,2,15,9,1
12249,38,1614,447,308,343,6,5,95,453,7,96,59,111,103,170,651,1136,4,4600,255,0,2,3,3,1
12250,46,938,447,308,343,6,5,95,453,7,96,59,111,103,170,651,1136,4,4600,255,0,2,0,1,0
12251,46,938,322,174,179,16,74,51,338,10,41,26,46,51,72,252,408,5,2291,127,0,2,0,1,0
12252,46,939,447,308,343,6,5,95,453,7,96,59,111,103,170,651,1136,4,4600,255,0,2,2,1,0
12253,46,939,322,174,179,16,74,51,338,10,41,26,46,51,72,252,408,5,2291,127,0,2,2,1,0
12254,46,943,447,308,343,6,5,95,453,7,96,59,111,103,170,651,1136,4,4600,255,0,2,17,12,0
12255,46,943,322,174,179,16,74,51,338,10,41,26,46,51,72,252,408,5,2291,127,0,2,17,12,0
12256,46,943,447,308,343,6,5,95,453,7,96,59,111,103,170,651,1136,4,4600,255,0,2,54,46,0
12257,46,943,322,174,179,16,74,51,338,10,41,26,46,51,72,252,408,5,2291,127,0,2,54,46,0
12258,38,1614,447,308,343,6,5,95,453,7,96,59,111,103,170,651,1136,4,4600,255,0,2,37,7,0
12259,19,527,1450,624,1228,12,26,181,1462,14,306,186,354,320,540,2580,4493,8,36391,2021,1,0,96,0,1
12260,199,4191,182,127,129,0,0,53,182,5,39,21,42,44,63,217,343,2,926,51,0,0,795,0,1
12261,199,4191,1165,710,800,67,119,181,1232,18,243,153,282,261,435,2000,3492,10,36473,2026,1,0,795,0,1
12262,100,2140,773,419,590,28,0,166,801,10,204,113,217,214,330,1598,2554,5,13587,754,0,0,421,0,1
12263,100,2140,421,273,302,44,34,57,465,17,81,59,107,98,166,583,1098,11,12329,684,0,0,421,0,1
12264,90,1944,477,336,357,30,23,73,507,16,194,134,250,210,384,1538,2962,10,30538,1696,0,2,2,1,1
12265,298,6082,1457,730,1242,11,6,188,1468,10,292,166,329,302,495,2424,4078,5,22973,1276,1,2,3,2,1
12266,298,6082,74,35,59,1,0,14,75,3,14,7,14,17,21,58,85,1,128,7,0,2,3,2,1
12267,298,6082,245,125,200,5,7,34,250,7,30,17,34,37,51,166,265,3,1053,58,0,2,3,2,1
12268,53,1439,1455,414,1257,16,76,112,1471,5,41,23,46,46,69,231,381,2,1069,59,0,2,7,3,1
12269,53,1439,669,365,481,22,61,110,691,15,103,63,122,118,185,747,1273,8,11311,628,0,2,7,3,1
12270,172,3987,77,34,69,0,0,8,77,3,24,16,29,27,45,114,213,1,387,21,0,2,8,4,1
12271,172,3987,712,438,573,51,9,84,763,14,102,71,128,116,199,733,1364,8,11988,666,0,2,8,4,1
12272,219,4866,722,423,573,19,0,135,741,12,172,101,199,184,300,1320,2257,6,15668,870,0,2,12,11,1
12273,219,4866,1508,847,911,44,250,301,1552,14,148,88,169,162,257,1120,1886,7,15077,837,0,2,12,11,1
12274,513,10978,72,33,56,0,4,12,72,1,1,1,1,2,2,0,2,0,1,0,0,2,36,34,1
12275,513,10978,1454,835,1044,76,110,219,1530,17,275,158,296,292,454,2297,3718,9,34017,1889,1,2,36,34,1
12276,41,951,386,256,301,16,9,68,402,4,59,35,69,63,104,355,621,2,1453,80,0,2,3,1,1
12277,41,951,264,131,164,11,41,46,275,6,38,22,40,44,62,214,338,3,1068,59,0,2,3,1,1
12278,116,2524,1043,504,840,53,9,147,1096,9,180,112,198,189,310,1377,2344,4,11604,644,0,2,4,3,1
12279,116,2524,383,288,292,26,6,62,409,11,65,38,67,76,105,429,656,5,3719,206,0,2,4,3,1
12280,95,1756,1178,367,1042,6,15,115,1184,9,94,51,95,103,146,644,976,4,4439,246,0,2,2,3,1
12281,95,1756,177,108,140,8,0,27,185,6,30,16,32,36,48,162,248,3,794,44,0,2,2,3,1
12282,53,1077,1098,241,925,5,10,155,1103,7,46,25,49,53,74,273,423,3,1580,87,0,2,5,6,1
12283,53,1077,282,202,222,14,2,44,296,8,42,24,43,50,67,250,378,4,1548,86,0,2,5,6,1
12284,60,1074,282,196,195,3,0,86,285,8,130,71,141,138,212,936,1507,4,6538,363,0,2,2,1,1
12285,7,296,72,33,56,0,4,12,72,1,1,1,1,2,2,0,2,0,1,0,0,2,3,2,1
12286,20,619,42,7,35,4,0,5,46,1,2,1,2,3,3,2,4,0,2,0,0,2,1,1,1
12287,20,619,11,6,10,0,0,1,11,2,4,2,4,6,6,10,15,1,15,0,0,2,1,1,1
12288,69,2871,1289,550,1043,56,32,155,1345,10,167,93,185,177,278,1266,2075,5,11498,638,0,2,5,2,1
12289,33,992,182,127,129,0,0,53,182,5,39,21,42,44,63,217,343,2,926,51,0,0,163,0,1
12290,118,5254,1392,870,1177,35,17,170,1427,14,494,280,531,508,811,4473,7289,7,54850,3047,2,0,911,0,1
12291,92,2943,773,419,590,28,0,166,801,10,204,113,217,214,330,1598,2554,5,13587,754,0,0,657,0,1
12292,77,3663,1338,495,1086,10,64,173,1348,11,122,82,157,133,239,883,1686,7,11934,663,0,2,12,9,1
12293,140,6182,139,89,101,2,0,35,141,7,54,34,62,61,96,330,569,4,2287,127,0,2,18,14,1
12294,140,6182,7,5,5,0,0,2,7,1,2,1,2,3,3,2,4,0,2,0,0,2,18,14,1
12295,32,933,465,148,393,5,8,60,470,4,31,20,31,35,51,161,261,2,523,29,0,2,2,1,1
12296,32,933,16,12,9,0,0,6,16,1,2,1,2,3,3,2,4,0,2,0,0,2,2,1,1
12297,81,4399,1782,648,1425,9,47,279,1791,8,171,97,189,179,286,1292,2140,4,9462,525,0,2,5,3,1
12298,11,230,256,139,192,9,7,47,265,4,23,12,24,27,36,112,171,2,357,19,0,2,2,1,1
12299,74,2703,1450,624,1228,12,26,181,1462,14,306,186,354,320,540,2580,4493,8,36391,2021,1,2,4,2,1
12300,135,3522,1660,832,1314,41,38,274,1701,20,312,209,395,332,604,2671,5058,12,64042,3557,1,2,4,3,1
12301,112,4316,1513,682,1277,25,13,200,1538,11,199,116,219,210,335,1557,2584,6,15641,868,0,2,3,1,1
12302,55,2831,1457,730,1242,11,6,188,1468,10,292,166,329,302,495,2424,4078,5,22973,1276,1,2,5,4,1
12303,35,2156,652,304,544,16,6,88,668,6,89,51,101,95,152,591,998,3,3399,188,0,2,10,7,1
12304,51,2242,1455,414,1257,16,76,112,1471,5,41,23,46,46,69,231,381,2,1069,59,0,2,4,4,1
12305,34,1289,1293,570,1093,25,15,163,1318,10,195,123,241,205,364,1516,2795,6,17273,959,0,2,4,3,1
12306,16,1265,215,129,180,6,0,29,221,8,65,43,72,73,115,415,711,4,3153,175,0,2,7,3,1
12307,57,2321,1043,504,840,53,9,147,1096,9,180,112,198,189,310,1377,2344,4,11604,644,0,2,10,6,1
12308,69,3533,1943,715,1694,26,18,214,1969,12,185,120,237,197,357,1436,2721,7,20915,1161,0,2,8,6,1
12309,38,1508,1098,241,925,5,10,155,1103,7,46,25,49,53,74,273,423,3,1580,87,0,2,2,1,1
12310,199,4197,182,127,129,0,0,53,182,5,39,21,42,44,63,217,343,2,926,51,0,2,6,6,1
12311,199,4197,1165,710,800,67,119,181,1232,18,243,153,282,261,435,2000,3492,10,36473,2026,1,2,6,6,1
12312,92,2961,773,419,590,28,0,166,801,10,204,113,217,214,330,1598,2554,5,13587,754,0,2,2,0,0
12313,53,1437,1455,414,1257,16,76,112,1471,5,41,23,46,46,69,231,381,2,1069,59,0,2,0,1,0
12314,53,1437,669,365,481,22,61,110,691,15,103,63,122,118,185,747,1273,8,11311,628,0,2,0,1,0
12315,199,4197,182,127,129,0,0,53,182,5,39,21,42,44,63,217,343,2,926,51,0,0,795,0,0
12316,199,4197,1165,710,800,67,119,181,1232,18,243,153,282,261,435,2000,3492,10,36473,2026,1,0,795,0,0
12317,100,2140,773,419,590,28,0,166,801,10,204,113,217,214,330,1598,2554,5,13587,754,0,0,421,0,0
12318,100,2140,421,273,302,44,34,57,465,17,81,59,107,98,166,583,1098,11,12329,684,0,0,421,0,0
12319,90,1944,477,336,357,30,23,73,507,16,194,134,250,210,384,1538,2962,10,30538,1696,0,2,2,1,0
12320,298,6082,1457,730,1242,11,6,188,1468,10,292,166,329,302,495,2424,4078,5,22973,1276,1,2,3,2,0
12321,298,6082,74,35,59,1,0,14,75,3,14,7,14,17,21,58,85,1,128,7,0,2,3,2,0
12322,298,6082,245,125,200,5,7,34,250,7,30,17,34,37,51,166,265,3,1053,58,0,2,3,2,0
12323,53,1437,1455,414,1257,16,76,112,1471,5,41,23,46,46,69,231,381,2,1069,59,0,2,6,3,0
12324,53,1437,669,365,481,22,61,110,691,15,103,63,122,118,185,747,1273,8,11311,628,0,2,6,3,0
12325,172,3987,77,34,69,0,0,8,77,3,24,16,29,27,45,114,213,1,387,21,0,2,8,4,0
12326,172,3987,712,438,573,51,9,84,763,14,102,71,128,116,199,733,1364,8,11988,666,0,2,8,4,0
12327,219,4866,722,423,573,19,0,135,741,12,172,101,199,184,300,1320,2257,6,15668,870,0,2,12,11,0
12328,219,4866,1508,847,911,44,250,301,1552,14,148,88,169,162,257,1120,1886,7,15077,837,0,2,12,11,0
12329,513,10978,72,33,56,0,4,12,72,1,1,1,1,2,2,0,2,0,1,0,0,2,36,34,0
12330,513,10978,1454,835,1044,76,110,219,1530,17,275,158,296,292,454,2297,3718,9,34017,1889,1,2,36,34,0
12331,41,951,386,256,301,16,9,68,402,4,59,35,69,63,104,355,621,2,1453,80,0,2,3,1,0
12332,41,951,264,131,164,11,41,46,275,6,38,22,40,44,62,214,338,3,1068,59,0,2,3,1,0
12333,116,2524,1043,504,840,53,9,147,1096,9,180,112,198,189,310,1377,2344,4,11604,644,0,2,4,3,0
12334,116,2524,383,288,292,26,6,62,409,11,65,38,67,76,105,429,656,5,3719,206,0,2,4,3,0
12335,95,1756,1178,367,1042,6,15,115,1184,9,94,51,95,103,146,644,976,4,4439,246,0,2,2,3,0
12336,95,1756,177,108,140,8,0,27,185,6,30,16,32,36,48,162,248,3,794,44,0,2,2,3,0
12337,53,1077,1098,241,925,5,10,155,1103,7,46,25,49,53,74,273,423,3,1580,87,0,2,5,6,0
12338,53,1077,282,202,222,14,2,44,296,8,42,24,43,50,67,250,378,4,1548,86,0,2,5,6,0
12339,60,1074,282,196,195,3,0,86,285,8,130,71,141,138,212,936,1507,4,6538,363,0,2,2,1,0
12340,7,296,72,33,56,0,4,12,72,1,1,1,1,2,2,0,2,0,1,0,0,2,3,2,0
12341,20,619,42,7,35,4,0,5,46,1,2,1,2,3,3,2,4,0,2,0,0,2,1,1,0
12342,20,619,11,6,10,0,0,1,11,2,4,2,4,6,6,10,15,1,15,0,0,2,1,1,0
12343,69,2871,1289,550,1043,56,32,155,1345,10,167,93,185,177,278,1266,2075,5,11498,638,0,2,5,2,0
12344,33,992,182,127,129,0,0,53,182,5,39,21,42,44,63,217,343,2,926,51,0,0,163,0,0
12345,118,5254,1392,870,1177,35,17,170,1427,14,494,280,531,508,811,4473,7289,7,54850,3047,2,0,911,0,0
12346,92,2961,773,419,590,28,0,166,801,10,204,113,217,214,330,1598,2554,5,13587,754,0,0,659,0,0
12347,77,3663,1338,495,1086,10,64,173,1348,11,122,82,157,133,239,883,1686,7,11934,663,0,2,12,9,0
12348,140,6182,139,89,101,2,0,35,141,7,54,34,62,61,96,330,569,4,2287,127,0,2,18,14,0
12349,140,6182,7,5,5,0,0,2,7,1,2,1,2,3,3,2,4,0,2,0,0,2,18,14,0
12350,32,933,465,148,393,5,8,60,470,4,31,20,31,35,51,161,261,2,523,29,0,2,2,1,0
12351,32,933,16,12,9,0,0,6,16,1,2,1,2,3,3,2,4,0,2,0,0,2,2,1,0
12352,81,4399,1782,648,1425,9,47,279,1791,8,171,97,189,179,286,1292,2140,4,9462,525,0,2,5,3,0
12353,11,230,256,139,192,9,7,47,265,4,23,12,24,27,36,112,171,2,357,19,0,2,2,1,0
12354,74,2703,1450,624,1228,12,26,181,1462,14,306,186,354,320,540,2580,4493,8,36391,2021,1,2,4,2,0
12355,135,3522,1660,832,1314,41,38,274,1701,20,312,209,395,332,604,2671,5058,12,64042,3557,1,2,4,3,0
12356,112,4316,1513,682,1277,25,13,200,1538,11,199,116,219,210,335,1557,2584,6,15641,868,0,2,3,1,0
12357,55,2831,1457,730,1242,11,6,188,1468,10,292,166,329,302,495,2424,4078,5,22973,1276,1,2,5,4,0
12358,35,2156,652,304,544,16,6,88,668,6,89,51,101,95,152,591,998,3,3399,188,0,2,10,7,0
12359,51,2242,1455,414,1257,16,76,112,1471,5,41,23,46,46,69,231,381,2,1069,59,0,2,4,4,0
12360,34,1289,1293,570,1093,25,15,163,1318,10,195,123,241,205,364,1516,2795,6,17273,959,0,2,4,3,0
12361,16,1265,215,129,180,6,0,29,221,8,65,43,72,73,115,415,711,4,3153,175,0,2,7,3,0
12362,57,2321,1043,504,840,53,9,147,1096,9,180,112,198,189,310,1377,2344,4,11604,644,0,2,10,6,0
12363,69,3533,1943,715,1694,26,18,214,1969,12,185,120,237,197,357,1436,2721,7,20915,1161,0,2,8,6,0
12364,38,1508,1098,241,925,5,10,155,1103,7,46,25,49,53,74,273,423,3,1580,87,0,2,2,1,0
12365,57,1223,996,429,845,24,10,117,1020,7,76,50,88,83,138,494,879,4,3565,198,0,2,2,2,0
12366,57,1223,456,277,329,12,42,72,468,13,85,50,97,98,147,592,972,7,7212,400,0,2,2,2,0
12367,57,1223,996,429,845,24,10,117,1020,7,76,50,88,83,138,494,879,4,3565,198,0,2,2,2,0
12368,57,1223,456,277,329,12,42,72,468,13,85,50,97,98,147,592,972,7,7212,400,0,2,2,2,0
12369,513,10983,72,33,56,0,4,12,72,1,1,1,1,2,2,0,2,0,1,0,0,2,1,2,0
12370,513,10983,1454,835,1044,76,110,219,1530,17,275,158,296,292,454,2297,3718,9,34017,1889,1,2,1,2,0
12371,13,271,256,139,192,9,7,47,265,4,23,12,24,27,36,112,171,2,357,19,0,2,6,0,0
12372,513,10983,72,33,56,0,4,12,72,1,1,1,1,2,2,0,2,0,1,0,0,2,1,2,0
12373,513,10983,1454,835,1044,76,110,219,1530,17,275,158,296,292,454,2297,3718,9,34017,1889,1,2,1,2,0
12374,13,271,256,139,192,9,7,47,265,4,23,12,24,27,36,112,171,2,357,19,0,2,6,0,0
12375,46,943,447,308,343,6,5,95,453,7,96,59,111,103,170,651,1136,4,4600,255,0,2,54,46,0
12376,46,943,322,174,179,16,74,51,338,10,41,26,46,51,72,252,408,5,2291,127,0,2,54,46,0
12377,38,1614,447,308,343,6,5,95,453,7,96,59,111,103,170,651,1136,4,4600,255,0,2,37,7,0
12378,147,4734,1660,832,1314,41,38,274,1701,20,312,209,395,332,604,2671,5058,12,64042,3557,1,2,5,0,1
12379,147,4734,1057,646,719,113,100,145,1170,18,215,134,248,233,382,1740,3004,10,31186,1732,1,2,5,0,1
12380,136,3553,1660,832,1314,41,38,274,1701,20,312,209,395,332,604,2671,5058,12,64042,3557,1,2,13,0,1
12381,9,220,19,8,11,5,0,4,24,2,5,3,6,7,9,13,25,1,30,1,0,2,0,3,0
12382,9,220,102,59,69,5,3,24,107,6,22,15,28,28,43,113,206,3,789,43,0,2,0,3,0
12383,9,220,106,40,36,3,49,17,109,8,17,13,23,25,36,93,167,5,904,50,0,2,0,3,0
12384,199,4197,182,127,129,0,0,53,182,5,39,21,42,44,63,217,343,2,926,51,0,0,795,0,0
12385,199,4197,1165,710,800,67,119,181,1232,18,243,153,282,261,435,2000,3492,10,36473,2026,1,0,795,0,0
12386,100,2140,773,419,590,28,0,166,801,10,204,113,217,214,330,1598,2554,5,13587,754,0,0,421,0,0
12387,100,2140,421,273,302,44,34,57,465,17,81,59,107,98,166,583,1098,11,12329,684,0,0,421,0,0
12388,36,711,2,2,2,0,0,0,2,0,0,0,0,0,0,0,0,0,0,0,0,2,11,2,0
12389,36,711,99,48,90,1,3,5,100,0,0,0,0,0,0,0,0,0,0,0,0,2,11,2,0
12390,36,711,8,5,5,2,0,1,10,0,0,0,0,0,0,0,0,0,0,0,0,2,11,2,0
12391,36,711,1217,716,841,84,126,174,1301,14,185,118,215,199,333,1446,2542,8,20687,1149,0,2,11,2,0
12392,36,711,160,89,115,0,13,31,160,7,15,11,17,22,28,78,124,3,495,27,0,2,11,2,0
12393,36,711,10,10,9,9,0,0,19,0,0,0,0,0,0,0,0,0,0,0,0,2,11,2,0
12394,36,711,173,84,99,8,29,36,181,5,12,7,13,17,20,54,81,2,221,12,0,2,11,2,0
12395,36,711,3,1,1,3,0,0,6,0,0,0,0,0,0,0,0,0,0,0,0,2,11,2,0
12396,90,1944,477,336,357,30,23,73,507,16,194,134,250,210,384,1538,2962,10,30538,1696,0,2,2,1,0
12397,57,1223,996,429,845,24,10,117,1020,7,76,50,88,83,138,494,879,4,3565,198,0,2,2,2,0
12398,57,1223,456,277,329,12,42,72,468,13,85,50,97,98,147,592,972,7,7212,400,0,2,2,2,0
12399,298,6082,1457,730,1242,11,6,188,1468,10,292,166,329,302,495,2424,4078,5,22973,1276,1,2,21,18,0
12400,298,6082,74,35,59,1,0,14,75,3,14,7,14,17,21,58,85,1,128,7,0,2,21,18,0
12401,298,6082,245,125,200,5,7,34,250,7,30,17,34,37,51,166,265,3,1053,58,0,2,21,18,0
12402,53,1437,1455,414,1257,16,76,112,1471,5,41,23,46,46,69,231,381,2,1069,59,0,2,57,27,0
12403,53,1437,669,365,481,22,61,110,691,15,103,63,122,118,185,747,1273,8,11311,628,0,2,57,27,0
12404,46,532,647,139,84,35,284,233,682,0,0,0,0,0,0,0,0,0,0,0,0,2,4,1,0
12405,172,3987,77,34,69,0,0,8,77,3,24,16,29,27,45,114,213,1,387,21,0,2,8,4,0
12406,172,3987,712,438,573,51,9,84,763,14,102,71,128,116,199,733,1364,8,11988,666,0,2,8,4,0
12407,21,594,1293,570,1093,25,15,163,1318,10,195,123,241,205,364,1516,2795,6,17273,959,0,2,1,2,0
12408,219,4866,722,423,573,19,0,135,741,12,172,101,199,184,300,1320,2257,6,15668,870,0,2,12,11,0
12409,219,4866,1508,847,911,44,250,301,1552,14,148,88,169,162,257,1120,1886,7,15077,837,0,2,12,11,0
12410,513,10983,72,33,56,0,4,12,72,1,1,1,1,2,2,0,2,0,1,0,0,2,37,36,0
12411,513,10983,1454,835,1044,76,110,219,1530,17,275,158,296,292,454,2297,3718,9,34017,1889,1,2,37,36,0
12412,41,951,386,256,301,16,9,68,402,4,59,35,69,63,104,355,621,2,1453,80,0,2,13,3,0
12413,41,951,264,131,164,11,41,46,275,6,38,22,40,44,62,214,338,3,1068,59,0,2,13,3,0
12414,116,2524,1043,504,840,53,9,147,1096,9,180,112,198,189,310,1377,2344,4,11604,644,0,2,9,4,0
12415,116,2524,383,288,292,26,6,62,409,11,65,38,67,76,105,429,656,5,3719,206,0,2,9,4,0
12416,95,1756,1178,367,1042,6,15,115,1184,9,94,51,95,103,146,644,976,4,4439,246,0,2,31,7,0
12417,95,1756,177,108,140,8,0,27,185,6,30,16,32,36,48,162,248,3,794,44,0,2,31,7,0
12418,181,3706,1943,715,1694,26,18,214,1969,12,185,120,237,197,357,1436,2721,7,20915,1161,0,2,15,1,0
12419,181,3706,1168,838,957,57,25,144,1225,19,348,224,416,367,640,3018,5452,11,61921,3440,1,2,15,1,0
12420,53,1077,1098,241,925,5,10,155,1103,7,46,25,49,53,74,273,423,3,1580,87,0,2,5,6,0
12421,53,1077,282,202,222,14,2,44,296,8,42,24,43,50,67,250,378,4,1548,86,0,2,5,6,0
12422,60,1074,282,196,195,3,0,86,285,8,130,71,141,138,212,936,1507,4,6538,363,0,2,2,1,0
12423,7,296,72,33,56,0,4,12,72,1,1,1,1,2,2,0,2,0,1,0,0,2,3,2,0
12424,20,619,42,7,35,4,0,5,46,1,2,1,2,3,3,2,4,0,2,0,0,2,1,1,0
12425,20,619,11,6,10,0,0,1,11,2,4,2,4,6,6,10,15,1,15,0,0,2,1,1,0
12426,69,2871,1289,550,1043,56,32,155,1345,10,167,93,185,177,278,1266,2075,5,11498,638,0,2,5,5,0
12427,33,992,182,127,129,0,0,53,182,5,39,21,42,44,63,217,343,2,926,51,0,0,163,0,0
12428,118,5254,1392,870,1177,35,17,170,1427,14,494,280,531,508,811,4473,7289,7,54850,3047,2,0,911,0,0
12429,92,2961,773,419,590,28,0,166,801,10,204,113,217,214,330,1598,2554,5,13587,754,0,0,659,0,0
12430,77,3663,1338,495,1086,10,64,173,1348,11,122,82,157,133,239,883,1686,7,11934,663,0,2,12,9,0
12431,140,6182,139,89,101,2,0,35,141,7,54,34,62,61,96,330,569,4,2287,127,0,2,18,14,0
12432,140,6182,7,5,5,0,0,2,7,1,2,1,2,3,3,2,4,0,2,0,0,2,18,14,0
12433,32,933,465,148,393,5,8,60,470,4,31,20,31,35,51,161,261,2,523,29,0,2,2,1,0
12434,32,933,16,12,9,0,0,6,16,1,2,1,2,3,3,2,4,0,2,0,0,2,2,1,0
12435,81,4399,1782,648,1425,9,47,279,1791,8,171,97,189,179,286,1292,2140,4,9462,525,0,2,5,3,0
12436,13,271,256,139,192,9,7,47,265,4,23,12,24,27,36,112,171,2,357,19,0,2,8,1,0
12437,23,594,102,59,69,5,3,24,107,6,22,15,28,28,43,113,206,3,789,43,0,2,0,4,0
12438,74,2703,1450,624,1228,12,26,181,1462,14,306,186,354,320,540,2580,4493,8,36391,2021,1,2,13,11,0
12439,135,3522,1660,832,1314,41,38,274,1701,20,312,209,395,332,604,2671,5058,12,64042,3557,1,2,4,3,0
12440,112,4316,1513,682,1277,25,13,200,1538,11,199,116,219,210,335,1557,2584,6,15641,868,0,2,3,2,0
12441,55,2831,1457,730,1242,11,6,188,1468,10,292,166,329,302,495,2424,4078,5,22973,1276,1,2,66,2,0
12442,35,2156,652,304,544,16,6,88,668,6,89,51,101,95,152,591,998,3,3399,188,0,2,10,7,0
12443,51,2242,1455,414,1257,16,76,112,1471,5,41,23,46,46,69,231,381,2,1069,59,0,2,80,5,0
12444,63,2582,1020,354,843,12,15,144,1032,8,134,77,144,142,221,970,1580,4,6792,377,0,2,0,2,0
12445,21,647,424,94,331,4,0,89,428,1,5,5,5,6,10,11,25,0,12,0,0,2,0,1,0
12446,38,2201,334,251,279,10,4,40,344,5,127,74,143,132,217,899,1528,2,4303,239,0,2,0,6,0
12447,34,1289,1293,570,1093,25,15,163,1318,10,195,123,241,205,364,1516,2795,6,17273,959,0,2,9,4,0
12448,29,1196,386,256,301,16,9,68,402,4,59,35,69,63,104,355,621,2,1453,80,0,2,10,0,0
12449,16,1265,215,129,180,6,0,29,221,8,65,43,72,73,115,415,711,4,3153,175,0,2,7,3,0
12450,57,2321,1043,504,840,53,9,147,1096,9,180,112,198,189,310,1377,2344,4,11604,644,0,2,10,6,0
12451,56,2421,1178,367,1042,6,15,115,1184,9,94,51,95,103,146,644,976,4,4439,246,0,2,85,0,0
12452,69,3533,1943,715,1694,26,18,214,1969,12,185,120,237,197,357,1436,2721,7,20915,1161,0,2,35,6,0
12453,38,1508,1098,241,925,5,10,155,1103,7,46,25,49,53,74,273,423,3,1580,87,0,2,2,1,0
12454,9,220,19,8,11,5,0,4,24,2,5,3,6,7,9,13,25,1,30,1,0,2,0,3,0
12455,9,220,102,59,69,5,3,24,107,6,22,15,28,28,43,113,206,3,789,43,0,2,0,3,0
12456,9,220,106,40,36,3,49,17,109,8,17,13,23,25,36,93,167,5,904,50,0,2,0,3,0
12457,199,4197,182,127,129,0,0,53,182,5,39,21,42,44,63,217,343,2,926,51,0,0,795,0,0
12458,199,4197,1165,710,800,67,119,181,1232,18,243,153,282,261,435,2000,3492,10,36473,2026,1,0,795,0,0
12459,100,2140,773,419,590,28,0,166,801,10,204,113,217,214,330,1598,2554,5,13587,754,0,0,421,0,0
12460,100,2140,421,273,302,44,34,57,465,17,81,59,107,98,166,583,1098,11,12329,684,0,0,421,0,0
12461,36,711,2,2,2,0,0,0,2,0,0,0,0,0,0,0,0,0,0,0,0,2,11,2,0
12462,36,711,99,48,90,1,3,5,100,0,0,0,0,0,0,0,0,0,0,0,0,2,11,2,0
12463,36,711,8,5,5,2,0,1,10,0,0,0,0,0,0,0,0,0,0,0,0,2,11,2,0
12464,36,711,1217,716,841,84,126,174,1301,14,185,118,215,199,333,1446,2542,8,20687,1149,0,2,11,2,0
12465,36,711,160,89,115,0,13,31,160,7,15,11,17,22,28,78,124,3,495,27,0,2,11,2,0
12466,36,711,10,10,9,9,0,0,19,0,0,0,0,0,0,0,0,0,0,0,0,2,11,2,0
12467,36,711,173,84,99,8,29,36,181,5,12,7,13,17,20,54,81,2,221,12,0,2,11,2,0
12468,36,711,3,1,1,3,0,0,6,0,0,0,0,0,0,0,0,0,0,0,0,2,11,2,0
12469,90,1944,477,336,357,30,23,73,507,16,194,134,250,210,384,1538,2962,10,30538,1696,0,2,2,1,0
12470,57,1223,996,429,845,24,10,117,1020,7,76,50,88,83,138,494,879,4,3565,198,0,2,2,2,0
12471,57,1223,456,277,329,12,42,72,468,13,85,50,97,98,147,592,972,7,7212,400,0,2,2,2,0
12472,298,6082,1457,730,1242,11,6,188,1468,10,292,166,329,302,495,2424,4078,5,22973,1276,1,2,21,18,0
12473,298,6082,74,35,59,1,0,14,75,3,14,7,14,17,21,58,85,1,128,7,0,2,21,18,0
12474,298,6082,245,125,200,5,7,34,250,7,30,17,34,37,51,166,265,3,1053,58,0,2,21,18,0
12475,53,1437,1455,414,1257,16,76,112,1471,5,41,23,46,46,69,231,381,2,1069,59,0,2,57,27,0
12476,53,1437,669,365,481,22,61,110,691,15,103,63,122,118,185,747,1273,8,11311,628,0,2,57,27,0
12477,46,532,647,139,84,35,284,233,682,0,0,0,0,0,0,0,0,0,0,0,0,2,4,1,0
12478,172,3987,77,34,69,0,0,8,77,3,24,16,29,27,45,114,213,1,387,21,0,2,8,4,0
12479,172,3987,712,438,573,51,9,84,763,14,102,71,128,116,199,733,1364,8,11988,666,0,2,8,4,0
12480,21,594,1293,570,1093,25,15,163,1318,10,195,123,241,205,364,1516,2795,6,17273,959,0,2,1,2,0
12481,219,4866,722,423,573,19,0,135,741,12,172,101,199,184,300,1320,2257,6,15668,870,0,2,12,11,0
12482,219,4866,1508,847,911,44,250,301,1552,14,148,88,169,162,257,1120,1886,7,15077,837,0,2,12,11,0
12483,513,10983,72,33,56,0,4,12,72,1,1,1,1,2,2,0,2,0,1,0,0,2,37,36,0
12484,513,10983,1454,835,1044,76,110,219,1530,17,275,158,296,292,454,2297,3718,9,34017,1889,1,2,37,36,0
12485,41,951,386,256,301,16,9,68,402,4,59,35,69,63,104,355,621,2,1453,80,0,2,13,3,0
12486,41,951,264,131,164,11,41,46,275,6,38,22,40,44,62,214,338,3,1068,59,0,2,13,3,0
12487,116,2524,1043,504,840,53,9,147,1096,9,180,112,198,189,310,1377,2344,4,11604,644,0,2,9,4,0
12488,116,2524,383,288,292,26,6,62,409,11,65,38,67,76,105,429,656,5,3719,206,0,2,9,4,0
12489,95,1756,1178,367,1042,6,15,115,1184,9,94,51,95,103,146,644,976,4,4439,246,0,2,31,7,0
12490,95,1756,177,108,140,8,0,27,185,6,30,16,32,36,48,162,248,3,794,44,0,2,31,7,0
12491,181,3706,1943,715,1694,26,18,214,1969,12,185,120,237,197,357,1436,2721,7,20915,1161,0,2,15,1,0
12492,181,3706,1168,838,957,57,25,144,1225,19,348,224,416,367,640,3018,5452,11,61921,3440,1,2,15,1,0
12493,53,1077,1098,241,925,5,10,155,1103,7,46,25,49,53,74,273,423,3,1580,87,0,2,5,6,0
12494,53,1077,282,202,222,14,2,44,296,8,42,24,43,50,67,250,378,4,1548,86,0,2,5,6,0
12495,60,1074,282,196,195,3,0,86,285,8,130,71,141,138,212,936,1507,4,6538,363,0,2,2,1,0
12496,7,296,72,33,56,0,4,12,72,1,1,1,1,2,2,0,2,0,1,0,0,2,3,2,0
12497,20,619,42,7,35,4,0,5,46,1,2,1,2,3,3,2,4,0,2,0,0,2,1,1,0
12498,20,619,11,6,10,0,0,1,11,2,4,2,4,6,6,10,15,1,15,0,0,2,1,1,0
12499,69,2871,1289,550,1043,56,32,155,1345,10,167,93,185,177,278,1266,2075,5,11498,638,0,2,5,5,0
12500,33,992,182,127,129,0,0,53,182,5,39,21,42,44,63,217,343,2,926,51,0,0,163,0,0
12501,118,5254,1392,870,1177,35,17,170,1427,14,494,280,531,508,811,4473,7289,7,54850,3047,2,0,911,0,0
12502,92,2961,773,419,590,28,0,166,801,10,204,113,217,214,330,1598,2554,5,13587,754,0,0,659,0,0
12503,77,3663,1338,495,1086,10,64,173,1348,11,122,82,157,133,239,883,1686,7,11934,663,0,2,12,9,0
12504,140,6182,139,89,101,2,0,35,141,7,54,34,62,61,96,330,569,4,2287,127,0,2,18,14,0
12505,140,6182,7,5,5,0,0,2,7,1,2,1,2,3,3,2,4,0,2,0,0,2,18,14,0
12506,32,933,465,148,393,5,8,60,470,4,31,20,31,35,51,161,261,2,523,29,0,2,2,1,0
12507,32,933,16,12,9,0,0,6,16,1,2,1,2,3,3,2,4,0,2,0,0,2,2,1,0
12508,81,4399,1782,648,1425,9,47,279,1791,8,171,97,189,179,286,1292,2140,4,9462,525,0,2,5,3,0
12509,13,271,256,139,192,9,7,47,265,4,23,12,24,27,36,112,171,2,357,19,0,2,8,1,0
12510,23,594,102,59,69,5,3,24,107,6,22,15,28,28,43,113,206,3,789,43,0,2,0,4,0
12511,74,2703,1450,624,1228,12,26,181,1462,14,306,186,354,320,540,2580,4493,8,36391,2021,1,2,13,11,0
12512,136,3557,1660,832,1314,41,38,274,1701,20,312,209,395,332,604,2671,5058,12,64042,3557,1,2,4,3,0
12513,112,4316,1513,682,1277,25,13,200,1538,11,199,116,219,210,335,1557,2584,6,15641,868,0,2,3,2,0
12514,55,2831,1457,730,1242,11,6,188,1468,10,292,166,329,302,495,2424,4078,5,22973,1276,1,2,66,2,0
12515,35,2156,652,304,544,16,6,88,668,6,89,51,101,95,152,591,998,3,3399,188,0,2,10,7,0
12516,51,2242,1455,414,1257,16,76,112,1471,5,41,23,46,46,69,231,381,2,1069,59,0,2,80,5,0
12517,63,2582,1020,354,843,12,15,144,1032,8,134,77,144,142,221,970,1580,4,6792,377,0,2,0,2,0
12518,21,647,424,94,331,4,0,89,428,1,5,5,5,6,10,11,25,0,12,0,0,2,0,1,0
12519,38,2201,334,251,279,10,4,40,344,5,127,74,143,132,217,899,1528,2,4303,239,0,2,0,6,0
12520,34,1289,1293,570,1093,25,15,163,1318,10,195,123,241,205,364,1516,2795,6,17273,959,0,2,9,4,0
12521,29,1196,386,256,301,16,9,68,402,4,59,35,69,63,104,355,621,2,1453,80,0,2,10,0,0
12522,16,1265,215,129,180,6,0,29,221,8,65,43,72,73,115,415,711,4,3153,175,0,2,7,3,0
12523,57,2321,1043,504,840,53,9,147,1096,9,180,112,198,189,310,1377,2344,4,11604,644,0,2,10,6,0
12524,56,2421,1178,367,1042,6,15,115,1184,9,94,51,95,103,146,644,976,4,4439,246,0,2,85,0,0
12525,69,3533,1943,715,1694,26,18,214,1969,12,185,120,237,197,357,1436,2721,7,20915,1161,0,2,35,6,0
12526,38,1508,1098,241,925,5,10,155,1103,7,46,25,49,53,74,273,423,3,1580,87,0,2,2,1,0
12527,147,4734,1660,832,1314,41,38,274,1701,20,312,209,395,332,604,2671,5058,12,64042,3557,1,2,5,0,0
12528,147,4734,1057,646,719,113,100,145,1170,18,215,134,248,233,382,1740,3004,10,31186,1732,1,2,5,0,0
12529,136,3557,1660,832,1314,41,38,274,1701,20,312,209,395,332,604,2671,5058,12,64042,3557,1,2,13,0,0
12530,181,3718,1943,715,1694,26,18,214,1969,12,185,120,237,197,357,1436,2721,7,20915,1161,0,2,1,0,1
12531,181,3718,1168,838,957,57,25,144,1225,19,348,224,416,367,640,3018,5452,11,61921,3440,1,2,1,0,1
12532,69,3545,1943,715,1694,26,18,214,1969,12,185,120,237,197,357,1436,2721,7,20915,1161,0,2,4,0,1
12533,181,3718,1943,715,1694,26,18,214,1969,12,185,120,237,197,357,1436,2721,7,20915,1161,0,2,1,0,0
12534,181,3718,1168,838,957,57,25,144,1225,19,348,224,416,367,640,3018,5452,11,61921,3440,1,2,1,0,0
12535,69,3545,1943,715,1694,26,18,214,1969,12,185,120,237,197,357,1436,2721,7,20915,1161,0,2,4,0,0
12536,90,1950,477,336,357,30,23,73,507,16,194,134,250,210,384,1538,2962,10,30538,1696,0,2,10,8,1
12537,75,2716,1450,624,1228,12,26,181,1462,14,306,186,354,320,540,2580,4493,8,36391,2021,1,2,3,0,1
12538,90,1950,477,336,357,30,23,73,507,16,194,134,250,210,384,1538,2962,10,30538,1696,0,2,10,8,0
12539,75,2716,1450,624,1228,12,26,181,1462,14,306,186,354,320,540,2580,4493,8,36391,2021,1,2,3,0,0
12540,9,220,19,8,11,5,0,4,24,2,5,3,6,7,9,13,25,1,30,1,0,2,0,3,0
12541,9,220,102,59,69,5,3,24,107,6,22,15,28,28,43,113,206,3,789,43,0,2,0,3,0
12542,9,220,106,40,36,3,49,17,109,8,17,13,23,25,36,93,167,5,904,50,0,2,0,3,0
12543,199,4197,182,127,129,0,0,53,182,5,39,21,42,44,63,217,343,2,926,51,0,0,795,0,0
12544,199,4197,1165,710,800,67,119,181,1232,18,243,153,282,261,435,2000,3492,10,36473,2026,1,0,795,0,0
12545,100,2140,773,419,590,28,0,166,801,10,204,113,217,214,330,1598,2554,5,13587,754,0,0,421,0,0
12546,100,2140,421,273,302,44,34,57,465,17,81,59,107,98,166,583,1098,11,12329,684,0,0,421,0,0
12547,36,711,2,2,2,0,0,0,2,0,0,0,0,0,0,0,0,0,0,0,0,2,11,2,0
12548,36,711,99,48,90,1,3,5,100,0,0,0,0,0,0,0,0,0,0,0,0,2,11,2,0
12549,36,711,8,5,5,2,0,1,10,0,0,0,0,0,0,0,0,0,0,0,0,2,11,2,0
12550,36,711,1217,716,841,84,126,174,1301,14,185,118,215,199,333,1446,2542,8,20687,1149,0,2,11,2,0
12551,36,711,160,89,115,0,13,31,160,7,15,11,17,22,28,78,124,3,495,27,0,2,11,2,0
12552,36,711,10,10,9,9,0,0,19,0,0,0,0,0,0,0,0,0,0,0,0,2,11,2,0
12553,36,711,173,84,99,8,29,36,181,5,12,7,13,17,20,54,81,2,221,12,0,2,11,2,0
12554,36,711,3,1,1,3,0,0,6,0,0,0,0,0,0,0,0,0,0,0,0,2,11,2,0
12555,147,4734,1660,832,1314,41,38,274,1701,20,312,209,395,332,604,2671,5058,12,64042,3557,1,2,5,0,0
12556,147,4734,1057,646,719,113,100,145,1170,18,215,134,248,233,382,1740,3004,10,31186,1732,1,2,5,0,0
12557,90,1950,477,336,357,30,23,73,507,16,194,134,250,210,384,1538,2962,10,30538,1696,0,2,12,9,0
12558,57,1223,996,429,845,24,10,117,1020,7,76,50,88,83,138,494,879,4,3565,198,0,2,2,2,0
12559,57,1223,456,277,329,12,42,72,468,13,85,50,97,98,147,592,972,7,7212,400,0,2,2,2,0
12560,298,6082,1457,730,1242,11,6,188,1468,10,292,166,329,302,495,2424,4078,5,22973,1276,1,2,21,18,0
12561,298,6082,74,35,59,1,0,14,75,3,14,7,14,17,21,58,85,1,128,7,0,2,21,18,0
12562,298,6082,245,125,200,5,7,34,250,7,30,17,34,37,51,166,265,3,1053,58,0,2,21,18,0
12563,53,1437,1455,414,1257,16,76,112,1471,5,41,23,46,46,69,231,381,2,1069,59,0,2,57,27,0
12564,53,1437,669,365,481,22,61,110,691,15,103,63,122,118,185,747,1273,8,11311,628,0,2,57,27,0
12565,46,532,647,139,84,35,284,233,682,0,0,0,0,0,0,0,0,0,0,0,0,2,4,1,0
12566,172,3987,77,34,69,0,0,8,77,3,24,16,29,27,45,114,213,1,387,21,0,2,8,4,0
12567,172,3987,712,438,573,51,9,84,763,14,102,71,128,116,199,733,1364,8,11988,666,0,2,8,4,0
12568,21,594,1293,570,1093,25,15,163,1318,10,195,123,241,205,364,1516,2795,6,17273,959,0,2,1,2,0
12569,219,4866,722,423,573,19,0,135,741,12,172,101,199,184,300,1320,2257,6,15668,870,0,2,12,11,0
12570,219,4866,1508,847,911,44,250,301,1552,14,148,88,169,162,257,1120,1886,7,15077,837,0,2,12,11,0
12571,513,10983,72,33,56,0,4,12,72,1,1,1,1,2,2,0,2,0,1,0,0,2,37,36,0
12572,513,10983,1454,835,1044,76,110,219,1530,17,275,158,296,292,454,2297,3718,9,34017,1889,1,2,37,36,0
12573,41,951,386,256,301,16,9,68,402,4,59,35,69,63,104,355,621,2,1453,80,0,2,13,3,0
12574,41,951,264,131,164,11,41,46,275,6,38,22,40,44,62,214,338,3,1068,59,0,2,13,3,0
12575,116,2524,1043,504,840,53,9,147,1096,9,180,112,198,189,310,1377,2344,4,11604,644,0,2,9,4,0
12576,116,2524,383,288,292,26,6,62,409,11,65,38,67,76,105,429,656,5,3719,206,0,2,9,4,0
12577,95,1756,1178,367,1042,6,15,115,1184,9,94,51,95,103,146,644,976,4,4439,246,0,2,31,7,0
12578,95,1756,177,108,140,8,0,27,185,6,30,16,32,36,48,162,248,3,794,44,0,2,31,7,0
12579,181,3718,1943,715,1694,26,18,214,1969,12,185,120,237,197,357,1436,2721,7,20915,1161,0,2,16,1,0
12580,181,3718,1168,838,957,57,25,144,1225,19,348,224,416,367,640,3018,5452,11,61921,3440,1,2,16,1,0
12581,53,1077,1098,241,925,5,10,155,1103,7,46,25,49,53,74,273,423,3,1580,87,0,2,5,6,0
12582,53,1077,282,202,222,14,2,44,296,8,42,24,43,50,67,250,378,4,1548,86,0,2,5,6,0
12583,60,1074,282,196,195,3,0,86,285,8,130,71,141,138,212,936,1507,4,6538,363,0,2,2,1,0
12584,7,296,72,33,56,0,4,12,72,1,1,1,1,2,2,0,2,0,1,0,0,2,3,2,0
12585,20,619,42,7,35,4,0,5,46,1,2,1,2,3,3,2,4,0,2,0,0,2,1,1,0
12586,20,619,11,6,10,0,0,1,11,2,4,2,4,6,6,10,15,1,15,0,0,2,1,1,0
12587,69,2871,1289,550,1043,56,32,155,1345,10,167,93,185,177,278,1266,2075,5,11498,638,0,2,5,5,0
12588,33,992,182,127,129,0,0,53,182,5,39,21,42,44,63,217,343,2,926,51,0,0,163,0,0
12589,118,5254,1392,870,1177,35,17,170,1427,14,494,280,531,508,811,4473,7289,7,54850,3047,2,0,911,0,0
12590,92,2961,773,419,590,28,0,166,801,10,204,113,217,214,330,1598,2554,5,13587,754,0,0,659,0,0
12591,77,3663,1338,495,1086,10,64,173,1348,11,122,82,157,133,239,883,1686,7,11934,663,0,2,12,9,0
12592,140,6182,139,89,101,2,0,35,141,7,54,34,62,61,96,330,569,4,2287,127,0,2,18,14,0
12593,140,6182,7,5,5,0,0,2,7,1,2,1,2,3,3,2,4,0,2,0,0,2,18,14,0
12594,32,933,465,148,393,5,8,60,470,4,31,20,31,35,51,161,261,2,523,29,0,2,2,1,0
12595,32,933,16,12,9,0,0,6,16,1,2,1,2,3,3,2,4,0,2,0,0,2,2,1,0
12596,81,4399,1782,648,1425,9,47,279,1791,8,171,97,189,179,286,1292,2140,4,9462,525,0,2,5,3,0
12597,13,271,256,139,192,9,7,47,265,4,23,12,24,27,36,112,171,2,357,19,0,2,8,1,0
12598,23,594,102,59,69,5,3,24,107,6,22,15,28,28,43,113,206,3,789,43,0,2,0,4,0
12599,75,2716,1450,624,1228,12,26,181,1462,14,306,186,354,320,540,2580,4493,8,36391,2021,1,2,16,11,0
12600,136,3557,1660,832,1314,41,38,274,1701,20,312,209,395,332,604,2671,5058,12,64042,3557,1,2,17,3,0
12601,112,4316,1513,682,1277,25,13,200,1538,11,199,116,219,210,335,1557,2584,6,15641,868,0,2,3,2,0
12602,55,2831,1457,730,1242,11,6,188,1468,10,292,166,329,302,495,2424,4078,5,22973,1276,1,2,66,2,0
12603,35,2156,652,304,544,16,6,88,668,6,89,51,101,95,152,591,998,3,3399,188,0,2,10,7,0
12604,51,2242,1455,414,1257,16,76,112,1471,5,41,23,46,46,69,231,381,2,1069,59,0,2,80,5,0
12605,63,2582,1020,354,843,12,15,144,1032,8,134,77,144,142,221,970,1580,4,6792,377,0,2,0,2,0
12606,21,647,424,94,331,4,0,89,428,1,5,5,5,6,10,11,25,0,12,0,0,2,0,1,0
12607,38,2201,334,251,279,10,4,40,344,5,127,74,143,132,217,899,1528,2,4303,239,0,2,0,6,0
12608,34,1289,1293,570,1093,25,15,163,1318,10,195,123,241,205,364,1516,2795,6,17273,959,0,2,9,4,0
12609,29,1196,386,256,301,16,9,68,402,4,59,35,69,63,104,355,621,2,1453,80,0,2,10,0,0
12610,16,1265,215,129,180,6,0,29,221,8,65,43,72,73,115,415,711,4,3153,175,0,2,7,3,0
12611,57,2321,1043,504,840,53,9,147,1096,9,180,112,198,189,310,1377,2344,4,11604,644,0,2,10,6,0
12612,56,2421,1178,367,1042,6,15,115,1184,9,94,51,95,103,146,644,976,4,4439,246,0,2,85,0,0
12613,69,3545,1943,715,1694,26,18,214,1969,12,185,120,237,197,357,1436,2721,7,20915,1161,0,2,39,6,0
12614,38,1508,1098,241,925,5,10,155,1103,7,46,25,49,53,74,273,423,3,1580,87,0,2,2,1,0
12615,302,6165,1457,730,1242,11,6,188,1468,10,292,166,329,302,495,2424,4078,5,22973,1276,1,2,23,2,0
12616,302,6165,74,35,59,1,0,14,75,3,14,7,14,17,21,58,85,1,128,7,0,2,23,2,0
12617,302,6165,245,125,200,5,7,34,250,7,30,17,34,37,51,166,265,3,1053,58,0,2,23,2,0
12618,57,2907,1457,730,1242,11,6,188,1468,10,292,166,329,302,495,2424,4078,5,22973,1276,1,2,15,0,0
12619,98,1843,1178,367,1042,6,15,115,1184,9,94,51,95,103,146,644,976,4,4439,246,0,2,18,0,1
12620,98,1843,177,108,140,8,0,27,185,6,30,16,32,36,48,162,248,3,794,44,0,2,18,0,1
12621,63,2648,1178,367,1042,6,15,115,1184,9,94,51,95,103,146,644,976,4,4439,246,0,2,52,0,1
12622,302,6165,1457,730,1242,11,6,188,1468,10,292,166,329,302,495,2424,4078,5,22973,1276,1,2,23,2,0
12623,302,6165,74,35,59,1,0,14,75,3,14,7,14,17,21,58,85,1,128,7,0,2,23,2,0
12624,302,6165,245,125,200,5,7,34,250,7,30,17,34,37,51,166,265,3,1053,58,0,2,23,2,0
12625,98,1843,1178,367,1042,6,15,115,1184,9,94,51,95,103,146,644,976,4,4439,246,0,2,18,0,0
12626,98,1843,177,108,140,8,0,27,185,6,30,16,32,36,48,162,248,3,794,44,0,2,18,0,0
12627,57,2907,1457,730,1242,11,6,188,1468,10,292,166,329,302,495,2424,4078,5,22973,1276,1,2,15,0,0
12628,63,2648,1178,367,1042,6,15,115,1184,9,94,51,95,103,146,644,976,4,4439,246,0,2,52,0,0
12629,98,1850,1178,367,1042,6,15,115,1184,9,94,51,95,103,146,644,976,4,4439,246,0,2,3,0,1
12630,98,1850,177,108,140,8,0,27,185,6,30,16,32,36,48,162,248,3,794,44,0,2,3,0,1
12631,77,3673,1338,495,1086,10,64,173,1348,11,122,82,157,133,239,883,1686,7,11934,663,0,2,1,0,1
12632,63,2661,1178,367,1042,6,15,115,1184,9,94,51,95,103,146,644,976,4,4439,246,0,2,2,1,1
12633,99,1863,1178,367,1042,6,15,115,1184,9,94,51,95,103,146,644,976,4,4439,246,0,2,18,12,1
12634,99,1863,177,108,140,8,0,27,185,6,30,16,32,36,48,162,248,3,794,44,0,2,18,12,1
12635,64,2726,1178,367,1042,6,15,115,1184,9,94,51,95,103,146,644,976,4,4439,246,0,2,22,3,1
12636,60,1251,996,429,845,24,10,117,1020,7,76,50,88,83,138,494,879,4,3565,198,0,2,3,1,1
12637,60,1251,456,277,329,12,42,72,468,13,85,50,97,98,147,592,972,7,7212,400,0,2,3,1,1
12638,99,1863,1178,367,1042,6,15,115,1184,9,94,51,95,103,146,644,976,4,4439,246,0,2,20,11,0
12639,99,1863,177,108,140,8,0,27,185,6,30,16,32,36,48,162,248,3,794,44,0,2,20,11,0
12640,77,3673,1338,495,1086,10,64,173,1348,11,122,82,157,133,239,883,1686,7,11934,663,0,2,1,0,0
12641,64,2726,1178,367,1042,6,15,115,1184,9,94,51,95,103,146,644,976,4,4439,246,0,2,24,4,0
12642,181,3727,1943,715,1694,26,18,214,1969,12,185,120,237,197,357,1436,2721,7,20915,1161,0,2,4,3,0
12643,181,3727,1168,838,957,57,25,144,1225,19,348,224,416,367,640,3018,5452,11,61921,3440,1,2,4,3,0
12644,72,3652,1943,715,1694,26,18,214,1969,12,185,120,237,197,357,1436,2721,7,20915,1161,0,2,25,0,0
12645,181,3727,1943,715,1694,26,18,214,1969,12,185,120,237,197,357,1436,2721,7,20915,1161,0,2,4,3,0
12646,181,3727,1168,838,957,57,25,144,1225,19,348,224,416,367,640,3018,5452,11,61921,3440,1,2,4,3,0
12647,72,3652,1943,715,1694,26,18,214,1969,12,185,120,237,197,357,1436,2721,7,20915,1161,0,2,25,0,0
12648,99,1873,1178,367,1042,6,15,115,1184,9,94,51,95,103,146,644,976,4,4439,246,0,2,3,3,1
12649,99,1873,177,108,140,8,0,27,185,6,30,16,32,36,48,162,248,3,794,44,0,2,3,3,1
12650,83,3847,1338,495,1086,10,64,173,1348,11,122,82,157,133,239,883,1686,7,11934,663,0,2,78,0,1
12651,64,2751,1178,367,1042,6,15,115,1184,9,94,51,95,103,146,644,976,4,4439,246,0,2,7,4,0
12652,513,10987,72,33,56,0,4,12,72,1,1,1,1,2,2,0,2,0,1,0,0,2,1,1,1
12653,513,10987,1454,835,1044,76,110,219,1530,17,275,158,296,292,454,2297,3718,9,34017,1889,1,2,1,1,1
12654,58,2427,1043,504,840,53,9,147,1096,9,180,112,198,189,310,1377,2344,4,11604,644,0,2,43,0,1
12655,60,2418,1043,504,840,53,9,147,1096,9,180,112,198,189,310,1377,2344,4,11604,644,0,2,20,37,1
12656,99,1873,1178,367,1042,6,15,115,1184,9,94,51,95,103,146,644,976,4,4439,246,0,2,3,3,0
12657,99,1873,177,108,140,8,0,27,185,6,30,16,32,36,48,162,248,3,794,44,0,2,3,3,0
12658,83,3847,1338,495,1086,10,64,173,1348,11,122,82,157,133,239,883,1686,7,11934,663,0,2,78,0,0
12659,64,2751,1178,367,1042,6,15,115,1184,9,94,51,95,103,146,644,976,4,4439,246,0,2,7,4,0
12660,513,10987,72,33,56,0,4,12,72,1,1,1,1,2,2,0,2,0,1,0,0,2,1,1,0
12661,513,10987,1454,835,1044,76,110,219,1530,17,275,158,296,292,454,2297,3718,9,34017,1889,1,2,1,1,0
12662,60,2418,1043,504,840,53,9,147,1096,9,180,112,198,189,310,1377,2344,4,11604,644,0,2,26,0,0
12663,68,1237,1020,354,843,12,15,144,1032,8,134,77,144,142,221,970,1580,4,6792,377,0,2,1,1,1
12664,68,1237,1020,354,843,12,15,144,1032,8,134,77,144,142,221,970,1580,4,6792,377,0,2,1,1,0
12665,68,1945,1523,757,1297,19,12,193,1542,12,193,117,230,205,347,1508,2664,7,19053,1058,0,2,4,8,1
12666,68,1945,701,378,504,33,58,109,734,13,110,68,126,123,194,794,1346,7,10027,557,0,2,4,8,1
12667,71,3371,1523,757,1297,19,12,193,1542,12,193,117,230,205,347,1508,2664,7,19053,1058,0,2,15,0,1
12668,68,1945,1523,757,1297,19,12,193,1542,12,193,117,230,205,347,1508,2664,7,19053,1058,0,2,4,8,0
12669,68,1945,701,378,504,33,58,109,734,13,110,68,126,123,194,794,1346,7,10027,557,0,2,4,8,0
12670,71,3371,1523,757,1297,19,12,193,1542,12,193,117,230,205,347,1508,2664,7,19053,1058,0,2,15,0,0
12671,56,1502,1455,414,1257,16,76,112,1471,5,41,23,46,46,69,231,381,2,1069,59,0,2,13,0,1
12672,56,1502,669,365,481,22,61,110,691,15,103,63,122,118,185,747,1273,8,11311,628,0,2,13,0,1
12673,53,2376,1455,414,1257,16,76,112,1471,5,41,23,46,46,69,231,381,2,1069,59,0,2,50,0,1
12674,67,1986,1523,757,1297,19,12,193,1542,12,193,117,230,205,347,1508,2664,7,19053,1058,0,2,14,3,0
12675,67,1986,701,378,504,33,58,109,734,13,110,68,126,123,194,794,1346,7,10027,557,0,2,14,3,0
12676,72,3430,1523,757,1297,19,12,193,1542,12,193,117,230,205,347,1508,2664,7,19053,1058,0,2,20,5,0
12677,56,1502,1455,414,1257,16,76,112,1471,5,41,23,46,46,69,231,381,2,1069,59,0,2,13,0,0
12678,56,1502,669,365,481,22,61,110,691,15,103,63,122,118,185,747,1273,8,11311,628,0,2,13,0,0
12679,53,2376,1455,414,1257,16,76,112,1471,5,41,23,46,46,69,231,381,2,1069,59,0,2,50,0,0
12680,67,1986,1523,757,1297,19,12,193,1542,12,193,117,230,205,347,1508,2664,7,19053,1058,0,2,14,3,0
12681,67,1986,701,378,504,33,58,109,734,13,110,68,126,123,194,794,1346,7,10027,557,0,2,14,3,0
12682,72,3430,1523,757,1297,19,12,193,1542,12,193,117,230,205,347,1508,2664,7,19053,1058,0,2,20,5,0
12683,73,3480,1523,757,1297,19,12,193,1542,12,193,117,230,205,347,1508,2664,7,19053,1058,0,2,18,2,1
12684,73,3480,1523,757,1297,19,12,193,1542,12,193,117,230,205,347,1508,2664,7,19053,1058,0,2,18,2,0
12685,46,532,647,139,84,35,284,233,682,0,0,0,0,0,0,0,0,0,0,0,0,2,6,9,0
12686,46,532,647,139,84,35,284,233,682,0,0,0,0,0,0,0,0,0,0,0,0,2,6,9,0
12687,513,10991,72,33,56,0,4,12,72,1,1,1,1,2,2,0,2,0,1,0,0,2,1,1,1
12688,513,10991,1454,835,1044,76,110,219,1530,17,275,158,296,292,454,2297,3718,9,34017,1889,1,2,1,1,1
12689,116,2528,1043,504,840,53,9,147,1096,9,180,112,198,189,310,1377,2344,4,11604,644,0,2,1,1,1
12690,116,2528,383,288,292,26,6,62,409,11,65,38,67,76,105,429,656,5,3719,206,0,2,1,1,1
12691,62,2486,1043,504,840,53,9,147,1096,9,180,112,198,189,310,1377,2344,4,11604,644,0,2,19,0,1
12692,36,1082,182,127,129,0,0,53,182,5,39,21,42,44,63,217,343,2,926,51,0,2,11,0,0
12693,84,3883,1338,495,1086,10,64,173,1348,11,122,82,157,133,239,883,1686,7,11934,663,0,2,17,0,0
12694,36,1082,182,127,129,0,0,53,182,5,39,21,42,44,63,217,343,2,926,51,0,2,11,0,0
12695,84,3883,1338,495,1086,10,64,173,1348,11,122,82,157,133,239,883,1686,7,11934,663,0,2,17,0,0
12696,117,2546,1043,504,840,53,9,147,1096,9,180,112,198,189,310,1377,2344,4,11604,644,0,2,4,1,1
12697,117,2546,383,288,292,26,6,62,409,11,65,38,67,76,105,429,656,5,3719,206,0,2,4,1,1
12698,62,2505,1043,504,840,53,9,147,1096,9,180,112,198,189,310,1377,2344,4,11604,644,0,2,6,3,1
12699,514,11003,72,33,56,0,4,12,72,1,1,1,1,2,2,0,2,0,1,0,0,2,1,1,1
12700,514,11003,1454,835,1044,76,110,219,1530,17,275,158,296,292,454,2297,3718,9,34017,1889,1,2,1,1,1
12701,70,2905,1289,550,1043,56,32,155,1345,10,167,93,185,177,278,1266,2075,5,11498,638,0,2,14,0,1
12702,82,4441,1782,648,1425,9,47,279,1791,8,171,97,189,179,286,1292,2140,4,9462,525,0,2,5,0,1
12703,513,10991,72,33,56,0,4,12,72,1,1,1,1,2,2,0,2,0,1,0,0,2,1,1,0
12704,513,10991,1454,835,1044,76,110,219,1530,17,275,158,296,292,454,2297,3718,9,34017,1889,1,2,1,1,0
12705,117,2546,1043,504,840,53,9,147,1096,9,180,112,198,189,310,1377,2344,4,11604,644,0,2,4,1,0
12706,117,2546,383,288,292,26,6,62,409,11,65,38,67,76,105,429,656,5,3719,206,0,2,4,1,0
12707,62,2505,1043,504,840,53,9,147,1096,9,180,112,198,189,310,1377,2344,4,11604,644,0,2,22,0,0
12708,514,11007,72,33,56,0,4,12,72,1,1,1,1,2,2,0,2,0,1,0,0,2,1,1,0
12709,514,11007,1454,835,1044,76,110,219,1530,17,275,158,296,292,454,2297,3718,9,34017,1889,1,2,1,1,0
12710,70,2905,1289,550,1043,56,32,155,1345,10,167,93,185,177,278,1266,2075,5,11498,638,0,2,14,0,0
12711,82,4441,1782,648,1425,9,47,279,1791,8,171,97,189,179,286,1292,2140,4,9462,525,0,2,5,0,0
12712,526,11221,72,33,56,0,4,12,72,1,1,1,1,2,2,0,2,0,1,0,0,2,101,1,1
12713,526,11221,1454,835,1044,76,110,219,1530,17,275,158,296,292,454,2297,3718,9,34017,1889,1,2,101,1,1
12714,3,128,520,294,400,33,13,81,553,10,261,204,367,271,571,2128,4614,7,32445,1802,1,0,27,0,1
12715,526,11222,72,33,56,0,4,12,72,1,1,1,1,2,2,0,2,0,1,0,0,2,8,7,1
12716,526,11222,1454,835,1044,76,110,219,1530,17,275,158,296,292,454,2297,3718,9,34017,1889,1,2,8,7,1
12717,4,159,520,294,400,33,13,81,553,10,261,204,367,271,571,2128,4614,7,32445,1802,1,2,6,1,1
12718,527,11252,72,33,56,0,4,12,72,1,1,1,1,2,2,0,2,0,1,0,0,2,4,3,1
12719,527,11252,1454,835,1044,76,110,219,1530,17,275,158,296,292,454,2297,3718,9,34017,1889,1,2,4,3,1
12720,4,166,520,294,400,33,13,81,553,10,261,204,367,271,571,2128,4614,7,32445,1802,1,2,2,1,1
12721,527,11252,72,33,56,0,4,12,72,1,1,1,1,2,2,0,2,0,1,0,0,2,8,5,1
12722,527,11252,1454,835,1044,76,110,219,1530,17,275,158,296,292,454,2297,3718,9,34017,1889,1,2,8,5,1
12723,527,11252,72,33,56,0,4,12,72,1,1,1,1,2,2,0,2,0,1,0,0,2,12,8,1
12724,527,11252,1454,835,1044,76,110,219,1530,17,275,158,296,292,454,2297,3718,9,34017,1889,1,2,12,8,1
12725,527,11252,72,33,56,0,4,12,72,1,1,1,1,2,2,0,2,0,1,0,0,2,1,1,0
12726,527,11252,1454,835,1044,76,110,219,1530,17,275,158,296,292,454,2297,3718,9,34017,1889,1,2,1,1,0
12727,527,11252,72,33,56,0,4,12,72,1,1,1,1,2,2,0,2,0,1,0,0,2,2,2,0
12728,527,11252,1454,835,1044,76,110,219,1530,17,275,158,296,292,454,2297,3718,9,34017,1889,1,2,2,2,0
12729,527,11253,72,33,56,0,4,12,72,1,1,1,1,2,2,0,2,0,1,0,0,2,1,1,0
12730,527,11253,1454,835,1044,76,110,219,1530,17,275,158,296,292,454,2297,3718,9,34017,1889,1,2,1,1,0
12731,302,6177,1457,730,1242,11,6,188,1468,10,292,166,329,302,495,2424,4078,5,22973,1276,1,2,2,2,1
12732,302,6177,74,35,59,1,0,14,75,3,14,7,14,17,21,58,85,1,128,7,0,2,2,2,1
12733,302,6177,245,125,200,5,7,34,250,7,30,17,34,37,51,166,265,3,1053,58,0,2,2,2,1
12734,35,1824,384,251,317,7,8,52,391,11,70,44,84,81,128,467,811,6,5355,297,0,2,6,2,1
12735,514,11018,72,33,56,0,4,12,72,1,1,1,1,2,2,0,2,0,1,0,0,2,14,4,1
12736,514,11018,1454,835,1044,76,110,219,1530,17,275,158,296,292,454,2297,3718,9,34017,1889,1,2,14,4,1
12737,141,6212,139,89,101,2,0,35,141,7,54,34,62,61,96,330,569,4,2287,127,0,2,11,0,1
12738,141,6212,7,5,5,0,0,2,7,1,2,1,2,3,3,2,4,0,2,0,0,2,11,0,1
12739,304,6210,1457,730,1242,11,6,188,1468,10,292,166,329,302,495,2424,4078,5,22973,1276,1,2,6,1,1
12740,304,6210,74,35,59,1,0,14,75,3,14,7,14,17,21,58,85,1,128,7,0,2,6,1,1
12741,304,6210,245,125,200,5,7,34,250,7,30,17,34,37,51,166,265,3,1053,58,0,2,6,1,1
12742,304,6210,1457,730,1242,11,6,188,1468,10,292,166,329,302,495,2424,4078,5,22973,1276,1,2,7,2,0
12743,304,6210,74,35,59,1,0,14,75,3,14,7,14,17,21,58,85,1,128,7,0,2,7,2,0
12744,304,6210,245,125,200,5,7,34,250,7,30,17,34,37,51,166,265,3,1053,58,0,2,7,2,0
12745,35,1824,384,251,317,7,8,52,391,11,70,44,84,81,128,467,811,6,5355,297,0,2,6,2,0
12746,60,1251,996,429,845,24,10,117,1020,7,76,50,88,83,138,494,879,4,3565,198,0,2,1,1,1
12747,60,1251,456,277,329,12,42,72,468,13,85,50,97,98,147,592,972,7,7212,400,0,2,1,1,1
12748,60,1251,996,429,845,24,10,117,1020,7,76,50,88,83,138,494,879,4,3565,198,0,2,3,1,0
12749,60,1251,456,277,329,12,42,72,468,13,85,50,97,98,147,592,972,7,7212,400,0,2,3,1,0
12750,540,11486,72,33,56,0,4,12,72,1,1,1,1,2,2,0,2,0,1,0,0,2,104,20,1
12751,540,11486,1454,835,1044,76,110,219,1530,17,275,158,296,292,454,2297,3718,9,34017,1889,1,2,104,20,1
12752,43,2254,520,294,400,33,13,81,553,10,261,204,367,271,571,2128,4614,7,32445,1802,1,2,259,9,1
12753,540,11486,72,33,56,0,4,12,72,1,1,1,1,2,2,0,2,0,1,0,0,2,102,50,1
12754,540,11486,1454,835,1044,76,110,219,1530,17,275,158,296,292,454,2297,3718,9,34017,1889,1,2,102,50,1
12755,542,11516,72,33,56,0,4,12,72,1,1,1,1,2,2,0,2,0,1,0,0,2,6,0,1
12756,542,11516,1454,835,1044,76,110,219,1530,17,275,158,296,292,454,2297,3718,9,34017,1889,1,2,6,0,1
12757,43,2308,520,294,400,33,13,81,553,10,261,204,367,271,571,2128,4614,7,32445,1802,1,2,6,3,1
12758,46,532,647,139,84,35,284,233,682,0,0,0,0,0,0,0,0,0,0,0,0,2,1,1,0
12759,173,4001,77,34,69,0,0,8,77,3,24,16,29,27,45,114,213,1,387,21,0,2,1,1,0
12760,173,4001,712,438,573,51,9,84,763,14,102,71,128,116,199,733,1364,8,11988,666,0,2,1,1,0
12761,64,2629,1020,354,843,12,15,144,1032,8,134,77,144,142,221,970,1580,4,6792,377,0,2,16,0,0
12762,514,11018,72,33,56,0,4,12,72,1,1,1,1,2,2,0,2,0,1,0,0,2,14,4,0
12763,514,11018,1454,835,1044,76,110,219,1530,17,275,158,296,292,454,2297,3718,9,34017,1889,1,2,14,4,0
12764,141,6212,139,89,101,2,0,35,141,7,54,34,62,61,96,330,569,4,2287,127,0,2,11,0,0
12765,141,6212,7,5,5,0,0,2,7,1,2,1,2,3,3,2,4,0,2,0,0,2,11,0,0
12766,46,532,647,139,84,35,284,233,682,0,0,0,0,0,0,0,0,0,0,0,0,2,1,1,0
12767,542,11516,72,33,56,0,4,12,72,1,1,1,1,2,2,0,2,0,1,0,0,2,9,7,1
12768,542,11516,1454,835,1044,76,110,219,1530,17,275,158,296,292,454,2297,3718,9,34017,1889,1,2,9,7,1
12769,542,11516,72,33,56,0,4,12,72,1,1,1,1,2,2,0,2,0,1,0,0,2,3,3,1
12770,542,11516,1454,835,1044,76,110,219,1530,17,275,158,296,292,454,2297,3718,9,34017,1889,1,2,3,3,1
12771,543,11547,72,33,56,0,4,12,72,1,1,1,1,2,2,0,2,0,1,0,0,2,14,4,0
12772,543,11547,1454,835,1044,76,110,219,1530,17,275,158,296,292,454,2297,3718,9,34017,1889,1,2,14,4,0
12773,141,6212,139,89,101,2,0,35,141,7,54,34,62,61,96,330,569,4,2287,127,0,2,11,0,0
12774,141,6212,7,5,5,0,0,2,7,1,2,1,2,3,3,2,4,0,2,0,0,2,11,0,0
12775,543,11547,72,33,56,0,4,12,72,1,1,1,1,2,2,0,2,0,1,0,0,2,255,2,0
12776,543,11547,1454,835,1044,76,110,219,1530,17,275,158,296,292,454,2297,3718,9,34017,1889,1,2,255,2,0
12777,43,2308,520,294,400,33,13,81,553,10,261,204,367,271,571,2128,4614,7,32445,1802,1,0,286,0,0
12778,173,4001,77,34,69,0,0,8,77,3,24,16,29,27,45,114,213,1,387,21,0,2,1,0,0
12779,173,4001,712,438,573,51,9,84,763,14,102,71,128,116,199,733,1364,8,11988,666,0,2,1,0,0
12780,173,4001,77,34,69,0,0,8,77,3,24,16,29,27,45,114,213,1,387,21,0,2,2,1,0
12781,173,4001,712,438,573,51,9,84,763,14,102,71,128,116,199,733,1364,8,11988,666,0,2,2,1,0
12782,64,2629,1020,354,843,12,15,144,1032,8,134,77,144,142,221,970,1580,4,6792,377,0,2,16,0,0
12783,72,2027,1523,757,1297,19,12,193,1542,12,193,117,230,205,347,1508,2664,7,19053,1058,0,2,21,0,1
12784,72,2027,701,378,504,33,58,109,734,13,110,68,126,123,194,794,1346,7,10027,557,0,2,21,0,1
12785,73,3542,1523,757,1297,19,12,193,1542,12,193,117,230,205,347,1508,2664,7,19053,1058,0,2,35,0,1
12786,72,2027,1523,757,1297,19,12,193,1542,12,193,117,230,205,347,1508,2664,7,19053,1058,0,2,21,0,0
12787,72,2027,701,378,504,33,58,109,734,13,110,68,126,123,194,794,1346,7,10027,557,0,2,21,0,0
12788,73,3542,1523,757,1297,19,12,193,1542,12,193,117,230,205,347,1508,2664,7,19053,1058,0,2,35,0,0
12789,60,1251,996,429,845,24,10,117,1020,7,76,50,88,83,138,494,879,4,3565,198,0,2,3,1,0
12790,60,1251,456,277,329,12,42,72,468,13,85,50,97,98,147,592,972,7,7212,400,0,2,3,1,0
12791,304,6210,1457,730,1242,11,6,188,1468,10,292,166,329,302,495,2424,4078,5,22973,1276,1,2,7,2,0
12792,304,6210,74,35,59,1,0,14,75,3,14,7,14,17,21,58,85,1,128,7,0,2,7,2,0
12793,304,6210,245,125,200,5,7,34,250,7,30,17,34,37,51,166,265,3,1053,58,0,2,7,2,0
12794,46,532,647,139,84,35,284,233,682,0,0,0,0,0,0,0,0,0,0,0,0,2,7,10,0
12795,71,2068,1523,757,1297,19,12,193,1542,12,193,117,230,205,347,1508,2664,7,19053,1058,0,2,14,3,0
12796,71,2068,701,378,504,33,58,109,734,13,110,68,126,123,194,794,1346,7,10027,557,0,2,14,3,0
12797,173,4001,77,34,69,0,0,8,77,3,24,16,29,27,45,114,213,1,387,21,0,2,2,1,0
12798,173,4001,712,438,573,51,9,84,763,14,102,71,128,116,199,733,1364,8,11988,666,0,2,2,1,0
12799,544,11567,72,33,56,0,4,12,72,1,1,1,1,2,2,0,2,0,1,0,0,2,2,2,0
12800,544,11567,1454,835,1044,76,110,219,1530,17,275,158,296,292,454,2297,3718,9,34017,1889,1,2,2,2,0
12801,117,2546,1043,504,840,53,9,147,1096,9,180,112,198,189,310,1377,2344,4,11604,644,0,2,4,1,0
12802,117,2546,383,288,292,26,6,62,409,11,65,38,67,76,105,429,656,5,3719,206,0,2,4,1,0
12803,70,2905,1289,550,1043,56,32,155,1345,10,167,93,185,177,278,1266,2075,5,11498,638,0,2,14,0,0
12804,36,1082,182,127,129,0,0,53,182,5,39,21,42,44,63,217,343,2,926,51,0,2,11,0,0
12805,84,3883,1338,495,1086,10,64,173,1348,11,122,82,157,133,239,883,1686,7,11934,663,0,2,17,0,0
12806,82,4441,1782,648,1425,9,47,279,1791,8,171,97,189,179,286,1292,2140,4,9462,525,0,2,5,0,0
12807,75,3651,1523,757,1297,19,12,193,1542,12,193,117,230,205,347,1508,2664,7,19053,1058,0,2,36,5,0
12808,64,2629,1020,354,843,12,15,144,1032,8,134,77,144,142,221,970,1580,4,6792,377,0,2,16,0,0
12809,35,1824,384,251,317,7,8,52,391,11,70,44,84,81,128,467,811,6,5355,297,0,2,6,2,0
12810,62,2505,1043,504,840,53,9,147,1096,9,180,112,198,189,310,1377,2344,4,11604,644,0,2,22,0,0
12811,60,1251,996,429,845,24,10,117,1020,7,76,50,88,83,138,494,879,4,3565,198,0,2,3,1,0
12812,60,1251,456,277,329,12,42,72,468,13,85,50,97,98,147,592,972,7,7212,400,0,2,3,1,0
12813,304,6210,1457,730,1242,11,6,188,1468,10,292,166,329,302,495,2424,4078,5,22973,1276,1,2,7,2,0
12814,304,6210,74,35,59,1,0,14,75,3,14,7,14,17,21,58,85,1,128,7,0,2,7,2,0
12815,304,6210,245,125,200,5,7,34,250,7,30,17,34,37,51,166,265,3,1053,58,0,2,7,2,0
12816,46,532,647,139,84,35,284,233,682,0,0,0,0,0,0,0,0,0,0,0,0,2,7,10,0
12817,71,2068,1523,757,1297,19,12,193,1542,12,193,117,230,205,347,1508,2664,7,19053,1058,0,2,14,3,0
12818,71,2068,701,378,504,33,58,109,734,13,110,68,126,123,194,794,1346,7,10027,557,0,2,14,3,0
12819,173,4001,77,34,69,0,0,8,77,3,24,16,29,27,45,114,213,1,387,21,0,2,2,1,0
12820,173,4001,712,438,573,51,9,84,763,14,102,71,128,116,199,733,1364,8,11988,666,0,2,2,1,0
12821,544,11567,72,33,56,0,4,12,72,1,1,1,1,2,2,0,2,0,1,0,0,2,2,2,0
12822,544,11567,1454,835,1044,76,110,219,1530,17,275,158,296,292,454,2297,3718,9,34017,1889,1,2,2,2,0
12823,117,2546,1043,504,840,53,9,147,1096,9,180,112,198,189,310,1377,2344,4,11604,644,0,2,4,1,0
12824,117,2546,383,288,292,26,6,62,409,11,65,38,67,76,105,429,656,5,3719,206,0,2,4,1,0
12825,70,2905,1289,550,1043,56,32,155,1345,10,167,93,185,177,278,1266,2075,5,11498,638,0,2,14,0,0
12826,36,1082,182,127,129,0,0,53,182,5,39,21,42,44,63,217,343,2,926,51,0,2,11,0,0
12827,84,3883,1338,495,1086,10,64,173,1348,11,122,82,157,133,239,883,1686,7,11934,663,0,2,17,0,0
12828,82,4441,1782,648,1425,9,47,279,1791,8,171,97,189,179,286,1292,2140,4,9462,525,0,2,5,0,0
12829,75,3651,1523,757,1297,19,12,193,1542,12,193,117,230,205,347,1508,2664,7,19053,1058,0,2,36,5,0
12830,64,2629,1020,354,843,12,15,144,1032,8,134,77,144,142,221,970,1580,4,6792,377,0,2,16,0,0
12831,35,1824,384,251,317,7,8,52,391,11,70,44,84,81,128,467,811,6,5355,297,0,2,6,2,0
12832,62,2505,1043,504,840,53,9,147,1096,9,180,112,198,189,310,1377,2344,4,11604,644,0,2,22,0,0
12833,515,11032,72,33,56,0,4,12,72,1,1,1,1,2,2,0,2,0,1,0,0,2,10,8,1
12834,515,11032,1454,835,1044,76,110,219,1530,17,275,158,296,292,454,2297,3718,9,34017,1889,1,2,10,8,1
12835,83,4493,1782,648,1425,9,47,279,1791,8,171,97,189,179,286,1292,2140,4,9462,525,0,2,7,0,1
12836,84,4536,1782,648,1425,9,47,279,1791,8,171,97,189,179,286,1292,2140,4,9462,525,0,2,18,0,1
12837,86,4628,1782,648,1425,9,47,279,1791,8,171,97,189,179,286,1292,2140,4,9462,525,0,2,25,1,0
12838,209,4494,182,127,129,0,0,53,182,5,39,21,42,44,63,217,343,2,926,51,0,2,59,9,1
12839,209,4494,1165,710,800,67,119,181,1232,18,243,153,282,261,435,2000,3492,10,36473,2026,1,2,59,9,1
12840,117,2533,1043,504,840,53,9,147,1096,9,180,112,198,189,310,1377,2344,4,11604,644,0,2,3,0,1
12841,117,2533,383,288,292,26,6,62,409,11,65,38,67,76,105,429,656,5,3719,206,0,2,3,0,1
12842,128,5981,1392,870,1177,35,17,170,1427,14,494,280,531,508,811,4473,7289,7,54850,3047,2,2,88,2,1
12843,60,1251,996,429,845,24,10,117,1020,7,76,50,88,83,138,494,879,4,3565,198,0,2,3,1,0
12844,60,1251,456,277,329,12,42,72,468,13,85,50,97,98,147,592,972,7,7212,400,0,2,3,1,0
12845,304,6210,1457,730,1242,11,6,188,1468,10,292,166,329,302,495,2424,4078,5,22973,1276,1,2,7,2,0
12846,304,6210,74,35,59,1,0,14,75,3,14,7,14,17,21,58,85,1,128,7,0,2,7,2,0
12847,304,6210,245,125,200,5,7,34,250,7,30,17,34,37,51,166,265,3,1053,58,0,2,7,2,0
12848,46,532,647,139,84,35,284,233,682,0,0,0,0,0,0,0,0,0,0,0,0,2,1,1,0
12849,173,4001,77,34,69,0,0,8,77,3,24,16,29,27,45,114,213,1,387,21,0,2,2,1,0
12850,173,4001,712,438,573,51,9,84,763,14,102,71,128,116,199,733,1364,8,11988,666,0,2,2,1,0
12851,514,11007,72,33,56,0,4,12,72,1,1,1,1,2,2,0,2,0,1,0,0,2,2,2,0
12852,514,11007,1454,835,1044,76,110,219,1530,17,275,158,296,292,454,2297,3718,9,34017,1889,1,2,2,2,0
12853,118,2555,1043,504,840,53,9,147,1096,9,180,112,198,189,310,1377,2344,4,11604,644,0,2,4,1,0
12854,118,2555,383,288,292,26,6,62,409,11,65,38,67,76,105,429,656,5,3719,206,0,2,4,1,0
12855,70,2905,1289,550,1043,56,32,155,1345,10,167,93,185,177,278,1266,2075,5,11498,638,0,2,14,0,0
12856,36,1082,182,127,129,0,0,53,182,5,39,21,42,44,63,217,343,2,926,51,0,2,11,0,0
12857,84,3883,1338,495,1086,10,64,173,1348,11,122,82,157,133,239,883,1686,7,11934,663,0,2,17,0,0
12858,82,4441,1782,648,1425,9,47,279,1791,8,171,97,189,179,286,1292,2140,4,9462,525,0,2,5,0,0
12859,64,2629,1020,354,843,12,15,144,1032,8,134,77,144,142,221,970,1580,4,6792,377,0,2,16,0,0
12860,35,1824,384,251,317,7,8,52,391,11,70,44,84,81,128,467,811,6,5355,297,0,2,6,2,0
12861,62,2505,1043,504,840,53,9,147,1096,9,180,112,198,189,310,1377,2344,4,11604,644,0,2,22,0,0
12862,515,11032,72,33,56,0,4,12,72,1,1,1,1,2,2,0,2,0,1,0,0,2,2,1,0
12863,515,11032,1454,835,1044,76,110,219,1530,17,275,158,296,292,454,2297,3718,9,34017,1889,1,2,2,1,0
12864,56,1502,1455,414,1257,16,76,112,1471,5,41,23,46,46,69,231,381,2,1069,59,0,2,13,0,0
12865,56,1502,669,365,481,22,61,110,691,15,103,63,122,118,185,747,1273,8,11311,628,0,2,13,0,0
12866,71,2068,1523,757,1297,19,12,193,1542,12,193,117,230,205,347,1508,2664,7,19053,1058,0,2,21,0,0
12867,71,2068,701,378,504,33,58,109,734,13,110,68,126,123,194,794,1346,7,10027,557,0,2,21,0,0
12868,545,11592,72,33,56,0,4,12,72,1,1,1,1,2,2,0,2,0,1,0,0,2,269,6,0
12869,545,11592,1454,835,1044,76,110,219,1530,17,275,158,296,292,454,2297,3718,9,34017,1889,1,2,269,6,0
12870,43,2308,520,294,400,33,13,81,553,10,261,204,367,271,571,2128,4614,7,32445,1802,1,0,286,0,0
12871,141,6212,139,89,101,2,0,35,141,7,54,34,62,61,96,330,569,4,2287,127,0,2,11,0,0
12872,141,6212,7,5,5,0,0,2,7,1,2,1,2,3,3,2,4,0,2,0,0,2,11,0,0
12873,53,2376,1455,414,1257,16,76,112,1471,5,41,23,46,46,69,231,381,2,1069,59,0,2,50,0,0
12874,75,3651,1523,757,1297,19,12,193,1542,12,193,117,230,205,347,1508,2664,7,19053,1058,0,2,35,0,0
12875,545,11592,72,33,56,0,4,12,72,1,1,1,1,2,2,0,2,0,1,0,0,2,12,9,0
12876,545,11592,1454,835,1044,76,110,219,1530,17,275,158,296,292,454,2297,3718,9,34017,1889,1,2,12,9,0
12877,86,4628,1782,648,1425,9,47,279,1791,8,171,97,189,179,286,1292,2140,4,9462,525,0,2,49,0,0
12878,545,11597,72,33,56,0,4,12,72,1,1,1,1,2,2,0,2,0,1,0,0,2,46,34,1
12879,545,11597,1454,835,1044,76,110,219,1530,17,275,158,296,292,454,2297,3718,9,34017,1889,1,2,46,34,1
12880,99,1883,1178,367,1042,6,15,115,1184,9,94,51,95,103,146,644,976,4,4439,246,0,2,5,0,1
12881,99,1883,177,108,140,8,0,27,185,6,30,16,32,36,48,162,248,3,794,44,0,2,5,0,1
12882,65,2786,1178,367,1042,6,15,115,1184,9,94,51,95,103,146,644,976,4,4439,246,0,2,13,0,1
12883,99,1883,1178,367,1042,6,15,115,1184,9,94,51,95,103,146,644,976,4,4439,246,0,2,7,7,1
12884,99,1883,177,108,140,8,0,27,185,6,30,16,32,36,48,162,248,3,794,44,0,2,7,7,1
12885,65,2786,1178,367,1042,6,15,115,1184,9,94,51,95,103,146,644,976,4,4439,246,0,2,1,1,1
12886,99,1883,1178,367,1042,6,15,115,1184,9,94,51,95,103,146,644,976,4,4439,246,0,2,12,7,0
12887,99,1883,177,108,140,8,0,27,185,6,30,16,32,36,48,162,248,3,794,44,0,2,12,7,0
12888,65,2786,1178,367,1042,6,15,115,1184,9,94,51,95,103,146,644,976,4,4439,246,0,2,14,1,0
12889,60,1251,996,429,845,24,10,117,1020,7,76,50,88,83,138,494,879,4,3565,198,0,2,3,1,1
12890,60,1251,456,277,329,12,42,72,468,13,85,50,97,98,147,592,972,7,7212,400,0,2,3,1,1
12891,304,6210,1457,730,1242,11,6,188,1468,10,292,166,329,302,495,2424,4078,5,22973,1276,1,2,7,2,1
12892,304,6210,74,35,59,1,0,14,75,3,14,7,14,17,21,58,85,1,128,7,0,2,7,2,1
12893,304,6210,245,125,200,5,7,34,250,7,30,17,34,37,51,166,265,3,1053,58,0,2,7,2,1
12894,46,532,647,139,84,35,284,233,682,0,0,0,0,0,0,0,0,0,0,0,0,2,7,10,1
12895,71,2068,1523,757,1297,19,12,193,1542,12,193,117,230,205,347,1508,2664,7,19053,1058,0,2,14,3,1
12896,71,2068,701,378,504,33,58,109,734,13,110,68,126,123,194,794,1346,7,10027,557,0,2,14,3,1
12897,173,4001,77,34,69,0,0,8,77,3,24,16,29,27,45,114,213,1,387,21,0,2,2,1,1
12898,173,4001,712,438,573,51,9,84,763,14,102,71,128,116,199,733,1364,8,11988,666,0,2,2,1,1
12899,545,11614,72,33,56,0,4,12,72,1,1,1,1,2,2,0,2,0,1,0,0,2,16,16,1
12900,545,11614,1454,835,1044,76,110,219,1530,17,275,158,296,292,454,2297,3718,9,34017,1889,1,2,16,16,1
12901,117,2546,1043,504,840,53,9,147,1096,9,180,112,198,189,310,1377,2344,4,11604,644,0,2,4,1,1
12902,117,2546,383,288,292,26,6,62,409,11,65,38,67,76,105,429,656,5,3719,206,0,2,4,1,1
12903,70,2905,1289,550,1043,56,32,155,1345,10,167,93,185,177,278,1266,2075,5,11498,638,0,2,14,0,1
12904,36,1082,182,127,129,0,0,53,182,5,39,21,42,44,63,217,343,2,926,51,0,2,11,0,1
12905,84,3883,1338,495,1086,10,64,173,1348,11,122,82,157,133,239,883,1686,7,11934,663,0,2,17,0,1
12906,86,4628,1782,648,1425,9,47,279,1791,8,171,97,189,179,286,1292,2140,4,9462,525,0,2,54,0,1
12907,75,3651,1523,757,1297,19,12,193,1542,12,193,117,230,205,347,1508,2664,7,19053,1058,0,2,36,5,1
12908,64,2629,1020,354,843,12,15,144,1032,8,134,77,144,142,221,970,1580,4,6792,377,0,2,16,0,1
12909,35,1824,384,251,317,7,8,52,391,11,70,44,84,81,128,467,811,6,5355,297,0,2,6,2,1
12910,62,2505,1043,504,840,53,9,147,1096,9,180,112,198,189,310,1377,2344,4,11604,644,0,2,22,0,1
12911,548,11627,72,33,56,0,4,12,72,1,1,1,1,2,2,0,2,0,1,0,0,2,9,3,1
12912,548,11627,1454,835,1044,76,110,219,1530,17,275,158,296,292,454,2297,3718,9,34017,1889,1,2,9,3,1
12913,86,4636,1782,648,1425,9,47,279,1791,8,171,97,189,179,286,1292,2140,4,9462,525,0,2,8,9,1
12914,548,11638,72,33,56,0,4,12,72,1,1,1,1,2,2,0,2,0,1,0,0,2,2,2,0
12915,548,11638,1454,835,1044,76,110,219,1530,17,275,158,296,292,454,2297,3718,9,34017,1889,1,2,2,2,0
12916,548,11638,72,33,56,0,4,12,72,1,1,1,1,2,2,0,2,0,1,0,0,2,9,3,0
12917,548,11638,1454,835,1044,76,110,219,1530,17,275,158,296,292,454,2297,3718,9,34017,1889,1,2,9,3,0
12918,86,4636,1782,648,1425,9,47,279,1791,8,171,97,189,179,286,1292,2140,4,9462,525,0,2,8,9,0
12919,118,2555,1043,504,840,53,9,147,1096,9,180,112,198,189,310,1377,2344,4,11604,644,0,2,1,0,0
12920,118,2555,383,288,292,26,6,62,409,11,65,38,67,76,105,429,656,5,3719,206,0,2,1,0,0
12921,17,386,85,59,61,8,0,16,93,5,18,10,18,23,28,86,126,2,316,17,0,2,40,30,0
12922,17,386,85,59,61,8,0,16,93,5,18,10,18,23,28,86,126,2,316,17,0,2,40,30,0
12923,545,11616,72,33,56,0,4,12,72,1,1,1,1,2,2,0,2,0,1,0,0,2,2,2,1
12924,545,11616,1454,835,1044,76,110,219,1530,17,275,158,296,292,454,2297,3718,9,34017,1889,1,2,2,2,1
12925,86,4619,1782,648,1425,9,47,279,1791,8,171,97,189,179,286,1292,2140,4,9462,525,0,2,8,9,1
12926,68,1241,1020,354,843,12,15,144,1032,8,134,77,144,142,221,970,1580,4,6792,377,0,2,1,1,1
12927,71,2935,1289,550,1043,56,32,155,1345,10,167,93,185,177,278,1266,2075,5,11498,638,0,2,5,0,1
12928,68,1241,1020,354,843,12,15,144,1032,8,134,77,144,142,221,970,1580,4,6792,377,0,2,1,1,0
12929,71,2935,1289,550,1043,56,32,155,1345,10,167,93,185,177,278,1266,2075,5,11498,638,0,2,5,0,0
12930,75,3651,1523,757,1297,19,12,193,1542,12,193,117,230,205,347,1508,2664,7,19053,1058,0,2,1,1,0
12931,545,11616,72,33,56,0,4,12,72,1,1,1,1,2,2,0,2,0,1,0,0,2,1,1,1
12932,545,11616,1454,835,1044,76,110,219,1530,17,275,158,296,292,454,2297,3718,9,34017,1889,1,2,1,1,1
12933,88,4705,1782,648,1425,9,47,279,1791,8,171,97,189,179,286,1292,2140,4,9462,525,0,2,17,0,1
12934,75,3651,1523,757,1297,19,12,193,1542,12,193,117,230,205,347,1508,2664,7,19053,1058,0,2,1,1,1
12935,548,11662,72,33,56,0,4,12,72,1,1,1,1,2,2,0,2,0,1,0,0,2,9,3,1
12936,548,11662,1454,835,1044,76,110,219,1530,17,275,158,296,292,454,2297,3718,9,34017,1889,1,2,9,3,1
12937,88,4713,1782,648,1425,9,47,279,1791,8,171,97,189,179,286,1292,2140,4,9462,525,0,2,8,9,1
12938,201,4242,182,127,129,0,0,53,182,5,39,21,42,44,63,217,343,2,926,51,0,2,14,0,1
12939,201,4242,1165,710,800,67,119,181,1232,18,243,153,282,261,435,2000,3492,10,36473,2026,1,2,14,0,1
12940,120,5315,1392,870,1177,35,17,170,1427,14,494,280,531,508,811,4473,7289,7,54850,3047,2,2,19,0,1
12941,201,4242,182,127,129,0,0,53,182,5,39,21,42,44,63,217,343,2,926,51,0,2,14,0,0
12942,201,4242,1165,710,800,67,119,181,1232,18,243,153,282,261,435,2000,3492,10,36473,2026,1,2,14,0,0
12943,120,5315,1392,870,1177,35,17,170,1427,14,494,280,531,508,811,4473,7289,7,54850,3047,2,2,19,0,0
12944,548,11662,72,33,56,0,4,12,72,1,1,1,1,2,2,0,2,0,1,0,0,2,42,33,0
12945,548,11662,1454,835,1044,76,110,219,1530,17,275,158,296,292,454,2297,3718,9,34017,1889,1,2,42,33,0
12946,88,4713,1782,648,1425,9,47,279,1791,8,171,97,189,179,286,1292,2140,4,9462,525,0,2,25,9,0
12947,75,3651,1523,757,1297,19,12,193,1542,12,193,117,230,205,347,1508,2664,7,19053,1058,0,2,2,2,0
12948,211,4539,182,127,129,0,0,53,182,5,39,21,42,44,63,217,343,2,926,51,0,2,59,9,0
12949,211,4539,1165,710,800,67,119,181,1232,18,243,153,282,261,435,2000,3492,10,36473,2026,1,2,59,9,0
12950,118,2555,1043,504,840,53,9,147,1096,9,180,112,198,189,310,1377,2344,4,11604,644,0,2,4,0,0
12951,118,2555,383,288,292,26,6,62,409,11,65,38,67,76,105,429,656,5,3719,206,0,2,4,0,0
12952,130,6042,1392,870,1177,35,17,170,1427,14,494,280,531,508,811,4473,7289,7,54850,3047,2,2,88,2,0
12953,202,4248,182,127,129,0,0,53,182,5,39,21,42,44,63,217,343,2,926,51,0,2,13,3,1
12954,202,4248,1165,710,800,67,119,181,1232,18,243,153,282,261,435,2000,3492,10,36473,2026,1,2,13,3,1
12955,121,5350,1392,870,1177,35,17,170,1427,14,494,280,531,508,811,4473,7289,7,54850,3047,2,2,17,1,1
12956,202,4248,182,127,129,0,0,53,182,5,39,21,42,44,63,217,343,2,926,51,0,2,13,3,0
12957,202,4248,1165,710,800,67,119,181,1232,18,243,153,282,261,435,2000,3492,10,36473,2026,1,2,13,3,0
12958,121,5350,1392,870,1177,35,17,170,1427,14,494,280,531,508,811,4473,7289,7,54850,3047,2,2,17,1,0
12959,305,6231,1457,730,1242,11,6,188,1468,10,292,166,329,302,495,2424,4078,5,22973,1276,1,2,4,1,0
12960,305,6231,74,35,59,1,0,14,75,3,14,7,14,17,21,58,85,1,128,7,0,2,4,1,0
12961,305,6231,245,125,200,5,7,34,250,7,30,17,34,37,51,166,265,3,1053,58,0,2,4,1,0
12962,101,1905,1178,367,1042,6,15,115,1184,9,94,51,95,103,146,644,976,4,4439,246,0,2,3,1,1
12963,101,1905,177,108,140,8,0,27,185,6,30,16,32,36,48,162,248,3,794,44,0,2,3,1,1
12964,66,2845,1178,367,1042,6,15,115,1184,9,94,51,95,103,146,644,976,4,4439,246,0,2,13,0,1
12965,304,6218,1457,730,1242,11,6,188,1468,10,292,166,329,302,495,2424,4078,5,22973,1276,1,2,1,4,1
12966,304,6218,74,35,59,1,0,14,75,3,14,7,14,17,21,58,85,1,128,7,0,2,1,4,1
12967,304,6218,245,125,200,5,7,34,250,7,30,17,34,37,51,166,265,3,1053,58,0,2,1,4,1
12968,58,2960,1457,730,1242,11,6,188,1468,10,292,166,329,302,495,2424,4078,5,22973,1276,1,2,11,1,1
12969,202,4248,182,127,129,0,0,53,182,5,39,21,42,44,63,217,343,2,926,51,0,2,3,3,0
12970,202,4248,1165,710,800,67,119,181,1232,18,243,153,282,261,435,2000,3492,10,36473,2026,1,2,3,3,0
12971,202,4248,182,127,129,0,0,53,182,5,39,21,42,44,63,217,343,2,926,51,0,2,3,3,0
12972,202,4248,1165,710,800,67,119,181,1232,18,243,153,282,261,435,2000,3492,10,36473,2026,1,2,3,3,0
12973,217,4674,182,127,129,0,0,53,182,5,39,21,42,44,63,217,343,2,926,51,0,2,28,9,0
12974,217,4674,1165,710,800,67,119,181,1232,18,243,153,282,261,435,2000,3492,10,36473,2026,1,2,28,9,0
12975,135,6195,1392,870,1177,35,17,170,1427,14,494,280,531,508,811,4473,7289,7,54850,3047,2,2,34,1,0
12976,135,6195,1392,870,1177,35,17,170,1427,14,494,280,531,508,811,4473,7289,7,54850,3047,2,2,2,2,0
12977,212,4592,182,127,129,0,0,53,182,5,39,21,42,44,63,217,343,2,926,51,0,2,13,22,1
12978,212,4592,1165,710,800,67,119,181,1232,18,243,153,282,261,435,2000,3492,10,36473,2026,1,2,13,22,1
12979,135,6209,1392,870,1177,35,17,170,1427,14,494,280,531,508,811,4473,7289,7,54850,3047,2,2,6,5,1
12980,212,4596,182,127,129,0,0,53,182,5,39,21,42,44,63,217,343,2,926,51,0,2,1,1,1
12981,212,4596,1165,710,800,67,119,181,1232,18,243,153,282,261,435,2000,3492,10,36473,2026,1,2,1,1,1
12982,212,4596,182,127,129,0,0,53,182,5,39,21,42,44,63,217,343,2,926,51,0,2,19,9,0
12983,212,4596,1165,710,800,67,119,181,1232,18,243,153,282,261,435,2000,3492,10,36473,2026,1,2,19,9,0
12984,135,6209,1392,870,1177,35,17,170,1427,14,494,280,531,508,811,4473,7289,7,54850,3047,2,2,35,1,0
12985,304,6218,1457,730,1242,11,6,188,1468,10,292,166,329,302,495,2424,4078,5,22973,1276,1,2,1,1,0
12986,304,6218,74,35,59,1,0,14,75,3,14,7,14,17,21,58,85,1,128,7,0,2,1,1,0
12987,304,6218,245,125,200,5,7,34,250,7,30,17,34,37,51,166,265,3,1053,58,0,2,1,1,0
12988,58,2960,1457,730,1242,11,6,188,1468,10,292,166,329,302,495,2424,4078,5,22973,1276,1,2,11,1,0
12989,550,11695,72,33,56,0,4,12,72,1,1,1,1,2,2,0,2,0,1,0,0,2,8,0,1
12990,550,11695,1454,835,1044,76,110,219,1530,17,275,158,296,292,454,2297,3718,9,34017,1889,1,2,8,0,1
12991,70,2907,1289,550,1043,56,32,155,1345,10,167,93,185,177,278,1266,2075,5,11498,638,0,2,2,1,1
12992,85,3922,1338,495,1086,10,64,173,1348,11,122,82,157,133,239,883,1686,7,11934,663,0,2,15,3,1
12993,53,2991,1296,573,1062,40,33,157,1336,8,201,118,231,209,349,1561,2689,4,12365,686,0,2,2,1,1
12994,24,966,373,158,315,8,0,51,381,5,76,44,79,81,123,486,779,2,2026,112,0,2,1,1,1
12995,72,3652,1943,715,1694,26,18,214,1969,12,185,120,237,197,357,1436,2721,7,20915,1161,0,2,3,3,1
12996,47,546,647,139,84,35,284,233,682,0,0,0,0,0,0,0,0,0,0,0,0,2,6,0,1
12997,551,11706,72,33,56,0,4,12,72,1,1,1,1,2,2,0,2,0,1,0,0,2,14,6,1
12998,551,11706,1454,835,1044,76,110,219,1530,17,275,158,296,292,454,2297,3718,9,34017,1889,1,2,14,6,1
12999,551,11710,72,33,56,0,4,12,72,1,1,1,1,2,2,0,2,0,1,0,0,2,2,2,1
13000,551,11710,1454,835,1044,76,110,219,1530,17,275,158,296,292,454,2297,3718,9,34017,1889,1,2,2,2,1
13001,89,4754,1782,648,1425,9,47,279,1791,8,171,97,189,179,286,1292,2140,4,9462,525,0,2,18,0,1
13002,47,546,647,139,84,35,284,233,682,0,0,0,0,0,0,0,0,0,0,0,0,2,6,6,1
13003,550,11695,72,33,56,0,4,12,72,1,1,1,1,2,2,0,2,0,1,0,0,2,8,0,0
13004,550,11695,1454,835,1044,76,110,219,1530,17,275,158,296,292,454,2297,3718,9,34017,1889,1,2,8,0,0
13005,70,2907,1289,550,1043,56,32,155,1345,10,167,93,185,177,278,1266,2075,5,11498,638,0,2,2,1,0
13006,85,3922,1338,495,1086,10,64,173,1348,11,122,82,157,133,239,883,1686,7,11934,663,0,2,15,3,0
13007,53,2991,1296,573,1062,40,33,157,1336,8,201,118,231,209,349,1561,2689,4,12365,686,0,2,2,1,0
13008,24,966,373,158,315,8,0,51,381,5,76,44,79,81,123,486,779,2,2026,112,0,2,1,1,0
13009,72,3652,1943,715,1694,26,18,214,1969,12,185,120,237,197,357,1436,2721,7,20915,1161,0,2,3,3,0
13010,47,548,647,139,84,35,284,233,682,0,0,0,0,0,0,0,0,0,0,0,0,2,1,1,1
13011,551,11716,72,33,56,0,4,12,72,1,1,1,1,2,2,0,2,0,1,0,0,2,2,2,1
13012,551,11716,1454,835,1044,76,110,219,1530,17,275,158,296,292,454,2297,3718,9,34017,1889,1,2,2,2,1
13013,89,4754,1782,648,1425,9,47,279,1791,8,171,97,189,179,286,1292,2140,4,9462,525,0,2,1,1,1
13014,47,548,647,139,84,35,284,233,682,0,0,0,0,0,0,0,0,0,0,0,0,2,6,0,0
13015,553,11749,72,33,56,0,4,12,72,1,1,1,1,2,2,0,2,0,1,0,0,2,14,6,0
13016,553,11749,1454,835,1044,76,110,219,1530,17,275,158,296,292,454,2297,3718,9,34017,1889,1,2,14,6,0
13017,89,4754,1782,648,1425,9,47,279,1791,8,171,97,189,179,286,1292,2140,4,9462,525,0,2,18,0,0
13018,514,11007,72,33,56,0,4,12,72,1,1,1,1,2,2,0,2,0,1,0,0,2,1,1,0
13019,514,11007,1454,835,1044,76,110,219,1530,17,275,158,296,292,454,2297,3718,9,34017,1889,1,2,1,1,0
13020,514,11007,72,33,56,0,4,12,72,1,1,1,1,2,2,0,2,0,1,0,0,2,1,1,0
13021,514,11007,1454,835,1044,76,110,219,1530,17,275,158,296,292,454,2297,3718,9,34017,1889,1,2,1,1,0
13022,65,2670,1020,354,843,12,15,144,1032,8,134,77,144,142,221,970,1580,4,6792,377,0,2,23,1,0
13023,65,2675,1020,354,843,12,15,144,1032,8,134,77,144,142,221,970,1580,4,6792,377,0,2,1,1,1
13024,67,1993,1523,757,1297,19,12,193,1542,12,193,117,230,205,347,1508,2664,7,19053,1058,0,2,1,1,1
13025,67,1993,701,378,504,33,58,109,734,13,110,68,126,123,194,794,1346,7,10027,557,0,2,1,1,1
13026,73,3480,1523,757,1297,19,12,193,1542,12,193,117,230,205,347,1508,2664,7,19053,1058,0,2,4,4,1
13027,67,1993,1523,757,1297,19,12,193,1542,12,193,117,230,205,347,1508,2664,7,19053,1058,0,2,1,1,0
13028,67,1993,701,378,504,33,58,109,734,13,110,68,126,123,194,794,1346,7,10027,557,0,2,1,1,0
13029,73,3480,1523,757,1297,19,12,193,1542,12,193,117,230,205,347,1508,2664,7,19053,1058,0,2,4,4,0
13030,99,1883,1178,367,1042,6,15,115,1184,9,94,51,95,103,146,644,976,4,4439,246,0,2,12,7,0
13031,99,1883,177,108,140,8,0,27,185,6,30,16,32,36,48,162,248,3,794,44,0,2,12,7,0
13032,17,386,85,59,61,8,0,16,93,5,18,10,18,23,28,86,126,2,316,17,0,2,40,30,0
13033,65,2786,1178,367,1042,6,15,115,1184,9,94,51,95,103,146,644,976,4,4439,246,0,2,14,1,0
13034,215,4647,182,127,129,0,0,53,182,5,39,21,42,44,63,217,343,2,926,51,0,2,13,3,0
13035,215,4647,1165,710,800,67,119,181,1232,18,243,153,282,261,435,2000,3492,10,36473,2026,1,2,13,3,0
13036,68,1241,1020,354,843,12,15,144,1032,8,134,77,144,142,221,970,1580,4,6792,377,0,2,1,1,0
13037,71,2937,1289,550,1043,56,32,155,1345,10,167,93,185,177,278,1266,2075,5,11498,638,0,2,5,0,0
13038,138,6305,1392,870,1177,35,17,170,1427,14,494,280,531,508,811,4473,7289,7,54850,3047,2,2,20,2,0
13039,215,4647,182,127,129,0,0,53,182,5,39,21,42,44,63,217,343,2,926,51,0,2,3,3,0
13040,215,4647,1165,710,800,67,119,181,1232,18,243,153,282,261,435,2000,3492,10,36473,2026,1,2,3,3,0
13041,304,6218,1457,730,1242,11,6,188,1468,10,292,166,329,302,495,2424,4078,5,22973,1276,1,2,1,1,0
13042,304,6218,74,35,59,1,0,14,75,3,14,7,14,17,21,58,85,1,128,7,0,2,1,1,0
13043,304,6218,245,125,200,5,7,34,250,7,30,17,34,37,51,166,265,3,1053,58,0,2,1,1,0
13044,71,2075,1523,757,1297,19,12,193,1542,12,193,117,230,205,347,1508,2664,7,19053,1058,0,2,1,1,0
13045,71,2075,701,378,504,33,58,109,734,13,110,68,126,123,194,794,1346,7,10027,557,0,2,1,1,0
13046,553,11749,72,33,56,0,4,12,72,1,1,1,1,2,2,0,2,0,1,0,0,2,1,1,0
13047,553,11749,1454,835,1044,76,110,219,1530,17,275,158,296,292,454,2297,3718,9,34017,1889,1,2,1,1,0
13048,58,2960,1457,730,1242,11,6,188,1468,10,292,166,329,302,495,2424,4078,5,22973,1276,1,2,11,1,0
13049,75,3651,1523,757,1297,19,12,193,1542,12,193,117,230,205,347,1508,2664,7,19053,1058,0,2,4,4,0
13050,20,619,42,7,35,4,0,5,46,1,2,1,2,3,3,2,4,0,2,0,0,2,1,1,1
13051,20,619,11,6,10,0,0,1,11,2,4,2,4,6,6,10,15,1,15,0,0,2,1,1,1
13052,20,619,42,7,35,4,0,5,46,1,2,1,2,3,3,2,4,0,2,0,0,2,1,1,0
13053,20,619,11,6,10,0,0,1,11,2,4,2,4,6,6,10,15,1,15,0,0,2,1,1,0
13054,65,2675,1020,354,843,12,15,144,1032,8,134,77,144,142,221,970,1580,4,6792,377,0,2,1,1,1
13055,54,1089,1098,241,925,5,10,155,1103,7,46,25,49,53,74,273,423,3,1580,87,0,2,2,0,1
13056,54,1089,282,202,222,14,2,44,296,8,42,24,43,50,67,250,378,4,1548,86,0,2,2,0,1
13057,39,1537,1098,241,925,5,10,155,1103,7,46,25,49,53,74,273,423,3,1580,87,0,2,14,0,1
13058,65,2675,1020,354,843,12,15,144,1032,8,134,77,144,142,221,970,1580,4,6792,377,0,2,23,1,0
13059,54,1089,1098,241,925,5,10,155,1103,7,46,25,49,53,74,273,423,3,1580,87,0,2,2,0,0
13060,54,1089,282,202,222,14,2,44,296,8,42,24,43,50,67,250,378,4,1548,86,0,2,2,0,0
13061,39,1537,1098,241,925,5,10,155,1103,7,46,25,49,53,74,273,423,3,1580,87,0,2,14,0,0
13062,173,4005,77,34,69,0,0,8,77,3,24,16,29,27,45,114,213,1,387,21,0,2,1,1,1
13063,173,4005,712,438,573,51,9,84,763,14,102,71,128,116,199,733,1364,8,11988,666,0,2,1,1,1
13064,53,3004,1296,573,1062,40,33,157,1336,8,201,118,231,209,349,1561,2689,4,12365,686,0,2,2,0,1
13065,20,619,42,7,35,4,0,5,46,1,2,1,2,3,3,2,4,0,2,0,0,2,1,1,0
13066,20,619,11,6,10,0,0,1,11,2,4,2,4,6,6,10,15,1,15,0,0,2,1,1,0
13067,173,4005,77,34,69,0,0,8,77,3,24,16,29,27,45,114,213,1,387,21,0,2,1,1,0
13068,173,4005,712,438,573,51,9,84,763,14,102,71,128,116,199,733,1364,8,11988,666,0,2,1,1,0
13069,53,3007,1296,573,1062,40,33,157,1336,8,201,118,231,209,349,1561,2689,4,12365,686,0,2,2,0,0
13070,304,6218,1457,730,1242,11,6,188,1468,10,292,166,329,302,495,2424,4078,5,22973,1276,1,2,1,1,0
13071,304,6218,74,35,59,1,0,14,75,3,14,7,14,17,21,58,85,1,128,7,0,2,1,1,0
13072,304,6218,245,125,200,5,7,34,250,7,30,17,34,37,51,166,265,3,1053,58,0,2,1,1,0
13073,304,6218,1457,730,1242,11,6,188,1468,10,292,166,329,302,495,2424,4078,5,22973,1276,1,2,1,1,0
13074,304,6218,74,35,59,1,0,14,75,3,14,7,14,17,21,58,85,1,128,7,0,2,1,1,0
13075,304,6218,245,125,200,5,7,34,250,7,30,17,34,37,51,166,265,3,1053,58,0,2,1,1,0
13076,304,6218,1457,730,1242,11,6,188,1468,10,292,166,329,302,495,2424,4078,5,22973,1276,1,2,1,1,0
13077,304,6218,74,35,59,1,0,14,75,3,14,7,14,17,21,58,85,1,128,7,0,2,1,1,0
13078,304,6218,245,125,200,5,7,34,250,7,30,17,34,37,51,166,265,3,1053,58,0,2,1,1,0
13079,215,4647,182,127,129,0,0,53,182,5,39,21,42,44,63,217,343,2,926,51,0,2,16,6,0
13080,215,4647,1165,710,800,67,119,181,1232,18,243,153,282,261,435,2000,3492,10,36473,2026,1,2,16,6,0
13081,304,6218,1457,730,1242,11,6,188,1468,10,292,166,329,302,495,2424,4078,5,22973,1276,1,2,1,1,0
13082,304,6218,74,35,59,1,0,14,75,3,14,7,14,17,21,58,85,1,128,7,0,2,1,1,0
13083,304,6218,245,125,200,5,7,34,250,7,30,17,34,37,51,166,265,3,1053,58,0,2,1,1,0
13084,71,2075,1523,757,1297,19,12,193,1542,12,193,117,230,205,347,1508,2664,7,19053,1058,0,2,1,1,0
13085,71,2075,701,378,504,33,58,109,734,13,110,68,126,123,194,794,1346,7,10027,557,0,2,1,1,0
13086,68,1241,1020,354,843,12,15,144,1032,8,134,77,144,142,221,970,1580,4,6792,377,0,2,1,1,0
13087,553,11749,72,33,56,0,4,12,72,1,1,1,1,2,2,0,2,0,1,0,0,2,1,1,0
13088,553,11749,1454,835,1044,76,110,219,1530,17,275,158,296,292,454,2297,3718,9,34017,1889,1,2,1,1,0
13089,99,1883,1178,367,1042,6,15,115,1184,9,94,51,95,103,146,644,976,4,4439,246,0,2,12,7,0
13090,99,1883,177,108,140,8,0,27,185,6,30,16,32,36,48,162,248,3,794,44,0,2,12,7,0
13091,17,386,85,59,61,8,0,16,93,5,18,10,18,23,28,86,126,2,316,17,0,2,40,30,0
13092,20,619,42,7,35,4,0,5,46,1,2,1,2,3,3,2,4,0,2,0,0,2,1,1,0
13093,20,619,11,6,10,0,0,1,11,2,4,2,4,6,6,10,15,1,15,0,0,2,1,1,0
13094,71,2937,1289,550,1043,56,32,155,1345,10,167,93,185,177,278,1266,2075,5,11498,638,0,2,5,0,0
13095,138,6305,1392,870,1177,35,17,170,1427,14,494,280,531,508,811,4473,7289,7,54850,3047,2,2,20,2,0
13096,58,2960,1457,730,1242,11,6,188,1468,10,292,166,329,302,495,2424,4078,5,22973,1276,1,2,11,1,0
13097,75,3651,1523,757,1297,19,12,193,1542,12,193,117,230,205,347,1508,2664,7,19053,1058,0,2,4,4,0
13098,65,2786,1178,367,1042,6,15,115,1184,9,94,51,95,103,146,644,976,4,4439,246,0,2,14,1,0
13099,514,11040,72,33,56,0,4,12,72,1,1,1,1,2,2,0,2,0,1,0,0,2,7,0,1
13100,514,11040,1454,835,1044,76,110,219,1530,17,275,158,296,292,454,2297,3718,9,34017,1889,1,2,7,0,1
13101,83,4488,1782,648,1425,9,47,279,1791,8,171,97,189,179,286,1292,2140,4,9462,525,0,2,7,0,1
13102,513,11010,72,33,56,0,4,12,72,1,1,1,1,2,2,0,2,0,1,0,0,2,3,12,1
13103,513,11010,1454,835,1044,76,110,219,1530,17,275,158,296,292,454,2297,3718,9,34017,1889,1,2,3,12,1
13104,513,11012,72,33,56,0,4,12,72,1,1,1,1,2,2,0,2,0,1,0,0,2,2,2,1
13105,513,11012,1454,835,1044,76,110,219,1530,17,275,158,296,292,454,2297,3718,9,34017,1889,1,2,2,2,1
13106,513,11012,72,33,56,0,4,12,72,1,1,1,1,2,2,0,2,0,1,0,0,2,9,11,0
13107,513,11012,1454,835,1044,76,110,219,1530,17,275,158,296,292,454,2297,3718,9,34017,1889,1,2,9,11,0
13108,83,4488,1782,648,1425,9,47,279,1791,8,171,97,189,179,286,1292,2140,4,9462,525,0,2,7,0,0
13109,101,1905,1178,367,1042,6,15,115,1184,9,94,51,95,103,146,644,976,4,4439,246,0,2,3,1,0
13110,101,1905,177,108,140,8,0,27,185,6,30,16,32,36,48,162,248,3,794,44,0,2,3,1,0
13111,66,2845,1178,367,1042,6,15,115,1184,9,94,51,95,103,146,644,976,4,4439,246,0,2,13,0,0
13112,101,1905,1178,367,1042,6,15,115,1184,9,94,51,95,103,146,644,976,4,4439,246,0,2,3,1,0
13113,101,1905,177,108,140,8,0,27,185,6,30,16,32,36,48,162,248,3,794,44,0,2,3,1,0
13114,66,2845,1178,367,1042,6,15,115,1184,9,94,51,95,103,146,644,976,4,4439,246,0,2,13,0,0
13115,514,11010,72,33,56,0,4,12,72,1,1,1,1,2,2,0,2,0,1,0,0,2,6,6,1
13116,514,11010,1454,835,1044,76,110,219,1530,17,275,158,296,292,454,2297,3718,9,34017,1889,1,2,6,6,1
13117,141,6224,139,89,101,2,0,35,141,7,54,34,62,61,96,330,569,4,2287,127,0,2,32,0,0
13118,141,6224,7,5,5,0,0,2,7,1,2,1,2,3,3,2,4,0,2,0,0,2,32,0,0
13119,514,11010,72,33,56,0,4,12,72,1,1,1,1,2,2,0,2,0,1,0,0,2,6,6,0
13120,514,11010,1454,835,1044,76,110,219,1530,17,275,158,296,292,454,2297,3718,9,34017,1889,1,2,6,6,0
13121,141,6224,139,89,101,2,0,35,141,7,54,34,62,61,96,330,569,4,2287,127,0,2,32,0,0
13122,141,6224,7,5,5,0,0,2,7,1,2,1,2,3,3,2,4,0,2,0,0,2,32,0,0
13123,553,11752,72,33,56,0,4,12,72,1,1,1,1,2,2,0,2,0,1,0,0,2,15,17,0
13124,553,11752,1454,835,1044,76,110,219,1530,17,275,158,296,292,454,2297,3718,9,34017,1889,1,2,15,17,0
13125,101,1905,1178,367,1042,6,15,115,1184,9,94,51,95,103,146,644,976,4,4439,246,0,2,3,1,0
13126,101,1905,177,108,140,8,0,27,185,6,30,16,32,36,48,162,248,3,794,44,0,2,3,1,0
13127,142,6254,139,89,101,2,0,35,141,7,54,34,62,61,96,330,569,4,2287,127,0,2,32,0,0
13128,142,6254,7,5,5,0,0,2,7,1,2,1,2,3,3,2,4,0,2,0,0,2,32,0,0
13129,90,4801,1782,648,1425,9,47,279,1791,8,171,97,189,179,286,1292,2140,4,9462,525,0,2,7,0,0
13130,66,2845,1178,367,1042,6,15,115,1184,9,94,51,95,103,146,644,976,4,4439,246,0,2,13,0,0
13131,53,1425,1455,414,1257,16,76,112,1471,5,41,23,46,46,69,231,381,2,1069,59,0,2,6,8,0
13132,53,1425,669,365,481,22,61,110,691,15,103,63,122,118,185,747,1273,8,11311,628,0,2,6,8,0
13133,52,2288,1455,414,1257,16,76,112,1471,5,41,23,46,46,69,231,381,2,1069,59,0,2,10,2,0
13134,53,1425,1455,414,1257,16,76,112,1471,5,41,23,46,46,69,231,381,2,1069,59,0,2,6,8,0
13135,53,1425,669,365,481,22,61,110,691,15,103,63,122,118,185,747,1273,8,11311,628,0,2,6,8,0
13136,52,2288,1455,414,1257,16,76,112,1471,5,41,23,46,46,69,231,381,2,1069,59,0,2,10,2,0
13137,203,4258,182,127,129,0,0,53,182,5,39,21,42,44,63,217,343,2,926,51,0,2,7,4,1
13138,203,4258,1165,710,800,67,119,181,1232,18,243,153,282,261,435,2000,3492,10,36473,2026,1,2,7,4,1
13139,174,4021,77,34,69,0,0,8,77,3,24,16,29,27,45,114,213,1,387,21,0,2,7,1,1
13140,174,4021,712,438,573,51,9,84,763,14,102,71,128,116,199,733,1364,8,11988,666,0,2,7,1,1
13141,122,5398,1392,870,1177,35,17,170,1427,14,494,280,531,508,811,4473,7289,7,54850,3047,2,2,11,0,1
13142,553,11758,72,33,56,0,4,12,72,1,1,1,1,2,2,0,2,0,1,0,0,2,1,0,1
13143,553,11758,1454,835,1044,76,110,219,1530,17,275,158,296,292,454,2297,3718,9,34017,1889,1,2,1,0,1
13144,140,6252,139,89,101,2,0,35,141,7,54,34,62,61,96,330,569,4,2287,127,0,2,29,58,1
13145,140,6252,7,5,5,0,0,2,7,1,2,1,2,3,3,2,4,0,2,0,0,2,29,58,1
13146,553,11773,72,33,56,0,4,12,72,1,1,1,1,2,2,0,2,0,1,0,0,2,4,4,1
13147,553,11773,1454,835,1044,76,110,219,1530,17,275,158,296,292,454,2297,3718,9,34017,1889,1,2,4,4,1
13148,140,6263,139,89,101,2,0,35,141,7,54,34,62,61,96,330,569,4,2287,127,0,2,11,12,1
13149,140,6263,7,5,5,0,0,2,7,1,2,1,2,3,3,2,4,0,2,0,0,2,11,12,1
13150,553,11737,72,33,56,0,4,12,72,1,1,1,1,2,2,0,2,0,1,0,0,2,14,18,1
13151,553,11737,1454,835,1044,76,110,219,1530,17,275,158,296,292,454,2297,3718,9,34017,1889,1,2,14,18,1
13152,3,63,127,75,83,2,11,30,129,4,14,7,14,18,21,61,87,2,175,9,0,2,2,2,1
13153,3,63,652,304,544,16,6,88,668,6,89,51,101,95,152,591,998,3,3399,188,0,2,2,2,1
13154,3,63,2,2,2,0,0,0,2,0,0,0,0,0,0,0,0,0,0,0,0,2,2,2,1
13155,3,63,8,5,5,0,0,3,8,0,0,0,0,0,0,0,0,0,0,0,0,2,2,2,1
13156,3,63,2,2,2,0,0,0,2,0,0,0,0,0,0,0,0,0,0,0,0,2,2,2,1
13157,3,63,14,8,8,0,0,6,14,0,0,0,0,0,0,0,0,0,0,0,0,2,2,2,1
13158,3,63,6,4,4,0,0,2,6,0,0,0,0,0,0,0,0,0,0,0,0,2,2,2,1
13159,3,63,6,4,4,0,0,2,6,1,2,1,2,3,3,2,4,0,2,0,0,2,2,2,1
13160,3,63,6,4,4,0,0,2,6,0,0,0,0,0,0,0,0,0,0,0,0,2,2,2,1
13161,3,63,7,5,5,0,0,2,7,0,0,0,0,0,0,0,0,0,0,0,0,2,2,2,1
13162,3,63,6,4,4,0,0,2,6,0,0,0,0,0,0,0,0,0,0,0,0,2,2,2,1
13163,3,63,10,6,6,0,0,4,10,0,0,0,0,0,0,0,0,0,0,0,0,2,2,2,1
13164,3,63,1,1,1,0,0,0,1,0,0,0,0,0,0,0,0,0,0,0,0,2,2,2,1
13165,3,63,1,1,1,0,0,0,1,0,0,0,0,0,0,0,0,0,0,0,0,2,2,2,1
13166,3,63,14,10,10,0,0,4,14,1,1,1,1,2,2,0,2,0,1,0,0,2,2,2,1
13167,3,63,46,26,30,3,0,12,49,3,6,3,6,9,9,20,28,1,42,2,0,2,2,2,1
13168,550,11685,72,33,56,0,4,12,72,1,1,1,1,2,2,0,2,0,1,0,0,2,5,14,1
13169,550,11685,1454,835,1044,76,110,219,1530,17,275,158,296,292,454,2297,3718,9,34017,1889,1,2,5,14,1
13170,203,4258,182,127,129,0,0,53,182,5,39,21,42,44,63,217,343,2,926,51,0,2,7,4,0
13171,203,4258,1165,710,800,67,119,181,1232,18,243,153,282,261,435,2000,3492,10,36473,2026,1,2,7,4,0
13172,174,4021,77,34,69,0,0,8,77,3,24,16,29,27,45,114,213,1,387,21,0,2,7,1,0
13173,174,4021,712,438,573,51,9,84,763,14,102,71,128,116,199,733,1364,8,11988,666,0,2,7,1,0
13174,122,5398,1392,870,1177,35,17,170,1427,14,494,280,531,508,811,4473,7289,7,54850,3047,2,2,11,0,0
13175,5,280,180,34,164,0,0,16,180,1,12,6,12,13,18,43,66,0,33,1,0,0,137,0,0
13176,568,12095,72,33,56,0,4,12,72,1,1,1,1,2,2,0,2,0,1,0,0,2,71,0,1
13177,568,12095,1454,835,1044,76,110,219,1530,17,275,158,296,292,454,2297,3718,9,34017,1889,1,2,71,0,1
13178,568,12095,72,33,56,0,4,12,72,1,1,1,1,2,2,0,2,0,1,0,0,2,4,4,1
13179,568,12095,1454,835,1044,76,110,219,1530,17,275,158,296,292,454,2297,3718,9,34017,1889,1,2,4,4,1
13180,175,4054,77,34,69,0,0,8,77,3,24,16,29,27,45,114,213,1,387,21,0,2,3,0,1
13181,175,4054,712,438,573,51,9,84,763,14,102,71,128,116,199,733,1364,8,11988,666,0,2,3,0,1
13182,63,2641,1043,504,840,53,9,147,1096,9,180,112,198,189,310,1377,2344,4,11604,644,0,2,33,0,1
13183,175,4054,77,34,69,0,0,8,77,3,24,16,29,27,45,114,213,1,387,21,0,2,3,0,0
13184,175,4054,712,438,573,51,9,84,763,14,102,71,128,116,199,733,1364,8,11988,666,0,2,3,0,0
13185,63,2641,1043,504,840,53,9,147,1096,9,180,112,198,189,310,1377,2344,4,11604,644,0,2,33,0,0
13186,568,12095,72,33,56,0,4,12,72,1,1,1,1,2,2,0,2,0,1,0,0,2,1,1,1
13187,568,12095,1454,835,1044,76,110,219,1530,17,275,158,296,292,454,2297,3718,9,34017,1889,1,2,1,1,1
13188,5,280,180,34,164,0,0,16,180,1,12,6,12,13,18,43,66,0,33,1,0,2,5,5,1
13189,174,4005,77,34,69,0,0,8,77,3,24,16,29,27,45,114,213,1,387,21,0,2,18,29,1
13190,174,4005,712,438,573,51,9,84,763,14,102,71,128,116,199,733,1364,8,11988,666,0,2,18,29,1
13191,78,3195,1289,550,1043,56,32,155,1345,10,167,93,185,177,278,1266,2075,5,11498,638,0,2,77,6,1
13192,174,4006,77,34,69,0,0,8,77,3,24,16,29,27,45,114,213,1,387,21,0,2,4,1,1
13193,174,4006,712,438,573,51,9,84,763,14,102,71,128,116,199,733,1364,8,11988,666,0,2,4,1,1
13194,77,3168,1289,550,1043,56,32,155,1345,10,167,93,185,177,278,1266,2075,5,11498,638,0,2,9,19,1
13195,550,11685,72,33,56,0,4,12,72,1,1,1,1,2,2,0,2,0,1,0,0,2,22,34,0
13196,550,11685,1454,835,1044,76,110,219,1530,17,275,158,296,292,454,2297,3718,9,34017,1889,1,2,22,34,0
13197,3,63,127,75,83,2,11,30,129,4,14,7,14,18,21,61,87,2,175,9,0,2,2,2,0
13198,3,63,652,304,544,16,6,88,668,6,89,51,101,95,152,591,998,3,3399,188,0,2,2,2,0
13199,3,63,2,2,2,0,0,0,2,0,0,0,0,0,0,0,0,0,0,0,0,2,2,2,0
13200,3,63,8,5,5,0,0,3,8,0,0,0,0,0,0,0,0,0,0,0,0,2,2,2,0
13201,3,63,2,2,2,0,0,0,2,0,0,0,0,0,0,0,0,0,0,0,0,2,2,2,0
13202,3,63,14,8,8,0,0,6,14,0,0,0,0,0,0,0,0,0,0,0,0,2,2,2,0
13203,3,63,6,4,4,0,0,2,6,0,0,0,0,0,0,0,0,0,0,0,0,2,2,2,0
13204,3,63,6,4,4,0,0,2,6,1,2,1,2,3,3,2,4,0,2,0,0,2,2,2,0
13205,3,63,6,4,4,0,0,2,6,0,0,0,0,0,0,0,0,0,0,0,0,2,2,2,0
13206,3,63,7,5,5,0,0,2,7,0,0,0,0,0,0,0,0,0,0,0,0,2,2,2,0
13207,3,63,6,4,4,0,0,2,6,0,0,0,0,0,0,0,0,0,0,0,0,2,2,2,0
13208,3,63,10,6,6,0,0,4,10,0,0,0,0,0,0,0,0,0,0,0,0,2,2,2,0
13209,3,63,1,1,1,0,0,0,1,0,0,0,0,0,0,0,0,0,0,0,0,2,2,2,0
13210,3,63,1,1,1,0,0,0,1,0,0,0,0,0,0,0,0,0,0,0,0,2,2,2,0
13211,3,63,14,10,10,0,0,4,14,1,1,1,1,2,2,0,2,0,1,0,0,2,2,2,0
13212,3,63,46,26,30,3,0,12,49,3,6,3,6,9,9,20,28,1,42,2,0,2,2,2,0
13213,140,6263,139,89,101,2,0,35,141,7,54,34,62,61,96,330,569,4,2287,127,0,2,20,50,0
13214,140,6263,7,5,5,0,0,2,7,1,2,1,2,3,3,2,4,0,2,0,0,2,20,50,0
13215,565,12028,72,33,56,0,4,12,72,1,1,1,1,2,2,0,2,0,1,0,0,2,71,0,0
13216,565,12028,1454,835,1044,76,110,219,1530,17,275,158,296,292,454,2297,3718,9,34017,1889,1,2,71,0,0
13217,5,280,180,34,164,0,0,16,180,1,12,6,12,13,18,43,66,0,33,1,0,0,137,0,0
13218,71,3617,1943,715,1694,26,18,214,1969,12,185,120,237,197,357,1436,2721,7,20915,1161,0,2,0,5,0
13219,174,4049,77,34,69,0,0,8,77,3,24,16,29,27,45,114,213,1,387,21,0,2,1,10,1
13220,174,4049,712,438,573,51,9,84,763,14,102,71,128,116,199,733,1364,8,11988,666,0,2,1,10,1
13221,174,4049,77,34,69,0,0,8,77,3,24,16,29,27,45,114,213,1,387,21,0,2,1,10,0
13222,174,4049,712,438,573,51,9,84,763,14,102,71,128,116,199,733,1364,8,11988,666,0,2,1,10,0
13223,71,3617,1943,715,1694,26,18,214,1969,12,185,120,237,197,357,1436,2721,7,20915,1161,0,2,0,5,0
13224,566,12057,72,33,56,0,4,12,72,1,1,1,1,2,2,0,2,0,1,0,0,2,10,4,1
13225,566,12057,1454,835,1044,76,110,219,1530,17,275,158,296,292,454,2297,3718,9,34017,1889,1,2,10,4,1
13226,17,373,256,139,192,9,7,47,265,4,23,12,24,27,36,112,171,2,357,19,0,2,17,0,1
13227,17,375,256,139,192,9,7,47,265,4,23,12,24,27,36,112,171,2,357,19,0,2,2,2,0
13228,117,2369,1513,682,1277,25,13,200,1538,11,199,116,219,210,335,1557,2584,6,15641,868,0,2,17,6,1
13229,117,2369,819,519,539,24,98,155,843,15,96,57,106,111,163,690,1107,8,9171,509,0,2,17,6,1
13230,113,4391,1513,682,1277,25,13,200,1538,11,199,116,219,210,335,1557,2584,6,15641,868,0,2,16,0,1
13231,173,4001,77,34,69,0,0,8,77,3,24,16,29,27,45,114,213,1,387,21,0,2,21,29,0
13232,173,4001,712,438,573,51,9,84,763,14,102,71,128,116,199,733,1364,8,11988,666,0,2,21,29,0
13233,77,3168,1289,550,1043,56,32,155,1345,10,167,93,185,177,278,1266,2075,5,11498,638,0,2,70,9,0
13234,566,12055,72,33,56,0,4,12,72,1,1,1,1,2,2,0,2,0,1,0,0,2,3,4,1
13235,566,12055,1454,835,1044,76,110,219,1530,17,275,158,296,292,454,2297,3718,9,34017,1889,1,2,3,4,1
13236,16,362,256,139,192,9,7,47,265,4,23,12,24,27,36,112,171,2,357,19,0,2,7,4,1
13237,566,12055,72,33,56,0,4,12,72,1,1,1,1,2,2,0,2,0,1,0,0,2,8,0,1
13238,566,12055,1454,835,1044,76,110,219,1530,17,275,158,296,292,454,2297,3718,9,34017,1889,1,2,8,0,1
13239,566,12055,72,33,56,0,4,12,72,1,1,1,1,2,2,0,2,0,1,0,0,2,2,0,1
13240,566,12055,1454,835,1044,76,110,219,1530,17,275,158,296,292,454,2297,3718,9,34017,1889,1,2,2,0,1
13241,117,2369,1513,682,1277,25,13,200,1538,11,199,116,219,210,335,1557,2584,6,15641,868,0,2,17,6,0
13242,117,2369,819,519,539,24,98,155,843,15,96,57,106,111,163,690,1107,8,9171,509,0,2,17,6,0
13243,113,4391,1513,682,1277,25,13,200,1538,11,199,116,219,210,335,1557,2584,6,15641,868,0,2,16,0,0
13244,566,12055,72,33,56,0,4,12,72,1,1,1,1,2,2,0,2,0,1,0,0,2,19,4,0
13245,566,12055,1454,835,1044,76,110,219,1530,17,275,158,296,292,454,2297,3718,9,34017,1889,1,2,19,4,0
13246,16,362,256,139,192,9,7,47,265,4,23,12,24,27,36,112,171,2,357,19,0,2,20,0,0
13247,16,362,256,139,192,9,7,47,265,4,23,12,24,27,36,112,171,2,357,19,0,2,1,1,0
13248,54,2999,1296,573,1062,40,33,157,1336,8,201,118,231,209,349,1561,2689,4,12365,686,0,2,3,1,0
13249,37,793,2,2,2,0,0,0,2,0,0,0,0,0,0,0,0,0,0,0,0,2,35,15,1
13250,37,793,99,48,90,1,3,5,100,0,0,0,0,0,0,0,0,0,0,0,0,2,35,15,1
13251,37,793,8,5,5,2,0,1,10,0,0,0,0,0,0,0,0,0,0,0,0,2,35,15,1
13252,37,793,1217,716,841,84,126,174,1301,14,185,118,215,199,333,1446,2542,8,20687,1149,0,2,35,15,1
13253,37,793,160,89,115,0,13,31,160,7,15,11,17,22,28,78,124,3,495,27,0,2,35,15,1
13254,37,793,10,10,9,9,0,0,19,0,0,0,0,0,0,0,0,0,0,0,0,2,35,15,1
13255,37,793,173,84,99,8,29,36,181,5,12,7,13,17,20,54,81,2,221,12,0,2,35,15,1
13256,37,793,3,1,1,3,0,0,6,0,0,0,0,0,0,0,0,0,0,0,0,2,35,15,1
13257,151,4796,1660,832,1314,41,38,274,1701,20,312,209,395,332,604,2671,5058,12,64042,3557,1,2,35,22,1
13258,151,4796,1057,646,719,113,100,145,1170,18,215,134,248,233,382,1740,3004,10,31186,1732,1,2,35,22,1
13259,141,3690,1660,832,1314,41,38,274,1701,20,312,209,395,332,604,2671,5058,12,64042,3557,1,2,34,0,1
13260,59,2950,1457,730,1242,11,6,188,1468,10,292,166,329,302,495,2424,4078,5,22973,1276,1,2,8,3,1
13261,220,4876,722,423,573,19,0,135,741,12,172,101,199,184,300,1320,2257,6,15668,870,0,2,7,4,1
13262,220,4876,1508,847,911,44,250,301,1552,14,148,88,169,162,257,1120,1886,7,15077,837,0,2,7,4,1
13263,37,788,2,2,2,0,0,0,2,0,0,0,0,0,0,0,0,0,0,0,0,2,1,2,1
13264,37,788,99,48,90,1,3,5,100,0,0,0,0,0,0,0,0,0,0,0,0,2,1,2,1
13265,37,788,8,5,5,2,0,1,10,0,0,0,0,0,0,0,0,0,0,0,0,2,1,2,1
13266,37,788,1217,716,841,84,126,174,1301,14,185,118,215,199,333,1446,2542,8,20687,1149,0,2,1,2,1
13267,37,788,160,89,115,0,13,31,160,7,15,11,17,22,28,78,124,3,495,27,0,2,1,2,1
13268,37,788,10,10,9,9,0,0,19,0,0,0,0,0,0,0,0,0,0,0,0,2,1,2,1
13269,37,788,173,84,99,8,29,36,181,5,12,7,13,17,20,54,81,2,221,12,0,2,1,2,1
13270,37,788,3,1,1,3,0,0,6,0,0,0,0,0,0,0,0,0,0,0,0,2,1,2,1
13271,150,4790,1660,832,1314,41,38,274,1701,20,312,209,395,332,604,2671,5058,12,64042,3557,1,2,3,5,1
13272,150,4790,1057,646,719,113,100,145,1170,18,215,134,248,233,382,1740,3004,10,31186,1732,1,2,3,5,1
13273,516,11121,72,33,56,0,4,12,72,1,1,1,1,2,2,0,2,0,1,0,0,2,19,0,1
13274,516,11121,1454,835,1044,76,110,219,1530,17,275,158,296,292,454,2297,3718,9,34017,1889,1,2,19,0,1
13275,145,6464,139,89,101,2,0,35,141,7,54,34,62,61,96,330,569,4,2287,127,0,2,105,0,1
13276,145,6464,7,5,5,0,0,2,7,1,2,1,2,3,3,2,4,0,2,0,0,2,105,0,1
13277,37,784,2,2,2,0,0,0,2,0,0,0,0,0,0,0,0,0,0,0,0,2,0,1,0
13278,37,784,99,48,90,1,3,5,100,0,0,0,0,0,0,0,0,0,0,0,0,2,0,1,0
13279,37,784,8,5,5,2,0,1,10,0,0,0,0,0,0,0,0,0,0,0,0,2,0,1,0
13280,37,784,1217,716,841,84,126,174,1301,14,185,118,215,199,333,1446,2542,8,20687,1149,0,2,0,1,0
13281,37,784,160,89,115,0,13,31,160,7,15,11,17,22,28,78,124,3,495,27,0,2,0,1,0
13282,37,784,10,10,9,9,0,0,19,0,0,0,0,0,0,0,0,0,0,0,0,2,0,1,0
13283,37,784,173,84,99,8,29,36,181,5,12,7,13,17,20,54,81,2,221,12,0,2,0,1,0
13284,37,784,3,1,1,3,0,0,6,0,0,0,0,0,0,0,0,0,0,0,0,2,0,1,0
13285,150,4791,1660,832,1314,41,38,274,1701,20,312,209,395,332,604,2671,5058,12,64042,3557,1,2,1,1,0
13286,150,4791,1057,646,719,113,100,145,1170,18,215,134,248,233,382,1740,3004,10,31186,1732,1,2,1,1,0
13287,175,4054,77,34,69,0,0,8,77,3,24,16,29,27,45,114,213,1,387,21,0,2,8,0,1
13288,175,4054,712,438,573,51,9,84,763,14,102,71,128,116,199,733,1364,8,11988,666,0,2,8,0,1
13289,71,2946,1289,550,1043,56,32,155,1345,10,167,93,185,177,278,1266,2075,5,11498,638,0,2,6,4,1
13290,58,3261,1296,573,1062,40,33,157,1336,8,201,118,231,209,349,1561,2689,4,12365,686,0,2,111,0,1
13291,54,2412,1455,414,1257,16,76,112,1471,5,41,23,46,46,69,231,381,2,1069,59,0,2,17,4,1
13292,16,1265,215,129,180,6,0,29,221,8,65,43,72,73,115,415,711,4,3153,175,0,2,1,1,1
13293,72,3652,1943,715,1694,26,18,214,1969,12,185,120,237,197,357,1436,2721,7,20915,1161,0,2,1,1,1
13294,514,11012,72,33,56,0,4,12,72,1,1,1,1,2,2,0,2,0,1,0,0,2,1,1,1
13295,514,11012,1454,835,1044,76,110,219,1530,17,275,158,296,292,454,2297,3718,9,34017,1889,1,2,1,1,1
13296,117,2369,1513,682,1277,25,13,200,1538,11,199,116,219,210,335,1557,2584,6,15641,868,0,2,1,1,1
13297,117,2369,819,519,539,24,98,155,843,15,96,57,106,111,163,690,1107,8,9171,509,0,2,1,1,1
13298,24,810,74,35,59,1,0,14,75,3,14,7,14,17,21,58,85,1,128,7,0,2,2,2,1
13299,24,810,245,125,200,5,7,34,250,7,30,17,34,37,51,166,265,3,1053,58,0,2,2,2,1
13300,47,548,647,139,84,35,284,233,682,0,0,0,0,0,0,0,0,0,0,0,0,2,1,1,1
13301,219,4866,722,423,573,19,0,135,741,12,172,101,199,184,300,1320,2257,6,15668,870,0,2,15,15,1
13302,219,4866,1508,847,911,44,250,301,1552,14,148,88,169,162,257,1120,1886,7,15077,837,0,2,15,15,1
13303,566,12055,72,33,56,0,4,12,72,1,1,1,1,2,2,0,2,0,1,0,0,2,1,1,1
13304,566,12055,1454,835,1044,76,110,219,1530,17,275,158,296,292,454,2297,3718,9,34017,1889,1,2,1,1,1
13305,3,23,14,7,7,2,0,5,16,0,0,0,0,0,0,0,0,0,0,0,0,2,1,1,1
13306,20,625,42,7,35,4,0,5,46,1,2,1,2,3,3,2,4,0,2,0,0,2,1,0,1
13307,20,625,11,6,10,0,0,1,11,2,4,2,4,6,6,10,15,1,15,0,0,2,1,0,1
13308,58,2960,1457,730,1242,11,6,188,1468,10,292,166,329,302,495,2424,4078,5,22973,1276,1,2,1,1,1
13309,8,265,74,35,59,1,0,14,75,3,14,7,14,17,21,58,85,1,128,7,0,2,2,2,1
13310,75,3651,1523,757,1297,19,12,193,1542,12,193,117,230,205,347,1508,2664,7,19053,1058,0,2,1,1,1
13311,38,2201,334,251,279,10,4,40,344,5,127,74,143,132,217,899,1528,2,4303,239,0,2,6,7,1
13312,220,4876,722,423,573,19,0,135,741,12,172,101,199,184,300,1320,2257,6,15668,870,0,2,7,4,0
13313,220,4876,1508,847,911,44,250,301,1552,14,148,88,169,162,257,1120,1886,7,15077,837,0,2,7,4,0
13314,175,4054,77,34,69,0,0,8,77,3,24,16,29,27,45,114,213,1,387,21,0,2,8,0,0
13315,175,4054,712,438,573,51,9,84,763,14,102,71,128,116,199,733,1364,8,11988,666,0,2,8,0,0
13316,71,2946,1289,550,1043,56,32,155,1345,10,167,93,185,177,278,1266,2075,5,11498,638,0,2,6,4,0
13317,58,3261,1296,573,1062,40,33,157,1336,8,201,118,231,209,349,1561,2689,4,12365,686,0,2,111,0,0
13318,54,2412,1455,414,1257,16,76,112,1471,5,41,23,46,46,69,231,381,2,1069,59,0,2,17,4,0
13319,16,1265,215,129,180,6,0,29,221,8,65,43,72,73,115,415,711,4,3153,175,0,2,1,1,0
13320,72,3652,1943,715,1694,26,18,214,1969,12,185,120,237,197,357,1436,2721,7,20915,1161,0,2,1,1,0
13321,175,4054,77,34,69,0,0,8,77,3,24,16,29,27,45,114,213,1,387,21,0,2,8,0,0
13322,175,4054,712,438,573,51,9,84,763,14,102,71,128,116,199,733,1364,8,11988,666,0,2,8,0,0
13323,71,2946,1289,550,1043,56,32,155,1345,10,167,93,185,177,278,1266,2075,5,11498,638,0,2,6,4,0
13324,58,3261,1296,573,1062,40,33,157,1336,8,201,118,231,209,349,1561,2689,4,12365,686,0,2,111,0,0
13325,54,2412,1455,414,1257,16,76,112,1471,5,41,23,46,46,69,231,381,2,1069,59,0,2,17,4,0
13326,16,1265,215,129,180,6,0,29,221,8,65,43,72,73,115,415,711,4,3153,175,0,2,1,1,0
13327,72,3652,1943,715,1694,26,18,214,1969,12,185,120,237,197,357,1436,2721,7,20915,1161,0,2,1,1,0
13328,37,784,2,2,2,0,0,0,2,0,0,0,0,0,0,0,0,0,0,0,0,2,34,16,0
13329,37,784,99,48,90,1,3,5,100,0,0,0,0,0,0,0,0,0,0,0,0,2,34,16,0
13330,37,784,8,5,5,2,0,1,10,0,0,0,0,0,0,0,0,0,0,0,0,2,34,16,0
13331,37,784,1217,716,841,84,126,174,1301,14,185,118,215,199,333,1446,2542,8,20687,1149,0,2,34,16,0
13332,37,784,160,89,115,0,13,31,160,7,15,11,17,22,28,78,124,3,495,27,0,2,34,16,0
13333,37,784,10,10,9,9,0,0,19,0,0,0,0,0,0,0,0,0,0,0,0,2,34,16,0
13334,37,784,173,84,99,8,29,36,181,5,12,7,13,17,20,54,81,2,221,12,0,2,34,16,0
13335,37,784,3,1,1,3,0,0,6,0,0,0,0,0,0,0,0,0,0,0,0,2,34,16,0
13336,150,4791,1660,832,1314,41,38,274,1701,20,312,209,395,332,604,2671,5058,12,64042,3557,1,2,34,23,0
13337,150,4791,1057,646,719,113,100,145,1170,18,215,134,248,233,382,1740,3004,10,31186,1732,1,2,34,23,0
13338,141,3690,1660,832,1314,41,38,274,1701,20,312,209,395,332,604,2671,5058,12,64042,3557,1,2,34,0,0
13339,59,2950,1457,730,1242,11,6,188,1468,10,292,166,329,302,495,2424,4078,5,22973,1276,1,2,8,3,0
13340,54,2999,1296,573,1062,40,33,157,1336,8,201,118,231,209,349,1561,2689,4,12365,686,0,2,3,1,0
13341,514,11012,72,33,56,0,4,12,72,1,1,1,1,2,2,0,2,0,1,0,0,2,1,1,0
13342,514,11012,1454,835,1044,76,110,219,1530,17,275,158,296,292,454,2297,3718,9,34017,1889,1,2,1,1,0
13343,117,2369,1513,682,1277,25,13,200,1538,11,199,116,219,210,335,1557,2584,6,15641,868,0,2,1,1,0
13344,117,2369,819,519,539,24,98,155,843,15,96,57,106,111,163,690,1107,8,9171,509,0,2,1,1,0
13345,24,810,74,35,59,1,0,14,75,3,14,7,14,17,21,58,85,1,128,7,0,2,2,2,0
13346,24,810,245,125,200,5,7,34,250,7,30,17,34,37,51,166,265,3,1053,58,0,2,2,2,0
13347,47,548,647,139,84,35,284,233,682,0,0,0,0,0,0,0,0,0,0,0,0,2,1,1,0
13348,219,4866,722,423,573,19,0,135,741,12,172,101,199,184,300,1320,2257,6,15668,870,0,2,15,15,0
13349,219,4866,1508,847,911,44,250,301,1552,14,148,88,169,162,257,1120,1886,7,15077,837,0,2,15,15,0
13350,566,12055,72,33,56,0,4,12,72,1,1,1,1,2,2,0,2,0,1,0,0,2,1,1,0
13351,566,12055,1454,835,1044,76,110,219,1530,17,275,158,296,292,454,2297,3718,9,34017,1889,1,2,1,1,0
13352,3,23,14,7,7,2,0,5,16,0,0,0,0,0,0,0,0,0,0,0,0,2,1,1,0
13353,20,625,42,7,35,4,0,5,46,1,2,1,2,3,3,2,4,0,2,0,0,2,1,0,0
13354,20,625,11,6,10,0,0,1,11,2,4,2,4,6,6,10,15,1,15,0,0,2,1,0,0
13355,59,2950,1457,730,1242,11,6,188,1468,10,292,166,329,302,495,2424,4078,5,22973,1276,1,2,1,1,0
13356,8,265,74,35,59,1,0,14,75,3,14,7,14,17,21,58,85,1,128,7,0,2,2,2,0
13357,75,3651,1523,757,1297,19,12,193,1542,12,193,117,230,205,347,1508,2664,7,19053,1058,0,2,1,1,0
13358,38,2201,334,251,279,10,4,40,344,5,127,74,143,132,217,899,1528,2,4303,239,0,2,6,7,0
13359,516,11123,72,33,56,0,4,12,72,1,1,1,1,2,2,0,2,0,1,0,0,2,19,0,0
13360,516,11123,1454,835,1044,76,110,219,1530,17,275,158,296,292,454,2297,3718,9,34017,1889,1,2,19,0,0
13361,145,6464,139,89,101,2,0,35,141,7,54,34,62,61,96,330,569,4,2287,127,0,2,105,0,0
13362,145,6464,7,5,5,0,0,2,7,1,2,1,2,3,3,2,4,0,2,0,0,2,105,0,0
13363,173,4021,77,34,69,0,0,8,77,3,24,16,29,27,45,114,213,1,387,21,0,2,2,0,1
13364,173,4021,712,438,573,51,9,84,763,14,102,71,128,116,199,733,1364,8,11988,666,0,2,2,0,1
13365,569,12221,72,33,56,0,4,12,72,1,1,1,1,2,2,0,2,0,1,0,0,2,15,0,1
13366,569,12221,1454,835,1044,76,110,219,1530,17,275,158,296,292,454,2297,3718,9,34017,1889,1,2,15,0,1
13367,120,2635,1043,504,840,53,9,147,1096,9,180,112,198,189,310,1377,2344,4,11604,644,0,2,11,1,1
13368,120,2635,383,288,292,26,6,62,409,11,65,38,67,76,105,429,656,5,3719,206,0,2,11,1,1
13369,90,1955,477,336,357,30,23,73,507,16,194,134,250,210,384,1538,2962,10,30538,1696,0,2,3,2,1
13370,76,2747,1450,624,1228,12,26,181,1462,14,306,186,354,320,540,2580,4493,8,36391,2021,1,2,15,1,1
13371,121,2646,1043,504,840,53,9,147,1096,9,180,112,198,189,310,1377,2344,4,11604,644,0,2,12,8,1
13372,121,2646,383,288,292,26,6,62,409,11,65,38,67,76,105,429,656,5,3719,206,0,2,12,8,1
13373,146,6501,139,89,101,2,0,35,141,7,54,34,62,61,96,330,569,4,2287,127,0,2,14,0,1
13374,146,6501,7,5,5,0,0,2,7,1,2,1,2,3,3,2,4,0,2,0,0,2,14,0,1
13375,573,12239,72,33,56,0,4,12,72,1,1,1,1,2,2,0,2,0,1,0,0,2,22,12,1
13376,573,12239,1454,835,1044,76,110,219,1530,17,275,158,296,292,454,2297,3718,9,34017,1889,1,2,22,12,1
13377,121,2646,1043,504,840,53,9,147,1096,9,180,112,198,189,310,1377,2344,4,11604,644,0,2,12,8,0
13378,121,2646,383,288,292,26,6,62,409,11,65,38,67,76,105,429,656,5,3719,206,0,2,12,8,0
13379,575,12268,72,33,56,0,4,12,72,1,1,1,1,2,2,0,2,0,1,0,0,2,9,1,0
13380,575,12268,1454,835,1044,76,110,219,1530,17,275,158,296,292,454,2297,3718,9,34017,1889,1,2,9,1,0
13381,3,147,601,196,481,2,23,85,603,8,63,36,72,71,108,400,664,4,3036,168,0,0,27,0,1
13382,579,12308,72,33,56,0,4,12,72,1,1,1,1,2,2,0,2,0,1,0,0,2,6,0,0
13383,579,12308,1454,835,1044,76,110,219,1530,17,275,158,296,292,454,2297,3718,9,34017,1889,1,2,6,0,0
13384,121,2645,1043,504,840,53,9,147,1096,9,180,112,198,189,310,1377,2344,4,11604,644,0,2,2,3,0
13385,121,2645,383,288,292,26,6,62,409,11,65,38,67,76,105,429,656,5,3719,206,0,2,2,3,0
13386,579,12308,72,33,56,0,4,12,72,1,1,1,1,2,2,0,2,0,1,0,0,2,6,0,0
13387,579,12308,1454,835,1044,76,110,219,1530,17,275,158,296,292,454,2297,3718,9,34017,1889,1,2,6,0,0
13388,121,2645,1043,504,840,53,9,147,1096,9,180,112,198,189,310,1377,2344,4,11604,644,0,2,2,3,0
13389,121,2645,383,288,292,26,6,62,409,11,65,38,67,76,105,429,656,5,3719,206,0,2,2,3,0
13390,90,1955,477,336,357,30,23,73,507,16,194,134,250,210,384,1538,2962,10,30538,1696,0,2,3,2,0
13391,76,2747,1450,624,1228,12,26,181,1462,14,306,186,354,320,540,2580,4493,8,36391,2021,1,2,15,1,0
13392,2,67,7,6,5,0,0,2,7,1,1,1,2,2,3,0,3,1,3,0,0,0,13,0,0
13393,216,4657,182,127,129,0,0,53,182,5,39,21,42,44,63,217,343,2,926,51,0,2,7,4,1
13394,216,4657,1165,710,800,67,119,181,1232,18,243,153,282,261,435,2000,3492,10,36473,2026,1,2,7,4,1
13395,55,1468,1455,414,1257,16,76,112,1471,5,41,23,46,46,69,231,381,2,1069,59,0,2,6,10,1
13396,55,1468,669,365,481,22,61,110,691,15,103,63,122,118,185,747,1273,8,11311,628,0,2,6,10,1
13397,175,4054,77,34,69,0,0,8,77,3,24,16,29,27,45,114,213,1,387,21,0,2,32,40,1
13398,175,4054,712,438,573,51,9,84,763,14,102,71,128,116,199,733,1364,8,11988,666,0,2,32,40,1
13399,220,4876,722,423,573,19,0,135,741,12,172,101,199,184,300,1320,2257,6,15668,870,0,2,7,4,1
13400,220,4876,1508,847,911,44,250,301,1552,14,148,88,169,162,257,1120,1886,7,15077,837,0,2,7,4,1
13401,568,12168,72,33,56,0,4,12,72,1,1,1,1,2,2,0,2,0,1,0,0,2,20,1,1
13402,568,12168,1454,835,1044,76,110,219,1530,17,275,158,296,292,454,2297,3718,9,34017,1889,1,2,20,1,1
13403,77,3179,1289,550,1043,56,32,155,1345,10,167,93,185,177,278,1266,2075,5,11498,638,0,2,70,9,1
13404,139,6353,1392,870,1177,35,17,170,1427,14,494,280,531,508,811,4473,7289,7,54850,3047,2,2,12,0,1
13405,144,6503,139,89,101,2,0,35,141,7,54,34,62,61,96,330,569,4,2287,127,0,2,105,0,1
13406,144,6503,7,5,5,0,0,2,7,1,2,1,2,3,3,2,4,0,2,0,0,2,105,0,1
13407,59,3272,1296,573,1062,40,33,157,1336,8,201,118,231,209,349,1561,2689,4,12365,686,0,2,3,1,1
13408,55,2458,1455,414,1257,16,76,112,1471,5,41,23,46,46,69,231,381,2,1069,59,0,2,10,2,1
13409,63,2641,1043,504,840,53,9,147,1096,9,180,112,198,189,310,1377,2344,4,11604,644,0,2,33,0,1
13410,71,3617,1943,715,1694,26,18,214,1969,12,185,120,237,197,357,1436,2721,7,20915,1161,0,2,0,5,1
13411,579,12308,72,33,56,0,4,12,72,1,1,1,1,2,2,0,2,0,1,0,0,2,2,2,0
13412,579,12308,1454,835,1044,76,110,219,1530,17,275,158,296,292,454,2297,3718,9,34017,1889,1,2,2,2,0
13413,121,2645,1043,504,840,53,9,147,1096,9,180,112,198,189,310,1377,2344,4,11604,644,0,2,2,2,0
13414,121,2645,383,288,292,26,6,62,409,11,65,38,67,76,105,429,656,5,3719,206,0,2,2,2,0
13415,2,67,7,6,5,0,0,2,7,1,1,1,2,2,3,0,3,1,3,0,0,0,13,0,0
13416,146,6501,139,89,101,2,0,35,141,7,54,34,62,61,96,330,569,4,2287,127,0,2,14,0,0
13417,146,6501,7,5,5,0,0,2,7,1,2,1,2,3,3,2,4,0,2,0,0,2,14,0,0
13418,2,67,7,6,5,0,0,2,7,1,1,1,2,2,3,0,3,1,3,0,0,0,13,0,0
13419,90,1955,477,336,357,30,23,73,507,16,194,134,250,210,384,1538,2962,10,30538,1696,0,2,3,2,0
13420,145,6540,139,89,101,2,0,35,141,7,54,34,62,61,96,330,569,4,2287,127,0,2,14,0,0
13421,145,6540,7,5,5,0,0,2,7,1,2,1,2,3,3,2,4,0,2,0,0,2,14,0,0
13422,76,2747,1450,624,1228,12,26,181,1462,14,306,186,354,320,540,2580,4493,8,36391,2021,1,2,15,1,0
13423,579,12308,72,33,56,0,4,12,72,1,1,1,1,2,2,0,2,0,1,0,0,2,2,2,0
13424,579,12308,1454,835,1044,76,110,219,1530,17,275,158,296,292,454,2297,3718,9,34017,1889,1,2,2,2,0
13425,121,2645,1043,504,840,53,9,147,1096,9,180,112,198,189,310,1377,2344,4,11604,644,0,2,2,2,0
13426,121,2645,383,288,292,26,6,62,409,11,65,38,67,76,105,429,656,5,3719,206,0,2,2,2,0
13427,173,4038,77,34,69,0,0,8,77,3,24,16,29,27,45,114,213,1,387,21,0,2,3,0,1
13428,173,4038,712,438,573,51,9,84,763,14,102,71,128,116,199,733,1364,8,11988,666,0,2,3,0,1
13429,582,12336,72,33,56,0,4,12,72,1,1,1,1,2,2,0,2,0,1,0,0,2,10,5,1
13430,582,12336,1454,835,1044,76,110,219,1530,17,275,158,296,292,454,2297,3718,9,34017,1889,1,2,10,5,1
13431,122,2653,1043,504,840,53,9,147,1096,9,180,112,198,189,310,1377,2344,4,11604,644,0,2,1,1,1
13432,122,2653,383,288,292,26,6,62,409,11,65,38,67,76,105,429,656,5,3719,206,0,2,1,1,1
13433,216,4657,182,127,129,0,0,53,182,5,39,21,42,44,63,217,343,2,926,51,0,2,7,4,0
13434,216,4657,1165,710,800,67,119,181,1232,18,243,153,282,261,435,2000,3492,10,36473,2026,1,2,7,4,0
13435,90,1955,477,336,357,30,23,73,507,16,194,134,250,210,384,1538,2962,10,30538,1696,0,2,3,2,0
13436,55,1468,1455,414,1257,16,76,112,1471,5,41,23,46,46,69,231,381,2,1069,59,0,2,6,10,0
13437,55,1468,669,365,481,22,61,110,691,15,103,63,122,118,185,747,1273,8,11311,628,0,2,6,10,0
13438,175,4054,77,34,69,0,0,8,77,3,24,16,29,27,45,114,213,1,387,21,0,2,32,40,0
13439,175,4054,712,438,573,51,9,84,763,14,102,71,128,116,199,733,1364,8,11988,666,0,2,32,40,0
13440,220,4876,722,423,573,19,0,135,741,12,172,101,199,184,300,1320,2257,6,15668,870,0,2,7,4,0
13441,220,4876,1508,847,911,44,250,301,1552,14,148,88,169,162,257,1120,1886,7,15077,837,0,2,7,4,0
13442,568,12168,72,33,56,0,4,12,72,1,1,1,1,2,2,0,2,0,1,0,0,2,20,1,0
13443,568,12168,1454,835,1044,76,110,219,1530,17,275,158,296,292,454,2297,3718,9,34017,1889,1,2,20,1,0
13444,77,3179,1289,550,1043,56,32,155,1345,10,167,93,185,177,278,1266,2075,5,11498,638,0,2,70,9,0
13445,139,6353,1392,870,1177,35,17,170,1427,14,494,280,531,508,811,4473,7289,7,54850,3047,2,2,12,0,0
13446,145,6540,139,89,101,2,0,35,141,7,54,34,62,61,96,330,569,4,2287,127,0,2,119,0,0
13447,145,6540,7,5,5,0,0,2,7,1,2,1,2,3,3,2,4,0,2,0,0,2,119,0,0
13448,76,2747,1450,624,1228,12,26,181,1462,14,306,186,354,320,540,2580,4493,8,36391,2021,1,2,15,1,0
13449,59,3272,1296,573,1062,40,33,157,1336,8,201,118,231,209,349,1561,2689,4,12365,686,0,2,3,1,0
13450,55,2458,1455,414,1257,16,76,112,1471,5,41,23,46,46,69,231,381,2,1069,59,0,2,10,2,0
13451,63,2641,1043,504,840,53,9,147,1096,9,180,112,198,189,310,1377,2344,4,11604,644,0,2,33,0,0
13452,71,3617,1943,715,1694,26,18,214,1969,12,185,120,237,197,357,1436,2721,7,20915,1161,0,2,0,5,0
13453,216,4657,182,127,129,0,0,53,182,5,39,21,42,44,63,217,343,2,926,51,0,2,7,4,0
13454,216,4657,1165,710,800,67,119,181,1232,18,243,153,282,261,435,2000,3492,10,36473,2026,1,2,7,4,0
13455,37,784,2,2,2,0,0,0,2,0,0,0,0,0,0,0,0,0,0,0,0,2,34,16,0
13456,37,784,99,48,90,1,3,5,100,0,0,0,0,0,0,0,0,0,0,0,0,2,34,16,0
13457,37,784,8,5,5,2,0,1,10,0,0,0,0,0,0,0,0,0,0,0,0,2,34,16,0
13458,37,784,1217,716,841,84,126,174,1301,14,185,118,215,199,333,1446,2542,8,20687,1149,0,2,34,16,0
13459,37,784,160,89,115,0,13,31,160,7,15,11,17,22,28,78,124,3,495,27,0,2,34,16,0
13460,37,784,10,10,9,9,0,0,19,0,0,0,0,0,0,0,0,0,0,0,0,2,34,16,0
13461,37,784,173,84,99,8,29,36,181,5,12,7,13,17,20,54,81,2,221,12,0,2,34,16,0
13462,37,784,3,1,1,3,0,0,6,0,0,0,0,0,0,0,0,0,0,0,0,2,34,16,0
13463,150,4791,1660,832,1314,41,38,274,1701,20,312,209,395,332,604,2671,5058,12,64042,3557,1,2,34,23,0
13464,150,4791,1057,646,719,113,100,145,1170,18,215,134,248,233,382,1740,3004,10,31186,1732,1,2,34,23,0
13465,90,1955,477,336,357,30,23,73,507,16,194,134,250,210,384,1538,2962,10,30538,1696,0,2,3,2,0
13466,117,2369,1513,682,1277,25,13,200,1538,11,199,116,219,210,335,1557,2584,6,15641,868,0,2,1,1,0
13467,117,2369,819,519,539,24,98,155,843,15,96,57,106,111,163,690,1107,8,9171,509,0,2,1,1,0
13468,55,1468,1455,414,1257,16,76,112,1471,5,41,23,46,46,69,231,381,2,1069,59,0,2,6,10,0
13469,55,1468,669,365,481,22,61,110,691,15,103,63,122,118,185,747,1273,8,11311,628,0,2,6,10,0
13470,24,810,74,35,59,1,0,14,75,3,14,7,14,17,21,58,85,1,128,7,0,2,2,2,0
13471,24,810,245,125,200,5,7,34,250,7,30,17,34,37,51,166,265,3,1053,58,0,2,2,2,0
13472,47,548,647,139,84,35,284,233,682,0,0,0,0,0,0,0,0,0,0,0,0,2,1,1,0
13473,175,4087,77,34,69,0,0,8,77,3,24,16,29,27,45,114,213,1,387,21,0,2,40,40,0
13474,175,4087,712,438,573,51,9,84,763,14,102,71,128,116,199,733,1364,8,11988,666,0,2,40,40,0
13475,220,4876,722,423,573,19,0,135,741,12,172,101,199,184,300,1320,2257,6,15668,870,0,2,22,19,0
13476,220,4876,1508,847,911,44,250,301,1552,14,148,88,169,162,257,1120,1886,7,15077,837,0,2,22,19,0
13477,584,12449,72,33,56,0,4,12,72,1,1,1,1,2,2,0,2,0,1,0,0,2,21,2,0
13478,584,12449,1454,835,1044,76,110,219,1530,17,275,158,296,292,454,2297,3718,9,34017,1889,1,2,21,2,0
13479,3,23,14,7,7,2,0,5,16,0,0,0,0,0,0,0,0,0,0,0,0,2,1,1,0
13480,20,625,42,7,35,4,0,5,46,1,2,1,2,3,3,2,4,0,2,0,0,2,1,0,0
13481,20,625,11,6,10,0,0,1,11,2,4,2,4,6,6,10,15,1,15,0,0,2,1,0,0
13482,77,3179,1289,550,1043,56,32,155,1345,10,167,93,185,177,278,1266,2075,5,11498,638,0,2,76,13,0
13483,139,6353,1392,870,1177,35,17,170,1427,14,494,280,531,508,811,4473,7289,7,54850,3047,2,2,12,0,0
13484,145,6540,139,89,101,2,0,35,141,7,54,34,62,61,96,330,569,4,2287,127,0,2,119,0,0
13485,145,6540,7,5,5,0,0,2,7,1,2,1,2,3,3,2,4,0,2,0,0,2,119,0,0
13486,76,2747,1450,624,1228,12,26,181,1462,14,306,186,354,320,540,2580,4493,8,36391,2021,1,2,15,1,0
13487,141,3690,1660,832,1314,41,38,274,1701,20,312,209,395,332,604,2671,5058,12,64042,3557,1,2,34,0,0
13488,59,3272,1296,573,1062,40,33,157,1336,8,201,118,231,209,349,1561,2689,4,12365,686,0,2,114,1,0
13489,59,2950,1457,730,1242,11,6,188,1468,10,292,166,329,302,495,2424,4078,5,22973,1276,1,2,9,4,0
13490,55,2458,1455,414,1257,16,76,112,1471,5,41,23,46,46,69,231,381,2,1069,59,0,2,27,6,0
13491,2,67,7,6,5,0,0,2,7,1,1,1,2,2,3,0,3,1,3,0,0,0,13,0,0
13492,8,265,74,35,59,1,0,14,75,3,14,7,14,17,21,58,85,1,128,7,0,2,2,2,0
13493,75,3651,1523,757,1297,19,12,193,1542,12,193,117,230,205,347,1508,2664,7,19053,1058,0,2,1,1,0
13494,38,2201,334,251,279,10,4,40,344,5,127,74,143,132,217,899,1528,2,4303,239,0,2,6,7,0
13495,16,1265,215,129,180,6,0,29,221,8,65,43,72,73,115,415,711,4,3153,175,0,2,1,1,0
13496,63,2641,1043,504,840,53,9,147,1096,9,180,112,198,189,310,1377,2344,4,11604,644,0,2,33,0,0
13497,71,3617,1943,715,1694,26,18,214,1969,12,185,120,237,197,357,1436,2721,7,20915,1161,0,2,1,6,0
13498,307,6253,1457,730,1242,11,6,188,1468,10,292,166,329,302,495,2424,4078,5,22973,1276,1,2,4,0,0
13499,307,6253,74,35,59,1,0,14,75,3,14,7,14,17,21,58,85,1,128,7,0,2,4,0,0
13500,307,6253,245,125,200,5,7,34,250,7,30,17,34,37,51,166,265,3,1053,58,0,2,4,0,0
13501,39,2266,334,251,279,10,4,40,344,5,127,74,143,132,217,899,1528,2,4303,239,0,2,7,0,0
13502,307,6253,1457,730,1242,11,6,188,1468,10,292,166,329,302,495,2424,4078,5,22973,1276,1,2,4,0,0
13503,307,6253,74,35,59,1,0,14,75,3,14,7,14,17,21,58,85,1,128,7,0,2,4,0,0
13504,307,6253,245,125,200,5,7,34,250,7,30,17,34,37,51,166,265,3,1053,58,0,2,4,0,0
13505,39,2266,334,251,279,10,4,40,344,5,127,74,143,132,217,899,1528,2,4303,239,0,2,7,0,0
13506,584,12469,72,33,56,0,4,12,72,1,1,1,1,2,2,0,2,0,1,0,0,2,3,1,0
13507,584,12469,1454,835,1044,76,110,219,1530,17,275,158,296,292,454,2297,3718,9,34017,1889,1,2,3,1,0
13508,122,2648,1043,504,840,53,9,147,1096,9,180,112,198,189,310,1377,2344,4,11604,644,0,2,1,1,0
13509,122,2648,383,288,292,26,6,62,409,11,65,38,67,76,105,429,656,5,3719,206,0,2,1,1,0
13510,585,12481,72,33,56,0,4,12,72,1,1,1,1,2,2,0,2,0,1,0,0,2,9,7,0
13511,585,12481,1454,835,1044,76,110,219,1530,17,275,158,296,292,454,2297,3718,9,34017,1889,1,2,9,7,0
13512,53,1425,1455,414,1257,16,76,112,1471,5,41,23,46,46,69,231,381,2,1069,59,0,2,1,1,1
13513,53,1425,669,365,481,22,61,110,691,15,103,63,122,118,185,747,1273,8,11311,628,0,2,1,1,1
13514,517,11149,72,33,56,0,4,12,72,1,1,1,1,2,2,0,2,0,1,0,0,2,17,10,1
13515,517,11149,1454,835,1044,76,110,219,1530,17,275,158,296,292,454,2297,3718,9,34017,1889,1,2,17,10,1
13516,122,5398,1392,870,1177,35,17,170,1427,14,494,280,531,508,811,4473,7289,7,54850,3047,2,2,1,1,1
13517,147,6532,139,89,101,2,0,35,141,7,54,34,62,61,96,330,569,4,2287,127,0,2,27,19,1
13518,147,6532,7,5,5,0,0,2,7,1,2,1,2,3,3,2,4,0,2,0,0,2,27,19,1
13519,83,4488,1782,648,1425,9,47,279,1791,8,171,97,189,179,286,1292,2140,4,9462,525,0,2,2,2,1
13520,34,1289,1293,570,1093,25,15,163,1318,10,195,123,241,205,364,1516,2795,6,17273,959,0,2,1,1,1
13521,53,1425,1455,414,1257,16,76,112,1471,5,41,23,46,46,69,231,381,2,1069,59,0,2,1,1,0
13522,53,1425,669,365,481,22,61,110,691,15,103,63,122,118,185,747,1273,8,11311,628,0,2,1,1,0
13523,517,11149,72,33,56,0,4,12,72,1,1,1,1,2,2,0,2,0,1,0,0,2,17,10,0
13524,517,11149,1454,835,1044,76,110,219,1530,17,275,158,296,292,454,2297,3718,9,34017,1889,1,2,17,10,0
13525,122,5398,1392,870,1177,35,17,170,1427,14,494,280,531,508,811,4473,7289,7,54850,3047,2,2,1,1,0
13526,147,6532,139,89,101,2,0,35,141,7,54,34,62,61,96,330,569,4,2287,127,0,2,27,19,0
13527,147,6532,7,5,5,0,0,2,7,1,2,1,2,3,3,2,4,0,2,0,0,2,27,19,0
13528,83,4488,1782,648,1425,9,47,279,1791,8,171,97,189,179,286,1292,2140,4,9462,525,0,2,2,2,0
13529,34,1289,1293,570,1093,25,15,163,1318,10,195,123,241,205,364,1516,2795,6,17273,959,0,2,1,1,0
13530,82,1803,477,336,357,30,23,73,507,16,194,134,250,210,384,1538,2962,10,30538,1696,0,2,0,33,1
13531,135,3546,1660,832,1314,41,38,274,1701,20,312,209,395,332,604,2671,5058,12,64042,3557,1,2,20,14,1
13532,82,1803,477,336,357,30,23,73,507,16,194,134,250,210,384,1538,2962,10,30538,1696,0,2,0,33,0
13533,135,3546,1660,832,1314,41,38,274,1701,20,312,209,395,332,604,2671,5058,12,64042,3557,1,2,20,14,0
13534,569,12184,72,33,56,0,4,12,72,1,1,1,1,2,2,0,2,0,1,0,0,2,6,0,1
13535,569,12184,1454,835,1044,76,110,219,1530,17,275,158,296,292,454,2297,3718,9,34017,1889,1,2,6,0,1
13536,76,3740,1523,757,1297,19,12,193,1542,12,193,117,230,205,347,1508,2664,7,19053,1058,0,2,41,18,1
13537,16,1198,215,129,180,6,0,29,221,8,65,43,72,73,115,415,711,4,3153,175,0,2,0,9,1
13538,62,2603,1043,504,840,53,9,147,1096,9,180,112,198,189,310,1377,2344,4,11604,644,0,2,0,12,1
13539,22,942,373,158,315,8,0,51,381,5,76,44,79,81,123,486,779,2,2026,112,0,2,1,7,1
13540,67,2869,1178,367,1042,6,15,115,1184,9,94,51,95,103,146,644,976,4,4439,246,0,2,17,5,1
13541,71,3615,1943,715,1694,26,18,214,1969,12,185,120,237,197,357,1436,2721,7,20915,1161,0,2,1,2,1
13542,303,6208,1457,730,1242,11,6,188,1468,10,292,166,329,302,495,2424,4078,5,22973,1276,1,2,7,10,0
13543,303,6208,74,35,59,1,0,14,75,3,14,7,14,17,21,58,85,1,128,7,0,2,7,10,0
13544,303,6208,245,125,200,5,7,34,250,7,30,17,34,37,51,166,265,3,1053,58,0,2,7,10,0
13545,38,2210,334,251,279,10,4,40,344,5,127,74,143,132,217,899,1528,2,4303,239,0,2,3,0,0
13546,303,6198,1457,730,1242,11,6,188,1468,10,292,166,329,302,495,2424,4078,5,22973,1276,1,2,1,4,1
13547,303,6198,74,35,59,1,0,14,75,3,14,7,14,17,21,58,85,1,128,7,0,2,1,4,1
13548,303,6198,245,125,200,5,7,34,250,7,30,17,34,37,51,166,265,3,1053,58,0,2,1,4,1
13549,61,3038,1457,730,1242,11,6,188,1468,10,292,166,329,302,495,2424,4078,5,22973,1276,1,2,17,0,1
13550,304,6218,1457,730,1242,11,6,188,1468,10,292,166,329,302,495,2424,4078,5,22973,1276,1,2,1,1,1
13551,304,6218,74,35,59,1,0,14,75,3,14,7,14,17,21,58,85,1,128,7,0,2,1,1,1
13552,304,6218,245,125,200,5,7,34,250,7,30,17,34,37,51,166,265,3,1053,58,0,2,1,1,1
13553,49,571,647,139,84,35,284,233,682,0,0,0,0,0,0,0,0,0,0,0,0,2,13,0,1
13554,570,12235,72,33,56,0,4,12,72,1,1,1,1,2,2,0,2,0,1,0,0,2,35,74,1
13555,570,12235,1454,835,1044,76,110,219,1530,17,275,158,296,292,454,2297,3718,9,34017,1889,1,2,35,74,1
13556,17,325,294,64,250,0,0,43,294,1,20,10,20,21,30,86,131,0,65,3,0,0,54,0,1
13557,17,325,78,46,62,3,0,14,81,3,8,4,8,11,12,28,41,1,62,3,0,0,54,0,1
13558,4,72,110,30,77,3,13,16,113,4,21,15,30,25,45,100,208,2,597,33,0,0,14,0,1
13559,4,72,28,15,21,1,0,6,29,0,0,0,0,0,0,0,0,0,0,0,0,0,14,0,1
13560,175,4054,77,34,69,0,0,8,77,3,24,16,29,27,45,114,213,1,387,21,0,2,0,5,0
13561,175,4054,712,438,573,51,9,84,763,14,102,71,128,116,199,733,1364,8,11988,666,0,2,0,5,0
13562,18,355,294,64,250,0,0,43,294,1,20,10,20,21,30,86,131,0,65,3,0,2,5,0,0
13563,18,355,78,46,62,3,0,14,81,3,8,4,8,11,12,28,41,1,62,3,0,2,5,0,0
13564,5,103,110,30,77,3,13,16,113,4,21,15,30,25,45,100,208,2,597,33,0,2,5,0,0
13565,5,103,28,15,21,1,0,6,29,0,0,0,0,0,0,0,0,0,0,0,0,2,5,0,0
13566,15,485,42,7,35,4,0,5,46,1,2,1,2,3,3,2,4,0,2,0,0,2,2,24,1
13567,15,485,11,6,10,0,0,1,11,2,4,2,4,6,6,10,15,1,15,0,0,2,2,24,1
13568,304,6218,1457,730,1242,11,6,188,1468,10,292,166,329,302,495,2424,4078,5,22973,1276,1,2,1,1,1
13569,304,6218,74,35,59,1,0,14,75,3,14,7,14,17,21,58,85,1,128,7,0,2,1,1,1
13570,304,6218,245,125,200,5,7,34,250,7,30,17,34,37,51,166,265,3,1053,58,0,2,1,1,1
13571,34,1289,1293,570,1093,25,15,163,1318,10,195,123,241,205,364,1516,2795,6,17273,959,0,2,1,1,1
13572,303,6198,1457,730,1242,11,6,188,1468,10,292,166,329,302,495,2424,4078,5,22973,1276,1,2,1,4,0
13573,303,6198,74,35,59,1,0,14,75,3,14,7,14,17,21,58,85,1,128,7,0,2,1,4,0
13574,303,6198,245,125,200,5,7,34,250,7,30,17,34,37,51,166,265,3,1053,58,0,2,1,4,0
13575,61,3038,1457,730,1242,11,6,188,1468,10,292,166,329,302,495,2424,4078,5,22973,1276,1,2,17,0,0
13576,302,6188,1457,730,1242,11,6,188,1468,10,292,166,329,302,495,2424,4078,5,22973,1276,1,2,7,10,0
13577,302,6188,74,35,59,1,0,14,75,3,14,7,14,17,21,58,85,1,128,7,0,2,7,10,0
13578,302,6188,245,125,200,5,7,34,250,7,30,17,34,37,51,166,265,3,1053,58,0,2,7,10,0
13579,38,2210,334,251,279,10,4,40,344,5,127,74,143,132,217,899,1528,2,4303,239,0,2,3,0,0
13580,302,6188,1457,730,1242,11,6,188,1468,10,292,166,329,302,495,2424,4078,5,22973,1276,1,2,1,1,0
13581,302,6188,74,35,59,1,0,14,75,3,14,7,14,17,21,58,85,1,128,7,0,2,1,1,0
13582,302,6188,245,125,200,5,7,34,250,7,30,17,34,37,51,166,265,3,1053,58,0,2,1,1,0
13583,34,1289,1293,570,1093,25,15,163,1318,10,195,123,241,205,364,1516,2795,6,17273,959,0,2,1,1,0
13584,569,12184,72,33,56,0,4,12,72,1,1,1,1,2,2,0,2,0,1,0,0,2,6,0,0
13585,569,12184,1454,835,1044,76,110,219,1530,17,275,158,296,292,454,2297,3718,9,34017,1889,1,2,6,0,0
13586,76,3740,1523,757,1297,19,12,193,1542,12,193,117,230,205,347,1508,2664,7,19053,1058,0,2,41,18,0
13587,16,1198,215,129,180,6,0,29,221,8,65,43,72,73,115,415,711,4,3153,175,0,2,0,9,0
13588,62,2603,1043,504,840,53,9,147,1096,9,180,112,198,189,310,1377,2344,4,11604,644,0,2,0,12,0
13589,22,942,373,158,315,8,0,51,381,5,76,44,79,81,123,486,779,2,2026,112,0,2,1,7,0
13590,67,2869,1178,367,1042,6,15,115,1184,9,94,51,95,103,146,644,976,4,4439,246,0,2,17,5,0
13591,71,3615,1943,715,1694,26,18,214,1969,12,185,120,237,197,357,1436,2721,7,20915,1161,0,2,1,2,0
13592,66,2745,1020,354,843,12,15,144,1032,8,134,77,144,142,221,970,1580,4,6792,377,0,2,26,0,1
13593,307,6253,1457,730,1242,11,6,188,1468,10,292,166,329,302,495,2424,4078,5,22973,1276,1,2,1,1,0
13594,307,6253,74,35,59,1,0,14,75,3,14,7,14,17,21,58,85,1,128,7,0,2,1,1,0
13595,307,6253,245,125,200,5,7,34,250,7,30,17,34,37,51,166,265,3,1053,58,0,2,1,1,0
13596,49,571,647,139,84,35,284,233,682,0,0,0,0,0,0,0,0,0,0,0,0,2,13,0,0
13597,571,12251,72,33,56,0,4,12,72,1,1,1,1,2,2,0,2,0,1,0,0,2,35,26,0
13598,571,12251,1454,835,1044,76,110,219,1530,17,275,158,296,292,454,2297,3718,9,34017,1889,1,2,35,26,0
13599,122,2648,1043,504,840,53,9,147,1096,9,180,112,198,189,310,1377,2344,4,11604,644,0,2,14,1,0
13600,122,2648,383,288,292,26,6,62,409,11,65,38,67,76,105,429,656,5,3719,206,0,2,14,1,0
13601,18,355,294,64,250,0,0,43,294,1,20,10,20,21,30,86,131,0,65,3,0,0,59,0,0
13602,18,355,78,46,62,3,0,14,81,3,8,4,8,11,12,28,41,1,62,3,0,0,59,0,0
13603,5,103,110,30,77,3,13,16,113,4,21,15,30,25,45,100,208,2,597,33,0,0,19,0,0
13604,5,103,28,15,21,1,0,6,29,0,0,0,0,0,0,0,0,0,0,0,0,0,19,0,0
13605,313,6325,1457,730,1242,11,6,188,1468,10,292,166,329,302,495,2424,4078,5,22973,1276,1,2,24,8,1
13606,313,6325,74,35,59,1,0,14,75,3,14,7,14,17,21,58,85,1,128,7,0,2,24,8,1
13607,313,6325,245,125,200,5,7,34,250,7,30,17,34,37,51,166,265,3,1053,58,0,2,24,8,1
13608,24,834,74,35,59,1,0,14,75,3,14,7,14,17,21,58,85,1,128,7,0,2,4,0,1
13609,24,834,245,125,200,5,7,34,250,7,30,17,34,37,51,166,265,3,1053,58,0,2,4,0,1
13610,62,3185,1457,730,1242,11,6,188,1468,10,292,166,329,302,495,2424,4078,5,22973,1276,1,2,89,0,1
13611,313,6325,1457,730,1242,11,6,188,1468,10,292,166,329,302,495,2424,4078,5,22973,1276,1,2,24,8,0
13612,313,6325,74,35,59,1,0,14,75,3,14,7,14,17,21,58,85,1,128,7,0,2,24,8,0
13613,313,6325,245,125,200,5,7,34,250,7,30,17,34,37,51,166,265,3,1053,58,0,2,24,8,0
13614,24,834,74,35,59,1,0,14,75,3,14,7,14,17,21,58,85,1,128,7,0,2,4,0,0
13615,24,834,245,125,200,5,7,34,250,7,30,17,34,37,51,166,265,3,1053,58,0,2,4,0,0
13616,62,3185,1457,730,1242,11,6,188,1468,10,292,166,329,302,495,2424,4078,5,22973,1276,1,2,89,0,0
13617,149,4786,1660,832,1314,41,38,274,1701,20,312,209,395,332,604,2671,5058,12,64042,3557,1,2,7,0,1
13618,149,4786,1057,646,719,113,100,145,1170,18,215,134,248,233,382,1740,3004,10,31186,1732,1,2,7,0,1
13619,138,3638,1660,832,1314,41,38,274,1701,20,312,209,395,332,604,2671,5058,12,64042,3557,1,2,27,0,1
13620,185,3788,1943,715,1694,26,18,214,1969,12,185,120,237,197,357,1436,2721,7,20915,1161,0,2,11,2,1
13621,185,3788,1168,838,957,57,25,144,1225,19,348,224,416,367,640,3018,5452,11,61921,3440,1,2,11,2,1
13622,58,2959,1457,730,1242,11,6,188,1468,10,292,166,329,302,495,2424,4078,5,22973,1276,1,2,1,1,1
13623,71,3662,1943,715,1694,26,18,214,1969,12,185,120,237,197,357,1436,2721,7,20915,1161,0,2,12,2,1
13624,153,4888,1660,832,1314,41,38,274,1701,20,312,209,395,332,604,2671,5058,12,64042,3557,1,2,15,5,1
13625,153,4888,1057,646,719,113,100,145,1170,18,215,134,248,233,382,1740,3004,10,31186,1732,1,2,15,5,1
13626,77,2775,1450,624,1228,12,26,181,1462,14,306,186,354,320,540,2580,4493,8,36391,2021,1,2,8,0,1
13627,78,2812,1450,624,1228,12,26,181,1462,14,306,186,354,320,540,2580,4493,8,36391,2021,1,2,10,0,0
13628,185,3788,1943,715,1694,26,18,214,1969,12,185,120,237,197,357,1436,2721,7,20915,1161,0,2,1,1,1
13629,185,3788,1168,838,957,57,25,144,1225,19,348,224,416,367,640,3018,5452,11,61921,3440,1,2,1,1,1
13630,71,3662,1943,715,1694,26,18,214,1969,12,185,120,237,197,357,1436,2721,7,20915,1161,0,2,1,1,1
13631,35,724,2,2,2,0,0,0,2,0,0,0,0,0,0,0,0,0,0,0,0,2,0,13,1
13632,35,724,99,48,90,1,3,5,100,0,0,0,0,0,0,0,0,0,0,0,0,2,0,13,1
13633,35,724,8,5,5,2,0,1,10,0,0,0,0,0,0,0,0,0,0,0,0,2,0,13,1
13634,35,724,1217,716,841,84,126,174,1301,14,185,118,215,199,333,1446,2542,8,20687,1149,0,2,0,13,1
13635,35,724,160,89,115,0,13,31,160,7,15,11,17,22,28,78,124,3,495,27,0,2,0,13,1
13636,35,724,10,10,9,9,0,0,19,0,0,0,0,0,0,0,0,0,0,0,0,2,0,13,1
13637,35,724,173,84,99,8,29,36,181,5,12,7,13,17,20,54,81,2,221,12,0,2,0,13,1
13638,35,724,3,1,1,3,0,0,6,0,0,0,0,0,0,0,0,0,0,0,0,2,0,13,1
13639,313,6325,1457,730,1242,11,6,188,1468,10,292,166,329,302,495,2424,4078,5,22973,1276,1,2,1,1,1
13640,313,6325,74,35,59,1,0,14,75,3,14,7,14,17,21,58,85,1,128,7,0,2,1,1,1
13641,313,6325,245,125,200,5,7,34,250,7,30,17,34,37,51,166,265,3,1053,58,0,2,1,1,1
13642,176,3641,1943,715,1694,26,18,214,1969,12,185,120,237,197,357,1436,2721,7,20915,1161,0,2,0,14,1
13643,176,3641,1168,838,957,57,25,144,1225,19,348,224,416,367,640,3018,5452,11,61921,3440,1,2,0,14,1
13644,75,2695,1450,624,1228,12,26,181,1462,14,306,186,354,320,540,2580,4493,8,36391,2021,1,2,3,11,1
13645,62,3181,1457,730,1242,11,6,188,1468,10,292,166,329,302,495,2424,4078,5,22973,1276,1,2,1,1,1
13646,67,2869,1178,367,1042,6,15,115,1184,9,94,51,95,103,146,644,976,4,4439,246,0,2,3,3,1
13647,71,3566,1943,715,1694,26,18,214,1969,12,185,120,237,197,357,1436,2721,7,20915,1161,0,2,0,9,1
13648,313,6326,1457,730,1242,11,6,188,1468,10,292,166,329,302,495,2424,4078,5,22973,1276,1,2,2,1,1
13649,313,6326,74,35,59,1,0,14,75,3,14,7,14,17,21,58,85,1,128,7,0,2,2,1,1
13650,313,6326,245,125,200,5,7,34,250,7,30,17,34,37,51,166,265,3,1053,58,0,2,2,1,1
13651,7,139,44,22,19,0,19,6,44,2,10,6,12,12,18,35,64,1,77,4,0,0,45,0,1
13652,15,485,42,7,35,4,0,5,46,1,2,1,2,3,3,2,4,0,2,0,0,2,2,24,0
13653,15,485,11,6,10,0,0,1,11,2,4,2,4,6,6,10,15,1,15,0,0,2,2,24,0
13654,35,724,2,2,2,0,0,0,2,0,0,0,0,0,0,0,0,0,0,0,0,2,0,13,0
13655,35,724,99,48,90,1,3,5,100,0,0,0,0,0,0,0,0,0,0,0,0,2,0,13,0
13656,35,724,8,5,5,2,0,1,10,0,0,0,0,0,0,0,0,0,0,0,0,2,0,13,0
13657,35,724,1217,716,841,84,126,174,1301,14,185,118,215,199,333,1446,2542,8,20687,1149,0,2,0,13,0
13658,35,724,160,89,115,0,13,31,160,7,15,11,17,22,28,78,124,3,495,27,0,2,0,13,0
13659,35,724,10,10,9,9,0,0,19,0,0,0,0,0,0,0,0,0,0,0,0,2,0,13,0
13660,35,724,173,84,99,8,29,36,181,5,12,7,13,17,20,54,81,2,221,12,0,2,0,13,0
13661,35,724,3,1,1,3,0,0,6,0,0,0,0,0,0,0,0,0,0,0,0,2,0,13,0
13662,313,6326,1457,730,1242,11,6,188,1468,10,292,166,329,302,495,2424,4078,5,22973,1276,1,2,3,2,0
13663,313,6326,74,35,59,1,0,14,75,3,14,7,14,17,21,58,85,1,128,7,0,2,3,2,0
13664,313,6326,245,125,200,5,7,34,250,7,30,17,34,37,51,166,265,3,1053,58,0,2,3,2,0
13665,7,139,44,22,19,0,19,6,44,2,10,6,12,12,18,35,64,1,77,4,0,0,45,0,0
13666,176,3641,1943,715,1694,26,18,214,1969,12,185,120,237,197,357,1436,2721,7,20915,1161,0,2,0,14,0
13667,176,3641,1168,838,957,57,25,144,1225,19,348,224,416,367,640,3018,5452,11,61921,3440,1,2,0,14,0
13668,75,2695,1450,624,1228,12,26,181,1462,14,306,186,354,320,540,2580,4493,8,36391,2021,1,2,3,11,0
13669,62,3181,1457,730,1242,11,6,188,1468,10,292,166,329,302,495,2424,4078,5,22973,1276,1,2,1,1,0
13670,67,2869,1178,367,1042,6,15,115,1184,9,94,51,95,103,146,644,976,4,4439,246,0,2,3,3,0
13671,71,3566,1943,715,1694,26,18,214,1969,12,185,120,237,197,357,1436,2721,7,20915,1161,0,2,0,9,0
13672,15,485,42,7,35,4,0,5,46,1,2,1,2,3,3,2,4,0,2,0,0,2,2,24,0
13673,15,485,11,6,10,0,0,1,11,2,4,2,4,6,6,10,15,1,15,0,0,2,2,24,0
13674,153,4888,1660,832,1314,41,38,274,1701,20,312,209,395,332,604,2671,5058,12,64042,3557,1,2,15,5,0
13675,153,4888,1057,646,719,113,100,145,1170,18,215,134,248,233,382,1740,3004,10,31186,1732,1,2,15,5,0
13676,77,2760,1450,624,1228,12,26,181,1462,14,306,186,354,320,540,2580,4493,8,36391,2021,1,2,18,0,0
13677,149,4786,1660,832,1314,41,38,274,1701,20,312,209,395,332,604,2671,5058,12,64042,3557,1,2,0,2,0
13678,149,4786,1057,646,719,113,100,145,1170,18,215,134,248,233,382,1740,3004,10,31186,1732,1,2,0,2,0
13679,149,4786,1660,832,1314,41,38,274,1701,20,312,209,395,332,604,2671,5058,12,64042,3557,1,2,5,0,0
13680,149,4786,1057,646,719,113,100,145,1170,18,215,134,248,233,382,1740,3004,10,31186,1732,1,2,5,0,0
13681,138,3638,1660,832,1314,41,38,274,1701,20,312,209,395,332,604,2671,5058,12,64042,3557,1,2,27,0,0
13682,66,2745,1020,354,843,12,15,144,1032,8,134,77,144,142,221,970,1580,4,6792,377,0,2,2,2,0
13683,66,2745,1020,354,843,12,15,144,1032,8,134,77,144,142,221,970,1580,4,6792,377,0,2,26,0,0
13684,14,470,42,7,35,4,0,5,46,1,2,1,2,3,3,2,4,0,2,0,0,2,3,3,1
13685,14,470,11,6,10,0,0,1,11,2,4,2,4,6,6,10,15,1,15,0,0,2,3,3,1
13686,92,2960,773,419,590,28,0,166,801,10,204,113,217,214,330,1598,2554,5,13587,754,0,2,1,3,1
13687,14,470,42,7,35,4,0,5,46,1,2,1,2,3,3,2,4,0,2,0,0,2,3,3,0
13688,14,470,11,6,10,0,0,1,11,2,4,2,4,6,6,10,15,1,15,0,0,2,3,3,0
13689,92,2960,773,419,590,28,0,166,801,10,204,113,217,214,330,1598,2554,5,13587,754,0,2,1,3,0
13690,35,724,2,2,2,0,0,0,2,0,0,0,0,0,0,0,0,0,0,0,0,2,0,13,0
13691,35,724,99,48,90,1,3,5,100,0,0,0,0,0,0,0,0,0,0,0,0,2,0,13,0
13692,35,724,8,5,5,2,0,1,10,0,0,0,0,0,0,0,0,0,0,0,0,2,0,13,0
13693,35,724,1217,716,841,84,126,174,1301,14,185,118,215,199,333,1446,2542,8,20687,1149,0,2,0,13,0
13694,35,724,160,89,115,0,13,31,160,7,15,11,17,22,28,78,124,3,495,27,0,2,0,13,0
13695,35,724,10,10,9,9,0,0,19,0,0,0,0,0,0,0,0,0,0,0,0,2,0,13,0
13696,35,724,173,84,99,8,29,36,181,5,12,7,13,17,20,54,81,2,221,12,0,2,0,13,0
13697,35,724,3,1,1,3,0,0,6,0,0,0,0,0,0,0,0,0,0,0,0,2,0,13,0
13698,153,4888,1660,832,1314,41,38,274,1701,20,312,209,395,332,604,2671,5058,12,64042,3557,1,2,15,5,0
13699,153,4888,1057,646,719,113,100,145,1170,18,215,134,248,233,382,1740,3004,10,31186,1732,1,2,15,5,0
13700,313,6326,1457,730,1242,11,6,188,1468,10,292,166,329,302,495,2424,4078,5,22973,1276,1,2,31,10,0
13701,313,6326,74,35,59,1,0,14,75,3,14,7,14,17,21,58,85,1,128,7,0,2,31,10,0
13702,313,6326,245,125,200,5,7,34,250,7,30,17,34,37,51,166,265,3,1053,58,0,2,31,10,0
13703,7,139,44,22,19,0,19,6,44,2,10,6,12,12,18,35,64,1,77,4,0,0,45,0,0
13704,24,834,74,35,59,1,0,14,75,3,14,7,14,17,21,58,85,1,128,7,0,2,4,0,0
13705,24,834,245,125,200,5,7,34,250,7,30,17,34,37,51,166,265,3,1053,58,0,2,4,0,0
13706,571,12251,72,33,56,0,4,12,72,1,1,1,1,2,2,0,2,0,1,0,0,2,6,0,0
13707,571,12251,1454,835,1044,76,110,219,1530,17,275,158,296,292,454,2297,3718,9,34017,1889,1,2,6,0,0
13708,176,3641,1943,715,1694,26,18,214,1969,12,185,120,237,197,357,1436,2721,7,20915,1161,0,2,0,14,0
13709,176,3641,1168,838,957,57,25,144,1225,19,348,224,416,367,640,3018,5452,11,61921,3440,1,2,0,14,0
13710,14,470,42,7,35,4,0,5,46,1,2,1,2,3,3,2,4,0,2,0,0,2,5,27,0
13711,14,470,11,6,10,0,0,1,11,2,4,2,4,6,6,10,15,1,15,0,0,2,5,27,0
13712,92,2960,773,419,590,28,0,166,801,10,204,113,217,214,330,1598,2554,5,13587,754,0,2,1,3,0
13713,77,2760,1450,624,1228,12,26,181,1462,14,306,186,354,320,540,2580,4493,8,36391,2021,1,2,21,11,0
13714,62,3181,1457,730,1242,11,6,188,1468,10,292,166,329,302,495,2424,4078,5,22973,1276,1,2,90,1,0
13715,76,3740,1523,757,1297,19,12,193,1542,12,193,117,230,205,347,1508,2664,7,19053,1058,0,2,41,18,0
13716,66,2745,1020,354,843,12,15,144,1032,8,134,77,144,142,221,970,1580,4,6792,377,0,2,26,0,0
13717,39,2266,334,251,279,10,4,40,344,5,127,74,143,132,217,899,1528,2,4303,239,0,2,7,0,0
13718,16,1198,215,129,180,6,0,29,221,8,65,43,72,73,115,415,711,4,3153,175,0,2,0,9,0
13719,62,2603,1043,504,840,53,9,147,1096,9,180,112,198,189,310,1377,2344,4,11604,644,0,2,0,12,0
13720,22,942,373,158,315,8,0,51,381,5,76,44,79,81,123,486,779,2,2026,112,0,2,1,7,0
13721,67,2869,1178,367,1042,6,15,115,1184,9,94,51,95,103,146,644,976,4,4439,246,0,2,20,8,0
13722,71,3566,1943,715,1694,26,18,214,1969,12,185,120,237,197,357,1436,2721,7,20915,1161,0,2,1,11,0
13723,122,2648,1043,504,840,53,9,147,1096,9,180,112,198,189,310,1377,2344,4,11604,644,0,2,2,2,1
13724,122,2648,383,288,292,26,6,62,409,11,65,38,67,76,105,429,656,5,3719,206,0,2,2,2,1
13725,20,400,294,64,250,0,0,43,294,1,20,10,20,21,30,86,131,0,65,3,0,2,9,2,1
13726,20,400,78,46,62,3,0,14,81,3,8,4,8,11,12,28,41,1,62,3,0,2,9,2,1
13727,5,110,110,30,77,3,13,16,113,4,21,15,30,25,45,100,208,2,597,33,0,2,1,0,1
13728,5,110,28,15,21,1,0,6,29,0,0,0,0,0,0,0,0,0,0,0,0,2,1,0,1
13729,20,400,294,64,250,0,0,43,294,1,20,10,20,21,30,86,131,0,65,3,0,2,9,3,1
13730,20,400,78,46,62,3,0,14,81,3,8,4,8,11,12,28,41,1,62,3,0,2,9,3,1
13731,5,110,110,30,77,3,13,16,113,4,21,15,30,25,45,100,208,2,597,33,0,2,5,2,1
13732,5,110,28,15,21,1,0,6,29,0,0,0,0,0,0,0,0,0,0,0,0,2,5,2,1
13733,314,6367,1457,730,1242,11,6,188,1468,10,292,166,329,302,495,2424,4078,5,22973,1276,1,2,6,0,0
13734,314,6367,74,35,59,1,0,14,75,3,14,7,14,17,21,58,85,1,128,7,0,2,6,0,0
13735,314,6367,245,125,200,5,7,34,250,7,30,17,34,37,51,166,265,3,1053,58,0,2,6,0,0
13736,37,2203,652,304,544,16,6,88,668,6,89,51,101,95,152,591,998,3,3399,188,0,2,13,0,0
13737,185,3788,1943,715,1694,26,18,214,1969,12,185,120,237,197,357,1436,2721,7,20915,1161,0,2,1,1,1
13738,185,3788,1168,838,957,57,25,144,1225,19,348,224,416,367,640,3018,5452,11,61921,3440,1,2,1,1,1
13739,58,2960,1457,730,1242,11,6,188,1468,10,292,166,329,302,495,2424,4078,5,22973,1276,1,2,3,3,1
13740,122,2648,1043,504,840,53,9,147,1096,9,180,112,198,189,310,1377,2344,4,11604,644,0,2,2,2,0
13741,122,2648,383,288,292,26,6,62,409,11,65,38,67,76,105,429,656,5,3719,206,0,2,2,2,0
13742,20,400,294,64,250,0,0,43,294,1,20,10,20,21,30,86,131,0,65,3,0,2,17,4,0
13743,20,400,78,46,62,3,0,14,81,3,8,4,8,11,12,28,41,1,62,3,0,2,17,4,0
13744,5,110,110,30,77,3,13,16,113,4,21,15,30,25,45,100,208,2,597,33,0,2,6,2,0
13745,5,110,28,15,21,1,0,6,29,0,0,0,0,0,0,0,0,0,0,0,0,2,6,2,0
13746,155,4940,1660,832,1314,41,38,274,1701,20,312,209,395,332,604,2671,5058,12,64042,3557,1,2,5,0,1
13747,155,4940,1057,646,719,113,100,145,1170,18,215,134,248,233,382,1740,3004,10,31186,1732,1,2,5,0,1
13748,82,1803,477,336,357,30,23,73,507,16,194,134,250,210,384,1538,2962,10,30538,1696,0,2,0,33,1
13749,311,6296,1457,730,1242,11,6,188,1468,10,292,166,329,302,495,2424,4078,5,22973,1276,1,2,9,15,1
13750,311,6296,74,35,59,1,0,14,75,3,14,7,14,17,21,58,85,1,128,7,0,2,9,15,1
13751,311,6296,245,125,200,5,7,34,250,7,30,17,34,37,51,166,265,3,1053,58,0,2,9,15,1
13752,55,1468,1455,414,1257,16,76,112,1471,5,41,23,46,46,69,231,381,2,1069,59,0,2,1,1,1
13753,55,1468,669,365,481,22,61,110,691,15,103,63,122,118,185,747,1273,8,11311,628,0,2,1,1,1
13754,572,12277,72,33,56,0,4,12,72,1,1,1,1,2,2,0,2,0,1,0,0,2,18,11,1
13755,572,12277,1454,835,1044,76,110,219,1530,17,275,158,296,292,454,2297,3718,9,34017,1889,1,2,18,11,1
13756,139,6353,1392,870,1177,35,17,170,1427,14,494,280,531,508,811,4473,7289,7,54850,3047,2,2,1,1,1
13757,146,6571,139,89,101,2,0,35,141,7,54,34,62,61,96,330,569,4,2287,127,0,2,27,19,1
13758,146,6571,7,5,5,0,0,2,7,1,2,1,2,3,3,2,4,0,2,0,0,2,27,19,1
13759,90,4801,1782,648,1425,9,47,279,1791,8,171,97,189,179,286,1292,2140,4,9462,525,0,2,2,2,1
13760,143,3771,1660,832,1314,41,38,274,1701,20,312,209,395,332,604,2671,5058,12,64042,3557,1,2,45,12,1
13761,65,3259,1457,730,1242,11,6,188,1468,10,292,166,329,302,495,2424,4078,5,22973,1276,1,2,17,0,1
13762,39,2275,334,251,279,10,4,40,344,5,127,74,143,132,217,899,1528,2,4303,239,0,2,3,0,1
13763,34,1289,1293,570,1093,25,15,163,1318,10,195,123,241,205,364,1516,2795,6,17273,959,0,2,2,2,1
13764,155,4940,1660,832,1314,41,38,274,1701,20,312,209,395,332,604,2671,5058,12,64042,3557,1,2,5,0,0
13765,155,4940,1057,646,719,113,100,145,1170,18,215,134,248,233,382,1740,3004,10,31186,1732,1,2,5,0,0
13766,82,1803,477,336,357,30,23,73,507,16,194,134,250,210,384,1538,2962,10,30538,1696,0,2,0,33,0
13767,311,6296,1457,730,1242,11,6,188,1468,10,292,166,329,302,495,2424,4078,5,22973,1276,1,2,9,15,0
13768,311,6296,74,35,59,1,0,14,75,3,14,7,14,17,21,58,85,1,128,7,0,2,9,15,0
13769,311,6296,245,125,200,5,7,34,250,7,30,17,34,37,51,166,265,3,1053,58,0,2,9,15,0
13770,55,1468,1455,414,1257,16,76,112,1471,5,41,23,46,46,69,231,381,2,1069,59,0,2,1,1,0
13771,55,1468,669,365,481,22,61,110,691,15,103,63,122,118,185,747,1273,8,11311,628,0,2,1,1,0
13772,572,12277,72,33,56,0,4,12,72,1,1,1,1,2,2,0,2,0,1,0,0,2,18,11,0
13773,572,12277,1454,835,1044,76,110,219,1530,17,275,158,296,292,454,2297,3718,9,34017,1889,1,2,18,11,0
13774,139,6353,1392,870,1177,35,17,170,1427,14,494,280,531,508,811,4473,7289,7,54850,3047,2,2,1,1,0
13775,146,6571,139,89,101,2,0,35,141,7,54,34,62,61,96,330,569,4,2287,127,0,2,27,19,0
13776,146,6571,7,5,5,0,0,2,7,1,2,1,2,3,3,2,4,0,2,0,0,2,27,19,0
13777,90,4801,1782,648,1425,9,47,279,1791,8,171,97,189,179,286,1292,2140,4,9462,525,0,2,2,2,0
13778,143,3771,1660,832,1314,41,38,274,1701,20,312,209,395,332,604,2671,5058,12,64042,3557,1,2,45,12,0
13779,65,3259,1457,730,1242,11,6,188,1468,10,292,166,329,302,495,2424,4078,5,22973,1276,1,2,17,0,0
13780,39,2275,334,251,279,10,4,40,344,5,127,74,143,132,217,899,1528,2,4303,239,0,2,3,0,0
13781,34,1289,1293,570,1093,25,15,163,1318,10,195,123,241,205,364,1516,2795,6,17273,959,0,2,2,2,0
13782,40,775,207,111,150,11,0,50,218,5,26,19,36,31,55,133,272,3,943,52,0,0,203,0,1
13783,40,775,410,198,237,31,55,97,441,11,63,38,72,74,110,414,683,6,4293,238,0,0,203,0,1
13784,311,6296,1457,730,1242,11,6,188,1468,10,292,166,329,302,495,2424,4078,5,22973,1276,1,2,1,1,1
13785,311,6296,74,35,59,1,0,14,75,3,14,7,14,17,21,58,85,1,128,7,0,2,1,1,1
13786,311,6296,245,125,200,5,7,34,250,7,30,17,34,37,51,166,265,3,1053,58,0,2,1,1,1
13787,55,1468,1455,414,1257,16,76,112,1471,5,41,23,46,46,69,231,381,2,1069,59,0,2,1,1,1
13788,55,1468,669,365,481,22,61,110,691,15,103,63,122,118,185,747,1273,8,11311,628,0,2,1,1,1
13789,222,4933,4293,999,3693,19,54,507,4312,9,155,88,170,164,258,1156,1898,4,9368,520,0,0,1083,0,1
13790,222,4933,1482,859,1002,125,135,219,1607,16,219,134,251,235,385,1766,3032,9,27804,1544,1,0,1083,0,1
13791,309,6680,72,33,56,0,4,12,72,1,1,1,1,2,2,0,2,0,1,0,0,2,33,1241,1
13792,309,6680,1454,835,1044,76,110,219,1530,17,275,158,296,292,454,2297,3718,9,34017,1889,1,2,33,1241,1
13793,85,3922,1338,495,1086,10,64,173,1348,11,122,82,157,133,239,883,1686,7,11934,663,0,2,1,1,1
13794,146,6569,139,89,101,2,0,35,141,7,54,34,62,61,96,330,569,4,2287,127,0,2,16,17,1
13795,146,6569,7,5,5,0,0,2,7,1,2,1,2,3,3,2,4,0,2,0,0,2,16,17,1
13796,32,933,465,148,393,5,8,60,470,4,31,20,31,35,51,161,261,2,523,29,0,2,3,3,1
13797,32,933,16,12,9,0,0,6,16,1,2,1,2,3,3,2,4,0,2,0,0,2,3,3,1
13798,90,4801,1782,648,1425,9,47,279,1791,8,171,97,189,179,286,1292,2140,4,9462,525,0,2,7,7,1
13799,117,2369,1513,682,1277,25,13,200,1538,11,199,116,219,210,335,1557,2584,6,15641,868,0,2,2,2,1
13800,117,2369,819,519,539,24,98,155,843,15,96,57,106,111,163,690,1107,8,9171,509,0,2,2,2,1
13801,587,12550,72,33,56,0,4,12,72,1,1,1,1,2,2,0,2,0,1,0,0,2,80,37,1
13802,587,12550,1454,835,1044,76,110,219,1530,17,275,158,296,292,454,2297,3718,9,34017,1889,1,2,80,37,1
13803,23,679,339,213,244,17,9,65,356,10,42,26,48,52,74,259,421,5,2410,133,0,2,18,6,1
13804,40,775,207,111,150,11,0,50,218,5,26,19,36,31,55,133,272,3,943,52,0,0,203,0,0
13805,40,775,410,198,237,31,55,97,441,11,63,38,72,74,110,414,683,6,4293,238,0,0,203,0,0
13806,311,6296,1457,730,1242,11,6,188,1468,10,292,166,329,302,495,2424,4078,5,22973,1276,1,2,1,1,0
13807,311,6296,74,35,59,1,0,14,75,3,14,7,14,17,21,58,85,1,128,7,0,2,1,1,0
13808,311,6296,245,125,200,5,7,34,250,7,30,17,34,37,51,166,265,3,1053,58,0,2,1,1,0
13809,55,1468,1455,414,1257,16,76,112,1471,5,41,23,46,46,69,231,381,2,1069,59,0,2,1,1,0
13810,55,1468,669,365,481,22,61,110,691,15,103,63,122,118,185,747,1273,8,11311,628,0,2,1,1,0
13811,222,4933,4293,999,3693,19,54,507,4312,9,155,88,170,164,258,1156,1898,4,9368,520,0,0,1083,0,0
13812,222,4933,1482,859,1002,125,135,219,1607,16,219,134,251,235,385,1766,3032,9,27804,1544,1,0,1083,0,0
13813,309,6680,72,33,56,0,4,12,72,1,1,1,1,2,2,0,2,0,1,0,0,2,33,1241,0
13814,309,6680,1454,835,1044,76,110,219,1530,17,275,158,296,292,454,2297,3718,9,34017,1889,1,2,33,1241,0
13815,85,3922,1338,495,1086,10,64,173,1348,11,122,82,157,133,239,883,1686,7,11934,663,0,2,1,1,0
13816,146,6569,139,89,101,2,0,35,141,7,54,34,62,61,96,330,569,4,2287,127,0,2,16,17,0
13817,146,6569,7,5,5,0,0,2,7,1,2,1,2,3,3,2,4,0,2,0,0,2,16,17,0
13818,32,933,465,148,393,5,8,60,470,4,31,20,31,35,51,161,261,2,523,29,0,2,3,3,0
13819,32,933,16,12,9,0,0,6,16,1,2,1,2,3,3,2,4,0,2,0,0,2,3,3,0
13820,90,4801,1782,648,1425,9,47,279,1791,8,171,97,189,179,286,1292,2140,4,9462,525,0,2,7,7,0
13821,40,775,207,111,150,11,0,50,218,5,26,19,36,31,55,133,272,3,943,52,0,0,203,0,1
13822,40,775,410,198,237,31,55,97,441,11,63,38,72,74,110,414,683,6,4293,238,0,0,203,0,1
13823,311,6296,1457,730,1242,11,6,188,1468,10,292,166,329,302,495,2424,4078,5,22973,1276,1,2,1,1,1
13824,311,6296,74,35,59,1,0,14,75,3,14,7,14,17,21,58,85,1,128,7,0,2,1,1,1
13825,311,6296,245,125,200,5,7,34,250,7,30,17,34,37,51,166,265,3,1053,58,0,2,1,1,1
13826,55,1468,1455,414,1257,16,76,112,1471,5,41,23,46,46,69,231,381,2,1069,59,0,2,1,1,1
13827,55,1468,669,365,481,22,61,110,691,15,103,63,122,118,185,747,1273,8,11311,628,0,2,1,1,1
13828,237,5206,4293,999,3693,19,54,507,4312,9,155,88,170,164,258,1156,1898,4,9368,520,0,0,1126,0,1
13829,237,5206,1482,859,1002,125,135,219,1607,16,219,134,251,235,385,1766,3032,9,27804,1544,1,0,1126,0,1
13830,309,6680,72,33,56,0,4,12,72,1,1,1,1,2,2,0,2,0,1,0,0,2,33,1288,1
13831,309,6680,1454,835,1044,76,110,219,1530,17,275,158,296,292,454,2297,3718,9,34017,1889,1,2,33,1288,1
13832,85,3922,1338,495,1086,10,64,173,1348,11,122,82,157,133,239,883,1686,7,11934,663,0,2,1,1,1
13833,146,6569,139,89,101,2,0,35,141,7,54,34,62,61,96,330,569,4,2287,127,0,2,16,17,1
13834,146,6569,7,5,5,0,0,2,7,1,2,1,2,3,3,2,4,0,2,0,0,2,16,17,1
13835,32,933,465,148,393,5,8,60,470,4,31,20,31,35,51,161,261,2,523,29,0,2,3,3,1
13836,32,933,16,12,9,0,0,6,16,1,2,1,2,3,3,2,4,0,2,0,0,2,3,3,1
13837,90,4801,1782,648,1425,9,47,279,1791,8,171,97,189,179,286,1292,2140,4,9462,525,0,2,7,7,1
13838,237,5209,4293,999,3693,19,54,507,4312,9,155,88,170,164,258,1156,1898,4,9368,520,0,2,19,0,1
13839,237,5209,1482,859,1002,125,135,219,1607,16,219,134,251,235,385,1766,3032,9,27804,1544,1,2,19,0,1
13840,114,4432,1513,682,1277,25,13,200,1538,11,199,116,219,210,335,1557,2584,6,15641,868,0,2,19,0,1
13841,309,6699,72,33,56,0,4,12,72,1,1,1,1,2,2,0,2,0,1,0,0,2,2,2,1
13842,309,6699,1454,835,1044,76,110,219,1530,17,275,158,296,292,454,2297,3718,9,34017,1889,1,2,2,2,1
13843,78,3212,1289,550,1043,56,32,155,1345,10,167,93,185,177,278,1266,2075,5,11498,638,0,2,15,0,1
13844,91,2970,773,419,590,28,0,166,801,10,204,113,217,214,330,1598,2554,5,13587,754,0,2,5,5,1
13845,222,4950,4293,999,3693,19,54,507,4312,9,155,88,170,164,258,1156,1898,4,9368,520,0,2,5,0,1
13846,222,4950,1482,859,1002,125,135,219,1607,16,219,134,251,235,385,1766,3032,9,27804,1544,1,2,5,0,1
13847,79,3247,1289,550,1043,56,32,155,1345,10,167,93,185,177,278,1266,2075,5,11498,638,0,2,16,0,1
13848,35,724,2,2,2,0,0,0,2,0,0,0,0,0,0,0,0,0,0,0,0,2,2,2,1
13849,35,724,99,48,90,1,3,5,100,0,0,0,0,0,0,0,0,0,0,0,0,2,2,2,1
13850,35,724,8,5,5,2,0,1,10,0,0,0,0,0,0,0,0,0,0,0,0,2,2,2,1
13851,35,724,1217,716,841,84,126,174,1301,14,185,118,215,199,333,1446,2542,8,20687,1149,0,2,2,2,1
13852,35,724,160,89,115,0,13,31,160,7,15,11,17,22,28,78,124,3,495,27,0,2,2,2,1
13853,35,724,10,10,9,9,0,0,19,0,0,0,0,0,0,0,0,0,0,0,0,2,2,2,1
13854,35,724,173,84,99,8,29,36,181,5,12,7,13,17,20,54,81,2,221,12,0,2,2,2,1
13855,35,724,3,1,1,3,0,0,6,0,0,0,0,0,0,0,0,0,0,0,0,2,2,2,1
13856,222,4964,4293,999,3693,19,54,507,4312,9,155,88,170,164,258,1156,1898,4,9368,520,0,2,5,3,1
13857,222,4964,1482,859,1002,125,135,219,1607,16,219,134,251,235,385,1766,3032,9,27804,1544,1,2,5,3,1
13858,46,949,447,308,343,6,5,95,453,7,96,59,111,103,170,651,1136,4,4600,255,0,2,7,4,1
13859,46,949,322,174,179,16,74,51,338,10,41,26,46,51,72,252,408,5,2291,127,0,2,7,4,1
13860,220,4885,722,423,573,19,0,135,741,12,172,101,199,184,300,1320,2257,6,15668,870,0,2,2,1,1
13861,220,4885,1508,847,911,44,250,301,1552,14,148,88,169,162,257,1120,1886,7,15077,837,0,2,2,1,1
13862,16,468,442,244,305,14,16,103,456,11,68,45,75,79,120,452,756,6,4588,254,0,2,2,2,1
13863,16,468,182,102,99,11,40,35,193,3,11,6,11,14,17,42,64,1,97,5,0,2,2,2,1
13864,139,6357,1392,870,1177,35,17,170,1427,14,494,280,531,508,811,4473,7289,7,54850,3047,2,2,3,1,1
13865,85,3904,1338,495,1086,10,64,173,1348,11,122,82,157,133,239,883,1686,7,11934,663,0,2,7,4,1
13866,146,6582,139,89,101,2,0,35,141,7,54,34,62,61,96,330,569,4,2287,127,0,2,128,48,1
13867,146,6582,7,5,5,0,0,2,7,1,2,1,2,3,3,2,4,0,2,0,0,2,128,48,1
13868,32,933,465,148,393,5,8,60,470,4,31,20,31,35,51,161,261,2,523,29,0,2,5,2,1
13869,32,933,16,12,9,0,0,6,16,1,2,1,2,3,3,2,4,0,2,0,0,2,5,2,1
13870,90,4801,1782,648,1425,9,47,279,1791,8,171,97,189,179,286,1292,2140,4,9462,525,0,2,25,12,1
13871,77,2760,1450,624,1228,12,26,181,1462,14,306,186,354,320,540,2580,4493,8,36391,2021,1,2,6,3,1
13872,76,3740,1523,757,1297,19,12,193,1542,12,193,117,230,205,347,1508,2664,7,19053,1058,0,2,13,4,1
13873,66,2745,1020,354,843,12,15,144,1032,8,134,77,144,142,221,970,1580,4,6792,377,0,2,2,1,1
13874,38,1616,447,308,343,6,5,95,453,7,96,59,111,103,170,651,1136,4,4600,255,0,2,4,3,1
13875,34,1295,1293,570,1093,25,15,163,1318,10,195,123,241,205,364,1516,2795,6,17273,959,0,2,4,1,1
13876,62,2603,1043,504,840,53,9,147,1096,9,180,112,198,189,310,1377,2344,4,11604,644,0,2,3,1,1
13877,13,413,295,56,236,0,4,54,295,2,9,5,10,11,15,30,51,1,57,3,0,2,2,1,1
13878,67,2869,1178,367,1042,6,15,115,1184,9,94,51,95,103,146,644,976,4,4439,246,0,2,4,2,1
13879,71,3566,1943,715,1694,26,18,214,1969,12,185,120,237,197,357,1436,2721,7,20915,1161,0,2,9,3,1
13880,39,1537,1098,241,925,5,10,155,1103,7,46,25,49,53,74,273,423,3,1580,87,0,2,2,2,1
13881,23,680,339,213,244,17,9,65,356,10,42,26,48,52,74,259,421,5,2410,133,0,2,2,1,1
13882,38,1395,1293,570,1093,25,15,163,1318,10,195,123,241,205,364,1516,2795,6,17273,959,0,2,25,0,1
13883,35,724,2,2,2,0,0,0,2,0,0,0,0,0,0,0,0,0,0,0,0,2,2,2,0
13884,35,724,99,48,90,1,3,5,100,0,0,0,0,0,0,0,0,0,0,0,0,2,2,2,0
13885,35,724,8,5,5,2,0,1,10,0,0,0,0,0,0,0,0,0,0,0,0,2,2,2,0
13886,35,724,1217,716,841,84,126,174,1301,14,185,118,215,199,333,1446,2542,8,20687,1149,0,2,2,2,0
13887,35,724,160,89,115,0,13,31,160,7,15,11,17,22,28,78,124,3,495,27,0,2,2,2,0
13888,35,724,10,10,9,9,0,0,19,0,0,0,0,0,0,0,0,0,0,0,0,2,2,2,0
13889,35,724,173,84,99,8,29,36,181,5,12,7,13,17,20,54,81,2,221,12,0,2,2,2,0
13890,35,724,3,1,1,3,0,0,6,0,0,0,0,0,0,0,0,0,0,0,0,2,2,2,0
13891,222,4964,4293,999,3693,19,54,507,4312,9,155,88,170,164,258,1156,1898,4,9368,520,0,2,8,1,0
13892,222,4964,1482,859,1002,125,135,219,1607,16,219,134,251,235,385,1766,3032,9,27804,1544,1,2,8,1,0
13893,46,949,447,308,343,6,5,95,453,7,96,59,111,103,170,651,1136,4,4600,255,0,2,7,4,0
13894,46,949,322,174,179,16,74,51,338,10,41,26,46,51,72,252,408,5,2291,127,0,2,7,4,0
13895,220,4885,722,423,573,19,0,135,741,12,172,101,199,184,300,1320,2257,6,15668,870,0,2,2,1,0
13896,220,4885,1508,847,911,44,250,301,1552,14,148,88,169,162,257,1120,1886,7,15077,837,0,2,2,1,0
13897,309,6699,72,33,56,0,4,12,72,1,1,1,1,2,2,0,2,0,1,0,0,2,2,2,0
13898,309,6699,1454,835,1044,76,110,219,1530,17,275,158,296,292,454,2297,3718,9,34017,1889,1,2,2,2,0
13899,16,468,442,244,305,14,16,103,456,11,68,45,75,79,120,452,756,6,4588,254,0,2,2,2,0
13900,16,468,182,102,99,11,40,35,193,3,11,6,11,14,17,42,64,1,97,5,0,2,2,2,0
13901,79,3247,1289,550,1043,56,32,155,1345,10,167,93,185,177,278,1266,2075,5,11498,638,0,2,31,0,0
13902,139,6357,1392,870,1177,35,17,170,1427,14,494,280,531,508,811,4473,7289,7,54850,3047,2,2,3,1,0
13903,91,2970,773,419,590,28,0,166,801,10,204,113,217,214,330,1598,2554,5,13587,754,0,2,5,5,0
13904,85,3904,1338,495,1086,10,64,173,1348,11,122,82,157,133,239,883,1686,7,11934,663,0,2,7,4,0
13905,146,6582,139,89,101,2,0,35,141,7,54,34,62,61,96,330,569,4,2287,127,0,2,128,48,0
13906,146,6582,7,5,5,0,0,2,7,1,2,1,2,3,3,2,4,0,2,0,0,2,128,48,0
13907,32,933,465,148,393,5,8,60,470,4,31,20,31,35,51,161,261,2,523,29,0,2,5,2,0
13908,32,933,16,12,9,0,0,6,16,1,2,1,2,3,3,2,4,0,2,0,0,2,5,2,0
13909,90,4801,1782,648,1425,9,47,279,1791,8,171,97,189,179,286,1292,2140,4,9462,525,0,2,25,12,0
13910,77,2760,1450,624,1228,12,26,181,1462,14,306,186,354,320,540,2580,4493,8,36391,2021,1,2,6,3,0
13911,76,3740,1523,757,1297,19,12,193,1542,12,193,117,230,205,347,1508,2664,7,19053,1058,0,2,13,4,0
13912,66,2745,1020,354,843,12,15,144,1032,8,134,77,144,142,221,970,1580,4,6792,377,0,2,2,1,0
13913,38,1616,447,308,343,6,5,95,453,7,96,59,111,103,170,651,1136,4,4600,255,0,2,4,3,0
13914,34,1295,1293,570,1093,25,15,163,1318,10,195,123,241,205,364,1516,2795,6,17273,959,0,2,4,1,0
13915,62,2603,1043,504,840,53,9,147,1096,9,180,112,198,189,310,1377,2344,4,11604,644,0,2,3,1,0
13916,13,413,295,56,236,0,4,54,295,2,9,5,10,11,15,30,51,1,57,3,0,2,2,1,0
13917,67,2869,1178,367,1042,6,15,115,1184,9,94,51,95,103,146,644,976,4,4439,246,0,2,4,2,0
13918,71,3566,1943,715,1694,26,18,214,1969,12,185,120,237,197,357,1436,2721,7,20915,1161,0,2,9,3,0
13919,39,1537,1098,241,925,5,10,155,1103,7,46,25,49,53,74,273,423,3,1580,87,0,2,2,2,0
13920,23,680,339,213,244,17,9,65,356,10,42,26,48,52,74,259,421,5,2410,133,0,2,19,6,0
13921,38,1401,1293,570,1093,25,15,163,1318,10,195,123,241,205,364,1516,2795,6,17273,959,0,2,25,0,0
13922,222,4964,4293,999,3693,19,54,507,4312,9,155,88,170,164,258,1156,1898,4,9368,520,0,2,5,6,1
13923,222,4964,1482,859,1002,125,135,219,1607,16,219,134,251,235,385,1766,3032,9,27804,1544,1,2,5,6,1
13924,222,4964,4293,999,3693,19,54,507,4312,9,155,88,170,164,258,1156,1898,4,9368,520,0,2,5,6,0
13925,222,4964,1482,859,1002,125,135,219,1607,16,219,134,251,235,385,1766,3032,9,27804,1544,1,2,5,6,0
13926,32,614,2,2,2,0,0,0,2,0,0,0,0,0,0,0,0,0,0,0,0,2,22,51,1
13927,32,614,99,48,90,1,3,5,100,0,0,0,0,0,0,0,0,0,0,0,0,2,22,51,1
13928,32,614,8,5,5,2,0,1,10,0,0,0,0,0,0,0,0,0,0,0,0,2,22,51,1
13929,32,614,1217,716,841,84,126,174,1301,14,185,118,215,199,333,1446,2542,8,20687,1149,0,2,22,51,1
13930,32,614,160,89,115,0,13,31,160,7,15,11,17,22,28,78,124,3,495,27,0,2,22,51,1
13931,32,614,10,10,9,9,0,0,19,0,0,0,0,0,0,0,0,0,0,0,0,2,22,51,1
13932,32,614,173,84,99,8,29,36,181,5,12,7,13,17,20,54,81,2,221,12,0,2,22,51,1
13933,32,614,3,1,1,3,0,0,6,0,0,0,0,0,0,0,0,0,0,0,0,2,22,51,1
13934,160,5038,1660,832,1314,41,38,274,1701,20,312,209,395,332,604,2671,5058,12,64042,3557,1,2,24,2,1
13935,160,5038,1057,646,719,113,100,145,1170,18,215,134,248,233,382,1740,3004,10,31186,1732,1,2,24,2,1
13936,326,6554,1457,730,1242,11,6,188,1468,10,292,166,329,302,495,2424,4078,5,22973,1276,1,2,51,1,1
13937,326,6554,74,35,59,1,0,14,75,3,14,7,14,17,21,58,85,1,128,7,0,2,51,1,1
13938,326,6554,245,125,200,5,7,34,250,7,30,17,34,37,51,166,265,3,1053,58,0,2,51,1,1
13939,86,3024,1450,624,1228,12,26,181,1462,14,306,186,354,320,540,2580,4493,8,36391,2021,1,2,110,0,1
13940,140,3706,1660,832,1314,41,38,274,1701,20,312,209,395,332,604,2671,5058,12,64042,3557,1,2,11,35,1
13941,67,3305,1457,730,1242,11,6,188,1468,10,292,166,329,302,495,2424,4078,5,22973,1276,1,2,12,3,1
13942,159,5043,1660,832,1314,41,38,274,1701,20,312,209,395,332,604,2671,5058,12,64042,3557,1,2,3,3,1
13943,159,5043,1057,646,719,113,100,145,1170,18,215,134,248,233,382,1740,3004,10,31186,1732,1,2,3,3,1
13944,221,4925,722,423,573,19,0,135,741,12,172,101,199,184,300,1320,2257,6,15668,870,0,2,11,1,1
13945,221,4925,1508,847,911,44,250,301,1552,14,148,88,169,162,257,1120,1886,7,15077,837,0,2,11,1,1
13946,37,691,2,2,2,0,0,0,2,0,0,0,0,0,0,0,0,0,0,0,0,2,29,0,1
13947,37,691,99,48,90,1,3,5,100,0,0,0,0,0,0,0,0,0,0,0,0,2,29,0,1
13948,37,691,8,5,5,2,0,1,10,0,0,0,0,0,0,0,0,0,0,0,0,2,29,0,1
13949,37,691,1217,716,841,84,126,174,1301,14,185,118,215,199,333,1446,2542,8,20687,1149,0,2,29,0,1
13950,37,691,160,89,115,0,13,31,160,7,15,11,17,22,28,78,124,3,495,27,0,2,29,0,1
13951,37,691,10,10,9,9,0,0,19,0,0,0,0,0,0,0,0,0,0,0,0,2,29,0,1
13952,37,691,173,84,99,8,29,36,181,5,12,7,13,17,20,54,81,2,221,12,0,2,29,0,1
13953,37,691,3,1,1,3,0,0,6,0,0,0,0,0,0,0,0,0,0,0,0,2,29,0,1
13954,160,5038,1660,832,1314,41,38,274,1701,20,312,209,395,332,604,2671,5058,12,64042,3557,1,2,3,3,1
13955,160,5038,1057,646,719,113,100,145,1170,18,215,134,248,233,382,1740,3004,10,31186,1732,1,2,3,3,1
13956,324,6573,1457,730,1242,11,6,188,1468,10,292,166,329,302,495,2424,4078,5,22973,1276,1,2,8,4,1
13957,324,6573,74,35,59,1,0,14,75,3,14,7,14,17,21,58,85,1,128,7,0,2,8,4,1
13958,324,6573,245,125,200,5,7,34,250,7,30,17,34,37,51,166,265,3,1053,58,0,2,8,4,1
13959,91,3201,1450,624,1228,12,26,181,1462,14,306,186,354,320,540,2580,4493,8,36391,2021,1,2,87,14,1
13960,222,4964,4293,999,3693,19,54,507,4312,9,155,88,170,164,258,1156,1898,4,9368,520,0,2,1,1,0
13961,222,4964,1482,859,1002,125,135,219,1607,16,219,134,251,235,385,1766,3032,9,27804,1544,1,2,1,1,0
13962,79,3250,1289,550,1043,56,32,155,1345,10,167,93,185,177,278,1266,2075,5,11498,638,0,2,4,2,0
13963,222,4964,4293,999,3693,19,54,507,4312,9,155,88,170,164,258,1156,1898,4,9368,520,0,2,1,1,0
13964,222,4964,1482,859,1002,125,135,219,1607,16,219,134,251,235,385,1766,3032,9,27804,1544,1,2,1,1,0
13965,79,3250,1289,550,1043,56,32,155,1345,10,167,93,185,177,278,1266,2075,5,11498,638,0,2,4,2,0
13966,216,4657,182,127,129,0,0,53,182,5,39,21,42,44,63,217,343,2,926,51,0,2,92,18,0
13967,216,4657,1165,710,800,67,119,181,1232,18,243,153,282,261,435,2000,3492,10,36473,2026,1,2,92,18,0
13968,35,724,2,2,2,0,0,0,2,0,0,0,0,0,0,0,0,0,0,0,0,2,33,28,0
13969,35,724,99,48,90,1,3,5,100,0,0,0,0,0,0,0,0,0,0,0,0,2,33,28,0
13970,35,724,8,5,5,2,0,1,10,0,0,0,0,0,0,0,0,0,0,0,0,2,33,28,0
13971,35,724,1217,716,841,84,126,174,1301,14,185,118,215,199,333,1446,2542,8,20687,1149,0,2,33,28,0
13972,35,724,160,89,115,0,13,31,160,7,15,11,17,22,28,78,124,3,495,27,0,2,33,28,0
13973,35,724,10,10,9,9,0,0,19,0,0,0,0,0,0,0,0,0,0,0,0,2,33,28,0
13974,35,724,173,84,99,8,29,36,181,5,12,7,13,17,20,54,81,2,221,12,0,2,33,28,0
13975,35,724,3,1,1,3,0,0,6,0,0,0,0,0,0,0,0,0,0,0,0,2,33,28,0
13976,155,4940,1660,832,1314,41,38,274,1701,20,312,209,395,332,604,2671,5058,12,64042,3557,1,2,54,28,0
13977,155,4940,1057,646,719,113,100,145,1170,18,215,134,248,233,382,1740,3004,10,31186,1732,1,2,54,28,0
13978,117,2369,1513,682,1277,25,13,200,1538,11,199,116,219,210,335,1557,2584,6,15641,868,0,2,18,7,0
13979,117,2369,819,519,539,24,98,155,843,15,96,57,106,111,163,690,1107,8,9171,509,0,2,18,7,0
13980,40,775,207,111,150,11,0,50,218,5,26,19,36,31,55,133,272,3,943,52,0,0,203,0,0
13981,40,775,410,198,237,31,55,97,441,11,63,38,72,74,110,414,683,6,4293,238,0,0,203,0,0
13982,311,6296,1457,730,1242,11,6,188,1468,10,292,166,329,302,495,2424,4078,5,22973,1276,1,2,40,25,0
13983,311,6296,74,35,59,1,0,14,75,3,14,7,14,17,21,58,85,1,128,7,0,2,40,25,0
13984,311,6296,245,125,200,5,7,34,250,7,30,17,34,37,51,166,265,3,1053,58,0,2,40,25,0
13985,23,680,339,213,244,17,9,65,356,10,42,26,48,52,74,259,421,5,2410,133,0,2,19,6,0
13986,55,1468,1455,414,1257,16,76,112,1471,5,41,23,46,46,69,231,381,2,1069,59,0,2,12,1,0
13987,55,1468,669,365,481,22,61,110,691,15,103,63,122,118,185,747,1273,8,11311,628,0,2,12,1,0
13988,222,4964,4293,999,3693,19,54,507,4312,9,155,88,170,164,258,1156,1898,4,9368,520,0,0,1089,0,0
13989,222,4964,1482,859,1002,125,135,219,1607,16,219,134,251,235,385,1766,3032,9,27804,1544,1,0,1089,0,0
13990,7,139,44,22,19,0,19,6,44,2,10,6,12,12,18,35,64,1,77,4,0,0,45,0,0
13991,24,834,74,35,59,1,0,14,75,3,14,7,14,17,21,58,85,1,128,7,0,2,6,2,0
13992,24,834,245,125,200,5,7,34,250,7,30,17,34,37,51,166,265,3,1053,58,0,2,6,2,0
13993,49,571,647,139,84,35,284,233,682,0,0,0,0,0,0,0,0,0,0,0,0,2,20,1,0
13994,71,2075,1523,757,1297,19,12,193,1542,12,193,117,230,205,347,1508,2664,7,19053,1058,0,2,21,0,0
13995,71,2075,701,378,504,33,58,109,734,13,110,68,126,123,194,794,1346,7,10027,557,0,2,21,0,0
13996,175,4054,77,34,69,0,0,8,77,3,24,16,29,27,45,114,213,1,387,21,0,2,9,1,0
13997,175,4054,712,438,573,51,9,84,763,14,102,71,128,116,199,733,1364,8,11988,666,0,2,9,1,0
13998,46,949,447,308,343,6,5,95,453,7,96,59,111,103,170,651,1136,4,4600,255,0,2,7,4,0
13999,46,949,322,174,179,16,74,51,338,10,41,26,46,51,72,252,408,5,2291,127,0,2,7,4,0
14000,220,4885,722,423,573,19,0,135,741,12,172,101,199,184,300,1320,2257,6,15668,870,0,2,17,16,0
14001,220,4885,1508,847,911,44,250,301,1552,14,148,88,169,162,257,1120,1886,7,15077,837,0,2,17,16,0
14002,309,6699,72,33,56,0,4,12,72,1,1,1,1,2,2,0,2,0,1,0,0,2,428,1250,0
14003,309,6699,1454,835,1044,76,110,219,1530,17,275,158,296,292,454,2297,3718,9,34017,1889,1,2,428,1250,0
14004,122,2648,1043,504,840,53,9,147,1096,9,180,112,198,189,310,1377,2344,4,11604,644,0,2,18,1,0
14005,122,2648,383,288,292,26,6,62,409,11,65,38,67,76,105,429,656,5,3719,206,0,2,18,1,0
14006,20,400,294,64,250,0,0,43,294,1,20,10,20,21,30,86,131,0,65,3,0,0,72,0,0
14007,20,400,78,46,62,3,0,14,81,3,8,4,8,11,12,28,41,1,62,3,0,0,72,0,0
14008,5,110,110,30,77,3,13,16,113,4,21,15,30,25,45,100,208,2,597,33,0,0,23,0,0
14009,5,110,28,15,21,1,0,6,29,0,0,0,0,0,0,0,0,0,0,0,0,0,23,0,0
14010,180,3702,1943,715,1694,26,18,214,1969,12,185,120,237,197,357,1436,2721,7,20915,1161,0,2,0,14,0
14011,180,3702,1168,838,957,57,25,144,1225,19,348,224,416,367,640,3018,5452,11,61921,3440,1,2,0,14,0
14012,16,468,442,244,305,14,16,103,456,11,68,45,75,79,120,452,756,6,4588,254,0,2,2,2,0
14013,16,468,182,102,99,11,40,35,193,3,11,6,11,14,17,42,64,1,97,5,0,2,2,2,0
14014,54,1089,1098,241,925,5,10,155,1103,7,46,25,49,53,74,273,423,3,1580,87,0,2,2,0,0
14015,54,1089,282,202,222,14,2,44,296,8,42,24,43,50,67,250,378,4,1548,86,0,2,2,0,0
14016,3,63,127,75,83,2,11,30,129,4,14,7,14,18,21,61,87,2,175,9,0,2,2,2,0
14017,3,63,652,304,544,16,6,88,668,6,89,51,101,95,152,591,998,3,3399,188,0,2,2,2,0
14018,3,63,2,2,2,0,0,0,2,0,0,0,0,0,0,0,0,0,0,0,0,2,2,2,0
14019,3,63,8,5,5,0,0,3,8,0,0,0,0,0,0,0,0,0,0,0,0,2,2,2,0
14020,3,63,2,2,2,0,0,0,2,0,0,0,0,0,0,0,0,0,0,0,0,2,2,2,0
14021,3,63,14,8,8,0,0,6,14,0,0,0,0,0,0,0,0,0,0,0,0,2,2,2,0
14022,3,63,6,4,4,0,0,2,6,0,0,0,0,0,0,0,0,0,0,0,0,2,2,2,0
14023,3,63,6,4,4,0,0,2,6,1,2,1,2,3,3,2,4,0,2,0,0,2,2,2,0
14024,3,63,6,4,4,0,0,2,6,0,0,0,0,0,0,0,0,0,0,0,0,2,2,2,0
14025,3,63,7,5,5,0,0,2,7,0,0,0,0,0,0,0,0,0,0,0,0,2,2,2,0
14026,3,63,6,4,4,0,0,2,6,0,0,0,0,0,0,0,0,0,0,0,0,2,2,2,0
14027,3,63,10,6,6,0,0,4,10,0,0,0,0,0,0,0,0,0,0,0,0,2,2,2,0
14028,3,63,1,1,1,0,0,0,1,0,0,0,0,0,0,0,0,0,0,0,0,2,2,2,0
14029,3,63,1,1,1,0,0,0,1,0,0,0,0,0,0,0,0,0,0,0,0,2,2,2,0
14030,3,63,14,10,10,0,0,4,14,1,1,1,1,2,2,0,2,0,1,0,0,2,2,2,0
14031,3,63,46,26,30,3,0,12,49,3,6,3,6,9,9,20,28,1,42,2,0,2,2,2,0
14032,3,23,14,7,7,2,0,5,16,0,0,0,0,0,0,0,0,0,0,0,0,2,1,1,0
14033,14,470,42,7,35,4,0,5,46,1,2,1,2,3,3,2,4,0,2,0,0,2,5,26,0
14034,14,470,11,6,10,0,0,1,11,2,4,2,4,6,6,10,15,1,15,0,0,2,5,26,0
14035,79,3250,1289,550,1043,56,32,155,1345,10,167,93,185,177,278,1266,2075,5,11498,638,0,2,41,5,0
14036,139,6357,1392,870,1177,35,17,170,1427,14,494,280,531,508,811,4473,7289,7,54850,3047,2,2,149,5,0
14037,91,2970,773,419,590,28,0,166,801,10,204,113,217,214,330,1598,2554,5,13587,754,0,2,6,8,0
14038,43,2308,520,294,400,33,13,81,553,10,261,204,367,271,571,2128,4614,7,32445,1802,1,0,286,0,0
14039,85,3904,1338,495,1086,10,64,173,1348,11,122,82,157,133,239,883,1686,7,11934,663,0,2,23,8,0
14040,146,6582,139,89,101,2,0,35,141,7,54,34,62,61,96,330,569,4,2287,127,0,2,168,108,0
14041,146,6582,7,5,5,0,0,2,7,1,2,1,2,3,3,2,4,0,2,0,0,2,168,108,0
14042,32,933,465,148,393,5,8,60,470,4,31,20,31,35,51,161,261,2,523,29,0,2,8,5,0
14043,32,933,16,12,9,0,0,6,16,1,2,1,2,3,3,2,4,0,2,0,0,2,8,5,0
14044,90,4801,1782,648,1425,9,47,279,1791,8,171,97,189,179,286,1292,2140,4,9462,525,0,2,126,31,0
14045,16,362,256,139,192,9,7,47,265,4,23,12,24,27,36,112,171,2,357,19,0,2,20,0,0
14046,5,280,180,34,164,0,0,16,180,1,12,6,12,13,18,43,66,0,33,1,0,0,137,0,0
14047,77,2760,1450,624,1228,12,26,181,1462,14,306,186,354,320,540,2580,4493,8,36391,2021,1,2,27,14,0
14048,143,3771,1660,832,1314,41,38,274,1701,20,312,209,395,332,604,2671,5058,12,64042,3557,1,2,61,0,0
14049,113,4391,1513,682,1277,25,13,200,1538,11,199,116,219,210,335,1557,2584,6,15641,868,0,2,16,0,0
14050,59,3272,1296,573,1062,40,33,157,1336,8,201,118,231,209,349,1561,2689,4,12365,686,0,2,115,1,0
14051,65,3259,1457,730,1242,11,6,188,1468,10,292,166,329,302,495,2424,4078,5,22973,1276,1,2,116,5,0
14052,55,2458,1455,414,1257,16,76,112,1471,5,41,23,46,46,69,231,381,2,1069,59,0,2,67,4,0
14053,2,67,7,6,5,0,0,2,7,1,1,1,2,2,3,0,3,1,3,0,0,0,13,0,0
14054,8,265,74,35,59,1,0,14,75,3,14,7,14,17,21,58,85,1,128,7,0,2,2,2,0
14055,76,3740,1523,757,1297,19,12,193,1542,12,193,117,230,205,347,1508,2664,7,19053,1058,0,2,91,24,0
14056,66,2745,1020,354,843,12,15,144,1032,8,134,77,144,142,221,970,1580,4,6792,377,0,2,51,2,0
14057,38,1616,447,308,343,6,5,95,453,7,96,59,111,103,170,651,1136,4,4600,255,0,2,4,3,0
14058,39,2275,334,251,279,10,4,40,344,5,127,74,143,132,217,899,1528,2,4303,239,0,2,16,7,0
14059,38,1401,1293,570,1093,25,15,163,1318,10,195,123,241,205,364,1516,2795,6,17273,959,0,2,29,1,0
14060,16,1198,215,129,180,6,0,29,221,8,65,43,72,73,115,415,711,4,3153,175,0,2,1,10,0
14061,62,2603,1043,504,840,53,9,147,1096,9,180,112,198,189,310,1377,2344,4,11604,644,0,2,3,13,0
14062,13,413,295,56,236,0,4,54,295,2,9,5,10,11,15,30,51,1,57,3,0,2,2,1,0
14063,22,942,373,158,315,8,0,51,381,5,76,44,79,81,123,486,779,2,2026,112,0,2,2,8,0
14064,67,2869,1178,367,1042,6,15,115,1184,9,94,51,95,103,146,644,976,4,4439,246,0,2,24,10,0
14065,71,3611,1943,715,1694,26,18,214,1969,12,185,120,237,197,357,1436,2721,7,20915,1161,0,2,15,19,0
14066,39,1537,1098,241,925,5,10,155,1103,7,46,25,49,53,74,273,423,3,1580,87,0,2,16,2,0
14067,180,3702,1943,715,1694,26,18,214,1969,12,185,120,237,197,357,1436,2721,7,20915,1161,0,2,12,3,0
14068,180,3702,1168,838,957,57,25,144,1225,19,348,224,416,367,640,3018,5452,11,61921,3440,1,2,12,3,0
14069,65,3259,1457,730,1242,11,6,188,1468,10,292,166,329,302,495,2424,4078,5,22973,1276,1,2,2,2,0
14070,71,3611,1943,715,1694,26,18,214,1969,12,185,120,237,197,357,1436,2721,7,20915,1161,0,2,11,1,0
14071,312,6316,1457,730,1242,11,6,188,1468,10,292,166,329,302,495,2424,4078,5,22973,1276,1,2,7,0,1
14072,312,6316,74,35,59,1,0,14,75,3,14,7,14,17,21,58,85,1,128,7,0,2,7,0,1
14073,312,6316,245,125,200,5,7,34,250,7,30,17,34,37,51,166,265,3,1053,58,0,2,7,0,1
14074,81,3313,1289,550,1043,56,32,155,1345,10,167,93,185,177,278,1266,2075,5,11498,638,0,2,14,0,1
14075,37,691,2,2,2,0,0,0,2,0,0,0,0,0,0,0,0,0,0,0,0,2,2,2,1
14076,37,691,99,48,90,1,3,5,100,0,0,0,0,0,0,0,0,0,0,0,0,2,2,2,1
14077,37,691,8,5,5,2,0,1,10,0,0,0,0,0,0,0,0,0,0,0,0,2,2,2,1
14078,37,691,1217,716,841,84,126,174,1301,14,185,118,215,199,333,1446,2542,8,20687,1149,0,2,2,2,1
14079,37,691,160,89,115,0,13,31,160,7,15,11,17,22,28,78,124,3,495,27,0,2,2,2,1
14080,37,691,10,10,9,9,0,0,19,0,0,0,0,0,0,0,0,0,0,0,0,2,2,2,1
14081,37,691,173,84,99,8,29,36,181,5,12,7,13,17,20,54,81,2,221,12,0,2,2,2,1
14082,37,691,3,1,1,3,0,0,6,0,0,0,0,0,0,0,0,0,0,0,0,2,2,2,1
14083,323,6553,1457,730,1242,11,6,188,1468,10,292,166,329,302,495,2424,4078,5,22973,1276,1,2,1,4,1
14084,323,6553,74,35,59,1,0,14,75,3,14,7,14,17,21,58,85,1,128,7,0,2,1,4,1
14085,323,6553,245,125,200,5,7,34,250,7,30,17,34,37,51,166,265,3,1053,58,0,2,1,4,1
14086,68,3328,1457,730,1242,11,6,188,1468,10,292,166,329,302,495,2424,4078,5,22973,1276,1,2,7,2,1
14087,312,6316,1457,730,1242,11,6,188,1468,10,292,166,329,302,495,2424,4078,5,22973,1276,1,2,7,0,0
14088,312,6316,74,35,59,1,0,14,75,3,14,7,14,17,21,58,85,1,128,7,0,2,7,0,0
14089,312,6316,245,125,200,5,7,34,250,7,30,17,34,37,51,166,265,3,1053,58,0,2,7,0,0
14090,81,3313,1289,550,1043,56,32,155,1345,10,167,93,185,177,278,1266,2075,5,11498,638,0,2,14,0,0
14091,146,6594,139,89,101,2,0,35,141,7,54,34,62,61,96,330,569,4,2287,127,0,2,2,1,1
14092,146,6594,7,5,5,0,0,2,7,1,2,1,2,3,3,2,4,0,2,0,0,2,2,1,1
14093,35,2163,652,304,544,16,6,88,668,6,89,51,101,95,152,591,998,3,3399,188,0,2,1,0,1
14094,37,691,2,2,2,0,0,0,2,0,0,0,0,0,0,0,0,0,0,0,0,2,51,51,0
14095,37,691,99,48,90,1,3,5,100,0,0,0,0,0,0,0,0,0,0,0,0,2,51,51,0
14096,37,691,8,5,5,2,0,1,10,0,0,0,0,0,0,0,0,0,0,0,0,2,51,51,0
14097,37,691,1217,716,841,84,126,174,1301,14,185,118,215,199,333,1446,2542,8,20687,1149,0,2,51,51,0
14098,37,691,160,89,115,0,13,31,160,7,15,11,17,22,28,78,124,3,495,27,0,2,51,51,0
14099,37,691,10,10,9,9,0,0,19,0,0,0,0,0,0,0,0,0,0,0,0,2,51,51,0
14100,37,691,173,84,99,8,29,36,181,5,12,7,13,17,20,54,81,2,221,12,0,2,51,51,0
14101,37,691,3,1,1,3,0,0,6,0,0,0,0,0,0,0,0,0,0,0,0,2,51,51,0
14102,160,5038,1660,832,1314,41,38,274,1701,20,312,209,395,332,604,2671,5058,12,64042,3557,1,2,24,2,0
14103,160,5038,1057,646,719,113,100,145,1170,18,215,134,248,233,382,1740,3004,10,31186,1732,1,2,24,2,0
14104,324,6573,1457,730,1242,11,6,188,1468,10,292,166,329,302,495,2424,4078,5,22973,1276,1,2,53,2,0
14105,324,6573,74,35,59,1,0,14,75,3,14,7,14,17,21,58,85,1,128,7,0,2,53,2,0
14106,324,6573,245,125,200,5,7,34,250,7,30,17,34,37,51,166,265,3,1053,58,0,2,53,2,0
14107,221,4925,722,423,573,19,0,135,741,12,172,101,199,184,300,1320,2257,6,15668,870,0,2,11,1,0
14108,221,4925,1508,847,911,44,250,301,1552,14,148,88,169,162,257,1120,1886,7,15077,837,0,2,11,1,0
14109,91,3201,1450,624,1228,12,26,181,1462,14,306,186,354,320,540,2580,4493,8,36391,2021,1,2,183,0,0
14110,140,3706,1660,832,1314,41,38,274,1701,20,312,209,395,332,604,2671,5058,12,64042,3557,1,2,11,35,0
14111,68,3328,1457,730,1242,11,6,188,1468,10,292,166,329,302,495,2424,4078,5,22973,1276,1,2,19,5,0
14112,146,6594,139,89,101,2,0,35,141,7,54,34,62,61,96,330,569,4,2287,127,0,2,2,1,0
14113,146,6594,7,5,5,0,0,2,7,1,2,1,2,3,3,2,4,0,2,0,0,2,2,1,0
14114,35,2163,652,304,544,16,6,88,668,6,89,51,101,95,152,591,998,3,3399,188,0,2,1,0,0
14115,81,3317,1289,550,1043,56,32,155,1345,10,167,93,185,177,278,1266,2075,5,11498,638,0,2,3,1,0
14116,81,3317,1289,550,1043,56,32,155,1345,10,167,93,185,177,278,1266,2075,5,11498,638,0,2,3,1,0
14117,207,4421,182,127,129,0,0,53,182,5,39,21,42,44,63,217,343,2,926,51,0,2,0,35,1
14118,207,4421,1165,710,800,67,119,181,1232,18,243,153,282,261,435,2000,3492,10,36473,2026,1,2,0,35,1
14119,32,595,2,2,2,0,0,0,2,0,0,0,0,0,0,0,0,0,0,0,0,2,19,45,1
14120,32,595,99,48,90,1,3,5,100,0,0,0,0,0,0,0,0,0,0,0,0,2,19,45,1
14121,32,595,8,5,5,2,0,1,10,0,0,0,0,0,0,0,0,0,0,0,0,2,19,45,1
14122,32,595,1217,716,841,84,126,174,1301,14,185,118,215,199,333,1446,2542,8,20687,1149,0,2,19,45,1
14123,32,595,160,89,115,0,13,31,160,7,15,11,17,22,28,78,124,3,495,27,0,2,19,45,1
14124,32,595,10,10,9,9,0,0,19,0,0,0,0,0,0,0,0,0,0,0,0,2,19,45,1
14125,32,595,173,84,99,8,29,36,181,5,12,7,13,17,20,54,81,2,221,12,0,2,19,45,1
14126,32,595,3,1,1,3,0,0,6,0,0,0,0,0,0,0,0,0,0,0,0,2,19,45,1
14127,324,6577,1457,730,1242,11,6,188,1468,10,292,166,329,302,495,2424,4078,5,22973,1276,1,2,16,12,1
14128,324,6577,74,35,59,1,0,14,75,3,14,7,14,17,21,58,85,1,128,7,0,2,16,12,1
14129,324,6577,245,125,200,5,7,34,250,7,30,17,34,37,51,166,265,3,1053,58,0,2,16,12,1
14130,34,980,182,127,129,0,0,53,182,5,39,21,42,44,63,217,343,2,926,51,0,2,0,18,1
14131,133,6161,1392,870,1177,35,17,170,1427,14,494,280,531,508,811,4473,7289,7,54850,3047,2,2,2,46,1
14132,86,3108,1450,624,1228,12,26,181,1462,14,306,186,354,320,540,2580,4493,8,36391,2021,1,2,4,24,1
14133,311,6718,72,33,56,0,4,12,72,1,1,1,1,2,2,0,2,0,1,0,0,2,45,40,1
14134,311,6718,1454,835,1044,76,110,219,1530,17,275,158,296,292,454,2297,3718,9,34017,1889,1,2,45,40,1
14135,62,2604,1043,504,840,53,9,147,1096,9,180,112,198,189,310,1377,2344,4,11604,644,0,2,4,3,1
14136,14,520,295,56,236,0,4,54,295,2,9,5,10,11,15,30,51,1,57,3,0,2,52,0,1
14137,207,4421,182,127,129,0,0,53,182,5,39,21,42,44,63,217,343,2,926,51,0,2,0,35,0
14138,207,4421,1165,710,800,67,119,181,1232,18,243,153,282,261,435,2000,3492,10,36473,2026,1,2,0,35,0
14139,32,595,2,2,2,0,0,0,2,0,0,0,0,0,0,0,0,0,0,0,0,2,19,45,0
14140,32,595,99,48,90,1,3,5,100,0,0,0,0,0,0,0,0,0,0,0,0,2,19,45,0
14141,32,595,8,5,5,2,0,1,10,0,0,0,0,0,0,0,0,0,0,0,0,2,19,45,0
14142,32,595,1217,716,841,84,126,174,1301,14,185,118,215,199,333,1446,2542,8,20687,1149,0,2,19,45,0
14143,32,595,160,89,115,0,13,31,160,7,15,11,17,22,28,78,124,3,495,27,0,2,19,45,0
14144,32,595,10,10,9,9,0,0,19,0,0,0,0,0,0,0,0,0,0,0,0,2,19,45,0
14145,32,595,173,84,99,8,29,36,181,5,12,7,13,17,20,54,81,2,221,12,0,2,19,45,0
14146,32,595,3,1,1,3,0,0,6,0,0,0,0,0,0,0,0,0,0,0,0,2,19,45,0
14147,324,6577,1457,730,1242,11,6,188,1468,10,292,166,329,302,495,2424,4078,5,22973,1276,1,2,16,12,0
14148,324,6577,74,35,59,1,0,14,75,3,14,7,14,17,21,58,85,1,128,7,0,2,16,12,0
14149,324,6577,245,125,200,5,7,34,250,7,30,17,34,37,51,166,265,3,1053,58,0,2,16,12,0
14150,34,980,182,127,129,0,0,53,182,5,39,21,42,44,63,217,343,2,926,51,0,2,0,18,0
14151,133,6161,1392,870,1177,35,17,170,1427,14,494,280,531,508,811,4473,7289,7,54850,3047,2,2,2,46,0
14152,86,3108,1450,624,1228,12,26,181,1462,14,306,186,354,320,540,2580,4493,8,36391,2021,1,2,4,24,0
14153,311,6718,72,33,56,0,4,12,72,1,1,1,1,2,2,0,2,0,1,0,0,2,45,40,0
14154,311,6718,1454,835,1044,76,110,219,1530,17,275,158,296,292,454,2297,3718,9,34017,1889,1,2,45,40,0
14155,62,2604,1043,504,840,53,9,147,1096,9,180,112,198,189,310,1377,2344,4,11604,644,0,2,4,3,0
14156,14,520,295,56,236,0,4,54,295,2,9,5,10,11,15,30,51,1,57,3,0,2,52,0,0
14157,324,6585,1457,730,1242,11,6,188,1468,10,292,166,329,302,495,2424,4078,5,22973,1276,1,2,9,2,0
14158,324,6585,74,35,59,1,0,14,75,3,14,7,14,17,21,58,85,1,128,7,0,2,9,2,0
14159,324,6585,245,125,200,5,7,34,250,7,30,17,34,37,51,166,265,3,1053,58,0,2,9,2,0
14160,321,6564,1457,730,1242,11,6,188,1468,10,292,166,329,302,495,2424,4078,5,22973,1276,1,2,19,28,1
14161,321,6564,74,35,59,1,0,14,75,3,14,7,14,17,21,58,85,1,128,7,0,2,19,28,1
14162,321,6564,245,125,200,5,7,34,250,7,30,17,34,37,51,166,265,3,1053,58,0,2,19,28,1
14163,321,6564,1457,730,1242,11,6,188,1468,10,292,166,329,302,495,2424,4078,5,22973,1276,1,2,28,30,0
14164,321,6564,74,35,59,1,0,14,75,3,14,7,14,17,21,58,85,1,128,7,0,2,28,30,0
14165,321,6564,245,125,200,5,7,34,250,7,30,17,34,37,51,166,265,3,1053,58,0,2,28,30,0
14166,174,4040,77,34,69,0,0,8,77,3,24,16,29,27,45,114,213,1,387,21,0,2,4,4,1
14167,174,4040,712,438,573,51,9,84,763,14,102,71,128,116,199,733,1364,8,11988,666,0,2,4,4,1
14168,25,1016,373,158,315,8,0,51,381,5,76,44,79,81,123,486,779,2,2026,112,0,2,8,0,1
14169,100,1889,1178,367,1042,6,15,115,1184,9,94,51,95,103,146,644,976,4,4439,246,0,2,1,5,1
14170,100,1889,177,108,140,8,0,27,185,6,30,16,32,36,48,162,248,3,794,44,0,2,1,5,1
14171,100,1889,1178,367,1042,6,15,115,1184,9,94,51,95,103,146,644,976,4,4439,246,0,2,1,5,0
14172,100,1889,177,108,140,8,0,27,185,6,30,16,32,36,48,162,248,3,794,44,0,2,1,5,0
14173,174,4040,77,34,69,0,0,8,77,3,24,16,29,27,45,114,213,1,387,21,0,2,4,4,0
14174,174,4040,712,438,573,51,9,84,763,14,102,71,128,116,199,733,1364,8,11988,666,0,2,4,4,0
14175,25,1016,373,158,315,8,0,51,381,5,76,44,79,81,123,486,779,2,2026,112,0,2,8,0,0
14176,207,4421,182,127,129,0,0,53,182,5,39,21,42,44,63,217,343,2,926,51,0,2,0,35,0
14177,207,4421,1165,710,800,67,119,181,1232,18,243,153,282,261,435,2000,3492,10,36473,2026,1,2,0,35,0
14178,32,595,2,2,2,0,0,0,2,0,0,0,0,0,0,0,0,0,0,0,0,2,59,85,0
14179,32,595,99,48,90,1,3,5,100,0,0,0,0,0,0,0,0,0,0,0,0,2,59,85,0
14180,32,595,8,5,5,2,0,1,10,0,0,0,0,0,0,0,0,0,0,0,0,2,59,85,0
14181,32,595,1217,716,841,84,126,174,1301,14,185,118,215,199,333,1446,2542,8,20687,1149,0,2,59,85,0
14182,32,595,160,89,115,0,13,31,160,7,15,11,17,22,28,78,124,3,495,27,0,2,59,85,0
14183,32,595,10,10,9,9,0,0,19,0,0,0,0,0,0,0,0,0,0,0,0,2,59,85,0
14184,32,595,173,84,99,8,29,36,181,5,12,7,13,17,20,54,81,2,221,12,0,2,59,85,0
14185,32,595,3,1,1,3,0,0,6,0,0,0,0,0,0,0,0,0,0,0,0,2,59,85,0
14186,160,5038,1660,832,1314,41,38,274,1701,20,312,209,395,332,604,2671,5058,12,64042,3557,1,2,29,2,0
14187,160,5038,1057,646,719,113,100,145,1170,18,215,134,248,233,382,1740,3004,10,31186,1732,1,2,29,2,0
14188,82,1803,477,336,357,30,23,73,507,16,194,134,250,210,384,1538,2962,10,30538,1696,0,2,0,33,0
14189,40,775,207,111,150,11,0,50,218,5,26,19,36,31,55,133,272,3,943,52,0,0,203,0,0
14190,40,775,410,198,237,31,55,97,441,11,63,38,72,74,110,414,683,6,4293,238,0,0,203,0,0
14191,322,6605,1457,730,1242,11,6,188,1468,10,292,166,329,302,495,2424,4078,5,22973,1276,1,2,100,46,0
14192,322,6605,74,35,59,1,0,14,75,3,14,7,14,17,21,58,85,1,128,7,0,2,100,46,0
14193,322,6605,245,125,200,5,7,34,250,7,30,17,34,37,51,166,265,3,1053,58,0,2,100,46,0
14194,23,680,339,213,244,17,9,65,356,10,42,26,48,52,74,259,421,5,2410,133,0,3,19,6,0
14195,55,1468,1455,414,1257,16,76,112,1471,5,41,23,46,46,69,231,381,2,1069,59,0,2,2,2,0
14196,55,1468,669,365,481,22,61,110,691,15,103,63,122,118,185,747,1273,8,11311,628,0,2,2,2,0
14197,222,4964,4293,999,3693,19,54,507,4312,9,155,88,170,164,258,1156,1898,4,9368,520,0,0,1089,0,0
14198,222,4964,1482,859,1002,125,135,219,1607,16,219,134,251,235,385,1766,3032,9,27804,1544,1,0,1089,0,0
14199,174,4040,77,34,69,0,0,8,77,3,24,16,29,27,45,114,213,1,387,21,0,2,4,4,0
14200,174,4040,712,438,573,51,9,84,763,14,102,71,128,116,199,733,1364,8,11988,666,0,2,4,4,0
14201,46,949,447,308,343,6,5,95,453,7,96,59,111,103,170,651,1136,4,4600,255,0,2,7,4,0
14202,46,949,322,174,179,16,74,51,338,10,41,26,46,51,72,252,408,5,2291,127,0,2,7,4,0
14203,221,4925,722,423,573,19,0,135,741,12,172,101,199,184,300,1320,2257,6,15668,870,0,2,13,2,0
14204,221,4925,1508,847,911,44,250,301,1552,14,148,88,169,162,257,1120,1886,7,15077,837,0,2,13,2,0
14205,311,6718,72,33,56,0,4,12,72,1,1,1,1,2,2,0,2,0,1,0,0,2,80,1276,0
14206,311,6718,1454,835,1044,76,110,219,1530,17,275,158,296,292,454,2297,3718,9,34017,1889,1,2,80,1276,0
14207,122,2648,1043,504,840,53,9,147,1096,9,180,112,198,189,310,1377,2344,4,11604,644,0,2,2,2,0
14208,122,2648,383,288,292,26,6,62,409,11,65,38,67,76,105,429,656,5,3719,206,0,2,2,2,0
14209,20,400,294,64,250,0,0,43,294,1,20,10,20,21,30,86,131,0,65,3,0,2,17,4,0
14210,20,400,78,46,62,3,0,14,81,3,8,4,8,11,12,28,41,1,62,3,0,2,17,4,0
14211,5,110,110,30,77,3,13,16,113,4,21,15,30,25,45,100,208,2,597,33,0,2,6,2,0
14212,5,110,28,15,21,1,0,6,29,0,0,0,0,0,0,0,0,0,0,0,0,2,6,2,0
14213,100,1889,1178,367,1042,6,15,115,1184,9,94,51,95,103,146,644,976,4,4439,246,0,2,1,5,0
14214,100,1889,177,108,140,8,0,27,185,6,30,16,32,36,48,162,248,3,794,44,0,2,1,5,0
14215,180,3702,1943,715,1694,26,18,214,1969,12,185,120,237,197,357,1436,2721,7,20915,1161,0,2,12,3,0
14216,180,3702,1168,838,957,57,25,144,1225,19,348,224,416,367,640,3018,5452,11,61921,3440,1,2,12,3,0
14217,16,468,442,244,305,14,16,103,456,11,68,45,75,79,120,452,756,6,4588,254,0,2,2,2,0
14218,16,468,182,102,99,11,40,35,193,3,11,6,11,14,17,42,64,1,97,5,0,2,2,2,0
14219,81,3317,1289,550,1043,56,32,155,1345,10,167,93,185,177,278,1266,2075,5,11498,638,0,2,49,0,0
14220,34,980,182,127,129,0,0,53,182,5,39,21,42,44,63,217,343,2,926,51,0,2,0,18,0
14221,133,6161,1392,870,1177,35,17,170,1427,14,494,280,531,508,811,4473,7289,7,54850,3047,2,2,6,48,0
14222,91,2970,773,419,590,28,0,166,801,10,204,113,217,214,330,1598,2554,5,13587,754,0,2,5,5,0
14223,85,3904,1338,495,1086,10,64,173,1348,11,122,82,157,133,239,883,1686,7,11934,663,0,2,8,5,0
14224,146,6594,139,89,101,2,0,35,141,7,54,34,62,61,96,330,569,4,2287,127,0,2,173,85,0
14225,146,6594,7,5,5,0,0,2,7,1,2,1,2,3,3,2,4,0,2,0,0,2,173,85,0
14226,32,933,465,148,393,5,8,60,470,4,31,20,31,35,51,161,261,2,523,29,0,2,8,5,0
14227,32,933,16,12,9,0,0,6,16,1,2,1,2,3,3,2,4,0,2,0,0,2,8,5,0
14228,90,4801,1782,648,1425,9,47,279,1791,8,171,97,189,179,286,1292,2140,4,9462,525,0,2,34,21,0
14229,86,3108,1450,624,1228,12,26,181,1462,14,306,186,354,320,540,2580,4493,8,36391,2021,1,2,181,15,0
14230,140,3706,1660,832,1314,41,38,274,1701,20,312,209,395,332,604,2671,5058,12,64042,3557,1,2,56,47,0
14231,68,3328,1457,730,1242,11,6,188,1468,10,292,166,329,302,495,2424,4078,5,22973,1276,1,2,37,6,0
14232,37,2210,652,304,544,16,6,88,668,6,89,51,101,95,152,591,998,3,3399,188,0,2,1,0,0
14233,76,3740,1523,757,1297,19,12,193,1542,12,193,117,230,205,347,1508,2664,7,19053,1058,0,2,13,4,0
14234,66,2745,1020,354,843,12,15,144,1032,8,134,77,144,142,221,970,1580,4,6792,377,0,2,2,1,0
14235,38,1616,447,308,343,6,5,95,453,7,96,59,111,103,170,651,1136,4,4600,255,0,2,4,3,0
14236,39,2275,334,251,279,10,4,40,344,5,127,74,143,132,217,899,1528,2,4303,239,0,2,3,0,0
14237,38,1401,1293,570,1093,25,15,163,1318,10,195,123,241,205,364,1516,2795,6,17273,959,0,2,31,3,0
14238,62,2604,1043,504,840,53,9,147,1096,9,180,112,198,189,310,1377,2344,4,11604,644,0,2,7,4,0
14239,14,520,295,56,236,0,4,54,295,2,9,5,10,11,15,30,51,1,57,3,0,2,54,1,0
14240,25,1016,373,158,315,8,0,51,381,5,76,44,79,81,123,486,779,2,2026,112,0,2,8,0,0
14241,67,2869,1178,367,1042,6,15,115,1184,9,94,51,95,103,146,644,976,4,4439,246,0,2,4,2,0
14242,71,3611,1943,715,1694,26,18,214,1969,12,185,120,237,197,357,1436,2721,7,20915,1161,0,2,20,4,0
14243,39,1537,1098,241,925,5,10,155,1103,7,46,25,49,53,74,273,423,3,1580,87,0,2,2,2,0
14244,237,5209,4293,999,3693,19,54,507,4312,9,155,88,170,164,258,1156,1898,4,9368,520,0,2,2,4,1
14245,237,5209,1482,859,1002,125,135,219,1607,16,219,134,251,235,385,1766,3032,9,27804,1544,1,2,2,4,1
14246,322,6605,1457,730,1242,11,6,188,1468,10,292,166,329,302,495,2424,4078,5,22973,1276,1,2,6,0,0
14247,322,6605,74,35,59,1,0,14,75,3,14,7,14,17,21,58,85,1,128,7,0,2,6,0,0
14248,322,6605,245,125,200,5,7,34,250,7,30,17,34,37,51,166,265,3,1053,58,0,2,6,0,0
14249,37,2210,652,304,544,16,6,88,668,6,89,51,101,95,152,591,998,3,3399,188,0,2,13,0,0
14250,207,4421,182,127,129,0,0,53,182,5,39,21,42,44,63,217,343,2,926,51,0,2,0,35,0
14251,207,4421,1165,710,800,67,119,181,1232,18,243,153,282,261,435,2000,3492,10,36473,2026,1,2,0,35,0
14252,32,595,2,2,2,0,0,0,2,0,0,0,0,0,0,0,0,0,0,0,0,2,59,85,0
14253,32,595,99,48,90,1,3,5,100,0,0,0,0,0,0,0,0,0,0,0,0,2,59,85,0
14254,32,595,8,5,5,2,0,1,10,0,0,0,0,0,0,0,0,0,0,0,0,2,59,85,0
14255,32,595,1217,716,841,84,126,174,1301,14,185,118,215,199,333,1446,2542,8,20687,1149,0,2,59,85,0
14256,32,595,160,89,115,0,13,31,160,7,15,11,17,22,28,78,124,3,495,27,0,2,59,85,0
14257,32,595,10,10,9,9,0,0,19,0,0,0,0,0,0,0,0,0,0,0,0,2,59,85,0
14258,32,595,173,84,99,8,29,36,181,5,12,7,13,17,20,54,81,2,221,12,0,2,59,85,0
14259,32,595,3,1,1,3,0,0,6,0,0,0,0,0,0,0,0,0,0,0,0,2,59,85,0
14260,160,5038,1660,832,1314,41,38,274,1701,20,312,209,395,332,604,2671,5058,12,64042,3557,1,2,24,2,0
14261,160,5038,1057,646,719,113,100,145,1170,18,215,134,248,233,382,1740,3004,10,31186,1732,1,2,24,2,0
14262,322,6605,1457,730,1242,11,6,188,1468,10,292,166,329,302,495,2424,4078,5,22973,1276,1,2,98,32,0
14263,322,6605,74,35,59,1,0,14,75,3,14,7,14,17,21,58,85,1,128,7,0,2,98,32,0
14264,322,6605,245,125,200,5,7,34,250,7,30,17,34,37,51,166,265,3,1053,58,0,2,98,32,0
14265,23,680,339,213,244,17,9,65,356,10,42,26,48,52,74,259,421,5,2410,133,0,2,19,6,0
14266,237,5240,4293,999,3693,19,54,507,4312,9,155,88,170,164,258,1156,1898,4,9368,520,0,2,9,3,0
14267,237,5240,1482,859,1002,125,135,219,1607,16,219,134,251,235,385,1766,3032,9,27804,1544,1,2,9,3,0
14268,174,4040,77,34,69,0,0,8,77,3,24,16,29,27,45,114,213,1,387,21,0,2,4,4,0
14269,174,4040,712,438,573,51,9,84,763,14,102,71,128,116,199,733,1364,8,11988,666,0,2,4,4,0
14270,46,949,447,308,343,6,5,95,453,7,96,59,111,103,170,651,1136,4,4600,255,0,2,7,4,0
14271,46,949,322,174,179,16,74,51,338,10,41,26,46,51,72,252,408,5,2291,127,0,2,7,4,0
14272,221,4925,722,423,573,19,0,135,741,12,172,101,199,184,300,1320,2257,6,15668,870,0,2,13,2,0
14273,221,4925,1508,847,911,44,250,301,1552,14,148,88,169,162,257,1120,1886,7,15077,837,0,2,13,2,0
14274,311,6718,72,33,56,0,4,12,72,1,1,1,1,2,2,0,2,0,1,0,0,2,47,39,0
14275,311,6718,1454,835,1044,76,110,219,1530,17,275,158,296,292,454,2297,3718,9,34017,1889,1,2,47,39,0
14276,100,1889,1178,367,1042,6,15,115,1184,9,94,51,95,103,146,644,976,4,4439,246,0,2,1,5,0
14277,100,1889,177,108,140,8,0,27,185,6,30,16,32,36,48,162,248,3,794,44,0,2,1,5,0
14278,180,3702,1943,715,1694,26,18,214,1969,12,185,120,237,197,357,1436,2721,7,20915,1161,0,2,12,3,0
14279,180,3702,1168,838,957,57,25,144,1225,19,348,224,416,367,640,3018,5452,11,61921,3440,1,2,12,3,0
14280,16,468,442,244,305,14,16,103,456,11,68,45,75,79,120,452,756,6,4588,254,0,2,2,2,0
14281,16,468,182,102,99,11,40,35,193,3,11,6,11,14,17,42,64,1,97,5,0,2,2,2,0
14282,81,3317,1289,550,1043,56,32,155,1345,10,167,93,185,177,278,1266,2075,5,11498,638,0,2,49,0,0
14283,34,980,182,127,129,0,0,53,182,5,39,21,42,44,63,217,343,2,926,51,0,2,0,18,0
14284,133,6161,1392,870,1177,35,17,170,1427,14,494,280,531,508,811,4473,7289,7,54850,3047,2,2,5,47,0
14285,91,2970,773,419,590,28,0,166,801,10,204,113,217,214,330,1598,2554,5,13587,754,0,2,5,5,0
14286,85,3904,1338,495,1086,10,64,173,1348,11,122,82,157,133,239,883,1686,7,11934,663,0,2,7,4,0
14287,146,6594,139,89,101,2,0,35,141,7,54,34,62,61,96,330,569,4,2287,127,0,2,130,49,0
14288,146,6594,7,5,5,0,0,2,7,1,2,1,2,3,3,2,4,0,2,0,0,2,130,49,0
14289,32,933,465,148,393,5,8,60,470,4,31,20,31,35,51,161,261,2,523,29,0,2,5,2,0
14290,32,933,16,12,9,0,0,6,16,1,2,1,2,3,3,2,4,0,2,0,0,2,5,2,0
14291,90,4801,1782,648,1425,9,47,279,1791,8,171,97,189,179,286,1292,2140,4,9462,525,0,2,25,12,0
14292,86,3108,1450,624,1228,12,26,181,1462,14,306,186,354,320,540,2580,4493,8,36391,2021,1,2,181,15,0
14293,140,3706,1660,832,1314,41,38,274,1701,20,312,209,395,332,604,2671,5058,12,64042,3557,1,2,11,35,0
14294,68,3328,1457,730,1242,11,6,188,1468,10,292,166,329,302,495,2424,4078,5,22973,1276,1,2,21,7,0
14295,37,2210,652,304,544,16,6,88,668,6,89,51,101,95,152,591,998,3,3399,188,0,2,14,0,0
14296,76,3740,1523,757,1297,19,12,193,1542,12,193,117,230,205,347,1508,2664,7,19053,1058,0,2,13,4,0
14297,66,2745,1020,354,843,12,15,144,1032,8,134,77,144,142,221,970,1580,4,6792,377,0,2,2,1,0
14298,38,1616,447,308,343,6,5,95,453,7,96,59,111,103,170,651,1136,4,4600,255,0,2,4,3,0
14299,38,1401,1293,570,1093,25,15,163,1318,10,195,123,241,205,364,1516,2795,6,17273,959,0,2,29,1,0
14300,62,2604,1043,504,840,53,9,147,1096,9,180,112,198,189,310,1377,2344,4,11604,644,0,2,7,4,0
14301,14,520,295,56,236,0,4,54,295,2,9,5,10,11,15,30,51,1,57,3,0,2,54,1,0
14302,25,1016,373,158,315,8,0,51,381,5,76,44,79,81,123,486,779,2,2026,112,0,2,8,0,0
14303,67,2869,1178,367,1042,6,15,115,1184,9,94,51,95,103,146,644,976,4,4439,246,0,2,4,2,0
14304,71,3611,1943,715,1694,26,18,214,1969,12,185,120,237,197,357,1436,2721,7,20915,1161,0,2,20,4,0
14305,39,1537,1098,241,925,5,10,155,1103,7,46,25,49,53,74,273,423,3,1580,87,0,2,2,2,0
14306,46,954,447,308,343,6,5,95,453,7,96,59,111,103,170,651,1136,4,4600,255,0,2,6,3,1
14307,46,954,322,174,179,16,74,51,338,10,41,26,46,51,72,252,408,5,2291,127,0,2,6,3,1
14308,39,1661,447,308,343,6,5,95,453,7,96,59,111,103,170,651,1136,4,4600,255,0,2,33,1,1
14309,223,4983,722,423,573,19,0,135,741,12,172,101,199,184,300,1320,2257,6,15668,870,0,2,18,10,1
14310,223,4983,1508,847,911,44,250,301,1552,14,148,88,169,162,257,1120,1886,7,15077,837,0,2,18,10,1
14311,223,4983,722,423,573,19,0,135,741,12,172,101,199,184,300,1320,2257,6,15668,870,0,2,18,10,0
14312,223,4983,1508,847,911,44,250,301,1552,14,148,88,169,162,257,1120,1886,7,15077,837,0,2,18,10,0
14313,117,2369,1513,682,1277,25,13,200,1538,11,199,116,219,210,335,1557,2584,6,15641,868,0,2,2,2,0
14314,117,2369,819,519,539,24,98,155,843,15,96,57,106,111,163,690,1107,8,9171,509,0,2,2,2,0
14315,237,5240,4293,999,3693,19,54,507,4312,9,155,88,170,164,258,1156,1898,4,9368,520,0,2,99,39,0
14316,237,5240,1482,859,1002,125,135,219,1607,16,219,134,251,235,385,1766,3032,9,27804,1544,1,2,99,39,0
14317,46,954,447,308,343,6,5,95,453,7,96,59,111,103,170,651,1136,4,4600,255,0,2,6,3,0
14318,46,954,322,174,179,16,74,51,338,10,41,26,46,51,72,252,408,5,2291,127,0,2,6,3,0
14319,311,6718,72,33,56,0,4,12,72,1,1,1,1,2,2,0,2,0,1,0,0,2,0,1,0
14320,311,6718,1454,835,1044,76,110,219,1530,17,275,158,296,292,454,2297,3718,9,34017,1889,1,2,0,1,0
14321,114,4432,1513,682,1277,25,13,200,1538,11,199,116,219,210,335,1557,2584,6,15641,868,0,2,19,0,0
14322,39,1661,447,308,343,6,5,95,453,7,96,59,111,103,170,651,1136,4,4600,255,0,2,33,1,0
14323,115,2299,1513,682,1277,25,13,200,1538,11,199,116,219,210,335,1557,2584,6,15641,868,0,2,2,2,1
14324,115,2299,819,519,539,24,98,155,843,15,96,57,106,111,163,690,1107,8,9171,509,0,2,2,2,1
14325,67,1993,1523,757,1297,19,12,193,1542,12,193,117,230,205,347,1508,2664,7,19053,1058,0,2,2,2,1
14326,67,1993,701,378,504,33,58,109,734,13,110,68,126,123,194,794,1346,7,10027,557,0,2,2,2,1
14327,46,943,447,308,343,6,5,95,453,7,96,59,111,103,170,651,1136,4,4600,255,0,2,3,3,1
14328,46,943,322,174,179,16,74,51,338,10,41,26,46,51,72,252,408,5,2291,127,0,2,3,3,1
14329,517,11149,72,33,56,0,4,12,72,1,1,1,1,2,2,0,2,0,1,0,0,2,1,1,1
14330,517,11149,1454,835,1044,76,110,219,1530,17,275,158,296,292,454,2297,3718,9,34017,1889,1,2,1,1,1
14331,16,468,442,244,305,14,16,103,456,11,68,45,75,79,120,452,756,6,4588,254,0,2,1,1,1
14332,16,468,182,102,99,11,40,35,193,3,11,6,11,14,17,42,64,1,97,5,0,2,1,1,1
14333,115,2299,1513,682,1277,25,13,200,1538,11,199,116,219,210,335,1557,2584,6,15641,868,0,2,2,2,0
14334,115,2299,819,519,539,24,98,155,843,15,96,57,106,111,163,690,1107,8,9171,509,0,2,2,2,0
14335,67,1993,1523,757,1297,19,12,193,1542,12,193,117,230,205,347,1508,2664,7,19053,1058,0,2,2,2,0
14336,67,1993,701,378,504,33,58,109,734,13,110,68,126,123,194,794,1346,7,10027,557,0,2,2,2,0
14337,46,943,447,308,343,6,5,95,453,7,96,59,111,103,170,651,1136,4,4600,255,0,2,3,3,0
14338,46,943,322,174,179,16,74,51,338,10,41,26,46,51,72,252,408,5,2291,127,0,2,3,3,0
14339,517,11149,72,33,56,0,4,12,72,1,1,1,1,2,2,0,2,0,1,0,0,2,1,1,0
14340,517,11149,1454,835,1044,76,110,219,1530,17,275,158,296,292,454,2297,3718,9,34017,1889,1,2,1,1,0
14341,16,468,442,244,305,14,16,103,456,11,68,45,75,79,120,452,756,6,4588,254,0,2,1,1,0
14342,16,468,182,102,99,11,40,35,193,3,11,6,11,14,17,42,64,1,97,5,0,2,1,1,0
14343,56,1547,1455,414,1257,16,76,112,1471,5,41,23,46,46,69,231,381,2,1069,59,0,2,15,1,1
14344,56,1547,669,365,481,22,61,110,691,15,103,63,122,118,185,747,1273,8,11311,628,0,2,15,1,1
14345,56,1556,1455,414,1257,16,76,112,1471,5,41,23,46,46,69,231,381,2,1069,59,0,2,8,7,1
14346,56,1556,669,365,481,22,61,110,691,15,103,63,122,118,185,747,1273,8,11311,628,0,2,8,7,1
14347,64,2717,1455,414,1257,16,76,112,1471,5,41,23,46,46,69,231,381,2,1069,59,0,2,79,0,1
14348,57,1569,1455,414,1257,16,76,112,1471,5,41,23,46,46,69,231,381,2,1069,59,0,2,8,7,0
14349,57,1569,669,365,481,22,61,110,691,15,103,63,122,118,185,747,1273,8,11311,628,0,2,8,7,0
14350,64,2720,1455,414,1257,16,76,112,1471,5,41,23,46,46,69,231,381,2,1069,59,0,2,81,79,1
14351,57,1571,1455,414,1257,16,76,112,1471,5,41,23,46,46,69,231,381,2,1069,59,0,2,11,3,0
14352,57,1571,669,365,481,22,61,110,691,15,103,63,122,118,185,747,1273,8,11311,628,0,2,11,3,0
14353,62,2710,1455,414,1257,16,76,112,1471,5,41,23,46,46,69,231,381,2,1069,59,0,2,2,5,0
14354,61,2720,1455,414,1257,16,76,112,1471,5,41,23,46,46,69,231,381,2,1069,59,0,2,15,15,0
14355,56,1576,1455,414,1257,16,76,112,1471,5,41,23,46,46,69,231,381,2,1069,59,0,2,26,18,1
14356,56,1576,669,365,481,22,61,110,691,15,103,63,122,118,185,747,1273,8,11311,628,0,2,26,18,1
14357,56,1576,1455,414,1257,16,76,112,1471,5,41,23,46,46,69,231,381,2,1069,59,0,2,2,2,1
14358,56,1576,669,365,481,22,61,110,691,15,103,63,122,118,185,747,1273,8,11311,628,0,2,2,2,1
14359,314,6752,72,33,56,0,4,12,72,1,1,1,1,2,2,0,2,0,1,0,0,2,8,2,1
14360,314,6752,1454,835,1044,76,110,219,1530,17,275,158,296,292,454,2297,3718,9,34017,1889,1,2,8,2,1
14361,91,4840,1782,648,1425,9,47,279,1791,8,171,97,189,179,286,1292,2140,4,9462,525,0,2,19,2,1
14362,148,6629,139,89,101,2,0,35,141,7,54,34,62,61,96,330,569,4,2287,127,0,2,32,0,1
14363,148,6629,7,5,5,0,0,2,7,1,2,1,2,3,3,2,4,0,2,0,0,2,32,0,1
14364,56,1576,1455,414,1257,16,76,112,1471,5,41,23,46,46,69,231,381,2,1069,59,0,2,36,4,0
14365,56,1576,669,365,481,22,61,110,691,15,103,63,122,118,185,747,1273,8,11311,628,0,2,36,4,0
14366,61,2720,1455,414,1257,16,76,112,1471,5,41,23,46,46,69,231,381,2,1069,59,0,2,78,0,0
14367,148,6629,139,89,101,2,0,35,141,7,54,34,62,61,96,330,569,4,2287,127,0,2,32,0,0
14368,148,6629,7,5,5,0,0,2,7,1,2,1,2,3,3,2,4,0,2,0,0,2,32,0,0
14369,518,11168,72,33,56,0,4,12,72,1,1,1,1,2,2,0,2,0,1,0,0,2,7,2,1
14370,518,11168,1454,835,1044,76,110,219,1530,17,275,158,296,292,454,2297,3718,9,34017,1889,1,2,7,2,1
14371,77,3168,1289,550,1043,56,32,155,1345,10,167,93,185,177,278,1266,2075,5,11498,638,0,2,1,1,1
14372,112,4316,1513,682,1277,25,13,200,1538,11,199,116,219,210,335,1557,2584,6,15641,868,0,2,2,2,1
14373,24,834,74,35,59,1,0,14,75,3,14,7,14,17,21,58,85,1,128,7,0,2,4,4,1
14374,24,834,245,125,200,5,7,34,250,7,30,17,34,37,51,166,265,3,1053,58,0,2,4,4,1
14375,146,6594,139,89,101,2,0,35,141,7,54,34,62,61,96,330,569,4,2287,127,0,2,1,1,1
14376,146,6594,7,5,5,0,0,2,7,1,2,1,2,3,3,2,4,0,2,0,0,2,1,1,1
14377,68,3327,1457,730,1242,11,6,188,1468,10,292,166,329,302,495,2424,4078,5,22973,1276,1,2,42,60,1
14378,314,6750,72,33,56,0,4,12,72,1,1,1,1,2,2,0,2,0,1,0,0,2,1,1,0
14379,314,6750,1454,835,1044,76,110,219,1530,17,275,158,296,292,454,2297,3718,9,34017,1889,1,2,1,1,0
14380,92,4879,1782,648,1425,9,47,279,1791,8,171,97,189,179,286,1292,2140,4,9462,525,0,2,17,0,0
14381,56,1576,1455,414,1257,16,76,112,1471,5,41,23,46,46,69,231,381,2,1069,59,0,2,36,4,0
14382,56,1576,669,365,481,22,61,110,691,15,103,63,122,118,185,747,1273,8,11311,628,0,2,36,4,0
14383,61,2720,1455,414,1257,16,76,112,1471,5,41,23,46,46,69,231,381,2,1069,59,0,2,78,0,0
14384,175,4054,77,34,69,0,0,8,77,3,24,16,29,27,45,114,213,1,387,21,0,2,5,0,1
14385,175,4054,712,438,573,51,9,84,763,14,102,71,128,116,199,733,1364,8,11988,666,0,2,5,0,1
14386,64,2671,1043,504,840,53,9,147,1096,9,180,112,198,189,310,1377,2344,4,11604,644,0,2,12,0,1
14387,24,834,74,35,59,1,0,14,75,3,14,7,14,17,21,58,85,1,128,7,0,2,4,4,0
14388,24,834,245,125,200,5,7,34,250,7,30,17,34,37,51,166,265,3,1053,58,0,2,4,4,0
14389,146,6594,139,89,101,2,0,35,141,7,54,34,62,61,96,330,569,4,2287,127,0,2,1,1,0
14390,146,6594,7,5,5,0,0,2,7,1,2,1,2,3,3,2,4,0,2,0,0,2,1,1,0
14391,68,3327,1457,730,1242,11,6,188,1468,10,292,166,329,302,495,2424,4078,5,22973,1276,1,2,42,60,0
14392,314,6750,72,33,56,0,4,12,72,1,1,1,1,2,2,0,2,0,1,0,0,2,8,2,0
14393,314,6750,1454,835,1044,76,110,219,1530,17,275,158,296,292,454,2297,3718,9,34017,1889,1,2,8,2,0
14394,92,4879,1782,648,1425,9,47,279,1791,8,171,97,189,179,286,1292,2140,4,9462,525,0,2,36,2,0
14395,175,4054,77,34,69,0,0,8,77,3,24,16,29,27,45,114,213,1,387,21,0,2,5,0,0
14396,175,4054,712,438,573,51,9,84,763,14,102,71,128,116,199,733,1364,8,11988,666,0,2,5,0,0
14397,64,2671,1043,504,840,53,9,147,1096,9,180,112,198,189,310,1377,2344,4,11604,644,0,2,12,0,0
14398,175,4040,77,34,69,0,0,8,77,3,24,16,29,27,45,114,213,1,387,21,0,2,1,2,0
14399,175,4040,712,438,573,51,9,84,763,14,102,71,128,116,199,733,1364,8,11988,666,0,2,1,2,0
14400,175,4040,77,34,69,0,0,8,77,3,24,16,29,27,45,114,213,1,387,21,0,2,1,2,0
14401,175,4040,712,438,573,51,9,84,763,14,102,71,128,116,199,733,1364,8,11988,666,0,2,1,2,0
14402,519,11194,72,33,56,0,4,12,72,1,1,1,1,2,2,0,2,0,1,0,0,2,11,4,0
14403,519,11194,1454,835,1044,76,110,219,1530,17,275,158,296,292,454,2297,3718,9,34017,1889,1,2,11,4,0
14404,85,3914,1338,495,1086,10,64,173,1348,11,122,82,157,133,239,883,1686,7,11934,663,0,2,12,0,0
14405,519,11194,72,33,56,0,4,12,72,1,1,1,1,2,2,0,2,0,1,0,0,2,11,4,0
14406,519,11194,1454,835,1044,76,110,219,1530,17,275,158,296,292,454,2297,3718,9,34017,1889,1,2,11,4,0
14407,85,3914,1338,495,1086,10,64,173,1348,11,122,82,157,133,239,883,1686,7,11934,663,0,2,12,0,0
14408,322,6612,1457,730,1242,11,6,188,1468,10,292,166,329,302,495,2424,4078,5,22973,1276,1,2,1,0,1
14409,322,6612,74,35,59,1,0,14,75,3,14,7,14,17,21,58,85,1,128,7,0,2,1,0,1
14410,322,6612,245,125,200,5,7,34,250,7,30,17,34,37,51,166,265,3,1053,58,0,2,1,0,1
14411,177,4103,77,34,69,0,0,8,77,3,24,16,29,27,45,114,213,1,387,21,0,2,22,1,1
14412,177,4103,712,438,573,51,9,84,763,14,102,71,128,116,199,733,1364,8,11988,666,0,2,22,1,1
14413,87,4028,1338,495,1086,10,64,173,1348,11,122,82,157,133,239,883,1686,7,11934,663,0,2,37,0,1
14414,92,4881,1782,648,1425,9,47,279,1791,8,171,97,189,179,286,1292,2140,4,9462,525,0,2,1,1,1
14415,523,11235,72,33,56,0,4,12,72,1,1,1,1,2,2,0,2,0,1,0,0,2,8,2,0
14416,523,11235,1454,835,1044,76,110,219,1530,17,275,158,296,292,454,2297,3718,9,34017,1889,1,2,8,2,0
14417,84,4537,1782,648,1425,9,47,279,1791,8,171,97,189,179,286,1292,2140,4,9462,525,0,2,37,0,0
14418,322,6608,1457,730,1242,11,6,188,1468,10,292,166,329,302,495,2424,4078,5,22973,1276,1,2,2,4,1
14419,322,6608,74,35,59,1,0,14,75,3,14,7,14,17,21,58,85,1,128,7,0,2,2,4,1
14420,322,6608,245,125,200,5,7,34,250,7,30,17,34,37,51,166,265,3,1053,58,0,2,2,4,1
14421,237,5245,4293,999,3693,19,54,507,4312,9,155,88,170,164,258,1156,1898,4,9368,520,0,2,4,6,1
14422,237,5245,1482,859,1002,125,135,219,1607,16,219,134,251,235,385,1766,3032,9,27804,1544,1,2,4,6,1
14423,311,6721,72,33,56,0,4,12,72,1,1,1,1,2,2,0,2,0,1,0,0,2,2,2,1
14424,311,6721,1454,835,1044,76,110,219,1530,17,275,158,296,292,454,2297,3718,9,34017,1889,1,2,2,2,1
14425,77,3179,1289,550,1043,56,32,155,1345,10,167,93,185,177,278,1266,2075,5,11498,638,0,2,0,48,1
14426,5,162,75,38,59,1,3,12,76,2,4,2,4,6,6,10,15,1,15,0,0,0,55,0,1
14427,145,6578,139,89,101,2,0,35,141,7,54,34,62,61,96,330,569,4,2287,127,0,2,1,2,1
14428,145,6578,7,5,5,0,0,2,7,1,2,1,2,3,3,2,4,0,2,0,0,2,1,2,1
14429,14,811,442,244,305,14,16,103,456,11,68,45,75,79,120,452,756,6,4588,254,0,2,0,1,1
14430,520,11213,72,33,56,0,4,12,72,1,1,1,1,2,2,0,2,0,1,0,0,2,7,2,0
14431,520,11213,1454,835,1044,76,110,219,1530,17,275,158,296,292,454,2297,3718,9,34017,1889,1,2,7,2,0
14432,77,3168,1289,550,1043,56,32,155,1345,10,167,93,185,177,278,1266,2075,5,11498,638,0,2,1,1,0
14433,112,4316,1513,682,1277,25,13,200,1538,11,199,116,219,210,335,1557,2584,6,15641,868,0,2,2,2,0
14434,524,11254,72,33,56,0,4,12,72,1,1,1,1,2,2,0,2,0,1,0,0,2,8,2,0
14435,524,11254,1454,835,1044,76,110,219,1530,17,275,158,296,292,454,2297,3718,9,34017,1889,1,2,8,2,0
14436,84,4537,1782,648,1425,9,47,279,1791,8,171,97,189,179,286,1292,2140,4,9462,525,0,2,37,0,0
14437,322,6612,1457,730,1242,11,6,188,1468,10,292,166,329,302,495,2424,4078,5,22973,1276,1,2,1,0,0
14438,322,6612,74,35,59,1,0,14,75,3,14,7,14,17,21,58,85,1,128,7,0,2,1,0,0
14439,322,6612,245,125,200,5,7,34,250,7,30,17,34,37,51,166,265,3,1053,58,0,2,1,0,0
14440,177,4103,77,34,69,0,0,8,77,3,24,16,29,27,45,114,213,1,387,21,0,2,22,1,0
14441,177,4103,712,438,573,51,9,84,763,14,102,71,128,116,199,733,1364,8,11988,666,0,2,22,1,0
14442,87,4028,1338,495,1086,10,64,173,1348,11,122,82,157,133,239,883,1686,7,11934,663,0,2,37,0,0
14443,92,4881,1782,648,1425,9,47,279,1791,8,171,97,189,179,286,1292,2140,4,9462,525,0,2,1,1,0
14444,177,4103,77,34,69,0,0,8,77,3,24,16,29,27,45,114,213,1,387,21,0,2,0,4,0
14445,177,4103,712,438,573,51,9,84,763,14,102,71,128,116,199,733,1364,8,11988,666,0,2,0,4,0
14446,117,2369,1513,682,1277,25,13,200,1538,11,199,116,219,210,335,1557,2584,6,15641,868,0,2,2,2,0
14447,117,2369,819,519,539,24,98,155,843,15,96,57,106,111,163,690,1107,8,9171,509,0,2,2,2,0
14448,238,5259,4293,999,3693,19,54,507,4312,9,155,88,170,164,258,1156,1898,4,9368,520,0,2,7,2,0
14449,238,5259,1482,859,1002,125,135,219,1607,16,219,134,251,235,385,1766,3032,9,27804,1544,1,2,7,2,0
14450,71,2075,1523,757,1297,19,12,193,1542,12,193,117,230,205,347,1508,2664,7,19053,1058,0,2,2,2,0
14451,71,2075,701,378,504,33,58,109,734,13,110,68,126,123,194,794,1346,7,10027,557,0,2,2,2,0
14452,179,4142,77,34,69,0,0,8,77,3,24,16,29,27,45,114,213,1,387,21,0,2,4,0,0
14453,179,4142,712,438,573,51,9,84,763,14,102,71,128,116,199,733,1364,8,11988,666,0,2,4,0,0
14454,46,954,447,308,343,6,5,95,453,7,96,59,111,103,170,651,1136,4,4600,255,0,2,2,2,0
14455,46,954,322,174,179,16,74,51,338,10,41,26,46,51,72,252,408,5,2291,127,0,2,2,2,0
14456,320,6840,72,33,56,0,4,12,72,1,1,1,1,2,2,0,2,0,1,0,0,2,22,8,0
14457,320,6840,1454,835,1044,76,110,219,1530,17,275,158,296,292,454,2297,3718,9,34017,1889,1,2,22,8,0
14458,16,468,442,244,305,14,16,103,456,11,68,45,75,79,120,452,756,6,4588,254,0,2,1,1,0
14459,16,468,182,102,99,11,40,35,193,3,11,6,11,14,17,42,64,1,97,5,0,2,1,1,0
14460,81,3317,1289,550,1043,56,32,155,1345,10,167,93,185,177,278,1266,2075,5,11498,638,0,2,1,1,0
14461,88,4059,1338,495,1086,10,64,173,1348,11,122,82,157,133,239,883,1686,7,11934,663,0,2,12,0,0
14462,147,6691,139,89,101,2,0,35,141,7,54,34,62,61,96,330,569,4,2287,127,0,2,32,0,0
14463,147,6691,7,5,5,0,0,2,7,1,2,1,2,3,3,2,4,0,2,0,0,2,32,0,0
14464,93,4930,1782,648,1425,9,47,279,1791,8,171,97,189,179,286,1292,2140,4,9462,525,0,2,37,0,0
14465,114,4432,1513,682,1277,25,13,200,1538,11,199,116,219,210,335,1557,2584,6,15641,868,0,2,2,2,0
14466,63,2634,1043,504,840,53,9,147,1096,9,180,112,198,189,310,1377,2344,4,11604,644,0,2,12,0,0
14467,117,2369,1513,682,1277,25,13,200,1538,11,199,116,219,210,335,1557,2584,6,15641,868,0,2,2,2,0
14468,117,2369,819,519,539,24,98,155,843,15,96,57,106,111,163,690,1107,8,9171,509,0,2,2,2,0
14469,238,5259,4293,999,3693,19,54,507,4312,9,155,88,170,164,258,1156,1898,4,9368,520,0,2,7,2,0
14470,238,5259,1482,859,1002,125,135,219,1607,16,219,134,251,235,385,1766,3032,9,27804,1544,1,2,7,2,0
14471,71,2075,1523,757,1297,19,12,193,1542,12,193,117,230,205,347,1508,2664,7,19053,1058,0,2,2,2,0
14472,71,2075,701,378,504,33,58,109,734,13,110,68,126,123,194,794,1346,7,10027,557,0,2,2,2,0
14473,179,4142,77,34,69,0,0,8,77,3,24,16,29,27,45,114,213,1,387,21,0,2,4,0,0
14474,179,4142,712,438,573,51,9,84,763,14,102,71,128,116,199,733,1364,8,11988,666,0,2,4,0,0
14475,46,954,447,308,343,6,5,95,453,7,96,59,111,103,170,651,1136,4,4600,255,0,2,2,2,0
14476,46,954,322,174,179,16,74,51,338,10,41,26,46,51,72,252,408,5,2291,127,0,2,2,2,0
14477,320,6840,72,33,56,0,4,12,72,1,1,1,1,2,2,0,2,0,1,0,0,2,22,8,0
14478,320,6840,1454,835,1044,76,110,219,1530,17,275,158,296,292,454,2297,3718,9,34017,1889,1,2,22,8,0
14479,16,468,442,244,305,14,16,103,456,11,68,45,75,79,120,452,756,6,4588,254,0,2,1,1,0
14480,16,468,182,102,99,11,40,35,193,3,11,6,11,14,17,42,64,1,97,5,0,2,1,1,0
14481,81,3317,1289,550,1043,56,32,155,1345,10,167,93,185,177,278,1266,2075,5,11498,638,0,2,1,1,0
14482,88,4059,1338,495,1086,10,64,173,1348,11,122,82,157,133,239,883,1686,7,11934,663,0,2,12,0,0
14483,147,6691,139,89,101,2,0,35,141,7,54,34,62,61,96,330,569,4,2287,127,0,2,32,0,0
14484,147,6691,7,5,5,0,0,2,7,1,2,1,2,3,3,2,4,0,2,0,0,2,32,0,0
14485,93,4930,1782,648,1425,9,47,279,1791,8,171,97,189,179,286,1292,2140,4,9462,525,0,2,37,0,0
14486,114,4432,1513,682,1277,25,13,200,1538,11,199,116,219,210,335,1557,2584,6,15641,868,0,2,2,2,0
14487,63,2634,1043,504,840,53,9,147,1096,9,180,112,198,189,310,1377,2344,4,11604,644,0,2,12,0,0
14488,179,4142,77,34,69,0,0,8,77,3,24,16,29,27,45,114,213,1,387,21,0,2,1,1,1
14489,179,4142,712,438,573,51,9,84,763,14,102,71,128,116,199,733,1364,8,11988,666,0,2,1,1,1
14490,179,4142,77,34,69,0,0,8,77,3,24,16,29,27,45,114,213,1,387,21,0,2,1,1,0
14491,179,4142,712,438,573,51,9,84,763,14,102,71,128,116,199,733,1364,8,11988,666,0,2,1,1,0
14492,2,26,6,4,4,0,0,2,6,1,4,2,4,5,6,8,13,0,6,0,0,3,5,5,1
14493,2,26,6,4,4,0,0,2,6,1,4,2,4,5,6,8,13,0,6,0,0,3,5,5,0
14494,322,6615,1457,730,1242,11,6,188,1468,10,292,166,329,302,495,2424,4078,5,22973,1276,1,2,2,4,0
14495,322,6615,74,35,59,1,0,14,75,3,14,7,14,17,21,58,85,1,128,7,0,2,2,4,0
14496,322,6615,245,125,200,5,7,34,250,7,30,17,34,37,51,166,265,3,1053,58,0,2,2,4,0
14497,238,5264,4293,999,3693,19,54,507,4312,9,155,88,170,164,258,1156,1898,4,9368,520,0,2,4,6,0
14498,238,5264,1482,859,1002,125,135,219,1607,16,219,134,251,235,385,1766,3032,9,27804,1544,1,2,4,6,0
14499,320,6843,72,33,56,0,4,12,72,1,1,1,1,2,2,0,2,0,1,0,0,2,2,2,0
14500,320,6843,1454,835,1044,76,110,219,1530,17,275,158,296,292,454,2297,3718,9,34017,1889,1,2,2,2,0
14501,77,3179,1289,550,1043,56,32,155,1345,10,167,93,185,177,278,1266,2075,5,11498,638,0,2,0,48,0
14502,5,162,75,38,59,1,3,12,76,2,4,2,4,6,6,10,15,1,15,0,0,0,55,0,0
14503,146,6675,139,89,101,2,0,35,141,7,54,34,62,61,96,330,569,4,2287,127,0,2,1,2,0
14504,146,6675,7,5,5,0,0,2,7,1,2,1,2,3,3,2,4,0,2,0,0,2,1,2,0
14505,14,811,442,244,305,14,16,103,456,11,68,45,75,79,120,452,756,6,4588,254,0,2,0,1,0
14506,238,5264,4293,999,3693,19,54,507,4312,9,155,88,170,164,258,1156,1898,4,9368,520,0,2,1,1,0
14507,238,5264,1482,859,1002,125,135,219,1607,16,219,134,251,235,385,1766,3032,9,27804,1544,1,2,1,1,0
14508,238,5264,4293,999,3693,19,54,507,4312,9,155,88,170,164,258,1156,1898,4,9368,520,0,2,1,1,1
14509,238,5264,1482,859,1002,125,135,219,1607,16,219,134,251,235,385,1766,3032,9,27804,1544,1,2,1,1,1
14510,177,3648,1943,715,1694,26,18,214,1969,12,185,120,237,197,357,1436,2721,7,20915,1161,0,2,2,10,1
14511,177,3648,1168,838,957,57,25,144,1225,19,348,224,416,367,640,3018,5452,11,61921,3440,1,2,2,10,1
14512,207,4433,182,127,129,0,0,53,182,5,39,21,42,44,63,217,343,2,926,51,0,2,2,1,1
14513,207,4433,1165,710,800,67,119,181,1232,18,243,153,282,261,435,2000,3492,10,36473,2026,1,2,2,1,1
14514,135,6349,1392,870,1177,35,17,170,1427,14,494,280,531,508,811,4473,7289,7,54850,3047,2,2,68,38,1
14515,135,6409,1392,870,1177,35,17,170,1427,14,494,280,531,508,811,4473,7289,7,54850,3047,2,2,44,34,1
14516,322,6887,72,33,56,0,4,12,72,1,1,1,1,2,2,0,2,0,1,0,0,2,11,1,1
14517,322,6887,1454,835,1044,76,110,219,1530,17,275,158,296,292,454,2297,3718,9,34017,1889,1,2,11,1,1
14518,147,6711,139,89,101,2,0,35,141,7,54,34,62,61,96,330,569,4,2287,127,0,2,7,0,1
14519,147,6711,7,5,5,0,0,2,7,1,2,1,2,3,3,2,4,0,2,0,0,2,7,0,1
14520,207,4433,182,127,129,0,0,53,182,5,39,21,42,44,63,217,343,2,926,51,0,2,2,1,0
14521,207,4433,1165,710,800,67,119,181,1232,18,243,153,282,261,435,2000,3492,10,36473,2026,1,2,2,1,0
14522,135,6409,1392,870,1177,35,17,170,1427,14,494,280,531,508,811,4473,7289,7,54850,3047,2,2,112,72,0
14523,322,6887,72,33,56,0,4,12,72,1,1,1,1,2,2,0,2,0,1,0,0,2,11,1,0
14524,322,6887,1454,835,1044,76,110,219,1530,17,275,158,296,292,454,2297,3718,9,34017,1889,1,2,11,1,0
14525,147,6711,139,89,101,2,0,35,141,7,54,34,62,61,96,330,569,4,2287,127,0,2,7,0,0
14526,147,6711,7,5,5,0,0,2,7,1,2,1,2,3,3,2,4,0,2,0,0,2,7,0,0
14527,240,5292,4293,999,3693,19,54,507,4312,9,155,88,170,164,258,1156,1898,4,9368,520,0,2,12,1,1
14528,240,5292,1482,859,1002,125,135,219,1607,16,219,134,251,235,385,1766,3032,9,27804,1544,1,2,12,1,1
14529,321,6880,72,33,56,0,4,12,72,1,1,1,1,2,2,0,2,0,1,0,0,2,2,3,1
14530,321,6880,1454,835,1044,76,110,219,1530,17,275,158,296,292,454,2297,3718,9,34017,1889,1,2,2,3,1
14531,147,6722,139,89,101,2,0,35,141,7,54,34,62,61,96,330,569,4,2287,127,0,2,1,0,1
14532,147,6722,7,5,5,0,0,2,7,1,2,1,2,3,3,2,4,0,2,0,0,2,1,0,1
14533,240,5292,4293,999,3693,19,54,507,4312,9,155,88,170,164,258,1156,1898,4,9368,520,0,2,12,1,0
14534,240,5292,1482,859,1002,125,135,219,1607,16,219,134,251,235,385,1766,3032,9,27804,1544,1,2,12,1,0
14535,321,6880,72,33,56,0,4,12,72,1,1,1,1,2,2,0,2,0,1,0,0,2,2,3,0
14536,321,6880,1454,835,1044,76,110,219,1530,17,275,158,296,292,454,2297,3718,9,34017,1889,1,2,2,3,0
14537,147,6722,139,89,101,2,0,35,141,7,54,34,62,61,96,330,569,4,2287,127,0,2,1,0,0
14538,147,6722,7,5,5,0,0,2,7,1,2,1,2,3,3,2,4,0,2,0,0,2,1,0,0
14539,12,228,127,75,83,2,11,30,129,4,14,7,14,18,21,61,87,2,175,9,0,2,2,2,0
14540,12,228,652,304,544,16,6,88,668,6,89,51,101,95,152,591,998,3,3399,188,0,2,2,2,0
14541,12,228,2,2,2,0,0,0,2,0,0,0,0,0,0,0,0,0,0,0,0,2,2,2,0
14542,12,228,8,5,5,0,0,3,8,0,0,0,0,0,0,0,0,0,0,0,0,2,2,2,0
14543,12,228,2,2,2,0,0,0,2,0,0,0,0,0,0,0,0,0,0,0,0,2,2,2,0
14544,12,228,14,8,8,0,0,6,14,0,0,0,0,0,0,0,0,0,0,0,0,2,2,2,0
14545,12,228,6,4,4,0,0,2,6,0,0,0,0,0,0,0,0,0,0,0,0,2,2,2,0
14546,12,228,6,4,4,0,0,2,6,1,2,1,2,3,3,2,4,0,2,0,0,2,2,2,0
14547,12,228,6,4,4,0,0,2,6,0,0,0,0,0,0,0,0,0,0,0,0,2,2,2,0
14548,12,228,7,5,5,0,0,2,7,0,0,0,0,0,0,0,0,0,0,0,0,2,2,2,0
14549,12,228,6,4,4,0,0,2,6,0,0,0,0,0,0,0,0,0,0,0,0,2,2,2,0
14550,12,228,10,6,6,0,0,4,10,0,0,0,0,0,0,0,0,0,0,0,0,2,2,2,0
14551,12,228,1,1,1,0,0,0,1,0,0,0,0,0,0,0,0,0,0,0,0,2,2,2,0
14552,12,228,1,1,1,0,0,0,1,0,0,0,0,0,0,0,0,0,0,0,0,2,2,2,0
14553,12,228,14,10,10,0,0,4,14,1,1,1,1,2,2,0,2,0,1,0,0,2,2,2,0
14554,12,228,46,26,30,3,0,12,49,3,6,3,6,9,9,20,28,1,42,2,0,2,2,2,0
14555,71,3611,1943,715,1694,26,18,214,1969,12,185,120,237,197,357,1436,2721,7,20915,1161,0,2,1,1,1
14556,12,228,127,75,83,2,11,30,129,4,14,7,14,18,21,61,87,2,175,9,0,2,2,2,0
14557,12,228,652,304,544,16,6,88,668,6,89,51,101,95,152,591,998,3,3399,188,0,2,2,2,0
14558,12,228,2,2,2,0,0,0,2,0,0,0,0,0,0,0,0,0,0,0,0,2,2,2,0
14559,12,228,8,5,5,0,0,3,8,0,0,0,0,0,0,0,0,0,0,0,0,2,2,2,0
14560,12,228,2,2,2,0,0,0,2,0,0,0,0,0,0,0,0,0,0,0,0,2,2,2,0
14561,12,228,14,8,8,0,0,6,14,0,0,0,0,0,0,0,0,0,0,0,0,2,2,2,0
14562,12,228,6,4,4,0,0,2,6,0,0,0,0,0,0,0,0,0,0,0,0,2,2,2,0
14563,12,228,6,4,4,0,0,2,6,1,2,1,2,3,3,2,4,0,2,0,0,2,2,2,0
14564,12,228,6,4,4,0,0,2,6,0,0,0,0,0,0,0,0,0,0,0,0,2,2,2,0
14565,12,228,7,5,5,0,0,2,7,0,0,0,0,0,0,0,0,0,0,0,0,2,2,2,0
14566,12,228,6,4,4,0,0,2,6,0,0,0,0,0,0,0,0,0,0,0,0,2,2,2,0
14567,12,228,10,6,6,0,0,4,10,0,0,0,0,0,0,0,0,0,0,0,0,2,2,2,0
14568,12,228,1,1,1,0,0,0,1,0,0,0,0,0,0,0,0,0,0,0,0,2,2,2,0
14569,12,228,1,1,1,0,0,0,1,0,0,0,0,0,0,0,0,0,0,0,0,2,2,2,0
14570,12,228,14,10,10,0,0,4,14,1,1,1,1,2,2,0,2,0,1,0,0,2,2,2,0
14571,12,228,46,26,30,3,0,12,49,3,6,3,6,9,9,20,28,1,42,2,0,2,2,2,0
14572,177,3648,1943,715,1694,26,18,214,1969,12,185,120,237,197,357,1436,2721,7,20915,1161,0,2,2,10,0
14573,177,3648,1168,838,957,57,25,144,1225,19,348,224,416,367,640,3018,5452,11,61921,3440,1,2,2,10,0
14574,71,3611,1943,715,1694,26,18,214,1969,12,185,120,237,197,357,1436,2721,7,20915,1161,0,2,1,1,0
14575,240,5295,4293,999,3693,19,54,507,4312,9,155,88,170,164,258,1156,1898,4,9368,520,0,2,1,1,1
14576,240,5295,1482,859,1002,125,135,219,1607,16,219,134,251,235,385,1766,3032,9,27804,1544,1,2,1,1,1
14577,147,6728,139,89,101,2,0,35,141,7,54,34,62,61,96,330,569,4,2287,127,0,2,18,1,1
14578,147,6728,7,5,5,0,0,2,7,1,2,1,2,3,3,2,4,0,2,0,0,2,18,1,1
14579,240,5295,4293,999,3693,19,54,507,4312,9,155,88,170,164,258,1156,1898,4,9368,520,0,2,1,1,0
14580,240,5295,1482,859,1002,125,135,219,1607,16,219,134,251,235,385,1766,3032,9,27804,1544,1,2,1,1,0
14581,147,6728,139,89,101,2,0,35,141,7,54,34,62,61,96,330,569,4,2287,127,0,2,18,1,0
14582,147,6728,7,5,5,0,0,2,7,1,2,1,2,3,3,2,4,0,2,0,0,2,18,1,0
14583,32,595,2,2,2,0,0,0,2,0,0,0,0,0,0,0,0,0,0,0,0,2,5,4,1
14584,32,595,99,48,90,1,3,5,100,0,0,0,0,0,0,0,0,0,0,0,0,2,5,4,1
14585,32,595,8,5,5,2,0,1,10,0,0,0,0,0,0,0,0,0,0,0,0,2,5,4,1
14586,32,595,1217,716,841,84,126,174,1301,14,185,118,215,199,333,1446,2542,8,20687,1149,0,2,5,4,1
14587,32,595,160,89,115,0,13,31,160,7,15,11,17,22,28,78,124,3,495,27,0,2,5,4,1
14588,32,595,10,10,9,9,0,0,19,0,0,0,0,0,0,0,0,0,0,0,0,2,5,4,1
14589,32,595,173,84,99,8,29,36,181,5,12,7,13,17,20,54,81,2,221,12,0,2,5,4,1
14590,32,595,3,1,1,3,0,0,6,0,0,0,0,0,0,0,0,0,0,0,0,2,5,4,1
14591,159,5031,1660,832,1314,41,38,274,1701,20,312,209,395,332,604,2671,5058,12,64042,3557,1,2,20,18,1
14592,159,5031,1057,646,719,113,100,145,1170,18,215,134,248,233,382,1740,3004,10,31186,1732,1,2,20,18,1
14593,141,3738,1660,832,1314,41,38,274,1701,20,312,209,395,332,604,2671,5058,12,64042,3557,1,2,10,0,1
14594,32,595,2,2,2,0,0,0,2,0,0,0,0,0,0,0,0,0,0,0,0,2,5,4,0
14595,32,595,99,48,90,1,3,5,100,0,0,0,0,0,0,0,0,0,0,0,0,2,5,4,0
14596,32,595,8,5,5,2,0,1,10,0,0,0,0,0,0,0,0,0,0,0,0,2,5,4,0
14597,32,595,1217,716,841,84,126,174,1301,14,185,118,215,199,333,1446,2542,8,20687,1149,0,2,5,4,0
14598,32,595,160,89,115,0,13,31,160,7,15,11,17,22,28,78,124,3,495,27,0,2,5,4,0
14599,32,595,10,10,9,9,0,0,19,0,0,0,0,0,0,0,0,0,0,0,0,2,5,4,0
14600,32,595,173,84,99,8,29,36,181,5,12,7,13,17,20,54,81,2,221,12,0,2,5,4,0
14601,32,595,3,1,1,3,0,0,6,0,0,0,0,0,0,0,0,0,0,0,0,2,5,4,0
14602,159,5031,1660,832,1314,41,38,274,1701,20,312,209,395,332,604,2671,5058,12,64042,3557,1,2,20,18,0
14603,159,5031,1057,646,719,113,100,145,1170,18,215,134,248,233,382,1740,3004,10,31186,1732,1,2,20,18,0
14604,141,3738,1660,832,1314,41,38,274,1701,20,312,209,395,332,604,2671,5058,12,64042,3557,1,2,10,0,0
14605,7,298,72,33,56,0,4,12,72,1,1,1,1,2,2,0,2,0,1,0,0,2,1,1,1
14606,7,298,72,33,56,0,4,12,72,1,1,1,1,2,2,0,2,0,1,0,0,2,1,1,0
14607,123,2695,1043,504,840,53,9,147,1096,9,180,112,198,189,310,1377,2344,4,11604,644,0,2,14,0,1
14608,123,2695,383,288,292,26,6,62,409,11,65,38,67,76,105,429,656,5,3719,206,0,2,14,0,1
14609,66,2714,1043,504,840,53,9,147,1096,9,180,112,198,189,310,1377,2344,4,11604,644,0,2,26,0,1
14610,70,2065,1523,757,1297,19,12,193,1542,12,193,117,230,205,347,1508,2664,7,19053,1058,0,2,3,6,1
14611,70,2065,701,378,504,33,58,109,734,13,110,68,126,123,194,794,1346,7,10027,557,0,2,3,6,1
14612,127,2753,1043,504,840,53,9,147,1096,9,180,112,198,189,310,1377,2344,4,11604,644,0,2,16,0,1
14613,127,2753,383,288,292,26,6,62,409,11,65,38,67,76,105,429,656,5,3719,206,0,2,16,0,1
14614,68,2807,1043,504,840,53,9,147,1096,9,180,112,198,189,310,1377,2344,4,11604,644,0,2,44,5,1
14615,127,2753,1043,504,840,53,9,147,1096,9,180,112,198,189,310,1377,2344,4,11604,644,0,2,4,2,0
14616,127,2753,383,288,292,26,6,62,409,11,65,38,67,76,105,429,656,5,3719,206,0,2,4,2,0
14617,321,6894,72,33,56,0,4,12,72,1,1,1,1,2,2,0,2,0,1,0,0,2,11,3,1
14618,321,6894,1454,835,1044,76,110,219,1530,17,275,158,296,292,454,2297,3718,9,34017,1889,1,2,11,3,1
14619,90,4091,1338,495,1086,10,64,173,1348,11,122,82,157,133,239,883,1686,7,11934,663,0,2,9,0,1
14620,102,1935,1178,367,1042,6,15,115,1184,9,94,51,95,103,146,644,976,4,4439,246,0,2,9,3,0
14621,102,1935,177,108,140,8,0,27,185,6,30,16,32,36,48,162,248,3,794,44,0,2,9,3,0
14622,310,6308,1457,730,1242,11,6,188,1468,10,292,166,329,302,495,2424,4078,5,22973,1276,1,2,19,4,1
14623,310,6308,74,35,59,1,0,14,75,3,14,7,14,17,21,58,85,1,128,7,0,2,19,4,1
14624,310,6308,245,125,200,5,7,34,250,7,30,17,34,37,51,166,265,3,1053,58,0,2,19,4,1
14625,54,3013,1296,573,1062,40,33,157,1336,8,201,118,231,209,349,1561,2689,4,12365,686,0,2,4,2,1
14626,65,3295,1457,730,1242,11,6,188,1468,10,292,166,329,302,495,2424,4078,5,22973,1276,1,2,39,3,1
14627,310,6308,1457,730,1242,11,6,188,1468,10,292,166,329,302,495,2424,4078,5,22973,1276,1,2,19,4,0
14628,310,6308,74,35,59,1,0,14,75,3,14,7,14,17,21,58,85,1,128,7,0,2,19,4,0
14629,310,6308,245,125,200,5,7,34,250,7,30,17,34,37,51,166,265,3,1053,58,0,2,19,4,0
14630,54,3013,1296,573,1062,40,33,157,1336,8,201,118,231,209,349,1561,2689,4,12365,686,0,2,4,2,0
14631,65,3295,1457,730,1242,11,6,188,1468,10,292,166,329,302,495,2424,4078,5,22973,1276,1,2,39,3,0
14632,330,6735,1457,730,1242,11,6,188,1468,10,292,166,329,302,495,2424,4078,5,22973,1276,1,2,19,4,1
14633,330,6735,74,35,59,1,0,14,75,3,14,7,14,17,21,58,85,1,128,7,0,2,19,4,1
14634,330,6735,245,125,200,5,7,34,250,7,30,17,34,37,51,166,265,3,1053,58,0,2,19,4,1
14635,2,26,6,4,4,0,0,2,6,1,4,2,4,5,6,8,13,0,6,0,0,3,5,5,1
14636,59,3286,1296,573,1062,40,33,157,1336,8,201,118,231,209,349,1561,2689,4,12365,686,0,2,4,2,1
14637,72,3606,1457,730,1242,11,6,188,1468,10,292,166,329,302,495,2424,4078,5,22973,1276,1,2,43,4,1
14638,330,6735,1457,730,1242,11,6,188,1468,10,292,166,329,302,495,2424,4078,5,22973,1276,1,2,19,4,0
14639,330,6735,74,35,59,1,0,14,75,3,14,7,14,17,21,58,85,1,128,7,0,2,19,4,0
14640,330,6735,245,125,200,5,7,34,250,7,30,17,34,37,51,166,265,3,1053,58,0,2,19,4,0
14641,2,26,6,4,4,0,0,2,6,1,4,2,4,5,6,8,13,0,6,0,0,3,5,5,0
14642,59,3286,1296,573,1062,40,33,157,1336,8,201,118,231,209,349,1561,2689,4,12365,686,0,2,4,2,0
14643,72,3606,1457,730,1242,11,6,188,1468,10,292,166,329,302,495,2424,4078,5,22973,1276,1,2,43,4,0
14644,70,2065,1523,757,1297,19,12,193,1542,12,193,117,230,205,347,1508,2664,7,19053,1058,0,2,3,6,0
14645,70,2065,701,378,504,33,58,109,734,13,110,68,126,123,194,794,1346,7,10027,557,0,2,3,6,0
14646,321,6894,72,33,56,0,4,12,72,1,1,1,1,2,2,0,2,0,1,0,0,2,11,3,0
14647,321,6894,1454,835,1044,76,110,219,1530,17,275,158,296,292,454,2297,3718,9,34017,1889,1,2,11,3,0
14648,127,2753,1043,504,840,53,9,147,1096,9,180,112,198,189,310,1377,2344,4,11604,644,0,2,34,2,0
14649,127,2753,383,288,292,26,6,62,409,11,65,38,67,76,105,429,656,5,3719,206,0,2,34,2,0
14650,90,4091,1338,495,1086,10,64,173,1348,11,122,82,157,133,239,883,1686,7,11934,663,0,2,9,0,0
14651,68,2807,1043,504,840,53,9,147,1096,9,180,112,198,189,310,1377,2344,4,11604,644,0,2,65,0,0
14652,67,2000,1523,757,1297,19,12,193,1542,12,193,117,230,205,347,1508,2664,7,19053,1058,0,2,1,1,1
14653,67,2000,701,378,504,33,58,109,734,13,110,68,126,123,194,794,1346,7,10027,557,0,2,1,1,1
14654,74,3538,1523,757,1297,19,12,193,1542,12,193,117,230,205,347,1508,2664,7,19053,1058,0,2,24,3,1
14655,67,2000,1523,757,1297,19,12,193,1542,12,193,117,230,205,347,1508,2664,7,19053,1058,0,2,1,1,0
14656,67,2000,701,378,504,33,58,109,734,13,110,68,126,123,194,794,1346,7,10027,557,0,2,1,1,0
14657,74,3538,1523,757,1297,19,12,193,1542,12,193,117,230,205,347,1508,2664,7,19053,1058,0,2,24,3,0
14658,39,1562,1098,241,925,5,10,155,1103,7,46,25,49,53,74,273,423,3,1580,87,0,2,22,8,1
14659,103,1947,1178,367,1042,6,15,115,1184,9,94,51,95,103,146,644,976,4,4439,246,0,2,7,4,0
14660,103,1947,177,108,140,8,0,27,185,6,30,16,32,36,48,162,248,3,794,44,0,2,7,4,0
14661,39,1564,1098,241,925,5,10,155,1103,7,46,25,49,53,74,273,423,3,1580,87,0,2,1,0,0
14662,103,1960,1178,367,1042,6,15,115,1184,9,94,51,95,103,146,644,976,4,4439,246,0,2,3,1,0
14663,103,1960,177,108,140,8,0,27,185,6,30,16,32,36,48,162,248,3,794,44,0,2,3,1,0
14664,49,573,647,139,84,35,284,233,682,0,0,0,0,0,0,0,0,0,0,0,0,2,1,1,0
14665,177,3652,1943,715,1694,26,18,214,1969,12,185,120,237,197,357,1436,2721,7,20915,1161,0,2,2,1,0
14666,177,3652,1168,838,957,57,25,144,1225,19,348,224,416,367,640,3018,5452,11,61921,3440,1,2,2,1,0
14667,71,3611,1943,715,1694,26,18,214,1969,12,185,120,237,197,357,1436,2721,7,20915,1161,0,2,3,1,0
14668,175,4048,77,34,69,0,0,8,77,3,24,16,29,27,45,114,213,1,387,21,0,2,1,1,1
14669,175,4048,712,438,573,51,9,84,763,14,102,71,128,116,199,733,1364,8,11988,666,0,2,1,1,1
14670,65,3297,1457,730,1242,11,6,188,1468,10,292,166,329,302,495,2424,4078,5,22973,1276,1,2,3,2,1
14671,524,11280,72,33,56,0,4,12,72,1,1,1,1,2,2,0,2,0,1,0,0,2,10,8,0
14672,524,11280,1454,835,1044,76,110,219,1530,17,275,158,296,292,454,2297,3718,9,34017,1889,1,2,10,8,0
14673,148,6631,139,89,101,2,0,35,141,7,54,34,62,61,96,330,569,4,2287,127,0,2,5,4,0
14674,148,6631,7,5,5,0,0,2,7,1,2,1,2,3,3,2,4,0,2,0,0,2,5,4,0
14675,49,573,647,139,84,35,284,233,682,0,0,0,0,0,0,0,0,0,0,0,0,2,1,1,0
14676,177,3652,1943,715,1694,26,18,214,1969,12,185,120,237,197,357,1436,2721,7,20915,1161,0,2,2,1,0
14677,177,3652,1168,838,957,57,25,144,1225,19,348,224,416,367,640,3018,5452,11,61921,3440,1,2,2,1,0
14678,71,3611,1943,715,1694,26,18,214,1969,12,185,120,237,197,357,1436,2721,7,20915,1161,0,2,3,1,0
14679,524,11280,72,33,56,0,4,12,72,1,1,1,1,2,2,0,2,0,1,0,0,2,10,8,0
14680,524,11280,1454,835,1044,76,110,219,1530,17,275,158,296,292,454,2297,3718,9,34017,1889,1,2,10,8,0
14681,148,6631,139,89,101,2,0,35,141,7,54,34,62,61,96,330,569,4,2287,127,0,2,5,4,0
14682,148,6631,7,5,5,0,0,2,7,1,2,1,2,3,3,2,4,0,2,0,0,2,5,4,0
14683,175,4048,77,34,69,0,0,8,77,3,24,16,29,27,45,114,213,1,387,21,0,2,1,1,0
14684,175,4048,712,438,573,51,9,84,763,14,102,71,128,116,199,733,1364,8,11988,666,0,2,1,1,0
14685,65,3297,1457,730,1242,11,6,188,1468,10,292,166,329,302,495,2424,4078,5,22973,1276,1,2,3,2,0
14686,73,3480,1523,757,1297,19,12,193,1542,12,193,117,230,205,347,1508,2664,7,19053,1058,0,2,1,1,0
14687,30,649,215,129,180,6,0,29,221,8,65,43,72,73,115,415,711,4,3153,175,0,2,4,1,1
14688,30,649,97,69,77,3,3,16,100,6,22,13,23,28,36,113,173,3,542,30,0,2,4,1,1
14689,6,219,75,38,59,1,3,12,76,2,4,2,4,6,6,10,15,1,15,0,0,2,12,0,1
14690,30,649,215,129,180,6,0,29,221,8,65,43,72,73,115,415,711,4,3153,175,0,2,4,1,0
14691,30,649,97,69,77,3,3,16,100,6,22,13,23,28,36,113,173,3,542,30,0,2,4,1,0
14692,6,219,75,38,59,1,3,12,76,2,4,2,4,6,6,10,15,1,15,0,0,2,12,0,0
14693,225,5008,4293,999,3693,19,54,507,4312,9,155,88,170,164,258,1156,1898,4,9368,520,0,2,26,83,1
14694,225,5008,1482,859,1002,125,135,219,1607,16,219,134,251,235,385,1766,3032,9,27804,1544,1,2,26,83,1
14695,46,949,447,308,343,6,5,95,453,7,96,59,111,103,170,651,1136,4,4600,255,0,2,1,3,1
14696,46,949,322,174,179,16,74,51,338,10,41,26,46,51,72,252,408,5,2291,127,0,2,1,3,1
14697,321,6872,72,33,56,0,4,12,72,1,1,1,1,2,2,0,2,0,1,0,0,2,3,7,1
14698,321,6872,1454,835,1044,76,110,219,1530,17,275,158,296,292,454,2297,3718,9,34017,1889,1,2,3,7,1
14699,146,6681,139,89,101,2,0,35,141,7,54,34,62,61,96,330,569,4,2287,127,0,2,1,9,1
14700,146,6681,7,5,5,0,0,2,7,1,2,1,2,3,3,2,4,0,2,0,0,2,1,9,1
14701,38,1616,447,308,343,6,5,95,453,7,96,59,111,103,170,651,1136,4,4600,255,0,2,0,30,1
14702,334,6788,1457,730,1242,11,6,188,1468,10,292,166,329,302,495,2424,4078,5,22973,1276,1,2,20,7,1
14703,334,6788,74,35,59,1,0,14,75,3,14,7,14,17,21,58,85,1,128,7,0,2,20,7,1
14704,334,6788,245,125,200,5,7,34,250,7,30,17,34,37,51,166,265,3,1053,58,0,2,20,7,1
14705,24,834,74,35,59,1,0,14,75,3,14,7,14,17,21,58,85,1,128,7,0,2,0,1,1
14706,24,834,245,125,200,5,7,34,250,7,30,17,34,37,51,166,265,3,1053,58,0,2,0,1,1
14707,6,195,75,38,59,1,3,12,76,2,4,2,4,6,6,10,15,1,15,0,0,2,9,0,1
14708,72,3655,1457,730,1242,11,6,188,1468,10,292,166,329,302,495,2424,4078,5,22973,1276,1,2,20,16,1
14709,225,5008,4293,999,3693,19,54,507,4312,9,155,88,170,164,258,1156,1898,4,9368,520,0,2,26,83,0
14710,225,5008,1482,859,1002,125,135,219,1607,16,219,134,251,235,385,1766,3032,9,27804,1544,1,2,26,83,0
14711,46,949,447,308,343,6,5,95,453,7,96,59,111,103,170,651,1136,4,4600,255,0,2,1,3,0
14712,46,949,322,174,179,16,74,51,338,10,41,26,46,51,72,252,408,5,2291,127,0,2,1,3,0
14713,321,6886,72,33,56,0,4,12,72,1,1,1,1,2,2,0,2,0,1,0,0,2,3,7,0
14714,321,6886,1454,835,1044,76,110,219,1530,17,275,158,296,292,454,2297,3718,9,34017,1889,1,2,3,7,0
14715,146,6681,139,89,101,2,0,35,141,7,54,34,62,61,96,330,569,4,2287,127,0,2,1,9,0
14716,146,6681,7,5,5,0,0,2,7,1,2,1,2,3,3,2,4,0,2,0,0,2,1,9,0
14717,38,1616,447,308,343,6,5,95,453,7,96,59,111,103,170,651,1136,4,4600,255,0,2,0,30,0
14718,334,6788,1457,730,1242,11,6,188,1468,10,292,166,329,302,495,2424,4078,5,22973,1276,1,2,20,7,0
14719,334,6788,74,35,59,1,0,14,75,3,14,7,14,17,21,58,85,1,128,7,0,2,20,7,0
14720,334,6788,245,125,200,5,7,34,250,7,30,17,34,37,51,166,265,3,1053,58,0,2,20,7,0
14721,24,834,74,35,59,1,0,14,75,3,14,7,14,17,21,58,85,1,128,7,0,2,0,1,0
14722,24,834,245,125,200,5,7,34,250,7,30,17,34,37,51,166,265,3,1053,58,0,2,0,1,0
14723,7,252,75,38,59,1,3,12,76,2,4,2,4,6,6,10,15,1,15,0,0,2,9,0,0
14724,72,3655,1457,730,1242,11,6,188,1468,10,292,166,329,302,495,2424,4078,5,22973,1276,1,2,20,16,0
14725,74,3550,1523,757,1297,19,12,193,1542,12,193,117,230,205,347,1508,2664,7,19053,1058,0,2,21,4,0
14726,67,2902,1178,367,1042,6,15,115,1184,9,94,51,95,103,146,644,976,4,4439,246,0,2,16,2,0
14727,310,6308,1457,730,1242,11,6,188,1468,10,292,166,329,302,495,2424,4078,5,22973,1276,1,2,19,4,0
14728,310,6308,74,35,59,1,0,14,75,3,14,7,14,17,21,58,85,1,128,7,0,2,19,4,0
14729,310,6308,245,125,200,5,7,34,250,7,30,17,34,37,51,166,265,3,1053,58,0,2,19,4,0
14730,67,2000,1523,757,1297,19,12,193,1542,12,193,117,230,205,347,1508,2664,7,19053,1058,0,2,1,1,0
14731,67,2000,701,378,504,33,58,109,734,13,110,68,126,123,194,794,1346,7,10027,557,0,2,1,1,0
14732,175,4048,77,34,69,0,0,8,77,3,24,16,29,27,45,114,213,1,387,21,0,2,1,1,0
14733,175,4048,712,438,573,51,9,84,763,14,102,71,128,116,199,733,1364,8,11988,666,0,2,1,1,0
14734,524,11280,72,33,56,0,4,12,72,1,1,1,1,2,2,0,2,0,1,0,0,2,10,8,0
14735,524,11280,1454,835,1044,76,110,219,1530,17,275,158,296,292,454,2297,3718,9,34017,1889,1,2,10,8,0
14736,148,6631,139,89,101,2,0,35,141,7,54,34,62,61,96,330,569,4,2287,127,0,2,5,4,0
14737,148,6631,7,5,5,0,0,2,7,1,2,1,2,3,3,2,4,0,2,0,0,2,5,4,0
14738,54,3013,1296,573,1062,40,33,157,1336,8,201,118,231,209,349,1561,2689,4,12365,686,0,2,4,2,0
14739,65,3297,1457,730,1242,11,6,188,1468,10,292,166,329,302,495,2424,4078,5,22973,1276,1,2,42,5,0
14740,75,3608,1523,757,1297,19,12,193,1542,12,193,117,230,205,347,1508,2664,7,19053,1058,0,2,24,3,0
14741,67,2902,1178,367,1042,6,15,115,1184,9,94,51,95,103,146,644,976,4,4439,246,0,2,2,2,0
14742,75,3608,1523,757,1297,19,12,193,1542,12,193,117,230,205,347,1508,2664,7,19053,1058,0,2,5,2,0
14743,85,4578,1782,648,1425,9,47,279,1791,8,171,97,189,179,286,1292,2140,4,9462,525,0,2,6,5,0
14744,85,4578,1782,648,1425,9,47,279,1791,8,171,97,189,179,286,1292,2140,4,9462,525,0,2,1,1,0
14745,105,1995,1178,367,1042,6,15,115,1184,9,94,51,95,103,146,644,976,4,4439,246,0,2,17,3,0
14746,105,1995,177,108,140,8,0,27,185,6,30,16,32,36,48,162,248,3,794,44,0,2,17,3,0
14747,45,1696,1098,241,925,5,10,155,1103,7,46,25,49,53,74,273,423,3,1580,87,0,2,44,19,0
14748,65,3307,1457,730,1242,11,6,188,1468,10,292,166,329,302,495,2424,4078,5,22973,1276,1,2,2,0,0
14749,105,1995,1178,367,1042,6,15,115,1184,9,94,51,95,103,146,644,976,4,4439,246,0,2,31,6,0
14750,105,1995,177,108,140,8,0,27,185,6,30,16,32,36,48,162,248,3,794,44,0,2,31,6,0
14751,85,4578,1782,648,1425,9,47,279,1791,8,171,97,189,179,286,1292,2140,4,9462,525,0,2,6,5,0
14752,65,3307,1457,730,1242,11,6,188,1468,10,292,166,329,302,495,2424,4078,5,22973,1276,1,2,2,0,0
14753,75,3608,1523,757,1297,19,12,193,1542,12,193,117,230,205,347,1508,2664,7,19053,1058,0,2,27,7,0
14754,67,2902,1178,367,1042,6,15,115,1184,9,94,51,95,103,146,644,976,4,4439,246,0,2,16,2,0
14755,45,1696,1098,241,925,5,10,155,1103,7,46,25,49,53,74,273,423,3,1580,87,0,2,54,14,0
14756,225,5040,4293,999,3693,19,54,507,4312,9,155,88,170,164,258,1156,1898,4,9368,520,0,2,11,7,1
14757,225,5040,1482,859,1002,125,135,219,1607,16,219,134,251,235,385,1766,3032,9,27804,1544,1,2,11,7,1
14758,70,2072,1523,757,1297,19,12,193,1542,12,193,117,230,205,347,1508,2664,7,19053,1058,0,2,1,1,1
14759,70,2072,701,378,504,33,58,109,734,13,110,68,126,123,194,794,1346,7,10027,557,0,2,1,1,1
14760,179,4150,77,34,69,0,0,8,77,3,24,16,29,27,45,114,213,1,387,21,0,2,1,1,1
14761,179,4150,712,438,573,51,9,84,763,14,102,71,128,116,199,733,1364,8,11988,666,0,2,1,1,1
14762,321,6886,72,33,56,0,4,12,72,1,1,1,1,2,2,0,2,0,1,0,0,2,0,1,1
14763,321,6886,1454,835,1044,76,110,219,1530,17,275,158,296,292,454,2297,3718,9,34017,1889,1,2,0,1,1
14764,104,1979,1178,367,1042,6,15,115,1184,9,94,51,95,103,146,644,976,4,4439,246,0,2,31,6,1
14765,104,1979,177,108,140,8,0,27,185,6,30,16,32,36,48,162,248,3,794,44,0,2,31,6,1
14766,146,6683,139,89,101,2,0,35,141,7,54,34,62,61,96,330,569,4,2287,127,0,2,5,5,1
14767,146,6683,7,5,5,0,0,2,7,1,2,1,2,3,3,2,4,0,2,0,0,2,5,5,1
14768,94,4971,1782,648,1425,9,47,279,1791,8,171,97,189,179,286,1292,2140,4,9462,525,0,2,6,5,1
14769,72,3657,1457,730,1242,11,6,188,1468,10,292,166,329,302,495,2424,4078,5,22973,1276,1,2,4,2,1
14770,78,3868,1523,757,1297,19,12,193,1542,12,193,117,230,205,347,1508,2664,7,19053,1058,0,2,49,8,1
14771,68,2926,1178,367,1042,6,15,115,1184,9,94,51,95,103,146,644,976,4,4439,246,0,2,16,2,1
14772,46,1725,1098,241,925,5,10,155,1103,7,46,25,49,53,74,273,423,3,1580,87,0,2,54,14,1
14773,41,791,207,111,150,11,0,50,218,5,26,19,36,31,55,133,272,3,943,52,0,2,15,0,1
14774,41,791,410,198,237,31,55,97,441,11,63,38,72,74,110,414,683,6,4293,238,0,2,15,0,1
14775,103,1969,1178,367,1042,6,15,115,1184,9,94,51,95,103,146,644,976,4,4439,246,0,2,1,12,1
14776,103,1969,177,108,140,8,0,27,185,6,30,16,32,36,48,162,248,3,794,44,0,2,1,12,1
14777,46,1725,1098,241,925,5,10,155,1103,7,46,25,49,53,74,273,423,3,1580,87,0,2,2,2,1
14778,41,791,207,111,150,11,0,50,218,5,26,19,36,31,55,133,272,3,943,52,0,2,0,2,0
14779,41,791,410,198,237,31,55,97,441,11,63,38,72,74,110,414,683,6,4293,238,0,2,0,2,0
14780,41,791,207,111,150,11,0,50,218,5,26,19,36,31,55,133,272,3,943,52,0,2,13,0,0
14781,41,791,410,198,237,31,55,97,441,11,63,38,72,74,110,414,683,6,4293,238,0,2,13,0,0
14782,225,5040,4293,999,3693,19,54,507,4312,9,155,88,170,164,258,1156,1898,4,9368,520,0,2,11,7,0
14783,225,5040,1482,859,1002,125,135,219,1607,16,219,134,251,235,385,1766,3032,9,27804,1544,1,2,11,7,0
14784,70,2072,1523,757,1297,19,12,193,1542,12,193,117,230,205,347,1508,2664,7,19053,1058,0,2,1,1,0
14785,70,2072,701,378,504,33,58,109,734,13,110,68,126,123,194,794,1346,7,10027,557,0,2,1,1,0
14786,179,4150,77,34,69,0,0,8,77,3,24,16,29,27,45,114,213,1,387,21,0,2,1,1,0
14787,179,4150,712,438,573,51,9,84,763,14,102,71,128,116,199,733,1364,8,11988,666,0,2,1,1,0
14788,321,6886,72,33,56,0,4,12,72,1,1,1,1,2,2,0,2,0,1,0,0,2,0,1,0
14789,321,6886,1454,835,1044,76,110,219,1530,17,275,158,296,292,454,2297,3718,9,34017,1889,1,2,0,1,0
14790,103,1969,1178,367,1042,6,15,115,1184,9,94,51,95,103,146,644,976,4,4439,246,0,2,20,6,0
14791,103,1969,177,108,140,8,0,27,185,6,30,16,32,36,48,162,248,3,794,44,0,2,20,6,0
14792,146,6683,139,89,101,2,0,35,141,7,54,34,62,61,96,330,569,4,2287,127,0,2,5,5,0
14793,146,6683,7,5,5,0,0,2,7,1,2,1,2,3,3,2,4,0,2,0,0,2,5,5,0
14794,94,4971,1782,648,1425,9,47,279,1791,8,171,97,189,179,286,1292,2140,4,9462,525,0,2,6,5,0
14795,72,3657,1457,730,1242,11,6,188,1468,10,292,166,329,302,495,2424,4078,5,22973,1276,1,2,4,2,0
14796,78,3868,1523,757,1297,19,12,193,1542,12,193,117,230,205,347,1508,2664,7,19053,1058,0,2,49,8,0
14797,68,2926,1178,367,1042,6,15,115,1184,9,94,51,95,103,146,644,976,4,4439,246,0,2,16,2,0
14798,46,1725,1098,241,925,5,10,155,1103,7,46,25,49,53,74,273,423,3,1580,87,0,2,54,14,0
14799,322,6894,72,33,56,0,4,12,72,1,1,1,1,2,2,0,2,0,1,0,0,2,3,1,1
14800,322,6894,1454,835,1044,76,110,219,1530,17,275,158,296,292,454,2297,3718,9,34017,1889,1,2,3,1,1
14801,128,2805,1043,504,840,53,9,147,1096,9,180,112,198,189,310,1377,2344,4,11604,644,0,2,12,5,1
14802,128,2805,383,288,292,26,6,62,409,11,65,38,67,76,105,429,656,5,3719,206,0,2,12,5,1
14803,69,2837,1043,504,840,53,9,147,1096,9,180,112,198,189,310,1377,2344,4,11604,644,0,2,13,0,1
14804,322,6894,72,33,56,0,4,12,72,1,1,1,1,2,2,0,2,0,1,0,0,2,3,1,0
14805,322,6894,1454,835,1044,76,110,219,1530,17,275,158,296,292,454,2297,3718,9,34017,1889,1,2,3,1,0
14806,128,2805,1043,504,840,53,9,147,1096,9,180,112,198,189,310,1377,2344,4,11604,644,0,2,12,5,0
14807,128,2805,383,288,292,26,6,62,409,11,65,38,67,76,105,429,656,5,3719,206,0,2,12,5,0
14808,69,2837,1043,504,840,53,9,147,1096,9,180,112,198,189,310,1377,2344,4,11604,644,0,2,13,0,0
14809,321,6886,72,33,56,0,4,12,72,1,1,1,1,2,2,0,2,0,1,0,0,2,2,2,0
14810,321,6886,1454,835,1044,76,110,219,1530,17,275,158,296,292,454,2297,3718,9,34017,1889,1,2,2,2,0
14811,68,2926,1178,367,1042,6,15,115,1184,9,94,51,95,103,146,644,976,4,4439,246,0,2,1,1,0
14812,128,2805,1043,504,840,53,9,147,1096,9,180,112,198,189,310,1377,2344,4,11604,644,0,2,1,1,1
14813,128,2805,383,288,292,26,6,62,409,11,65,38,67,76,105,429,656,5,3719,206,0,2,1,1,1
14814,128,2805,1043,504,840,53,9,147,1096,9,180,112,198,189,310,1377,2344,4,11604,644,0,2,1,1,0
14815,128,2805,383,288,292,26,6,62,409,11,65,38,67,76,105,429,656,5,3719,206,0,2,1,1,0
14816,322,6894,72,33,56,0,4,12,72,1,1,1,1,2,2,0,2,0,1,0,0,2,2,2,0
14817,322,6894,1454,835,1044,76,110,219,1530,17,275,158,296,292,454,2297,3718,9,34017,1889,1,2,2,2,0
14818,68,2926,1178,367,1042,6,15,115,1184,9,94,51,95,103,146,644,976,4,4439,246,0,2,1,1,0
14819,70,1304,1020,354,843,12,15,144,1032,8,134,77,144,142,221,970,1580,4,6792,377,0,2,15,0,1
14820,321,6850,72,33,56,0,4,12,72,1,1,1,1,2,2,0,2,0,1,0,0,2,13,18,1
14821,321,6850,1454,835,1044,76,110,219,1530,17,275,158,296,292,454,2297,3718,9,34017,1889,1,2,13,18,1
14822,179,4151,77,34,69,0,0,8,77,3,24,16,29,27,45,114,213,1,387,21,0,2,1,1,1
14823,179,4151,712,438,573,51,9,84,763,14,102,71,128,116,199,733,1364,8,11988,666,0,2,1,1,1
14824,70,1304,1020,354,843,12,15,144,1032,8,134,77,144,142,221,970,1580,4,6792,377,0,2,15,0,0
14825,321,6850,72,33,56,0,4,12,72,1,1,1,1,2,2,0,2,0,1,0,0,2,13,18,0
14826,321,6850,1454,835,1044,76,110,219,1530,17,275,158,296,292,454,2297,3718,9,34017,1889,1,2,13,18,0
14827,78,3291,1289,550,1043,56,32,155,1345,10,167,93,185,177,278,1266,2075,5,11498,638,0,2,18,0,0
14828,179,4151,77,34,69,0,0,8,77,3,24,16,29,27,45,114,213,1,387,21,0,2,1,1,0
14829,179,4151,712,438,573,51,9,84,763,14,102,71,128,116,199,733,1364,8,11988,666,0,2,1,1,0
14830,78,3291,1289,550,1043,56,32,155,1345,10,167,93,185,177,278,1266,2075,5,11498,638,0,2,18,0,0
14831,326,6911,72,33,56,0,4,12,72,1,1,1,1,2,2,0,2,0,1,0,0,2,26,8,1
14832,326,6911,1454,835,1044,76,110,219,1530,17,275,158,296,292,454,2297,3718,9,34017,1889,1,2,26,8,1
14833,98,5099,1782,648,1425,9,47,279,1791,8,171,97,189,179,286,1292,2140,4,9462,525,0,2,119,37,1
14834,334,6788,1457,730,1242,11,6,188,1468,10,292,166,329,302,495,2424,4078,5,22973,1276,1,2,1,1,0
14835,334,6788,74,35,59,1,0,14,75,3,14,7,14,17,21,58,85,1,128,7,0,2,1,1,0
14836,334,6788,245,125,200,5,7,34,250,7,30,17,34,37,51,166,265,3,1053,58,0,2,1,1,0
14837,326,6911,72,33,56,0,4,12,72,1,1,1,1,2,2,0,2,0,1,0,0,2,26,8,0
14838,326,6911,1454,835,1044,76,110,219,1530,17,275,158,296,292,454,2297,3718,9,34017,1889,1,2,26,8,0
14839,98,5099,1782,648,1425,9,47,279,1791,8,171,97,189,179,286,1292,2140,4,9462,525,0,2,119,37,0
14840,327,6920,72,33,56,0,4,12,72,1,1,1,1,2,2,0,2,0,1,0,0,2,1,1,0
14841,327,6920,1454,835,1044,76,110,219,1530,17,275,158,296,292,454,2297,3718,9,34017,1889,1,2,1,1,0
14842,100,5163,1782,648,1425,9,47,279,1791,8,171,97,189,179,286,1292,2140,4,9462,525,0,2,27,0,0
14843,327,6920,72,33,56,0,4,12,72,1,1,1,1,2,2,0,2,0,1,0,0,2,1,1,0
14844,327,6920,1454,835,1044,76,110,219,1530,17,275,158,296,292,454,2297,3718,9,34017,1889,1,2,1,1,0
14845,100,5163,1782,648,1425,9,47,279,1791,8,171,97,189,179,286,1292,2140,4,9462,525,0,2,27,0,0
14846,179,4151,77,34,69,0,0,8,77,3,24,16,29,27,45,114,213,1,387,21,0,2,1,1,0
14847,179,4151,712,438,573,51,9,84,763,14,102,71,128,116,199,733,1364,8,11988,666,0,2,1,1,0
14848,70,1304,1020,354,843,12,15,144,1032,8,134,77,144,142,221,970,1580,4,6792,377,0,2,15,0,0
14849,327,6920,72,33,56,0,4,12,72,1,1,1,1,2,2,0,2,0,1,0,0,2,45,30,0
14850,327,6920,1454,835,1044,76,110,219,1530,17,275,158,296,292,454,2297,3718,9,34017,1889,1,2,45,30,0
14851,128,2805,1043,504,840,53,9,147,1096,9,180,112,198,189,310,1377,2344,4,11604,644,0,2,12,5,0
14852,128,2805,383,288,292,26,6,62,409,11,65,38,67,76,105,429,656,5,3719,206,0,2,12,5,0
14853,78,3291,1289,550,1043,56,32,155,1345,10,167,93,185,177,278,1266,2075,5,11498,638,0,2,18,0,0
14854,100,5163,1782,648,1425,9,47,279,1791,8,171,97,189,179,286,1292,2140,4,9462,525,0,2,146,37,0
14855,69,2837,1043,504,840,53,9,147,1096,9,180,112,198,189,310,1377,2344,4,11604,644,0,2,13,0,0
14856,68,2926,1178,367,1042,6,15,115,1184,9,94,51,95,103,146,644,976,4,4439,246,0,2,1,1,0
14857,330,6968,72,33,56,0,4,12,72,1,1,1,1,2,2,0,2,0,1,0,0,2,9,3,1
14858,330,6968,1454,835,1044,76,110,219,1530,17,275,158,296,292,454,2297,3718,9,34017,1889,1,2,9,3,1
14859,101,5195,1782,648,1425,9,47,279,1791,8,171,97,189,179,286,1292,2140,4,9462,525,0,2,12,0,1
14860,179,4151,77,34,69,0,0,8,77,3,24,16,29,27,45,114,213,1,387,21,0,2,1,1,0
14861,179,4151,712,438,573,51,9,84,763,14,102,71,128,116,199,733,1364,8,11988,666,0,2,1,1,0
14862,70,1304,1020,354,843,12,15,144,1032,8,134,77,144,142,221,970,1580,4,6792,377,0,2,15,0,0
14863,327,6920,72,33,56,0,4,12,72,1,1,1,1,2,2,0,2,0,1,0,0,2,45,30,0
14864,327,6920,1454,835,1044,76,110,219,1530,17,275,158,296,292,454,2297,3718,9,34017,1889,1,2,45,30,0
14865,128,2805,1043,504,840,53,9,147,1096,9,180,112,198,189,310,1377,2344,4,11604,644,0,2,12,5,0
14866,128,2805,383,288,292,26,6,62,409,11,65,38,67,76,105,429,656,5,3719,206,0,2,12,5,0
14867,78,3291,1289,550,1043,56,32,155,1345,10,167,93,185,177,278,1266,2075,5,11498,638,0,2,18,0,0
14868,100,5163,1782,648,1425,9,47,279,1791,8,171,97,189,179,286,1292,2140,4,9462,525,0,2,146,37,0
14869,69,2837,1043,504,840,53,9,147,1096,9,180,112,198,189,310,1377,2344,4,11604,644,0,2,13,0,0
14870,68,2926,1178,367,1042,6,15,115,1184,9,94,51,95,103,146,644,976,4,4439,246,0,2,1,1,0
14871,330,6968,72,33,56,0,4,12,72,1,1,1,1,2,2,0,2,0,1,0,0,2,9,3,0
14872,330,6968,1454,835,1044,76,110,219,1530,17,275,158,296,292,454,2297,3718,9,34017,1889,1,2,9,3,0
14873,101,5195,1782,648,1425,9,47,279,1791,8,171,97,189,179,286,1292,2140,4,9462,525,0,2,12,0,0
14874,334,6788,1457,730,1242,11,6,188,1468,10,292,166,329,302,495,2424,4078,5,22973,1276,1,2,1,1,1
14875,334,6788,74,35,59,1,0,14,75,3,14,7,14,17,21,58,85,1,128,7,0,2,1,1,1
14876,334,6788,245,125,200,5,7,34,250,7,30,17,34,37,51,166,265,3,1053,58,0,2,1,1,1
14877,119,2397,1513,682,1277,25,13,200,1538,11,199,116,219,210,335,1557,2584,6,15641,868,0,2,7,0,1
14878,119,2397,819,519,539,24,98,155,843,15,96,57,106,111,163,690,1107,8,9171,509,0,2,7,0,1
14879,116,4563,1513,682,1277,25,13,200,1538,11,199,116,219,210,335,1557,2584,6,15641,868,0,2,22,0,1
14880,119,2397,1513,682,1277,25,13,200,1538,11,199,116,219,210,335,1557,2584,6,15641,868,0,2,7,0,0
14881,119,2397,819,519,539,24,98,155,843,15,96,57,106,111,163,690,1107,8,9171,509,0,2,7,0,0
14882,116,4563,1513,682,1277,25,13,200,1538,11,199,116,219,210,335,1557,2584,6,15641,868,0,2,22,0,0
14883,71,2088,1523,757,1297,19,12,193,1542,12,193,117,230,205,347,1508,2664,7,19053,1058,0,2,2,0,0
14884,71,2088,701,378,504,33,58,109,734,13,110,68,126,123,194,794,1346,7,10027,557,0,2,2,0,0
14885,79,3991,1523,757,1297,19,12,193,1542,12,193,117,230,205,347,1508,2664,7,19053,1058,0,2,25,0,0
14886,207,4437,182,127,129,0,0,53,182,5,39,21,42,44,63,217,343,2,926,51,0,2,1,1,1
14887,207,4437,1165,710,800,67,119,181,1232,18,243,153,282,261,435,2000,3492,10,36473,2026,1,2,1,1,1
14888,87,3140,1450,624,1228,12,26,181,1462,14,306,186,354,320,540,2580,4493,8,36391,2021,1,2,9,0,1
14889,207,4437,182,127,129,0,0,53,182,5,39,21,42,44,63,217,343,2,926,51,0,2,1,1,0
14890,207,4437,1165,710,800,67,119,181,1232,18,243,153,282,261,435,2000,3492,10,36473,2026,1,2,1,1,0
14891,87,3140,1450,624,1228,12,26,181,1462,14,306,186,354,320,540,2580,4493,8,36391,2021,1,2,9,0,0
14892,330,6968,72,33,56,0,4,12,72,1,1,1,1,2,2,0,2,0,1,0,0,2,11,16,1
14893,330,6968,1454,835,1044,76,110,219,1530,17,275,158,296,292,454,2297,3718,9,34017,1889,1,2,11,16,1
14894,1,310,382,65,130,157,2,92,539,4,10,5,10,14,15,41,57,2,114,6,0,2,2,2,1
14895,330,6968,72,33,56,0,4,12,72,1,1,1,1,2,2,0,2,0,1,0,0,2,11,16,0
14896,330,6968,1454,835,1044,76,110,219,1530,17,275,158,296,292,454,2297,3718,9,34017,1889,1,2,11,16,0
14897,1,310,382,65,130,157,2,92,539,4,10,5,10,14,15,41,57,2,114,6,0,2,2,2,0
14898,23,680,339,213,244,17,9,65,356,10,42,26,48,52,74,259,421,5,2410,133,0,2,1,1,0
14899,23,680,339,213,244,17,9,65,356,10,42,26,48,52,74,259,421,5,2410,133,0,2,1,1,0
14900,55,1112,1098,241,925,5,10,155,1103,7,46,25,49,53,74,273,423,3,1580,87,0,2,6,1,0
14901,55,1112,282,202,222,14,2,44,296,8,42,24,43,50,67,250,378,4,1548,86,0,2,6,1,0
14902,207,4437,182,127,129,0,0,53,182,5,39,21,42,44,63,217,343,2,926,51,0,2,1,1,0
14903,207,4437,1165,710,800,67,119,181,1232,18,243,153,282,261,435,2000,3492,10,36473,2026,1,2,1,1,0
14904,119,2397,1513,682,1277,25,13,200,1538,11,199,116,219,210,335,1557,2584,6,15641,868,0,2,7,0,0
14905,119,2397,819,519,539,24,98,155,843,15,96,57,106,111,163,690,1107,8,9171,509,0,2,7,0,0
14906,23,680,339,213,244,17,9,65,356,10,42,26,48,52,74,259,421,5,2410,133,0,2,1,1,0
14907,330,6968,72,33,56,0,4,12,72,1,1,1,1,2,2,0,2,0,1,0,0,2,20,19,0
14908,330,6968,1454,835,1044,76,110,219,1530,17,275,158,296,292,454,2297,3718,9,34017,1889,1,2,20,19,0
14909,1,310,382,65,130,157,2,92,539,4,10,5,10,14,15,41,57,2,114,6,0,2,2,2,0
14910,101,5195,1782,648,1425,9,47,279,1791,8,171,97,189,179,286,1292,2140,4,9462,525,0,2,12,0,0
14911,87,3140,1450,624,1228,12,26,181,1462,14,306,186,354,320,540,2580,4493,8,36391,2021,1,2,9,0,0
14912,116,4563,1513,682,1277,25,13,200,1538,11,199,116,219,210,335,1557,2584,6,15641,868,0,2,22,0,0
14913,34,625,2,2,2,0,0,0,2,0,0,0,0,0,0,0,0,0,0,0,0,2,6,0,1
14914,34,625,99,48,90,1,3,5,100,0,0,0,0,0,0,0,0,0,0,0,0,2,6,0,1
14915,34,625,8,5,5,2,0,1,10,0,0,0,0,0,0,0,0,0,0,0,0,2,6,0,1
14916,34,625,1217,716,841,84,126,174,1301,14,185,118,215,199,333,1446,2542,8,20687,1149,0,2,6,0,1
14917,34,625,160,89,115,0,13,31,160,7,15,11,17,22,28,78,124,3,495,27,0,2,6,0,1
14918,34,625,10,10,9,9,0,0,19,0,0,0,0,0,0,0,0,0,0,0,0,2,6,0,1
14919,34,625,173,84,99,8,29,36,181,5,12,7,13,17,20,54,81,2,221,12,0,2,6,0,1
14920,34,625,3,1,1,3,0,0,6,0,0,0,0,0,0,0,0,0,0,0,0,2,6,0,1
14921,335,6801,1457,730,1242,11,6,188,1468,10,292,166,329,302,495,2424,4078,5,22973,1276,1,2,2,0,1
14922,335,6801,74,35,59,1,0,14,75,3,14,7,14,17,21,58,85,1,128,7,0,2,2,0,1
14923,335,6801,245,125,200,5,7,34,250,7,30,17,34,37,51,166,265,3,1053,58,0,2,2,0,1
14924,90,3249,1450,624,1228,12,26,181,1462,14,306,186,354,320,540,2580,4493,8,36391,2021,1,2,29,0,1
14925,34,625,2,2,2,0,0,0,2,0,0,0,0,0,0,0,0,0,0,0,0,2,6,0,0
14926,34,625,99,48,90,1,3,5,100,0,0,0,0,0,0,0,0,0,0,0,0,2,6,0,0
14927,34,625,8,5,5,2,0,1,10,0,0,0,0,0,0,0,0,0,0,0,0,2,6,0,0
14928,34,625,1217,716,841,84,126,174,1301,14,185,118,215,199,333,1446,2542,8,20687,1149,0,2,6,0,0
14929,34,625,160,89,115,0,13,31,160,7,15,11,17,22,28,78,124,3,495,27,0,2,6,0,0
14930,34,625,10,10,9,9,0,0,19,0,0,0,0,0,0,0,0,0,0,0,0,2,6,0,0
14931,34,625,173,84,99,8,29,36,181,5,12,7,13,17,20,54,81,2,221,12,0,2,6,0,0
14932,34,625,3,1,1,3,0,0,6,0,0,0,0,0,0,0,0,0,0,0,0,2,6,0,0
14933,335,6801,1457,730,1242,11,6,188,1468,10,292,166,329,302,495,2424,4078,5,22973,1276,1,2,2,0,0
14934,335,6801,74,35,59,1,0,14,75,3,14,7,14,17,21,58,85,1,128,7,0,2,2,0,0
14935,335,6801,245,125,200,5,7,34,250,7,30,17,34,37,51,166,265,3,1053,58,0,2,2,0,0
14936,90,3249,1450,624,1228,12,26,181,1462,14,306,186,354,320,540,2580,4493,8,36391,2021,1,2,29,0,0
14937,40,1472,1293,570,1093,25,15,163,1318,10,195,123,241,205,364,1516,2795,6,17273,959,0,2,19,0,0
14938,34,625,2,2,2,0,0,0,2,0,0,0,0,0,0,0,0,0,0,0,0,2,6,0,0
14939,34,625,99,48,90,1,3,5,100,0,0,0,0,0,0,0,0,0,0,0,0,2,6,0,0
14940,34,625,8,5,5,2,0,1,10,0,0,0,0,0,0,0,0,0,0,0,0,2,6,0,0
14941,34,625,1217,716,841,84,126,174,1301,14,185,118,215,199,333,1446,2542,8,20687,1149,0,2,6,0,0
14942,34,625,160,89,115,0,13,31,160,7,15,11,17,22,28,78,124,3,495,27,0,2,6,0,0
14943,34,625,10,10,9,9,0,0,19,0,0,0,0,0,0,0,0,0,0,0,0,2,6,0,0
14944,34,625,173,84,99,8,29,36,181,5,12,7,13,17,20,54,81,2,221,12,0,2,6,0,0
14945,34,625,3,1,1,3,0,0,6,0,0,0,0,0,0,0,0,0,0,0,0,2,6,0,0
14946,335,6801,1457,730,1242,11,6,188,1468,10,292,166,329,302,495,2424,4078,5,22973,1276,1,2,2,0,0
14947,335,6801,74,35,59,1,0,14,75,3,14,7,14,17,21,58,85,1,128,7,0,2,2,0,0
14948,335,6801,245,125,200,5,7,34,250,7,30,17,34,37,51,166,265,3,1053,58,0,2,2,0,0
14949,90,3249,1450,624,1228,12,26,181,1462,14,306,186,354,320,540,2580,4493,8,36391,2021,1,2,29,0,0
14950,55,1112,1098,241,925,5,10,155,1103,7,46,25,49,53,74,273,423,3,1580,87,0,2,1,1,1
14951,55,1112,282,202,222,14,2,44,296,8,42,24,43,50,67,250,378,4,1548,86,0,2,1,1,1
14952,40,1472,1293,570,1093,25,15,163,1318,10,195,123,241,205,364,1516,2795,6,17273,959,0,2,2,2,1
14953,55,1112,1098,241,925,5,10,155,1103,7,46,25,49,53,74,273,423,3,1580,87,0,2,6,1,0
14954,55,1112,282,202,222,14,2,44,296,8,42,24,43,50,67,250,378,4,1548,86,0,2,6,1,0
14955,40,1472,1293,570,1093,25,15,163,1318,10,195,123,241,205,364,1516,2795,6,17273,959,0,2,19,0,0
14956,56,1576,1455,414,1257,16,76,112,1471,5,41,23,46,46,69,231,381,2,1069,59,0,2,1,1,0
14957,56,1576,669,365,481,22,61,110,691,15,103,63,122,118,185,747,1273,8,11311,628,0,2,1,1,0
14958,56,1576,1455,414,1257,16,76,112,1471,5,41,23,46,46,69,231,381,2,1069,59,0,2,1,1,0
14959,56,1576,669,365,481,22,61,110,691,15,103,63,122,118,185,747,1273,8,11311,628,0,2,1,1,0
14960,34,625,2,2,2,0,0,0,2,0,0,0,0,0,0,0,0,0,0,0,0,2,6,0,1
14961,34,625,99,48,90,1,3,5,100,0,0,0,0,0,0,0,0,0,0,0,0,2,6,0,1
14962,34,625,8,5,5,2,0,1,10,0,0,0,0,0,0,0,0,0,0,0,0,2,6,0,1
14963,34,625,1217,716,841,84,126,174,1301,14,185,118,215,199,333,1446,2542,8,20687,1149,0,2,6,0,1
14964,34,625,160,89,115,0,13,31,160,7,15,11,17,22,28,78,124,3,495,27,0,2,6,0,1
14965,34,625,10,10,9,9,0,0,19,0,0,0,0,0,0,0,0,0,0,0,0,2,6,0,1
14966,34,625,173,84,99,8,29,36,181,5,12,7,13,17,20,54,81,2,221,12,0,2,6,0,1
14967,34,625,3,1,1,3,0,0,6,0,0,0,0,0,0,0,0,0,0,0,0,2,6,0,1
14968,335,6801,1457,730,1242,11,6,188,1468,10,292,166,329,302,495,2424,4078,5,22973,1276,1,2,2,0,1
14969,335,6801,74,35,59,1,0,14,75,3,14,7,14,17,21,58,85,1,128,7,0,2,2,0,1
14970,335,6801,245,125,200,5,7,34,250,7,30,17,34,37,51,166,265,3,1053,58,0,2,2,0,1
14971,56,1576,1455,414,1257,16,76,112,1471,5,41,23,46,46,69,231,381,2,1069,59,0,2,1,1,1
14972,56,1576,669,365,481,22,61,110,691,15,103,63,122,118,185,747,1273,8,11311,628,0,2,1,1,1
14973,55,1112,1098,241,925,5,10,155,1103,7,46,25,49,53,74,273,423,3,1580,87,0,2,6,1,1
14974,55,1112,282,202,222,14,2,44,296,8,42,24,43,50,67,250,378,4,1548,86,0,2,6,1,1
14975,90,3249,1450,624,1228,12,26,181,1462,14,306,186,354,320,540,2580,4493,8,36391,2021,1,2,29,0,1
14976,40,1472,1293,570,1093,25,15,163,1318,10,195,123,241,205,364,1516,2795,6,17273,959,0,2,19,0,1
14977,34,625,2,2,2,0,0,0,2,0,0,0,0,0,0,0,0,0,0,0,0,2,6,0,0
14978,34,625,99,48,90,1,3,5,100,0,0,0,0,0,0,0,0,0,0,0,0,2,6,0,0
14979,34,625,8,5,5,2,0,1,10,0,0,0,0,0,0,0,0,0,0,0,0,2,6,0,0
14980,34,625,1217,716,841,84,126,174,1301,14,185,118,215,199,333,1446,2542,8,20687,1149,0,2,6,0,0
14981,34,625,160,89,115,0,13,31,160,7,15,11,17,22,28,78,124,3,495,27,0,2,6,0,0
14982,34,625,10,10,9,9,0,0,19,0,0,0,0,0,0,0,0,0,0,0,0,2,6,0,0
14983,34,625,173,84,99,8,29,36,181,5,12,7,13,17,20,54,81,2,221,12,0,2,6,0,0
14984,34,625,3,1,1,3,0,0,6,0,0,0,0,0,0,0,0,0,0,0,0,2,6,0,0
14985,335,6801,1457,730,1242,11,6,188,1468,10,292,166,329,302,495,2424,4078,5,22973,1276,1,2,2,0,0
14986,335,6801,74,35,59,1,0,14,75,3,14,7,14,17,21,58,85,1,128,7,0,2,2,0,0
14987,335,6801,245,125,200,5,7,34,250,7,30,17,34,37,51,166,265,3,1053,58,0,2,2,0,0
14988,56,1576,1455,414,1257,16,76,112,1471,5,41,23,46,46,69,231,381,2,1069,59,0,2,1,1,0
14989,56,1576,669,365,481,22,61,110,691,15,103,63,122,118,185,747,1273,8,11311,628,0,2,1,1,0
14990,55,1112,1098,241,925,5,10,155,1103,7,46,25,49,53,74,273,423,3,1580,87,0,2,6,1,0
14991,55,1112,282,202,222,14,2,44,296,8,42,24,43,50,67,250,378,4,1548,86,0,2,6,1,0
14992,90,3249,1450,624,1228,12,26,181,1462,14,306,186,354,320,540,2580,4493,8,36391,2021,1,2,29,0,0
14993,40,1472,1293,570,1093,25,15,163,1318,10,195,123,241,205,364,1516,2795,6,17273,959,0,2,19,0,0
14994,330,6972,72,33,56,0,4,12,72,1,1,1,1,2,2,0,2,0,1,0,0,2,1,1,1
14995,330,6972,1454,835,1044,76,110,219,1530,17,275,158,296,292,454,2297,3718,9,34017,1889,1,2,1,1,1
14996,103,5262,1782,648,1425,9,47,279,1791,8,171,97,189,179,286,1292,2140,4,9462,525,0,2,8,0,1
14997,70,1304,1020,354,843,12,15,144,1032,8,134,77,144,142,221,970,1580,4,6792,377,0,2,1,1,1
14998,70,1304,1020,354,843,12,15,144,1032,8,134,77,144,142,221,970,1580,4,6792,377,0,2,1,1,0
14999,330,6963,72,33,56,0,4,12,72,1,1,1,1,2,2,0,2,0,1,0,0,2,2,1,0
15000,330,6963,1454,835,1044,76,110,219,1530,17,275,158,296,292,454,2297,3718,9,34017,1889,1,2,2,1,0
15001,178,4126,77,34,69,0,0,8,77,3,24,16,29,27,45,114,213,1,387,21,0,2,0,4,1
15002,178,4126,712,438,573,51,9,84,763,14,102,71,128,116,199,733,1364,8,11988,666,0,2,0,4,1
15003,224,5018,722,423,573,19,0,135,741,12,172,101,199,184,300,1320,2257,6,15668,870,0,2,7,1,1
15004,224,5018,1508,847,911,44,250,301,1552,14,148,88,169,162,257,1120,1886,7,15077,837,0,2,7,1,1
15005,128,2812,1043,504,840,53,9,147,1096,9,180,112,198,189,310,1377,2344,4,11604,644,0,2,3,2,1
15006,128,2812,383,288,292,26,6,62,409,11,65,38,67,76,105,429,656,5,3719,206,0,2,3,2,1
15007,330,6972,72,33,56,0,4,12,72,1,1,1,1,2,2,0,2,0,1,0,0,2,1,1,0
15008,330,6972,1454,835,1044,76,110,219,1530,17,275,158,296,292,454,2297,3718,9,34017,1889,1,2,1,1,0
15009,103,5262,1782,648,1425,9,47,279,1791,8,171,97,189,179,286,1292,2140,4,9462,525,0,2,8,0,0
15010,82,1794,477,336,357,30,23,73,507,16,194,134,250,210,384,1538,2962,10,30538,1696,0,2,1,1,0
15011,320,6878,72,33,56,0,4,12,72,1,1,1,1,2,2,0,2,0,1,0,0,2,0,6,0
15012,320,6878,1454,835,1044,76,110,219,1530,17,275,158,296,292,454,2297,3718,9,34017,1889,1,2,0,6,0
15013,15,340,256,139,192,9,7,47,265,4,23,12,24,27,36,112,171,2,357,19,0,2,0,8,0
15014,1,300,382,65,130,157,2,92,539,4,10,5,10,14,15,41,57,2,114,6,0,2,2,5,0
15015,82,1794,477,336,357,30,23,73,507,16,194,134,250,210,384,1538,2962,10,30538,1696,0,2,1,1,0
15016,329,6952,72,33,56,0,4,12,72,1,1,1,1,2,2,0,2,0,1,0,0,2,0,6,0
15017,329,6952,1454,835,1044,76,110,219,1530,17,275,158,296,292,454,2297,3718,9,34017,1889,1,2,0,6,0
15018,15,340,256,139,192,9,7,47,265,4,23,12,24,27,36,112,171,2,357,19,0,2,0,8,0
15019,1,300,382,65,130,157,2,92,539,4,10,5,10,14,15,41,57,2,114,6,0,2,2,5,0
15020,179,4155,77,34,69,0,0,8,77,3,24,16,29,27,45,114,213,1,387,21,0,2,1,1,1
15021,179,4155,712,438,573,51,9,84,763,14,102,71,128,116,199,733,1364,8,11988,666,0,2,1,1,1
15022,69,1346,1020,354,843,12,15,144,1032,8,134,77,144,142,221,970,1580,4,6792,377,0,2,46,37,1
15023,103,1956,1178,367,1042,6,15,115,1184,9,94,51,95,103,146,644,976,4,4439,246,0,2,3,5,1
15024,103,1956,177,108,140,8,0,27,185,6,30,16,32,36,48,162,248,3,794,44,0,2,3,5,1
15025,66,2750,1020,354,843,12,15,144,1032,8,134,77,144,142,221,970,1580,4,6792,377,0,2,2,2,1
15026,41,798,207,111,150,11,0,50,218,5,26,19,36,31,55,133,272,3,943,52,0,2,4,2,1
15027,41,798,410,198,237,31,55,97,441,11,63,38,72,74,110,414,683,6,4293,238,0,2,4,2,1
15028,69,1347,1020,354,843,12,15,144,1032,8,134,77,144,142,221,970,1580,4,6792,377,0,2,1,1,1
15029,41,798,207,111,150,11,0,50,218,5,26,19,36,31,55,133,272,3,943,52,0,2,1,1,1
15030,41,798,410,198,237,31,55,97,441,11,63,38,72,74,110,414,683,6,4293,238,0,2,1,1,1
15031,336,6810,1457,730,1242,11,6,188,1468,10,292,166,329,302,495,2424,4078,5,22973,1276,1,2,15,10,1
15032,336,6810,74,35,59,1,0,14,75,3,14,7,14,17,21,58,85,1,128,7,0,2,15,10,1
15033,336,6810,245,125,200,5,7,34,250,7,30,17,34,37,51,166,265,3,1053,58,0,2,15,10,1
15034,90,3273,1450,624,1228,12,26,181,1462,14,306,186,354,320,540,2580,4493,8,36391,2021,1,2,14,4,1
15035,336,6810,1457,730,1242,11,6,188,1468,10,292,166,329,302,495,2424,4078,5,22973,1276,1,2,15,10,0
15036,336,6810,74,35,59,1,0,14,75,3,14,7,14,17,21,58,85,1,128,7,0,2,15,10,0
15037,336,6810,245,125,200,5,7,34,250,7,30,17,34,37,51,166,265,3,1053,58,0,2,15,10,0
15038,90,3273,1450,624,1228,12,26,181,1462,14,306,186,354,320,540,2580,4493,8,36391,2021,1,2,14,4,0
15039,336,6810,1457,730,1242,11,6,188,1468,10,292,166,329,302,495,2424,4078,5,22973,1276,1,2,1,1,0
15040,336,6810,74,35,59,1,0,14,75,3,14,7,14,17,21,58,85,1,128,7,0,2,1,1,0
15041,336,6810,245,125,200,5,7,34,250,7,30,17,34,37,51,166,265,3,1053,58,0,2,1,1,0
15042,178,4126,77,34,69,0,0,8,77,3,24,16,29,27,45,114,213,1,387,21,0,2,0,4,0
15043,178,4126,712,438,573,51,9,84,763,14,102,71,128,116,199,733,1364,8,11988,666,0,2,0,4,0
15044,224,5018,722,423,573,19,0,135,741,12,172,101,199,184,300,1320,2257,6,15668,870,0,2,7,1,0
15045,224,5018,1508,847,911,44,250,301,1552,14,148,88,169,162,257,1120,1886,7,15077,837,0,2,7,1,0
15046,329,6947,72,33,56,0,4,12,72,1,1,1,1,2,2,0,2,0,1,0,0,2,2,1,0
15047,329,6947,1454,835,1044,76,110,219,1530,17,275,158,296,292,454,2297,3718,9,34017,1889,1,2,2,1,0
15048,128,2812,1043,504,840,53,9,147,1096,9,180,112,198,189,310,1377,2344,4,11604,644,0,2,3,2,0
15049,128,2812,383,288,292,26,6,62,409,11,65,38,67,76,105,429,656,5,3719,206,0,2,3,2,0
15050,71,2088,1523,757,1297,19,12,193,1542,12,193,117,230,205,347,1508,2664,7,19053,1058,0,2,2,0,0
15051,71,2088,701,378,504,33,58,109,734,13,110,68,126,123,194,794,1346,7,10027,557,0,2,2,0,0
15052,79,3991,1523,757,1297,19,12,193,1542,12,193,117,230,205,347,1508,2664,7,19053,1058,0,2,25,0,0
15053,82,1795,477,336,357,30,23,73,507,16,194,134,250,210,384,1538,2962,10,30538,1696,0,2,2,2,0
15054,91,3316,1450,624,1228,12,26,181,1462,14,306,186,354,320,540,2580,4493,8,36391,2021,1,2,10,2,0
15055,34,643,2,2,2,0,0,0,2,0,0,0,0,0,0,0,0,0,0,0,0,2,11,4,0
15056,34,643,99,48,90,1,3,5,100,0,0,0,0,0,0,0,0,0,0,0,0,2,11,4,0
15057,34,643,8,5,5,2,0,1,10,0,0,0,0,0,0,0,0,0,0,0,0,2,11,4,0
15058,34,643,1217,716,841,84,126,174,1301,14,185,118,215,199,333,1446,2542,8,20687,1149,0,2,11,4,0
15059,34,643,160,89,115,0,13,31,160,7,15,11,17,22,28,78,124,3,495,27,0,2,11,4,0
15060,34,643,10,10,9,9,0,0,19,0,0,0,0,0,0,0,0,0,0,0,0,2,11,4,0
15061,34,643,173,84,99,8,29,36,181,5,12,7,13,17,20,54,81,2,221,12,0,2,11,4,0
15062,34,643,3,1,1,3,0,0,6,0,0,0,0,0,0,0,0,0,0,0,0,2,11,4,0
15063,41,798,207,111,150,11,0,50,218,5,26,19,36,31,55,133,272,3,943,52,0,2,4,2,0
15064,41,798,410,198,237,31,55,97,441,11,63,38,72,74,110,414,683,6,4293,238,0,2,4,2,0
15065,178,4130,77,34,69,0,0,8,77,3,24,16,29,27,45,114,213,1,387,21,0,2,1,1,0
15066,178,4130,712,438,573,51,9,84,763,14,102,71,128,116,199,733,1364,8,11988,666,0,2,1,1,0
15067,69,1347,1020,354,843,12,15,144,1032,8,134,77,144,142,221,970,1580,4,6792,377,0,2,46,37,0
15068,103,1956,1178,367,1042,6,15,115,1184,9,94,51,95,103,146,644,976,4,4439,246,0,2,3,5,0
15069,103,1956,177,108,140,8,0,27,185,6,30,16,32,36,48,162,248,3,794,44,0,2,3,5,0
15070,66,2750,1020,354,843,12,15,144,1032,8,134,77,144,142,221,970,1580,4,6792,377,0,2,2,2,0
15071,34,643,2,2,2,0,0,0,2,0,0,0,0,0,0,0,0,0,0,0,0,2,11,4,0
15072,34,643,99,48,90,1,3,5,100,0,0,0,0,0,0,0,0,0,0,0,0,2,11,4,0
15073,34,643,8,5,5,2,0,1,10,0,0,0,0,0,0,0,0,0,0,0,0,2,11,4,0
15074,34,643,1217,716,841,84,126,174,1301,14,185,118,215,199,333,1446,2542,8,20687,1149,0,2,11,4,0
15075,34,643,160,89,115,0,13,31,160,7,15,11,17,22,28,78,124,3,495,27,0,2,11,4,0
15076,34,643,10,10,9,9,0,0,19,0,0,0,0,0,0,0,0,0,0,0,0,2,11,4,0
15077,34,643,173,84,99,8,29,36,181,5,12,7,13,17,20,54,81,2,221,12,0,2,11,4,0
15078,34,643,3,1,1,3,0,0,6,0,0,0,0,0,0,0,0,0,0,0,0,2,11,4,0
15079,82,1795,477,336,357,30,23,73,507,16,194,134,250,210,384,1538,2962,10,30538,1696,0,2,2,2,0
15080,91,3316,1450,624,1228,12,26,181,1462,14,306,186,354,320,540,2580,4493,8,36391,2021,1,2,10,2,0
15081,330,6978,72,33,56,0,4,12,72,1,1,1,1,2,2,0,2,0,1,0,0,2,3,4,0
15082,330,6978,1454,835,1044,76,110,219,1530,17,275,158,296,292,454,2297,3718,9,34017,1889,1,2,3,4,0
15083,91,3313,1450,624,1228,12,26,181,1462,14,306,186,354,320,540,2580,4493,8,36391,2021,1,2,12,0,0
15084,330,6978,72,33,56,0,4,12,72,1,1,1,1,2,2,0,2,0,1,0,0,2,3,4,0
15085,330,6978,1454,835,1044,76,110,219,1530,17,275,158,296,292,454,2297,3718,9,34017,1889,1,2,3,4,0
15086,91,3313,1450,624,1228,12,26,181,1462,14,306,186,354,320,540,2580,4493,8,36391,2021,1,2,12,0,0
15087,22,673,339,213,244,17,9,65,356,10,42,26,48,52,74,259,421,5,2410,133,0,2,9,8,0
15088,42,1533,1293,570,1093,25,15,163,1318,10,195,123,241,205,364,1516,2795,6,17273,959,0,2,31,15,0
15089,44,1603,1293,570,1093,25,15,163,1318,10,195,123,241,205,364,1516,2795,6,17273,959,0,2,19,0,1
15090,228,5101,4293,999,3693,19,54,507,4312,9,155,88,170,164,258,1156,1898,4,9368,520,0,2,23,1,1
15091,228,5101,1482,859,1002,125,135,219,1607,16,219,134,251,235,385,1766,3032,9,27804,1544,1,2,23,1,1
15092,330,6987,72,33,56,0,4,12,72,1,1,1,1,2,2,0,2,0,1,0,0,2,3,2,1
15093,330,6987,1454,835,1044,76,110,219,1530,17,275,158,296,292,454,2297,3718,9,34017,1889,1,2,3,2,1
15094,147,6715,139,89,101,2,0,35,141,7,54,34,62,61,96,330,569,4,2287,127,0,2,16,0,1
15095,147,6715,7,5,5,0,0,2,7,1,2,1,2,3,3,2,4,0,2,0,0,2,16,0,1
15096,106,5313,1782,648,1425,9,47,279,1791,8,171,97,189,179,286,1292,2140,4,9462,525,0,2,8,0,1
15097,228,5101,4293,999,3693,19,54,507,4312,9,155,88,170,164,258,1156,1898,4,9368,520,0,2,23,1,0
15098,228,5101,1482,859,1002,125,135,219,1607,16,219,134,251,235,385,1766,3032,9,27804,1544,1,2,23,1,0
15099,330,6987,72,33,56,0,4,12,72,1,1,1,1,2,2,0,2,0,1,0,0,2,3,2,0
15100,330,6987,1454,835,1044,76,110,219,1530,17,275,158,296,292,454,2297,3718,9,34017,1889,1,2,3,2,0
15101,147,6715,139,89,101,2,0,35,141,7,54,34,62,61,96,330,569,4,2287,127,0,2,16,0,0
15102,147,6715,7,5,5,0,0,2,7,1,2,1,2,3,3,2,4,0,2,0,0,2,16,0,0
15103,106,5313,1782,648,1425,9,47,279,1791,8,171,97,189,179,286,1292,2140,4,9462,525,0,2,8,0,0
15104,208,4450,182,127,129,0,0,53,182,5,39,21,42,44,63,217,343,2,926,51,0,2,4,0,1
15105,208,4450,1165,710,800,67,119,181,1232,18,243,153,282,261,435,2000,3492,10,36473,2026,1,2,4,0,1
15106,101,2153,773,419,590,28,0,166,801,10,204,113,217,214,330,1598,2554,5,13587,754,0,2,3,0,1
15107,101,2153,421,273,302,44,34,57,465,17,81,59,107,98,166,583,1098,11,12329,684,0,2,3,0,1
15108,82,1800,477,336,357,30,23,73,507,16,194,134,250,210,384,1538,2962,10,30538,1696,0,2,1,1,1
15109,332,7010,72,33,56,0,4,12,72,1,1,1,1,2,2,0,2,0,1,0,0,2,6,0,1
15110,332,7010,1454,835,1044,76,110,219,1530,17,275,158,296,292,454,2297,3718,9,34017,1889,1,2,6,0,1
15111,207,4440,182,127,129,0,0,53,182,5,39,21,42,44,63,217,343,2,926,51,0,2,1,2,1
15112,207,4440,1165,710,800,67,119,181,1232,18,243,153,282,261,435,2000,3492,10,36473,2026,1,2,1,2,1
15113,100,2143,773,419,590,28,0,166,801,10,204,113,217,214,330,1598,2554,5,13587,754,0,2,1,2,1
15114,100,2143,421,273,302,44,34,57,465,17,81,59,107,98,166,583,1098,11,12329,684,0,2,1,2,1
15115,330,6984,72,33,56,0,4,12,72,1,1,1,1,2,2,0,2,0,1,0,0,2,2,4,1
15116,330,6984,1454,835,1044,76,110,219,1530,17,275,158,296,292,454,2297,3718,9,34017,1889,1,2,2,4,1
15117,207,4440,182,127,129,0,0,53,182,5,39,21,42,44,63,217,343,2,926,51,0,2,3,0,0
15118,207,4440,1165,710,800,67,119,181,1232,18,243,153,282,261,435,2000,3492,10,36473,2026,1,2,3,0,0
15119,100,2143,773,419,590,28,0,166,801,10,204,113,217,214,330,1598,2554,5,13587,754,0,2,2,0,0
15120,100,2143,421,273,302,44,34,57,465,17,81,59,107,98,166,583,1098,11,12329,684,0,2,2,0,0
15121,82,1800,477,336,357,30,23,73,507,16,194,134,250,210,384,1538,2962,10,30538,1696,0,2,1,1,0
15122,330,6993,72,33,56,0,4,12,72,1,1,1,1,2,2,0,2,0,1,0,0,2,4,0,0
15123,330,6993,1454,835,1044,76,110,219,1530,17,275,158,296,292,454,2297,3718,9,34017,1889,1,2,4,0,0
15124,99,2124,773,419,590,28,0,166,801,10,204,113,217,214,330,1598,2554,5,13587,754,0,2,3,6,0
15125,99,2124,421,273,302,44,34,57,465,17,81,59,107,98,166,583,1098,11,12329,684,0,2,3,6,0
15126,99,2124,773,419,590,28,0,166,801,10,204,113,217,214,330,1598,2554,5,13587,754,0,2,3,6,0
15127,99,2124,421,273,302,44,34,57,465,17,81,59,107,98,166,583,1098,11,12329,684,0,2,3,6,0
15128,22,673,339,213,244,17,9,65,356,10,42,26,48,52,74,259,421,5,2410,133,0,2,9,8,0
15129,44,1603,1293,570,1093,25,15,163,1318,10,195,123,241,205,364,1516,2795,6,17273,959,0,2,50,15,0
15130,119,2401,1513,682,1277,25,13,200,1538,11,199,116,219,210,335,1557,2584,6,15641,868,0,2,2,1,0
15131,119,2401,819,519,539,24,98,155,843,15,96,57,106,111,163,690,1107,8,9171,509,0,2,2,1,0
15132,119,2402,1513,682,1277,25,13,200,1538,11,199,116,219,210,335,1557,2584,6,15641,868,0,2,2,1,0
15133,119,2402,819,519,539,24,98,155,843,15,96,57,106,111,163,690,1107,8,9171,509,0,2,2,1,0
15134,207,4440,182,127,129,0,0,53,182,5,39,21,42,44,63,217,343,2,926,51,0,2,3,0,0
15135,207,4440,1165,710,800,67,119,181,1232,18,243,153,282,261,435,2000,3492,10,36473,2026,1,2,3,0,0
15136,99,2124,773,419,590,28,0,166,801,10,204,113,217,214,330,1598,2554,5,13587,754,0,2,5,6,0
15137,99,2124,421,273,302,44,34,57,465,17,81,59,107,98,166,583,1098,11,12329,684,0,2,5,6,0
15138,82,1792,477,336,357,30,23,73,507,16,194,134,250,210,384,1538,2962,10,30538,1696,0,2,1,1,0
15139,336,6810,1457,730,1242,11,6,188,1468,10,292,166,329,302,495,2424,4078,5,22973,1276,1,2,16,11,0
15140,336,6810,74,35,59,1,0,14,75,3,14,7,14,17,21,58,85,1,128,7,0,2,16,11,0
15141,336,6810,245,125,200,5,7,34,250,7,30,17,34,37,51,166,265,3,1053,58,0,2,16,11,0
15142,228,5101,4293,999,3693,19,54,507,4312,9,155,88,170,164,258,1156,1898,4,9368,520,0,2,23,1,0
15143,228,5101,1482,859,1002,125,135,219,1607,16,219,134,251,235,385,1766,3032,9,27804,1544,1,2,23,1,0
15144,69,1347,1020,354,843,12,15,144,1032,8,134,77,144,142,221,970,1580,4,6792,377,0,2,1,1,0
15145,329,6972,72,33,56,0,4,12,72,1,1,1,1,2,2,0,2,0,1,0,0,2,11,7,0
15146,329,6972,1454,835,1044,76,110,219,1530,17,275,158,296,292,454,2297,3718,9,34017,1889,1,2,11,7,0
15147,1,300,382,65,130,157,2,92,539,4,10,5,10,14,15,41,57,2,114,6,0,2,2,5,0
15148,147,6715,139,89,101,2,0,35,141,7,54,34,62,61,96,330,569,4,2287,127,0,2,16,0,0
15149,147,6715,7,5,5,0,0,2,7,1,2,1,2,3,3,2,4,0,2,0,0,2,16,0,0
15150,106,5313,1782,648,1425,9,47,279,1791,8,171,97,189,179,286,1292,2140,4,9462,525,0,2,16,0,0
15151,92,3380,1450,624,1228,12,26,181,1462,14,306,186,354,320,540,2580,4493,8,36391,2021,1,2,26,4,0
15152,330,6993,72,33,56,0,4,12,72,1,1,1,1,2,2,0,2,0,1,0,0,2,3,3,1
15153,330,6993,1454,835,1044,76,110,219,1530,17,275,158,296,292,454,2297,3718,9,34017,1889,1,2,3,3,1
15154,68,2926,1178,367,1042,6,15,115,1184,9,94,51,95,103,146,644,976,4,4439,246,0,2,1,1,0
15155,330,6993,72,33,56,0,4,12,72,1,1,1,1,2,2,0,2,0,1,0,0,2,3,3,0
15156,330,6993,1454,835,1044,76,110,219,1530,17,275,158,296,292,454,2297,3718,9,34017,1889,1,2,3,3,0
15157,68,2926,1178,367,1042,6,15,115,1184,9,94,51,95,103,146,644,976,4,4439,246,0,2,1,1,0
15158,329,7012,72,33,56,0,4,12,72,1,1,1,1,2,2,0,2,0,1,0,0,2,8,5,0
15159,329,7012,1454,835,1044,76,110,219,1530,17,275,158,296,292,454,2297,3718,9,34017,1889,1,2,8,5,0
15160,78,3291,1289,550,1043,56,32,155,1345,10,167,93,185,177,278,1266,2075,5,11498,638,0,2,1,1,0
15161,91,4149,1338,495,1086,10,64,173,1348,11,122,82,157,133,239,883,1686,7,11934,663,0,2,21,1,0
15162,58,3234,1296,573,1062,40,33,157,1336,8,201,118,231,209,349,1561,2689,4,12365,686,0,2,0,11,0
15163,71,3611,1943,715,1694,26,18,214,1969,12,185,120,237,197,357,1436,2721,7,20915,1161,0,2,1,1,0
15164,332,7078,72,33,56,0,4,12,72,1,1,1,1,2,2,0,2,0,1,0,0,2,14,7,1
15165,332,7078,1454,835,1044,76,110,219,1530,17,275,158,296,292,454,2297,3718,9,34017,1889,1,2,14,7,1
15166,93,4223,1338,495,1086,10,64,173,1348,11,122,82,157,133,239,883,1686,7,11934,663,0,2,17,4,1
15167,24,834,74,35,59,1,0,14,75,3,14,7,14,17,21,58,85,1,128,7,0,2,2,2,0
15168,24,834,245,125,200,5,7,34,250,7,30,17,34,37,51,166,265,3,1053,58,0,2,2,2,0
15169,24,834,74,35,59,1,0,14,75,3,14,7,14,17,21,58,85,1,128,7,0,2,2,2,0
15170,24,834,245,125,200,5,7,34,250,7,30,17,34,37,51,166,265,3,1053,58,0,2,2,2,0
15171,332,7078,72,33,56,0,4,12,72,1,1,1,1,2,2,0,2,0,1,0,0,2,17,7,0
15172,332,7078,1454,835,1044,76,110,219,1530,17,275,158,296,292,454,2297,3718,9,34017,1889,1,2,17,7,0
15173,78,3291,1289,550,1043,56,32,155,1345,10,167,93,185,177,278,1266,2075,5,11498,638,0,2,1,1,0
15174,93,4223,1338,495,1086,10,64,173,1348,11,122,82,157,133,239,883,1686,7,11934,663,0,2,34,1,0
15175,58,3234,1296,573,1062,40,33,157,1336,8,201,118,231,209,349,1561,2689,4,12365,686,0,2,0,11,0
15176,71,3611,1943,715,1694,26,18,214,1969,12,185,120,237,197,357,1436,2721,7,20915,1161,0,2,1,1,0
15177,28,547,2,2,2,0,0,0,2,0,0,0,0,0,0,0,0,0,0,0,0,2,4,23,1
15178,28,547,99,48,90,1,3,5,100,0,0,0,0,0,0,0,0,0,0,0,0,2,4,23,1
15179,28,547,8,5,5,2,0,1,10,0,0,0,0,0,0,0,0,0,0,0,0,2,4,23,1
15180,28,547,1217,716,841,84,126,174,1301,14,185,118,215,199,333,1446,2542,8,20687,1149,0,2,4,23,1
15181,28,547,160,89,115,0,13,31,160,7,15,11,17,22,28,78,124,3,495,27,0,2,4,23,1
15182,28,547,10,10,9,9,0,0,19,0,0,0,0,0,0,0,0,0,0,0,0,2,4,23,1
15183,28,547,173,84,99,8,29,36,181,5,12,7,13,17,20,54,81,2,221,12,0,2,4,23,1
15184,28,547,3,1,1,3,0,0,6,0,0,0,0,0,0,0,0,0,0,0,0,2,4,23,1
15185,17,341,95,58,50,9,16,20,104,12,33,24,45,45,69,209,378,8,3100,172,0,0,102,0,1
15186,105,3912,1450,624,1228,12,26,181,1462,14,306,186,354,320,540,2580,4493,8,36391,2021,1,2,106,35,1
15187,28,545,2,2,2,0,0,0,2,0,0,0,0,0,0,0,0,0,0,0,0,2,0,1,0
15188,28,545,99,48,90,1,3,5,100,0,0,0,0,0,0,0,0,0,0,0,0,2,0,1,0
15189,28,545,8,5,5,2,0,1,10,0,0,0,0,0,0,0,0,0,0,0,0,2,0,1,0
15190,28,545,1217,716,841,84,126,174,1301,14,185,118,215,199,333,1446,2542,8,20687,1149,0,2,0,1,0
15191,28,545,160,89,115,0,13,31,160,7,15,11,17,22,28,78,124,3,495,27,0,2,0,1,0
15192,28,545,10,10,9,9,0,0,19,0,0,0,0,0,0,0,0,0,0,0,0,2,0,1,0
15193,28,545,173,84,99,8,29,36,181,5,12,7,13,17,20,54,81,2,221,12,0,2,0,1,0
15194,28,545,3,1,1,3,0,0,6,0,0,0,0,0,0,0,0,0,0,0,0,2,0,1,0
15195,105,3912,1450,624,1228,12,26,181,1462,14,306,186,354,320,540,2580,4493,8,36391,2021,1,2,1,1,0
15196,44,837,207,111,150,11,0,50,218,5,26,19,36,31,55,133,272,3,943,52,0,2,15,1,1
15197,44,837,410,198,237,31,55,97,441,11,63,38,72,74,110,414,683,6,4293,238,0,2,15,1,1
15198,336,6824,1457,730,1242,11,6,188,1468,10,292,166,329,302,495,2424,4078,5,22973,1276,1,2,2,1,1
15199,336,6824,74,35,59,1,0,14,75,3,14,7,14,17,21,58,85,1,128,7,0,2,2,1,1
15200,336,6824,245,125,200,5,7,34,250,7,30,17,34,37,51,166,265,3,1053,58,0,2,2,1,1
15201,35,1824,384,251,317,7,8,52,391,11,70,44,84,81,128,467,811,6,5355,297,0,2,9,3,1
15202,105,3908,1450,624,1228,12,26,181,1462,14,306,186,354,320,540,2580,4493,8,36391,2021,1,2,2,2,0
15203,44,837,207,111,150,11,0,50,218,5,26,19,36,31,55,133,272,3,943,52,0,2,15,1,0
15204,44,837,410,198,237,31,55,97,441,11,63,38,72,74,110,414,683,6,4293,238,0,2,15,1,0
15205,336,6824,1457,730,1242,11,6,188,1468,10,292,166,329,302,495,2424,4078,5,22973,1276,1,2,2,1,0
15206,336,6824,74,35,59,1,0,14,75,3,14,7,14,17,21,58,85,1,128,7,0,2,2,1,0
15207,336,6824,245,125,200,5,7,34,250,7,30,17,34,37,51,166,265,3,1053,58,0,2,2,1,0
15208,35,1824,384,251,317,7,8,52,391,11,70,44,84,81,128,467,811,6,5355,297,0,2,9,3,0
15209,336,6826,1457,730,1242,11,6,188,1468,10,292,166,329,302,495,2424,4078,5,22973,1276,1,2,1,1,1
15210,336,6826,74,35,59,1,0,14,75,3,14,7,14,17,21,58,85,1,128,7,0,2,1,1,1
15211,336,6826,245,125,200,5,7,34,250,7,30,17,34,37,51,166,265,3,1053,58,0,2,1,1,1
15212,40,2349,334,251,279,10,4,40,344,5,127,74,143,132,217,899,1528,2,4303,239,0,2,13,1,1
15213,336,6826,1457,730,1242,11,6,188,1468,10,292,166,329,302,495,2424,4078,5,22973,1276,1,2,1,1,0
15214,336,6826,74,35,59,1,0,14,75,3,14,7,14,17,21,58,85,1,128,7,0,2,1,1,0
15215,336,6826,245,125,200,5,7,34,250,7,30,17,34,37,51,166,265,3,1053,58,0,2,1,1,0
15216,40,2349,334,251,279,10,4,40,344,5,127,74,143,132,217,899,1528,2,4303,239,0,2,13,1,0
15217,161,5059,1660,832,1314,41,38,274,1701,20,312,209,395,332,604,2671,5058,12,64042,3557,1,2,6,1,1
15218,161,5059,1057,646,719,113,100,145,1170,18,215,134,248,233,382,1740,3004,10,31186,1732,1,2,6,1,1
15219,142,3828,1660,832,1314,41,38,274,1701,20,312,209,395,332,604,2671,5058,12,64042,3557,1,2,16,0,1
15220,44,844,207,111,150,11,0,50,218,5,26,19,36,31,55,133,272,3,943,52,0,2,14,0,0
15221,44,844,410,198,237,31,55,97,441,11,63,38,72,74,110,414,683,6,4293,238,0,2,14,0,0
15222,336,6826,1457,730,1242,11,6,188,1468,10,292,166,329,302,495,2424,4078,5,22973,1276,1,2,3,2,0
15223,336,6826,74,35,59,1,0,14,75,3,14,7,14,17,21,58,85,1,128,7,0,2,3,2,0
15224,336,6826,245,125,200,5,7,34,250,7,30,17,34,37,51,166,265,3,1053,58,0,2,3,2,0
15225,24,834,74,35,59,1,0,14,75,3,14,7,14,17,21,58,85,1,128,7,0,2,2,2,0
15226,24,834,245,125,200,5,7,34,250,7,30,17,34,37,51,166,265,3,1053,58,0,2,2,2,0
15227,331,7057,72,33,56,0,4,12,72,1,1,1,1,2,2,0,2,0,1,0,0,2,20,10,0
15228,331,7057,1454,835,1044,76,110,219,1530,17,275,158,296,292,454,2297,3718,9,34017,1889,1,2,20,10,0
15229,78,3291,1289,550,1043,56,32,155,1345,10,167,93,185,177,278,1266,2075,5,11498,638,0,2,1,1,0
15230,93,4223,1338,495,1086,10,64,173,1348,11,122,82,157,133,239,883,1686,7,11934,663,0,2,34,1,0
15231,58,3234,1296,573,1062,40,33,157,1336,8,201,118,231,209,349,1561,2689,4,12365,686,0,2,0,11,0
15232,40,2349,334,251,279,10,4,40,344,5,127,74,143,132,217,899,1528,2,4303,239,0,2,13,1,0
15233,35,1824,384,251,317,7,8,52,391,11,70,44,84,81,128,467,811,6,5355,297,0,2,9,3,0
15234,68,2926,1178,367,1042,6,15,115,1184,9,94,51,95,103,146,644,976,4,4439,246,0,2,1,1,0
15235,71,3611,1943,715,1694,26,18,214,1969,12,185,120,237,197,357,1436,2721,7,20915,1161,0,2,1,1,0
15236,332,7078,72,33,56,0,4,12,72,1,1,1,1,2,2,0,2,0,1,0,0,2,13,9,1
15237,332,7078,1454,835,1044,76,110,219,1530,17,275,158,296,292,454,2297,3718,9,34017,1889,1,2,13,9,1
15238,41,951,386,256,301,16,9,68,402,4,59,35,69,63,104,355,621,2,1453,80,0,2,6,1,1
15239,41,951,264,131,164,11,41,46,275,6,38,22,40,44,62,214,338,3,1068,59,0,2,6,1,1
15240,29,1414,1293,570,1093,25,15,163,1318,10,195,123,241,205,364,1516,2795,6,17273,959,0,2,16,24,0
15241,29,1416,1293,570,1093,25,15,163,1318,10,195,123,241,205,364,1516,2795,6,17273,959,0,2,2,2,0
15242,222,4970,722,423,573,19,0,135,741,12,172,101,199,184,300,1320,2257,6,15668,870,0,2,0,2,1
15243,222,4970,1508,847,911,44,250,301,1552,14,148,88,169,162,257,1120,1886,7,15077,837,0,2,0,2,1
15244,30,1428,1293,570,1093,25,15,163,1318,10,195,123,241,205,364,1516,2795,6,17273,959,0,2,3,0,1
15245,222,4970,722,423,573,19,0,135,741,12,172,101,199,184,300,1320,2257,6,15668,870,0,2,0,2,0
15246,222,4970,1508,847,911,44,250,301,1552,14,148,88,169,162,257,1120,1886,7,15077,837,0,2,0,2,0
15247,30,1428,1293,570,1093,25,15,163,1318,10,195,123,241,205,364,1516,2795,6,17273,959,0,2,21,26,0
15248,9,360,601,196,481,2,23,85,603,8,63,36,72,71,108,400,664,4,3036,168,0,2,68,0,1
15249,9,360,601,196,481,2,23,85,603,8,63,36,72,71,108,400,664,4,3036,168,0,2,68,0,0
15250,332,7078,72,33,56,0,4,12,72,1,1,1,1,2,2,0,2,0,1,0,0,2,13,9,0
15251,332,7078,1454,835,1044,76,110,219,1530,17,275,158,296,292,454,2297,3718,9,34017,1889,1,2,13,9,0
15252,41,951,386,256,301,16,9,68,402,4,59,35,69,63,104,355,621,2,1453,80,0,2,6,1,0
15253,41,951,264,131,164,11,41,46,275,6,38,22,40,44,62,214,338,3,1068,59,0,2,6,1,0
15254,161,5059,1660,832,1314,41,38,274,1701,20,312,209,395,332,604,2671,5058,12,64042,3557,1,2,6,1,0
15255,161,5059,1057,646,719,113,100,145,1170,18,215,134,248,233,382,1740,3004,10,31186,1732,1,2,6,1,0
15256,142,3828,1660,832,1314,41,38,274,1701,20,312,209,395,332,604,2671,5058,12,64042,3557,1,2,16,0,0
15257,119,2402,1513,682,1277,25,13,200,1538,11,199,116,219,210,335,1557,2584,6,15641,868,0,2,3,1,0
15258,119,2402,819,519,539,24,98,155,843,15,96,57,106,111,163,690,1107,8,9171,509,0,2,3,1,0
15259,40,922,386,256,301,16,9,68,402,4,59,35,69,63,104,355,621,2,1453,80,0,2,5,10,0
15260,40,922,264,131,164,11,41,46,275,6,38,22,40,44,62,214,338,3,1068,59,0,2,5,10,0
15261,29,1224,386,256,301,16,9,68,402,4,59,35,69,63,104,355,621,2,1453,80,0,2,3,0,0
15262,184,3741,1943,715,1694,26,18,214,1969,12,185,120,237,197,357,1436,2721,7,20915,1161,0,2,12,0,1
15263,184,3741,1168,838,957,57,25,144,1225,19,348,224,416,367,640,3018,5452,11,61921,3440,1,2,12,0,1
15264,72,3658,1943,715,1694,26,18,214,1969,12,185,120,237,197,357,1436,2721,7,20915,1161,0,2,25,0,1
15265,184,3741,1943,715,1694,26,18,214,1969,12,185,120,237,197,357,1436,2721,7,20915,1161,0,2,12,0,0
15266,184,3741,1168,838,957,57,25,144,1225,19,348,224,416,367,640,3018,5452,11,61921,3440,1,2,12,0,0
15267,72,3658,1943,715,1694,26,18,214,1969,12,185,120,237,197,357,1436,2721,7,20915,1161,0,2,25,0,0
15268,40,922,386,256,301,16,9,68,402,4,59,35,69,63,104,355,621,2,1453,80,0,2,5,10,0
15269,40,922,264,131,164,11,41,46,275,6,38,22,40,44,62,214,338,3,1068,59,0,2,5,10,0
15270,29,1224,386,256,301,16,9,68,402,4,59,35,69,63,104,355,621,2,1453,80,0,2,3,0,0
15271,71,2092,1523,757,1297,19,12,193,1542,12,193,117,230,205,347,1508,2664,7,19053,1058,0,2,5,1,1
15272,71,2092,701,378,504,33,58,109,734,13,110,68,126,123,194,794,1346,7,10027,557,0,2,5,1,1
15273,79,3954,1523,757,1297,19,12,193,1542,12,193,117,230,205,347,1508,2664,7,19053,1058,0,2,24,0,1
15274,71,2092,1523,757,1297,19,12,193,1542,12,193,117,230,205,347,1508,2664,7,19053,1058,0,2,5,1,0
15275,71,2092,701,378,504,33,58,109,734,13,110,68,126,123,194,794,1346,7,10027,557,0,2,5,1,0
15276,79,3954,1523,757,1297,19,12,193,1542,12,193,117,230,205,347,1508,2664,7,19053,1058,0,2,24,0,0
15277,210,4482,182,127,129,0,0,53,182,5,39,21,42,44,63,217,343,2,926,51,0,2,11,4,1
15278,210,4482,1165,710,800,67,119,181,1232,18,243,153,282,261,435,2000,3492,10,36473,2026,1,2,11,4,1
15279,137,6580,1392,870,1177,35,17,170,1427,14,494,280,531,508,811,4473,7289,7,54850,3047,2,2,44,0,1
15280,92,3384,1450,624,1228,12,26,181,1462,14,306,186,354,320,540,2580,4493,8,36391,2021,1,2,31,0,1
15281,210,4482,182,127,129,0,0,53,182,5,39,21,42,44,63,217,343,2,926,51,0,2,11,4,0
15282,210,4482,1165,710,800,67,119,181,1232,18,243,153,282,261,435,2000,3492,10,36473,2026,1,2,11,4,0
15283,137,6580,1392,870,1177,35,17,170,1427,14,494,280,531,508,811,4473,7289,7,54850,3047,2,2,44,0,0
15284,92,3384,1450,624,1228,12,26,181,1462,14,306,186,354,320,540,2580,4493,8,36391,2021,1,2,31,0,0
15285,55,1122,1098,241,925,5,10,155,1103,7,46,25,49,53,74,273,423,3,1580,87,0,2,3,0,1
15286,55,1122,282,202,222,14,2,44,296,8,42,24,43,50,67,250,378,4,1548,86,0,2,3,0,1
15287,48,1773,1098,241,925,5,10,155,1103,7,46,25,49,53,74,273,423,3,1580,87,0,2,23,0,1
15288,55,1122,1098,241,925,5,10,155,1103,7,46,25,49,53,74,273,423,3,1580,87,0,2,3,0,0
15289,55,1122,282,202,222,14,2,44,296,8,42,24,43,50,67,250,378,4,1548,86,0,2,3,0,0
15290,48,1773,1098,241,925,5,10,155,1103,7,46,25,49,53,74,273,423,3,1580,87,0,2,23,0,0
15291,211,4499,182,127,129,0,0,53,182,5,39,21,42,44,63,217,343,2,926,51,0,2,3,2,1
15292,211,4499,1165,710,800,67,119,181,1232,18,243,153,282,261,435,2000,3492,10,36473,2026,1,2,3,2,1
15293,19,443,256,139,192,9,7,47,265,4,23,12,24,27,36,112,171,2,357,19,0,2,18,0,0
15294,334,7098,72,33,56,0,4,12,72,1,1,1,1,2,2,0,2,0,1,0,0,2,5,1,1
15295,334,7098,1454,835,1044,76,110,219,1530,17,275,158,296,292,454,2297,3718,9,34017,1889,1,2,5,1,1
15296,20,468,256,139,192,9,7,47,265,4,23,12,24,27,36,112,171,2,357,19,0,2,17,5,1
15297,211,4499,182,127,129,0,0,53,182,5,39,21,42,44,63,217,343,2,926,51,0,2,3,2,0
15298,211,4499,1165,710,800,67,119,181,1232,18,243,153,282,261,435,2000,3492,10,36473,2026,1,2,3,2,0
15299,334,7098,72,33,56,0,4,12,72,1,1,1,1,2,2,0,2,0,1,0,0,2,5,1,0
15300,334,7098,1454,835,1044,76,110,219,1530,17,275,158,296,292,454,2297,3718,9,34017,1889,1,2,5,1,0
15301,20,468,256,139,192,9,7,47,265,4,23,12,24,27,36,112,171,2,357,19,0,2,30,0,0
15302,14,474,42,7,35,4,0,5,46,1,2,1,2,3,3,2,4,0,2,0,0,2,1,0,0
15303,14,474,11,6,10,0,0,1,11,2,4,2,4,6,6,10,15,1,15,0,0,2,1,0,0
15304,14,474,42,7,35,4,0,5,46,1,2,1,2,3,3,2,4,0,2,0,0,2,1,0,0
15305,14,474,11,6,10,0,0,1,11,2,4,2,4,6,6,10,15,1,15,0,0,2,1,0,0
15306,211,4499,182,127,129,0,0,53,182,5,39,21,42,44,63,217,343,2,926,51,0,2,14,6,0
15307,211,4499,1165,710,800,67,119,181,1232,18,243,153,282,261,435,2000,3492,10,36473,2026,1,2,14,6,0
15308,161,5059,1660,832,1314,41,38,274,1701,20,312,209,395,332,604,2671,5058,12,64042,3557,1,2,6,1,0
15309,161,5059,1057,646,719,113,100,145,1170,18,215,134,248,233,382,1740,3004,10,31186,1732,1,2,6,1,0
15310,72,2108,1523,757,1297,19,12,193,1542,12,193,117,230,205,347,1508,2664,7,19053,1058,0,2,5,1,0
15311,72,2108,701,378,504,33,58,109,734,13,110,68,126,123,194,794,1346,7,10027,557,0,2,5,1,0
15312,223,5005,722,423,573,19,0,135,741,12,172,101,199,184,300,1320,2257,6,15668,870,0,2,0,2,0
15313,223,5005,1508,847,911,44,250,301,1552,14,148,88,169,162,257,1120,1886,7,15077,837,0,2,0,2,0
15314,333,7077,72,33,56,0,4,12,72,1,1,1,1,2,2,0,2,0,1,0,0,2,18,10,0
15315,333,7077,1454,835,1044,76,110,219,1530,17,275,158,296,292,454,2297,3718,9,34017,1889,1,2,18,10,0
15316,40,922,386,256,301,16,9,68,402,4,59,35,69,63,104,355,621,2,1453,80,0,2,6,1,0
15317,40,922,264,131,164,11,41,46,275,6,38,22,40,44,62,214,338,3,1068,59,0,2,6,1,0
15318,184,3741,1943,715,1694,26,18,214,1969,12,185,120,237,197,357,1436,2721,7,20915,1161,0,2,12,0,0
15319,184,3741,1168,838,957,57,25,144,1225,19,348,224,416,367,640,3018,5452,11,61921,3440,1,2,12,0,0
15320,55,1122,1098,241,925,5,10,155,1103,7,46,25,49,53,74,273,423,3,1580,87,0,2,3,0,0
15321,55,1122,282,202,222,14,2,44,296,8,42,24,43,50,67,250,378,4,1548,86,0,2,3,0,0
15322,14,474,42,7,35,4,0,5,46,1,2,1,2,3,3,2,4,0,2,0,0,2,1,0,0
15323,14,474,11,6,10,0,0,1,11,2,4,2,4,6,6,10,15,1,15,0,0,2,1,0,0
15324,137,6580,1392,870,1177,35,17,170,1427,14,494,280,531,508,811,4473,7289,7,54850,3047,2,2,44,0,0
15325,19,446,256,139,192,9,7,47,265,4,23,12,24,27,36,112,171,2,357,19,0,2,30,0,0
15326,93,3451,1450,624,1228,12,26,181,1462,14,306,186,354,320,540,2580,4493,8,36391,2021,1,2,31,0,0
15327,142,3828,1660,832,1314,41,38,274,1701,20,312,209,395,332,604,2671,5058,12,64042,3557,1,2,16,0,0
15328,80,4077,1523,757,1297,19,12,193,1542,12,193,117,230,205,347,1508,2664,7,19053,1058,0,2,24,0,0
15329,34,1559,1293,570,1093,25,15,163,1318,10,195,123,241,205,364,1516,2795,6,17273,959,0,2,21,26,0
15330,72,3658,1943,715,1694,26,18,214,1969,12,185,120,237,197,357,1436,2721,7,20915,1161,0,2,25,0,0
15331,48,1773,1098,241,925,5,10,155,1103,7,46,25,49,53,74,273,423,3,1580,87,0,2,23,0,0
15332,211,4499,182,127,129,0,0,53,182,5,39,21,42,44,63,217,343,2,926,51,0,2,14,6,0
15333,211,4499,1165,710,800,67,119,181,1232,18,243,153,282,261,435,2000,3492,10,36473,2026,1,2,14,6,0
15334,161,5059,1660,832,1314,41,38,274,1701,20,312,209,395,332,604,2671,5058,12,64042,3557,1,2,6,1,0
15335,161,5059,1057,646,719,113,100,145,1170,18,215,134,248,233,382,1740,3004,10,31186,1732,1,2,6,1,0
15336,72,2108,1523,757,1297,19,12,193,1542,12,193,117,230,205,347,1508,2664,7,19053,1058,0,2,5,1,0
15337,72,2108,701,378,504,33,58,109,734,13,110,68,126,123,194,794,1346,7,10027,557,0,2,5,1,0
15338,223,5005,722,423,573,19,0,135,741,12,172,101,199,184,300,1320,2257,6,15668,870,0,2,0,2,0
15339,223,5005,1508,847,911,44,250,301,1552,14,148,88,169,162,257,1120,1886,7,15077,837,0,2,0,2,0
15340,333,7077,72,33,56,0,4,12,72,1,1,1,1,2,2,0,2,0,1,0,0,2,18,10,0
15341,333,7077,1454,835,1044,76,110,219,1530,17,275,158,296,292,454,2297,3718,9,34017,1889,1,2,18,10,0
15342,40,922,386,256,301,16,9,68,402,4,59,35,69,63,104,355,621,2,1453,80,0,2,6,1,0
15343,40,922,264,131,164,11,41,46,275,6,38,22,40,44,62,214,338,3,1068,59,0,2,6,1,0
15344,184,3741,1943,715,1694,26,18,214,1969,12,185,120,237,197,357,1436,2721,7,20915,1161,0,2,12,0,0
15345,184,3741,1168,838,957,57,25,144,1225,19,348,224,416,367,640,3018,5452,11,61921,3440,1,2,12,0,0
15346,55,1122,1098,241,925,5,10,155,1103,7,46,25,49,53,74,273,423,3,1580,87,0,2,3,0,0
15347,55,1122,282,202,222,14,2,44,296,8,42,24,43,50,67,250,378,4,1548,86,0,2,3,0,0
15348,14,474,42,7,35,4,0,5,46,1,2,1,2,3,3,2,4,0,2,0,0,2,1,0,0
15349,14,474,11,6,10,0,0,1,11,2,4,2,4,6,6,10,15,1,15,0,0,2,1,0,0
15350,137,6580,1392,870,1177,35,17,170,1427,14,494,280,531,508,811,4473,7289,7,54850,3047,2,2,44,0,0
15351,19,446,256,139,192,9,7,47,265,4,23,12,24,27,36,112,171,2,357,19,0,2,30,0,0
15352,93,3451,1450,624,1228,12,26,181,1462,14,306,186,354,320,540,2580,4493,8,36391,2021,1,2,31,0,0
15353,142,3828,1660,832,1314,41,38,274,1701,20,312,209,395,332,604,2671,5058,12,64042,3557,1,2,16,0,0
15354,80,4077,1523,757,1297,19,12,193,1542,12,193,117,230,205,347,1508,2664,7,19053,1058,0,2,24,0,0
15355,34,1559,1293,570,1093,25,15,163,1318,10,195,123,241,205,364,1516,2795,6,17273,959,0,2,21,26,0
15356,72,3658,1943,715,1694,26,18,214,1969,12,185,120,237,197,357,1436,2721,7,20915,1161,0,2,25,0,0
15357,48,1773,1098,241,925,5,10,155,1103,7,46,25,49,53,74,273,423,3,1580,87,0,2,23,0,0
15358,28,545,2,2,2,0,0,0,2,0,0,0,0,0,0,0,0,0,0,0,0,2,4,24,0
15359,28,545,99,48,90,1,3,5,100,0,0,0,0,0,0,0,0,0,0,0,0,2,4,24,0
15360,28,545,8,5,5,2,0,1,10,0,0,0,0,0,0,0,0,0,0,0,0,2,4,24,0
15361,28,545,1217,716,841,84,126,174,1301,14,185,118,215,199,333,1446,2542,8,20687,1149,0,2,4,24,0
15362,28,545,160,89,115,0,13,31,160,7,15,11,17,22,28,78,124,3,495,27,0,2,4,24,0
15363,28,545,10,10,9,9,0,0,19,0,0,0,0,0,0,0,0,0,0,0,0,2,4,24,0
15364,28,545,173,84,99,8,29,36,181,5,12,7,13,17,20,54,81,2,221,12,0,2,4,24,0
15365,28,545,3,1,1,3,0,0,6,0,0,0,0,0,0,0,0,0,0,0,0,2,4,24,0
15366,17,341,95,58,50,9,16,20,104,12,33,24,45,45,69,209,378,8,3100,172,0,0,102,0,0
15367,106,3979,1450,624,1228,12,26,181,1462,14,306,186,354,320,540,2580,4493,8,36391,2021,1,2,106,35,0
15368,162,5072,1660,832,1314,41,38,274,1701,20,312,209,395,332,604,2671,5058,12,64042,3557,1,2,6,1,0
15369,162,5072,1057,646,719,113,100,145,1170,18,215,134,248,233,382,1740,3004,10,31186,1732,1,2,6,1,0
15370,146,3937,1660,832,1314,41,38,274,1701,20,312,209,395,332,604,2671,5058,12,64042,3557,1,2,28,0,0
15371,9,220,19,8,11,5,0,4,24,2,5,3,6,7,9,13,25,1,30,1,0,2,1,0,1
15372,9,220,102,59,69,5,3,24,107,6,22,15,28,28,43,113,206,3,789,43,0,2,1,0,1
15373,9,220,106,40,36,3,49,17,109,8,17,13,23,25,36,93,167,5,904,50,0,2,1,0,1
15374,211,4499,182,127,129,0,0,53,182,5,39,21,42,44,63,217,343,2,926,51,0,2,2,0,1
15375,211,4499,1165,710,800,67,119,181,1232,18,243,153,282,261,435,2000,3492,10,36473,2026,1,2,2,0,1
15376,99,2124,773,419,590,28,0,166,801,10,204,113,217,214,330,1598,2554,5,13587,754,0,2,3,0,1
15377,99,2124,421,273,302,44,34,57,465,17,81,59,107,98,166,583,1098,11,12329,684,0,2,3,0,1
15378,34,625,2,2,2,0,0,0,2,0,0,0,0,0,0,0,0,0,0,0,0,2,2,0,1
15379,34,625,99,48,90,1,3,5,100,0,0,0,0,0,0,0,0,0,0,0,0,2,2,0,1
15380,34,625,8,5,5,2,0,1,10,0,0,0,0,0,0,0,0,0,0,0,0,2,2,0,1
15381,34,625,1217,716,841,84,126,174,1301,14,185,118,215,199,333,1446,2542,8,20687,1149,0,2,2,0,1
15382,34,625,160,89,115,0,13,31,160,7,15,11,17,22,28,78,124,3,495,27,0,2,2,0,1
15383,34,625,10,10,9,9,0,0,19,0,0,0,0,0,0,0,0,0,0,0,0,2,2,0,1
15384,34,625,173,84,99,8,29,36,181,5,12,7,13,17,20,54,81,2,221,12,0,2,2,0,1
15385,34,625,3,1,1,3,0,0,6,0,0,0,0,0,0,0,0,0,0,0,0,2,2,0,1
15386,161,5059,1660,832,1314,41,38,274,1701,20,312,209,395,332,604,2671,5058,12,64042,3557,1,2,1,0,1
15387,161,5059,1057,646,719,113,100,145,1170,18,215,134,248,233,382,1740,3004,10,31186,1732,1,2,1,0,1
15388,119,2397,1513,682,1277,25,13,200,1538,11,199,116,219,210,335,1557,2584,6,15641,868,0,2,1,0,1
15389,119,2397,819,519,539,24,98,155,843,15,96,57,106,111,163,690,1107,8,9171,509,0,2,1,0,1
15390,336,6826,1457,730,1242,11,6,188,1468,10,292,166,329,302,495,2424,4078,5,22973,1276,1,2,6,0,1
15391,336,6826,74,35,59,1,0,14,75,3,14,7,14,17,21,58,85,1,128,7,0,2,6,0,1
15392,336,6826,245,125,200,5,7,34,250,7,30,17,34,37,51,166,265,3,1053,58,0,2,6,0,1
15393,23,680,339,213,244,17,9,65,356,10,42,26,48,52,74,259,421,5,2410,133,0,2,2,0,1
15394,228,5101,4293,999,3693,19,54,507,4312,9,155,88,170,164,258,1156,1898,4,9368,520,0,2,2,0,1
15395,228,5101,1482,859,1002,125,135,219,1607,16,219,134,251,235,385,1766,3032,9,27804,1544,1,2,2,0,1
15396,24,834,74,35,59,1,0,14,75,3,14,7,14,17,21,58,85,1,128,7,0,2,2,0,1
15397,24,834,245,125,200,5,7,34,250,7,30,17,34,37,51,166,265,3,1053,58,0,2,2,0,1
15398,71,2092,1523,757,1297,19,12,193,1542,12,193,117,230,205,347,1508,2664,7,19053,1058,0,2,1,0,1
15399,71,2092,701,378,504,33,58,109,734,13,110,68,126,123,194,794,1346,7,10027,557,0,2,1,0,1
15400,70,1304,1020,354,843,12,15,144,1032,8,134,77,144,142,221,970,1580,4,6792,377,0,2,2,0,1
15401,17,510,184,100,137,2,15,30,186,6,38,20,39,44,59,214,322,3,991,55,0,2,6,0,1
15402,17,510,103,65,74,8,5,16,111,7,17,9,17,24,26,89,119,3,417,23,0,2,6,0,1
15403,222,4970,722,423,573,19,0,135,741,12,172,101,199,184,300,1320,2257,6,15668,870,0,2,8,0,1
15404,222,4970,1508,847,911,44,250,301,1552,14,148,88,169,162,257,1120,1886,7,15077,837,0,2,8,0,1
15405,334,7098,72,33,56,0,4,12,72,1,1,1,1,2,2,0,2,0,1,0,0,2,3,0,1
15406,334,7098,1454,835,1044,76,110,219,1530,17,275,158,296,292,454,2297,3718,9,34017,1889,1,2,3,0,1
15407,128,2805,1043,504,840,53,9,147,1096,9,180,112,198,189,310,1377,2344,4,11604,644,0,2,7,0,1
15408,128,2805,383,288,292,26,6,62,409,11,65,38,67,76,105,429,656,5,3719,206,0,2,7,0,1
15409,103,1969,1178,367,1042,6,15,115,1184,9,94,51,95,103,146,644,976,4,4439,246,0,2,4,0,1
15410,103,1969,177,108,140,8,0,27,185,6,30,16,32,36,48,162,248,3,794,44,0,2,4,0,1
15411,16,468,442,244,305,14,16,103,456,11,68,45,75,79,120,452,756,6,4588,254,0,2,1,0,1
15412,16,468,182,102,99,11,40,35,193,3,11,6,11,14,17,42,64,1,97,5,0,2,1,0,1
15413,55,1122,1098,241,925,5,10,155,1103,7,46,25,49,53,74,273,423,3,1580,87,0,2,2,0,1
15414,55,1122,282,202,222,14,2,44,296,8,42,24,43,50,67,250,378,4,1548,86,0,2,2,0,1
15415,34,980,182,127,129,0,0,53,182,5,39,21,42,44,63,217,343,2,926,51,0,2,5,0,1
15416,137,6580,1392,870,1177,35,17,170,1427,14,494,280,531,508,811,4473,7289,7,54850,3047,2,2,21,2,1
15417,93,4223,1338,495,1086,10,64,173,1348,11,122,82,157,133,239,883,1686,7,11934,663,0,2,6,0,1
15418,147,6715,139,89,101,2,0,35,141,7,54,34,62,61,96,330,569,4,2287,127,0,2,10,0,1
15419,147,6715,7,5,5,0,0,2,7,1,2,1,2,3,3,2,4,0,2,0,0,2,10,0,1
15420,32,933,465,148,393,5,8,60,470,4,31,20,31,35,51,161,261,2,523,29,0,2,10,0,1
15421,32,933,16,12,9,0,0,6,16,1,2,1,2,3,3,2,4,0,2,0,0,2,10,0,1
15422,106,5313,1782,648,1425,9,47,279,1791,8,171,97,189,179,286,1292,2140,4,9462,525,0,2,12,0,1
15423,92,3384,1450,624,1228,12,26,181,1462,14,306,186,354,320,540,2580,4493,8,36391,2021,1,2,3,0,1
15424,142,3828,1660,832,1314,41,38,274,1701,20,312,209,395,332,604,2671,5058,12,64042,3557,1,2,97,0,1
15425,58,3234,1296,573,1062,40,33,157,1336,8,201,118,231,209,349,1561,2689,4,12365,686,0,2,5,0,1
15426,72,3657,1457,730,1242,11,6,188,1468,10,292,166,329,302,495,2424,4078,5,22973,1276,1,2,25,0,1
15427,37,2210,652,304,544,16,6,88,668,6,89,51,101,95,152,591,998,3,3399,188,0,2,2,0,1
15428,66,2745,1020,354,843,12,15,144,1032,8,134,77,144,142,221,970,1580,4,6792,377,0,2,20,1,1
15429,21,647,424,94,331,4,0,89,428,1,5,5,5,6,10,11,25,0,12,0,0,2,4,0,1
15430,40,2349,334,251,279,10,4,40,344,5,127,74,143,132,217,899,1528,2,4303,239,0,2,4,1,1
15431,12,475,184,100,137,2,15,30,186,6,38,20,39,44,59,214,322,3,991,55,0,2,2,0,1
15432,30,1428,1293,570,1093,25,15,163,1318,10,195,123,241,205,364,1516,2795,6,17273,959,0,2,2,0,1
15433,35,1824,384,251,317,7,8,52,391,11,70,44,84,81,128,467,811,6,5355,297,0,2,4,0,1
15434,14,581,722,423,573,19,0,135,741,12,172,101,199,184,300,1320,2257,6,15668,870,0,2,4,0,1
15435,69,2837,1043,504,840,53,9,147,1096,9,180,112,198,189,310,1377,2344,4,11604,644,0,2,10,0,1
15436,137,6580,1392,870,1177,35,17,170,1427,14,494,280,531,508,811,4473,7289,7,54850,3047,2,2,1,1,0
15437,16,476,2,2,2,0,0,0,2,0,0,0,0,0,0,0,0,0,0,0,0,0,83,0,0
15438,16,476,99,48,90,1,3,5,100,0,0,0,0,0,0,0,0,0,0,0,0,0,83,0,0
15439,16,476,8,5,5,2,0,1,10,0,0,0,0,0,0,0,0,0,0,0,0,0,83,0,0
15440,16,476,1217,716,841,84,126,174,1301,14,185,118,215,199,333,1446,2542,8,20687,1149,0,0,83,0,0
15441,16,476,160,89,115,0,13,31,160,7,15,11,17,22,28,78,124,3,495,27,0,0,83,0,0
15442,16,476,10,10,9,9,0,0,19,0,0,0,0,0,0,0,0,0,0,0,0,0,83,0,0
15443,16,476,173,84,99,8,29,36,181,5,12,7,13,17,20,54,81,2,221,12,0,0,83,0,0
15444,16,476,3,1,1,3,0,0,6,0,0,0,0,0,0,0,0,0,0,0,0,0,83,0,0
15445,9,360,601,196,481,2,23,85,603,8,63,36,72,71,108,400,664,4,3036,168,0,0,95,0,0
15446,336,6826,1457,730,1242,11,6,188,1468,10,292,166,329,302,495,2424,4078,5,22973,1276,1,2,1,1,1
15447,336,6826,74,35,59,1,0,14,75,3,14,7,14,17,21,58,85,1,128,7,0,2,1,1,1
15448,336,6826,245,125,200,5,7,34,250,7,30,17,34,37,51,166,265,3,1053,58,0,2,1,1,1
15449,8,213,601,196,481,2,23,85,603,8,63,36,72,71,108,400,664,4,3036,168,0,0,60,0,1
15450,336,6826,1457,730,1242,11,6,188,1468,10,292,166,329,302,495,2424,4078,5,22973,1276,1,2,1,1,0
15451,336,6826,74,35,59,1,0,14,75,3,14,7,14,17,21,58,85,1,128,7,0,2,1,1,0
15452,336,6826,245,125,200,5,7,34,250,7,30,17,34,37,51,166,265,3,1053,58,0,2,1,1,0
15453,336,6826,1457,730,1242,11,6,188,1468,10,292,166,329,302,495,2424,4078,5,22973,1276,1,2,1,1,0
15454,336,6826,74,35,59,1,0,14,75,3,14,7,14,17,21,58,85,1,128,7,0,2,1,1,0
15455,336,6826,245,125,200,5,7,34,250,7,30,17,34,37,51,166,265,3,1053,58,0,2,1,1,0
15456,9,220,19,8,11,5,0,4,24,2,5,3,6,7,9,13,25,1,30,1,0,2,1,0,0
15457,9,220,102,59,69,5,3,24,107,6,22,15,28,28,43,113,206,3,789,43,0,2,1,0,0
15458,9,220,106,40,36,3,49,17,109,8,17,13,23,25,36,93,167,5,904,50,0,2,1,0,0
15459,211,4499,182,127,129,0,0,53,182,5,39,21,42,44,63,217,343,2,926,51,0,2,2,0,0
15460,211,4499,1165,710,800,67,119,181,1232,18,243,153,282,261,435,2000,3492,10,36473,2026,1,2,2,0,0
15461,99,2124,773,419,590,28,0,166,801,10,204,113,217,214,330,1598,2554,5,13587,754,0,2,3,0,0
15462,99,2124,421,273,302,44,34,57,465,17,81,59,107,98,166,583,1098,11,12329,684,0,2,3,0,0
15463,34,625,2,2,2,0,0,0,2,0,0,0,0,0,0,0,0,0,0,0,0,2,2,0,0
15464,34,625,99,48,90,1,3,5,100,0,0,0,0,0,0,0,0,0,0,0,0,2,2,0,0
15465,34,625,8,5,5,2,0,1,10,0,0,0,0,0,0,0,0,0,0,0,0,2,2,0,0
15466,34,625,1217,716,841,84,126,174,1301,14,185,118,215,199,333,1446,2542,8,20687,1149,0,2,2,0,0
15467,34,625,160,89,115,0,13,31,160,7,15,11,17,22,28,78,124,3,495,27,0,2,2,0,0
15468,34,625,10,10,9,9,0,0,19,0,0,0,0,0,0,0,0,0,0,0,0,2,2,0,0
15469,34,625,173,84,99,8,29,36,181,5,12,7,13,17,20,54,81,2,221,12,0,2,2,0,0
15470,34,625,3,1,1,3,0,0,6,0,0,0,0,0,0,0,0,0,0,0,0,2,2,0,0
15471,161,5059,1660,832,1314,41,38,274,1701,20,312,209,395,332,604,2671,5058,12,64042,3557,1,2,1,0,0
15472,161,5059,1057,646,719,113,100,145,1170,18,215,134,248,233,382,1740,3004,10,31186,1732,1,2,1,0,0
15473,119,2397,1513,682,1277,25,13,200,1538,11,199,116,219,210,335,1557,2584,6,15641,868,0,2,1,0,0
15474,119,2397,819,519,539,24,98,155,843,15,96,57,106,111,163,690,1107,8,9171,509,0,2,1,0,0
15475,336,6826,1457,730,1242,11,6,188,1468,10,292,166,329,302,495,2424,4078,5,22973,1276,1,2,6,0,0
15476,336,6826,74,35,59,1,0,14,75,3,14,7,14,17,21,58,85,1,128,7,0,2,6,0,0
15477,336,6826,245,125,200,5,7,34,250,7,30,17,34,37,51,166,265,3,1053,58,0,2,6,0,0
15478,23,680,339,213,244,17,9,65,356,10,42,26,48,52,74,259,421,5,2410,133,0,2,2,0,0
15479,228,5101,4293,999,3693,19,54,507,4312,9,155,88,170,164,258,1156,1898,4,9368,520,0,2,2,0,0
15480,228,5101,1482,859,1002,125,135,219,1607,16,219,134,251,235,385,1766,3032,9,27804,1544,1,2,2,0,0
15481,24,834,74,35,59,1,0,14,75,3,14,7,14,17,21,58,85,1,128,7,0,2,2,0,0
15482,24,834,245,125,200,5,7,34,250,7,30,17,34,37,51,166,265,3,1053,58,0,2,2,0,0
15483,71,2092,1523,757,1297,19,12,193,1542,12,193,117,230,205,347,1508,2664,7,19053,1058,0,2,1,0,0
15484,71,2092,701,378,504,33,58,109,734,13,110,68,126,123,194,794,1346,7,10027,557,0,2,1,0,0
15485,70,1304,1020,354,843,12,15,144,1032,8,134,77,144,142,221,970,1580,4,6792,377,0,2,2,0,0
15486,17,510,184,100,137,2,15,30,186,6,38,20,39,44,59,214,322,3,991,55,0,2,6,0,0
15487,17,510,103,65,74,8,5,16,111,7,17,9,17,24,26,89,119,3,417,23,0,2,6,0,0
15488,222,4970,722,423,573,19,0,135,741,12,172,101,199,184,300,1320,2257,6,15668,870,0,2,8,0,0
15489,222,4970,1508,847,911,44,250,301,1552,14,148,88,169,162,257,1120,1886,7,15077,837,0,2,8,0,0
15490,334,7098,72,33,56,0,4,12,72,1,1,1,1,2,2,0,2,0,1,0,0,2,3,0,0
15491,334,7098,1454,835,1044,76,110,219,1530,17,275,158,296,292,454,2297,3718,9,34017,1889,1,2,3,0,0
15492,128,2805,1043,504,840,53,9,147,1096,9,180,112,198,189,310,1377,2344,4,11604,644,0,2,7,0,0
15493,128,2805,383,288,292,26,6,62,409,11,65,38,67,76,105,429,656,5,3719,206,0,2,7,0,0
15494,103,1969,1178,367,1042,6,15,115,1184,9,94,51,95,103,146,644,976,4,4439,246,0,2,4,0,0
15495,103,1969,177,108,140,8,0,27,185,6,30,16,32,36,48,162,248,3,794,44,0,2,4,0,0
15496,16,468,442,244,305,14,16,103,456,11,68,45,75,79,120,452,756,6,4588,254,0,2,1,0,0
15497,16,468,182,102,99,11,40,35,193,3,11,6,11,14,17,42,64,1,97,5,0,2,1,0,0
15498,55,1122,1098,241,925,5,10,155,1103,7,46,25,49,53,74,273,423,3,1580,87,0,2,2,0,0
15499,55,1122,282,202,222,14,2,44,296,8,42,24,43,50,67,250,378,4,1548,86,0,2,2,0,0
15500,34,980,182,127,129,0,0,53,182,5,39,21,42,44,63,217,343,2,926,51,0,2,5,0,0
15501,137,6580,1392,870,1177,35,17,170,1427,14,494,280,531,508,811,4473,7289,7,54850,3047,2,2,22,3,0
15502,93,4223,1338,495,1086,10,64,173,1348,11,122,82,157,133,239,883,1686,7,11934,663,0,2,6,0,0
15503,147,6715,139,89,101,2,0,35,141,7,54,34,62,61,96,330,569,4,2287,127,0,2,10,0,0
15504,147,6715,7,5,5,0,0,2,7,1,2,1,2,3,3,2,4,0,2,0,0,2,10,0,0
15505,32,933,465,148,393,5,8,60,470,4,31,20,31,35,51,161,261,2,523,29,0,2,10,0,0
15506,32,933,16,12,9,0,0,6,16,1,2,1,2,3,3,2,4,0,2,0,0,2,10,0,0
15507,106,5313,1782,648,1425,9,47,279,1791,8,171,97,189,179,286,1292,2140,4,9462,525,0,2,12,0,0
15508,92,3384,1450,624,1228,12,26,181,1462,14,306,186,354,320,540,2580,4493,8,36391,2021,1,2,3,0,0
15509,142,3828,1660,832,1314,41,38,274,1701,20,312,209,395,332,604,2671,5058,12,64042,3557,1,2,97,0,0
15510,58,3234,1296,573,1062,40,33,157,1336,8,201,118,231,209,349,1561,2689,4,12365,686,0,2,5,0,0
15511,72,3657,1457,730,1242,11,6,188,1468,10,292,166,329,302,495,2424,4078,5,22973,1276,1,2,25,0,0
15512,37,2210,652,304,544,16,6,88,668,6,89,51,101,95,152,591,998,3,3399,188,0,2,2,0,0
15513,66,2745,1020,354,843,12,15,144,1032,8,134,77,144,142,221,970,1580,4,6792,377,0,2,20,1,0
15514,21,647,424,94,331,4,0,89,428,1,5,5,5,6,10,11,25,0,12,0,0,2,4,0,0
15515,40,2349,334,251,279,10,4,40,344,5,127,74,143,132,217,899,1528,2,4303,239,0,2,4,1,0
15516,12,475,184,100,137,2,15,30,186,6,38,20,39,44,59,214,322,3,991,55,0,2,2,0,0
15517,30,1428,1293,570,1093,25,15,163,1318,10,195,123,241,205,364,1516,2795,6,17273,959,0,2,2,0,0
15518,35,1824,384,251,317,7,8,52,391,11,70,44,84,81,128,467,811,6,5355,297,0,2,4,0,0
15519,14,581,722,423,573,19,0,135,741,12,172,101,199,184,300,1320,2257,6,15668,870,0,2,4,0,0
15520,69,2837,1043,504,840,53,9,147,1096,9,180,112,198,189,310,1377,2344,4,11604,644,0,2,10,0,0
15521,9,220,19,8,11,5,0,4,24,2,5,3,6,7,9,13,25,1,30,1,0,2,1,0,0
15522,9,220,102,59,69,5,3,24,107,6,22,15,28,28,43,113,206,3,789,43,0,2,1,0,0
15523,9,220,106,40,36,3,49,17,109,8,17,13,23,25,36,93,167,5,904,50,0,2,1,0,0
15524,211,4499,182,127,129,0,0,53,182,5,39,21,42,44,63,217,343,2,926,51,0,2,2,0,0
15525,211,4499,1165,710,800,67,119,181,1232,18,243,153,282,261,435,2000,3492,10,36473,2026,1,2,2,0,0
15526,99,2124,773,419,590,28,0,166,801,10,204,113,217,214,330,1598,2554,5,13587,754,0,2,3,0,0
15527,99,2124,421,273,302,44,34,57,465,17,81,59,107,98,166,583,1098,11,12329,684,0,2,3,0,0
15528,28,545,2,2,2,0,0,0,2,0,0,0,0,0,0,0,0,0,0,0,0,2,2,0,0
15529,28,545,99,48,90,1,3,5,100,0,0,0,0,0,0,0,0,0,0,0,0,2,2,0,0
15530,28,545,8,5,5,2,0,1,10,0,0,0,0,0,0,0,0,0,0,0,0,2,2,0,0
15531,28,545,1217,716,841,84,126,174,1301,14,185,118,215,199,333,1446,2542,8,20687,1149,0,2,2,0,0
15532,28,545,160,89,115,0,13,31,160,7,15,11,17,22,28,78,124,3,495,27,0,2,2,0,0
15533,28,545,10,10,9,9,0,0,19,0,0,0,0,0,0,0,0,0,0,0,0,2,2,0,0
15534,28,545,173,84,99,8,29,36,181,5,12,7,13,17,20,54,81,2,221,12,0,2,2,0,0
15535,28,545,3,1,1,3,0,0,6,0,0,0,0,0,0,0,0,0,0,0,0,2,2,0,0
15536,161,5059,1660,832,1314,41,38,274,1701,20,312,209,395,332,604,2671,5058,12,64042,3557,1,2,1,0,0
15537,161,5059,1057,646,719,113,100,145,1170,18,215,134,248,233,382,1740,3004,10,31186,1732,1,2,1,0,0
15538,119,2402,1513,682,1277,25,13,200,1538,11,199,116,219,210,335,1557,2584,6,15641,868,0,2,1,0,0
15539,119,2402,819,519,539,24,98,155,843,15,96,57,106,111,163,690,1107,8,9171,509,0,2,1,0,0
15540,336,6826,1457,730,1242,11,6,188,1468,10,292,166,329,302,495,2424,4078,5,22973,1276,1,2,7,1,0
15541,336,6826,74,35,59,1,0,14,75,3,14,7,14,17,21,58,85,1,128,7,0,2,7,1,0
15542,336,6826,245,125,200,5,7,34,250,7,30,17,34,37,51,166,265,3,1053,58,0,2,7,1,0
15543,22,673,339,213,244,17,9,65,356,10,42,26,48,52,74,259,421,5,2410,133,0,2,2,0,0
15544,228,5101,4293,999,3693,19,54,507,4312,9,155,88,170,164,258,1156,1898,4,9368,520,0,2,2,0,0
15545,228,5101,1482,859,1002,125,135,219,1607,16,219,134,251,235,385,1766,3032,9,27804,1544,1,2,2,0,0
15546,24,834,74,35,59,1,0,14,75,3,14,7,14,17,21,58,85,1,128,7,0,2,2,0,0
15547,24,834,245,125,200,5,7,34,250,7,30,17,34,37,51,166,265,3,1053,58,0,2,2,0,0
15548,72,2108,1523,757,1297,19,12,193,1542,12,193,117,230,205,347,1508,2664,7,19053,1058,0,2,1,0,0
15549,72,2108,701,378,504,33,58,109,734,13,110,68,126,123,194,794,1346,7,10027,557,0,2,1,0,0
15550,69,1347,1020,354,843,12,15,144,1032,8,134,77,144,142,221,970,1580,4,6792,377,0,2,2,0,0
15551,17,510,184,100,137,2,15,30,186,6,38,20,39,44,59,214,322,3,991,55,0,2,6,0,0
15552,17,510,103,65,74,8,5,16,111,7,17,9,17,24,26,89,119,3,417,23,0,2,6,0,0
15553,223,5005,722,423,573,19,0,135,741,12,172,101,199,184,300,1320,2257,6,15668,870,0,2,8,0,0
15554,223,5005,1508,847,911,44,250,301,1552,14,148,88,169,162,257,1120,1886,7,15077,837,0,2,8,0,0
15555,333,7077,72,33,56,0,4,12,72,1,1,1,1,2,2,0,2,0,1,0,0,2,3,0,0
15556,333,7077,1454,835,1044,76,110,219,1530,17,275,158,296,292,454,2297,3718,9,34017,1889,1,2,3,0,0
15557,128,2812,1043,504,840,53,9,147,1096,9,180,112,198,189,310,1377,2344,4,11604,644,0,2,7,0,0
15558,128,2812,383,288,292,26,6,62,409,11,65,38,67,76,105,429,656,5,3719,206,0,2,7,0,0
15559,103,1956,1178,367,1042,6,15,115,1184,9,94,51,95,103,146,644,976,4,4439,246,0,2,4,0,0
15560,103,1956,177,108,140,8,0,27,185,6,30,16,32,36,48,162,248,3,794,44,0,2,4,0,0
15561,16,468,442,244,305,14,16,103,456,11,68,45,75,79,120,452,756,6,4588,254,0,2,1,0,0
15562,16,468,182,102,99,11,40,35,193,3,11,6,11,14,17,42,64,1,97,5,0,2,1,0,0
15563,55,1122,1098,241,925,5,10,155,1103,7,46,25,49,53,74,273,423,3,1580,87,0,2,2,0,0
15564,55,1122,282,202,222,14,2,44,296,8,42,24,43,50,67,250,378,4,1548,86,0,2,2,0,0
15565,34,980,182,127,129,0,0,53,182,5,39,21,42,44,63,217,343,2,926,51,0,2,5,0,0
15566,137,6580,1392,870,1177,35,17,170,1427,14,494,280,531,508,811,4473,7289,7,54850,3047,2,2,22,3,0
15567,93,4223,1338,495,1086,10,64,173,1348,11,122,82,157,133,239,883,1686,7,11934,663,0,2,6,0,0
15568,147,6715,139,89,101,2,0,35,141,7,54,34,62,61,96,330,569,4,2287,127,0,2,10,0,0
15569,147,6715,7,5,5,0,0,2,7,1,2,1,2,3,3,2,4,0,2,0,0,2,10,0,0
15570,32,933,465,148,393,5,8,60,470,4,31,20,31,35,51,161,261,2,523,29,0,2,10,0,0
15571,32,933,16,12,9,0,0,6,16,1,2,1,2,3,3,2,4,0,2,0,0,2,10,0,0
15572,106,5313,1782,648,1425,9,47,279,1791,8,171,97,189,179,286,1292,2140,4,9462,525,0,2,12,0,0
15573,106,3979,1450,624,1228,12,26,181,1462,14,306,186,354,320,540,2580,4493,8,36391,2021,1,2,3,0,0
15574,142,3828,1660,832,1314,41,38,274,1701,20,312,209,395,332,604,2671,5058,12,64042,3557,1,2,97,0,0
15575,58,3234,1296,573,1062,40,33,157,1336,8,201,118,231,209,349,1561,2689,4,12365,686,0,2,5,0,0
15576,72,3657,1457,730,1242,11,6,188,1468,10,292,166,329,302,495,2424,4078,5,22973,1276,1,2,25,0,0
15577,37,2210,652,304,544,16,6,88,668,6,89,51,101,95,152,591,998,3,3399,188,0,2,2,0,0
15578,66,2750,1020,354,843,12,15,144,1032,8,134,77,144,142,221,970,1580,4,6792,377,0,2,20,1,0
15579,21,647,424,94,331,4,0,89,428,1,5,5,5,6,10,11,25,0,12,0,0,2,4,0,0
15580,40,2349,334,251,279,10,4,40,344,5,127,74,143,132,217,899,1528,2,4303,239,0,2,4,1,0
15581,12,475,184,100,137,2,15,30,186,6,38,20,39,44,59,214,322,3,991,55,0,2,2,0,0
15582,34,1559,1293,570,1093,25,15,163,1318,10,195,123,241,205,364,1516,2795,6,17273,959,0,2,2,0,0
15583,35,1824,384,251,317,7,8,52,391,11,70,44,84,81,128,467,811,6,5355,297,0,2,4,0,0
15584,14,581,722,423,573,19,0,135,741,12,172,101,199,184,300,1320,2257,6,15668,870,0,2,4,0,0
15585,69,2837,1043,504,840,53,9,147,1096,9,180,112,198,189,310,1377,2344,4,11604,644,0,2,10,0,0
15586,9,220,19,8,11,5,0,4,24,2,5,3,6,7,9,13,25,1,30,1,0,2,1,0,0
15587,9,220,102,59,69,5,3,24,107,6,22,15,28,28,43,113,206,3,789,43,0,2,1,0,0
15588,9,220,106,40,36,3,49,17,109,8,17,13,23,25,36,93,167,5,904,50,0,2,1,0,0
15589,211,4499,182,127,129,0,0,53,182,5,39,21,42,44,63,217,343,2,926,51,0,2,2,0,0
15590,211,4499,1165,710,800,67,119,181,1232,18,243,153,282,261,435,2000,3492,10,36473,2026,1,2,2,0,0
15591,99,2124,773,419,590,28,0,166,801,10,204,113,217,214,330,1598,2554,5,13587,754,0,2,3,0,0
15592,99,2124,421,273,302,44,34,57,465,17,81,59,107,98,166,583,1098,11,12329,684,0,2,3,0,0
15593,28,545,2,2,2,0,0,0,2,0,0,0,0,0,0,0,0,0,0,0,0,2,2,0,0
15594,28,545,99,48,90,1,3,5,100,0,0,0,0,0,0,0,0,0,0,0,0,2,2,0,0
15595,28,545,8,5,5,2,0,1,10,0,0,0,0,0,0,0,0,0,0,0,0,2,2,0,0
15596,28,545,1217,716,841,84,126,174,1301,14,185,118,215,199,333,1446,2542,8,20687,1149,0,2,2,0,0
15597,28,545,160,89,115,0,13,31,160,7,15,11,17,22,28,78,124,3,495,27,0,2,2,0,0
15598,28,545,10,10,9,9,0,0,19,0,0,0,0,0,0,0,0,0,0,0,0,2,2,0,0
15599,28,545,173,84,99,8,29,36,181,5,12,7,13,17,20,54,81,2,221,12,0,2,2,0,0
15600,28,545,3,1,1,3,0,0,6,0,0,0,0,0,0,0,0,0,0,0,0,2,2,0,0
15601,161,5059,1660,832,1314,41,38,274,1701,20,312,209,395,332,604,2671,5058,12,64042,3557,1,2,1,0,0
15602,161,5059,1057,646,719,113,100,145,1170,18,215,134,248,233,382,1740,3004,10,31186,1732,1,2,1,0,0
15603,119,2402,1513,682,1277,25,13,200,1538,11,199,116,219,210,335,1557,2584,6,15641,868,0,2,1,0,0
15604,119,2402,819,519,539,24,98,155,843,15,96,57,106,111,163,690,1107,8,9171,509,0,2,1,0,0
15605,336,6826,1457,730,1242,11,6,188,1468,10,292,166,329,302,495,2424,4078,5,22973,1276,1,2,7,1,0
15606,336,6826,74,35,59,1,0,14,75,3,14,7,14,17,21,58,85,1,128,7,0,2,7,1,0
15607,336,6826,245,125,200,5,7,34,250,7,30,17,34,37,51,166,265,3,1053,58,0,2,7,1,0
15608,22,673,339,213,244,17,9,65,356,10,42,26,48,52,74,259,421,5,2410,133,0,2,2,0,0
15609,228,5101,4293,999,3693,19,54,507,4312,9,155,88,170,164,258,1156,1898,4,9368,520,0,2,2,0,0
15610,228,5101,1482,859,1002,125,135,219,1607,16,219,134,251,235,385,1766,3032,9,27804,1544,1,2,2,0,0
15611,24,834,74,35,59,1,0,14,75,3,14,7,14,17,21,58,85,1,128,7,0,2,2,0,0
15612,24,834,245,125,200,5,7,34,250,7,30,17,34,37,51,166,265,3,1053,58,0,2,2,0,0
15613,72,2108,1523,757,1297,19,12,193,1542,12,193,117,230,205,347,1508,2664,7,19053,1058,0,2,1,0,0
15614,72,2108,701,378,504,33,58,109,734,13,110,68,126,123,194,794,1346,7,10027,557,0,2,1,0,0
15615,69,1347,1020,354,843,12,15,144,1032,8,134,77,144,142,221,970,1580,4,6792,377,0,2,2,0,0
15616,17,510,184,100,137,2,15,30,186,6,38,20,39,44,59,214,322,3,991,55,0,2,6,0,0
15617,17,510,103,65,74,8,5,16,111,7,17,9,17,24,26,89,119,3,417,23,0,2,6,0,0
15618,223,5005,722,423,573,19,0,135,741,12,172,101,199,184,300,1320,2257,6,15668,870,0,2,8,0,0
15619,223,5005,1508,847,911,44,250,301,1552,14,148,88,169,162,257,1120,1886,7,15077,837,0,2,8,0,0
15620,333,7077,72,33,56,0,4,12,72,1,1,1,1,2,2,0,2,0,1,0,0,2,3,0,0
15621,333,7077,1454,835,1044,76,110,219,1530,17,275,158,296,292,454,2297,3718,9,34017,1889,1,2,3,0,0
15622,128,2812,1043,504,840,53,9,147,1096,9,180,112,198,189,310,1377,2344,4,11604,644,0,2,7,0,0
15623,128,2812,383,288,292,26,6,62,409,11,65,38,67,76,105,429,656,5,3719,206,0,2,7,0,0
15624,103,1956,1178,367,1042,6,15,115,1184,9,94,51,95,103,146,644,976,4,4439,246,0,2,4,0,0
15625,103,1956,177,108,140,8,0,27,185,6,30,16,32,36,48,162,248,3,794,44,0,2,4,0,0
15626,16,468,442,244,305,14,16,103,456,11,68,45,75,79,120,452,756,6,4588,254,0,2,1,0,0
15627,16,468,182,102,99,11,40,35,193,3,11,6,11,14,17,42,64,1,97,5,0,2,1,0,0
15628,55,1122,1098,241,925,5,10,155,1103,7,46,25,49,53,74,273,423,3,1580,87,0,2,2,0,0
15629,55,1122,282,202,222,14,2,44,296,8,42,24,43,50,67,250,378,4,1548,86,0,2,2,0,0
15630,34,980,182,127,129,0,0,53,182,5,39,21,42,44,63,217,343,2,926,51,0,2,5,0,0
15631,137,6580,1392,870,1177,35,17,170,1427,14,494,280,531,508,811,4473,7289,7,54850,3047,2,2,22,3,0
15632,93,4223,1338,495,1086,10,64,173,1348,11,122,82,157,133,239,883,1686,7,11934,663,0,2,6,0,0
15633,147,6715,139,89,101,2,0,35,141,7,54,34,62,61,96,330,569,4,2287,127,0,2,10,0,0
15634,147,6715,7,5,5,0,0,2,7,1,2,1,2,3,3,2,4,0,2,0,0,2,10,0,0
15635,32,933,465,148,393,5,8,60,470,4,31,20,31,35,51,161,261,2,523,29,0,2,10,0,0
15636,32,933,16,12,9,0,0,6,16,1,2,1,2,3,3,2,4,0,2,0,0,2,10,0,0
15637,106,5313,1782,648,1425,9,47,279,1791,8,171,97,189,179,286,1292,2140,4,9462,525,0,2,12,0,0
15638,106,3979,1450,624,1228,12,26,181,1462,14,306,186,354,320,540,2580,4493,8,36391,2021,1,2,3,0,0
15639,142,3828,1660,832,1314,41,38,274,1701,20,312,209,395,332,604,2671,5058,12,64042,3557,1,2,97,0,0
15640,58,3234,1296,573,1062,40,33,157,1336,8,201,118,231,209,349,1561,2689,4,12365,686,0,2,5,0,0
15641,72,3657,1457,730,1242,11,6,188,1468,10,292,166,329,302,495,2424,4078,5,22973,1276,1,2,25,0,0
15642,37,2210,652,304,544,16,6,88,668,6,89,51,101,95,152,591,998,3,3399,188,0,2,2,0,0
15643,66,2750,1020,354,843,12,15,144,1032,8,134,77,144,142,221,970,1580,4,6792,377,0,2,20,1,0
15644,21,647,424,94,331,4,0,89,428,1,5,5,5,6,10,11,25,0,12,0,0,2,4,0,0
15645,40,2349,334,251,279,10,4,40,344,5,127,74,143,132,217,899,1528,2,4303,239,0,2,4,1,0
15646,12,475,184,100,137,2,15,30,186,6,38,20,39,44,59,214,322,3,991,55,0,2,2,0,0
15647,34,1559,1293,570,1093,25,15,163,1318,10,195,123,241,205,364,1516,2795,6,17273,959,0,2,2,0,0
15648,35,1824,384,251,317,7,8,52,391,11,70,44,84,81,128,467,811,6,5355,297,0,2,4,0,0
15649,14,581,722,423,573,19,0,135,741,12,172,101,199,184,300,1320,2257,6,15668,870,0,2,4,0,0
15650,69,2837,1043,504,840,53,9,147,1096,9,180,112,198,189,310,1377,2344,4,11604,644,0,2,10,0,0
15651,162,5072,1660,832,1314,41,38,274,1701,20,312,209,395,332,604,2671,5058,12,64042,3557,1,2,6,1,0
15652,162,5072,1057,646,719,113,100,145,1170,18,215,134,248,233,382,1740,3004,10,31186,1732,1,2,6,1,0
15653,146,3937,1660,832,1314,41,38,274,1701,20,312,209,395,332,604,2671,5058,12,64042,3557,1,2,28,0,0
15654,338,6856,1457,730,1242,11,6,188,1468,10,292,166,329,302,495,2424,4078,5,22973,1276,1,2,5,1,1
15655,338,6856,74,35,59,1,0,14,75,3,14,7,14,17,21,58,85,1,128,7,0,2,5,1,1
15656,338,6856,245,125,200,5,7,34,250,7,30,17,34,37,51,166,265,3,1053,58,0,2,5,1,1
15657,73,3766,1457,730,1242,11,6,188,1468,10,292,166,329,302,495,2424,4078,5,22973,1276,1,2,9,0,1
15658,338,6856,1457,730,1242,11,6,188,1468,10,292,166,329,302,495,2424,4078,5,22973,1276,1,2,5,1,0
15659,338,6856,74,35,59,1,0,14,75,3,14,7,14,17,21,58,85,1,128,7,0,2,5,1,0
15660,338,6856,245,125,200,5,7,34,250,7,30,17,34,37,51,166,265,3,1053,58,0,2,5,1,0
15661,73,3766,1457,730,1242,11,6,188,1468,10,292,166,329,302,495,2424,4078,5,22973,1276,1,2,9,0,0
15662,335,7115,72,33,56,0,4,12,72,1,1,1,1,2,2,0,2,0,1,0,0,2,3,0,1
15663,335,7115,1454,835,1044,76,110,219,1530,17,275,158,296,292,454,2297,3718,9,34017,1889,1,2,3,0,1
15664,43,2321,520,294,400,33,13,81,553,10,261,204,367,271,571,2128,4614,7,32445,1802,1,2,1,0,1
15665,335,7115,72,33,56,0,4,12,72,1,1,1,1,2,2,0,2,0,1,0,0,2,3,0,0
15666,335,7115,1454,835,1044,76,110,219,1530,17,275,158,296,292,454,2297,3718,9,34017,1889,1,2,3,0,0
15667,43,2321,520,294,400,33,13,81,553,10,261,204,367,271,571,2128,4614,7,32445,1802,1,2,1,0,0
15668,179,4156,77,34,69,0,0,8,77,3,24,16,29,27,45,114,213,1,387,21,0,2,2,3,1
15669,179,4156,712,438,573,51,9,84,763,14,102,71,128,116,199,733,1364,8,11988,666,0,2,2,3,1
15670,179,4156,77,34,69,0,0,8,77,3,24,16,29,27,45,114,213,1,387,21,0,2,2,3,0
15671,179,4156,712,438,573,51,9,84,763,14,102,71,128,116,199,733,1364,8,11988,666,0,2,2,3,0
15672,80,3999,1523,757,1297,19,12,193,1542,12,193,117,230,205,347,1508,2664,7,19053,1058,0,2,12,0,0
15673,80,3999,1523,757,1297,19,12,193,1542,12,193,117,230,205,347,1508,2664,7,19053,1058,0,2,12,0,0
15674,179,4170,77,34,69,0,0,8,77,3,24,16,29,27,45,114,213,1,387,21,0,2,3,1,1
15675,179,4170,712,438,573,51,9,84,763,14,102,71,128,116,199,733,1364,8,11988,666,0,2,3,1,1
15676,179,4175,77,34,69,0,0,8,77,3,24,16,29,27,45,114,213,1,387,21,0,2,1,1,1
15677,179,4175,712,438,573,51,9,84,763,14,102,71,128,116,199,733,1364,8,11988,666,0,2,1,1,1
15678,179,4175,77,34,69,0,0,8,77,3,24,16,29,27,45,114,213,1,387,21,0,2,3,1,0
15679,179,4175,712,438,573,51,9,84,763,14,102,71,128,116,199,733,1364,8,11988,666,0,2,3,1,0
15680,162,5072,1660,832,1314,41,38,274,1701,20,312,209,395,332,604,2671,5058,12,64042,3557,1,2,6,1,0
15681,162,5072,1057,646,719,113,100,145,1170,18,215,134,248,233,382,1740,3004,10,31186,1732,1,2,6,1,0
15682,338,6856,1457,730,1242,11,6,188,1468,10,292,166,329,302,495,2424,4078,5,22973,1276,1,2,5,1,0
15683,338,6856,74,35,59,1,0,14,75,3,14,7,14,17,21,58,85,1,128,7,0,2,5,1,0
15684,338,6856,245,125,200,5,7,34,250,7,30,17,34,37,51,166,265,3,1053,58,0,2,5,1,0
15685,178,4154,77,34,69,0,0,8,77,3,24,16,29,27,45,114,213,1,387,21,0,2,5,4,0
15686,178,4154,712,438,573,51,9,84,763,14,102,71,128,116,199,733,1364,8,11988,666,0,2,5,4,0
15687,334,7094,72,33,56,0,4,12,72,1,1,1,1,2,2,0,2,0,1,0,0,2,3,0,0
15688,334,7094,1454,835,1044,76,110,219,1530,17,275,158,296,292,454,2297,3718,9,34017,1889,1,2,3,0,0
15689,43,2321,520,294,400,33,13,81,553,10,261,204,367,271,571,2128,4614,7,32445,1802,1,2,1,0,0
15690,146,3937,1660,832,1314,41,38,274,1701,20,312,209,395,332,604,2671,5058,12,64042,3557,1,2,28,0,0
15691,73,3766,1457,730,1242,11,6,188,1468,10,292,166,329,302,495,2424,4078,5,22973,1276,1,2,9,0,0
15692,81,4122,1523,757,1297,19,12,193,1542,12,193,117,230,205,347,1508,2664,7,19053,1058,0,2,12,0,0
15693,162,5072,1660,832,1314,41,38,274,1701,20,312,209,395,332,604,2671,5058,12,64042,3557,1,2,6,1,0
15694,162,5072,1057,646,719,113,100,145,1170,18,215,134,248,233,382,1740,3004,10,31186,1732,1,2,6,1,0
15695,338,6856,1457,730,1242,11,6,188,1468,10,292,166,329,302,495,2424,4078,5,22973,1276,1,2,5,1,0
15696,338,6856,74,35,59,1,0,14,75,3,14,7,14,17,21,58,85,1,128,7,0,2,5,1,0
15697,338,6856,245,125,200,5,7,34,250,7,30,17,34,37,51,166,265,3,1053,58,0,2,5,1,0
15698,178,4154,77,34,69,0,0,8,77,3,24,16,29,27,45,114,213,1,387,21,0,2,5,4,0
15699,178,4154,712,438,573,51,9,84,763,14,102,71,128,116,199,733,1364,8,11988,666,0,2,5,4,0
15700,334,7094,72,33,56,0,4,12,72,1,1,1,1,2,2,0,2,0,1,0,0,2,3,0,0
15701,334,7094,1454,835,1044,76,110,219,1530,17,275,158,296,292,454,2297,3718,9,34017,1889,1,2,3,0,0
15702,43,2321,520,294,400,33,13,81,553,10,261,204,367,271,571,2128,4614,7,32445,1802,1,2,1,0,0
15703,146,3937,1660,832,1314,41,38,274,1701,20,312,209,395,332,604,2671,5058,12,64042,3557,1,2,28,0,0
15704,73,3766,1457,730,1242,11,6,188,1468,10,292,166,329,302,495,2424,4078,5,22973,1276,1,2,9,0,0
15705,81,4122,1523,757,1297,19,12,193,1542,12,193,117,230,205,347,1508,2664,7,19053,1058,0,2,12,0,0
15706,340,6900,1457,730,1242,11,6,188,1468,10,292,166,329,302,495,2424,4078,5,22973,1276,1,2,23,4,1
15707,340,6900,74,35,59,1,0,14,75,3,14,7,14,17,21,58,85,1,128,7,0,2,23,4,1
15708,340,6900,245,125,200,5,7,34,250,7,30,17,34,37,51,166,265,3,1053,58,0,2,23,4,1
15709,71,2113,1523,757,1297,19,12,193,1542,12,193,117,230,205,347,1508,2664,7,19053,1058,0,2,3,0,1
15710,71,2113,701,378,504,33,58,109,734,13,110,68,126,123,194,794,1346,7,10027,557,0,2,3,0,1
15711,179,4196,77,34,69,0,0,8,77,3,24,16,29,27,45,114,213,1,387,21,0,2,3,1,1
15712,179,4196,712,438,573,51,9,84,763,14,102,71,128,116,199,733,1364,8,11988,666,0,2,3,1,1
15713,81,4024,1523,757,1297,19,12,193,1542,12,193,117,230,205,347,1508,2664,7,19053,1058,0,2,4,0,1
15714,20,400,294,64,250,0,0,43,294,1,20,10,20,21,30,86,131,0,65,3,0,2,2,2,0
15715,20,400,78,46,62,3,0,14,81,3,8,4,8,11,12,28,41,1,62,3,0,2,2,2,0
15716,340,6900,1457,730,1242,11,6,188,1468,10,292,166,329,302,495,2424,4078,5,22973,1276,1,2,23,4,0
15717,340,6900,74,35,59,1,0,14,75,3,14,7,14,17,21,58,85,1,128,7,0,2,23,4,0
15718,340,6900,245,125,200,5,7,34,250,7,30,17,34,37,51,166,265,3,1053,58,0,2,23,4,0
15719,71,2113,1523,757,1297,19,12,193,1542,12,193,117,230,205,347,1508,2664,7,19053,1058,0,2,3,0,0
15720,71,2113,701,378,504,33,58,109,734,13,110,68,126,123,194,794,1346,7,10027,557,0,2,3,0,0
15721,179,4196,77,34,69,0,0,8,77,3,24,16,29,27,45,114,213,1,387,21,0,2,3,1,0
15722,179,4196,712,438,573,51,9,84,763,14,102,71,128,116,199,733,1364,8,11988,666,0,2,3,1,0
15723,81,4024,1523,757,1297,19,12,193,1542,12,193,117,230,205,347,1508,2664,7,19053,1058,0,2,4,0,0
15724,20,400,294,64,250,0,0,43,294,1,20,10,20,21,30,86,131,0,65,3,0,2,2,2,0
15725,20,400,78,46,62,3,0,14,81,3,8,4,8,11,12,28,41,1,62,3,0,2,2,2,0
15726,56,1608,1455,414,1257,16,76,112,1471,5,41,23,46,46,69,231,381,2,1069,59,0,2,5,1,0
15727,56,1608,669,365,481,22,61,110,691,15,103,63,122,118,185,747,1273,8,11311,628,0,2,5,1,0
15728,223,5009,722,423,573,19,0,135,741,12,172,101,199,184,300,1320,2257,6,15668,870,0,2,2,2,1
15729,223,5009,1508,847,911,44,250,301,1552,14,148,88,169,162,257,1120,1886,7,15077,837,0,2,2,2,1
15730,64,2862,1455,414,1257,16,76,112,1471,5,41,23,46,46,69,231,381,2,1069,59,0,2,46,0,1
15731,64,2864,1455,414,1257,16,76,112,1471,5,41,23,46,46,69,231,381,2,1069,59,0,2,6,6,0
15732,56,1599,1455,414,1257,16,76,112,1471,5,41,23,46,46,69,231,381,2,1069,59,0,2,3,6,1
15733,56,1599,669,365,481,22,61,110,691,15,103,63,122,118,185,747,1273,8,11311,628,0,2,3,6,1
15734,62,2825,1455,414,1257,16,76,112,1471,5,41,23,46,46,69,231,381,2,1069,59,0,2,19,38,1
15735,62,2825,1455,414,1257,16,76,112,1471,5,41,23,46,46,69,231,381,2,1069,59,0,2,2,2,0
15736,44,844,207,111,150,11,0,50,218,5,26,19,36,31,55,133,272,3,943,52,0,2,1,1,0
15737,44,844,410,198,237,31,55,97,441,11,63,38,72,74,110,414,683,6,4293,238,0,2,1,1,0
15738,335,7110,72,33,56,0,4,12,72,1,1,1,1,2,2,0,2,0,1,0,0,2,2,0,0
15739,335,7110,1454,835,1044,76,110,219,1530,17,275,158,296,292,454,2297,3718,9,34017,1889,1,2,2,0,0
15740,59,3269,1296,573,1062,40,33,157,1336,8,201,118,231,209,349,1561,2689,4,12365,686,0,2,16,0,0
15741,44,844,207,111,150,11,0,50,218,5,26,19,36,31,55,133,272,3,943,52,0,2,1,1,0
15742,44,844,410,198,237,31,55,97,441,11,63,38,72,74,110,414,683,6,4293,238,0,2,1,1,0
15743,335,7110,72,33,56,0,4,12,72,1,1,1,1,2,2,0,2,0,1,0,0,2,2,0,0
15744,335,7110,1454,835,1044,76,110,219,1530,17,275,158,296,292,454,2297,3718,9,34017,1889,1,2,2,0,0
15745,59,3269,1296,573,1062,40,33,157,1336,8,201,118,231,209,349,1561,2689,4,12365,686,0,2,16,0,0
15746,56,1599,1455,414,1257,16,76,112,1471,5,41,23,46,46,69,231,381,2,1069,59,0,2,3,2,0
15747,56,1599,669,365,481,22,61,110,691,15,103,63,122,118,185,747,1273,8,11311,628,0,2,3,2,0
15748,223,5009,722,423,573,19,0,135,741,12,172,101,199,184,300,1320,2257,6,15668,870,0,2,2,2,0
15749,223,5009,1508,847,911,44,250,301,1552,14,148,88,169,162,257,1120,1886,7,15077,837,0,2,2,2,0
15750,62,2825,1455,414,1257,16,76,112,1471,5,41,23,46,46,69,231,381,2,1069,59,0,2,27,0,0
15751,99,2079,773,419,590,28,0,166,801,10,204,113,217,214,330,1598,2554,5,13587,754,0,2,0,8,0
15752,99,2079,421,273,302,44,34,57,465,17,81,59,107,98,166,583,1098,11,12329,684,0,2,0,8,0
15753,99,2075,773,419,590,28,0,166,801,10,204,113,217,214,330,1598,2554,5,13587,754,0,2,0,1,0
15754,99,2075,421,273,302,44,34,57,465,17,81,59,107,98,166,583,1098,11,12329,684,0,2,0,1,0
15755,99,2075,773,419,590,28,0,166,801,10,204,113,217,214,330,1598,2554,5,13587,754,0,2,0,9,0
15756,99,2075,421,273,302,44,34,57,465,17,81,59,107,98,166,583,1098,11,12329,684,0,2,0,9,0
15757,341,6910,1457,730,1242,11,6,188,1468,10,292,166,329,302,495,2424,4078,5,22973,1276,1,2,4,1,1
15758,341,6910,74,35,59,1,0,14,75,3,14,7,14,17,21,58,85,1,128,7,0,2,4,1,1
15759,341,6910,245,125,200,5,7,34,250,7,30,17,34,37,51,166,265,3,1053,58,0,2,4,1,1
15760,24,834,74,35,59,1,0,14,75,3,14,7,14,17,21,58,85,1,128,7,0,2,1,1,1
15761,24,834,245,125,200,5,7,34,250,7,30,17,34,37,51,166,265,3,1053,58,0,2,1,1,1
15762,74,3802,1457,730,1242,11,6,188,1468,10,292,166,329,302,495,2424,4078,5,22973,1276,1,2,9,1,1
15763,341,6910,1457,730,1242,11,6,188,1468,10,292,166,329,302,495,2424,4078,5,22973,1276,1,2,4,1,0
15764,341,6910,74,35,59,1,0,14,75,3,14,7,14,17,21,58,85,1,128,7,0,2,4,1,0
15765,341,6910,245,125,200,5,7,34,250,7,30,17,34,37,51,166,265,3,1053,58,0,2,4,1,0
15766,24,834,74,35,59,1,0,14,75,3,14,7,14,17,21,58,85,1,128,7,0,2,1,1,0
15767,24,834,245,125,200,5,7,34,250,7,30,17,34,37,51,166,265,3,1053,58,0,2,1,1,0
15768,74,3802,1457,730,1242,11,6,188,1468,10,292,166,329,302,495,2424,4078,5,22973,1276,1,2,9,1,0
15769,162,5067,1660,832,1314,41,38,274,1701,20,312,209,395,332,604,2671,5058,12,64042,3557,1,2,4,5,1
15770,162,5067,1057,646,719,113,100,145,1170,18,215,134,248,233,382,1740,3004,10,31186,1732,1,2,4,5,1
15771,147,4008,1660,832,1314,41,38,274,1701,20,312,209,395,332,604,2671,5058,12,64042,3557,1,2,13,0,1
15772,162,5067,1660,832,1314,41,38,274,1701,20,312,209,395,332,604,2671,5058,12,64042,3557,1,2,4,5,0
15773,162,5067,1057,646,719,113,100,145,1170,18,215,134,248,233,382,1740,3004,10,31186,1732,1,2,4,5,0
15774,147,4008,1660,832,1314,41,38,274,1701,20,312,209,395,332,604,2671,5058,12,64042,3557,1,2,13,0,0
15775,178,4170,77,34,69,0,0,8,77,3,24,16,29,27,45,114,213,1,387,21,0,2,12,18,0
15776,178,4170,712,438,573,51,9,84,763,14,102,71,128,116,199,733,1364,8,11988,666,0,2,12,18,0
15777,222,4979,722,423,573,19,0,135,741,12,172,101,199,184,300,1320,2257,6,15668,870,0,2,1,0,0
15778,222,4979,1508,847,911,44,250,301,1552,14,148,88,169,162,257,1120,1886,7,15077,837,0,2,1,0,0
15779,38,2269,652,304,544,16,6,88,668,6,89,51,101,95,152,591,998,3,3399,188,0,2,25,0,0
15780,36,1940,384,251,317,7,8,52,391,11,70,44,84,81,128,467,811,6,5355,297,0,2,21,1,0
15781,178,4170,77,34,69,0,0,8,77,3,24,16,29,27,45,114,213,1,387,21,0,2,12,18,0
15782,178,4170,712,438,573,51,9,84,763,14,102,71,128,116,199,733,1364,8,11988,666,0,2,12,18,0
15783,222,4979,722,423,573,19,0,135,741,12,172,101,199,184,300,1320,2257,6,15668,870,0,2,1,0,0
15784,222,4979,1508,847,911,44,250,301,1552,14,148,88,169,162,257,1120,1886,7,15077,837,0,2,1,0,0
15785,38,2269,652,304,544,16,6,88,668,6,89,51,101,95,152,591,998,3,3399,188,0,2,25,0,0
15786,36,1940,384,251,317,7,8,52,391,11,70,44,84,81,128,467,811,6,5355,297,0,2,21,1,0
15787,34,625,2,2,2,0,0,0,2,0,0,0,0,0,0,0,0,0,0,0,0,2,1,1,0
15788,34,625,99,48,90,1,3,5,100,0,0,0,0,0,0,0,0,0,0,0,0,2,1,1,0
15789,34,625,8,5,5,2,0,1,10,0,0,0,0,0,0,0,0,0,0,0,0,2,1,1,0
15790,34,625,1217,716,841,84,126,174,1301,14,185,118,215,199,333,1446,2542,8,20687,1149,0,2,1,1,0
15791,34,625,160,89,115,0,13,31,160,7,15,11,17,22,28,78,124,3,495,27,0,2,1,1,0
15792,34,625,10,10,9,9,0,0,19,0,0,0,0,0,0,0,0,0,0,0,0,2,1,1,0
15793,34,625,173,84,99,8,29,36,181,5,12,7,13,17,20,54,81,2,221,12,0,2,1,1,0
15794,34,625,3,1,1,3,0,0,6,0,0,0,0,0,0,0,0,0,0,0,0,2,1,1,0
15795,335,7116,72,33,56,0,4,12,72,1,1,1,1,2,2,0,2,0,1,0,0,2,2,8,1
15796,335,7116,1454,835,1044,76,110,219,1530,17,275,158,296,292,454,2297,3718,9,34017,1889,1,2,2,8,1
15797,47,2495,520,294,400,33,13,81,553,10,261,204,367,271,571,2128,4614,7,32445,1802,1,2,33,8,1
15798,335,7116,72,33,56,0,4,12,72,1,1,1,1,2,2,0,2,0,1,0,0,2,2,8,0
15799,335,7116,1454,835,1044,76,110,219,1530,17,275,158,296,292,454,2297,3718,9,34017,1889,1,2,2,8,0
15800,47,2495,520,294,400,33,13,81,553,10,261,204,367,271,571,2128,4614,7,32445,1802,1,2,33,8,0
15801,179,4222,77,34,69,0,0,8,77,3,24,16,29,27,45,114,213,1,387,21,0,2,30,17,1
15802,179,4222,712,438,573,51,9,84,763,14,102,71,128,116,199,733,1364,8,11988,666,0,2,30,17,1
15803,228,5105,4293,999,3693,19,54,507,4312,9,155,88,170,164,258,1156,1898,4,9368,520,0,2,4,4,1
15804,228,5105,1482,859,1002,125,135,219,1607,16,219,134,251,235,385,1766,3032,9,27804,1544,1,2,4,4,1
15805,149,6801,139,89,101,2,0,35,141,7,54,34,62,61,96,330,569,4,2287,127,0,2,45,0,1
15806,149,6801,7,5,5,0,0,2,7,1,2,1,2,3,3,2,4,0,2,0,0,2,45,0,1
15807,45,853,207,111,150,11,0,50,218,5,26,19,36,31,55,133,272,3,943,52,0,2,10,5,1
15808,45,853,410,198,237,31,55,97,441,11,63,38,72,74,110,414,683,6,4293,238,0,2,10,5,1
15809,3,34,207,111,150,11,0,50,218,5,26,19,36,31,55,133,272,3,943,52,0,0,12,0,1
15810,5,123,207,111,150,11,0,50,218,5,26,19,36,31,55,133,272,3,943,52,0,2,37,0,1
15811,47,867,207,111,150,11,0,50,218,5,26,19,36,31,55,133,272,3,943,52,0,2,11,8,1
15812,47,867,410,198,237,31,55,97,441,11,63,38,72,74,110,414,683,6,4293,238,0,2,11,8,1
15813,5,138,207,111,150,11,0,50,218,5,26,19,36,31,55,133,272,3,943,52,0,2,3,2,1
15814,14,476,42,7,35,4,0,5,46,1,2,1,2,3,3,2,4,0,2,0,0,2,1,1,1
15815,14,476,11,6,10,0,0,1,11,2,4,2,4,6,6,10,15,1,15,0,0,2,1,1,1
15816,228,5110,4293,999,3693,19,54,507,4312,9,155,88,170,164,258,1156,1898,4,9368,520,0,2,3,1,1
15817,228,5110,1482,859,1002,125,135,219,1607,16,219,134,251,235,385,1766,3032,9,27804,1544,1,2,3,1,1
15818,42,969,386,256,301,16,9,68,402,4,59,35,69,63,104,355,621,2,1453,80,0,2,4,1,1
15819,42,969,264,131,164,11,41,46,275,6,38,22,40,44,62,214,338,3,1068,59,0,2,4,1,1
15820,30,1334,386,256,301,16,9,68,402,4,59,35,69,63,104,355,621,2,1453,80,0,2,28,5,1
15821,42,969,386,256,301,16,9,68,402,4,59,35,69,63,104,355,621,2,1453,80,0,2,4,1,0
15822,42,969,264,131,164,11,41,46,275,6,38,22,40,44,62,214,338,3,1068,59,0,2,4,1,0
15823,30,1334,386,256,301,16,9,68,402,4,59,35,69,63,104,355,621,2,1453,80,0,2,28,5,0
15824,344,6953,1457,730,1242,11,6,188,1468,10,292,166,329,302,495,2424,4078,5,22973,1276,1,2,31,16,0
15825,344,6953,74,35,59,1,0,14,75,3,14,7,14,17,21,58,85,1,128,7,0,2,31,16,0
15826,344,6953,245,125,200,5,7,34,250,7,30,17,34,37,51,166,265,3,1053,58,0,2,31,16,0
15827,75,3862,1457,730,1242,11,6,188,1468,10,292,166,329,302,495,2424,4078,5,22973,1276,1,2,23,0,0
15828,61,2763,1455,414,1257,16,76,112,1471,5,41,23,46,46,69,231,381,2,1069,59,0,2,7,3,0
15829,344,6953,1457,730,1242,11,6,188,1468,10,292,166,329,302,495,2424,4078,5,22973,1276,1,2,31,16,0
15830,344,6953,74,35,59,1,0,14,75,3,14,7,14,17,21,58,85,1,128,7,0,2,31,16,0
15831,344,6953,245,125,200,5,7,34,250,7,30,17,34,37,51,166,265,3,1053,58,0,2,31,16,0
15832,75,3862,1457,730,1242,11,6,188,1468,10,292,166,329,302,495,2424,4078,5,22973,1276,1,2,23,0,0
15833,44,859,207,111,150,11,0,50,218,5,26,19,36,31,55,133,272,3,943,52,0,2,3,0,0
15834,44,859,410,198,237,31,55,97,441,11,63,38,72,74,110,414,683,6,4293,238,0,2,3,0,0
15835,61,2747,1455,414,1257,16,76,112,1471,5,41,23,46,46,69,231,381,2,1069,59,0,2,1,3,0
15836,14,476,42,7,35,4,0,5,46,1,2,1,2,3,3,2,4,0,2,0,0,2,1,1,0
15837,14,476,11,6,10,0,0,1,11,2,4,2,4,6,6,10,15,1,15,0,0,2,1,1,0
15838,47,867,207,111,150,11,0,50,218,5,26,19,36,31,55,133,272,3,943,52,0,2,13,5,0
15839,47,867,410,198,237,31,55,97,441,11,63,38,72,74,110,414,683,6,4293,238,0,2,13,5,0
15840,5,138,207,111,150,11,0,50,218,5,26,19,36,31,55,133,272,3,943,52,0,0,50,0,0
15841,47,889,207,111,150,11,0,50,218,5,26,19,36,31,55,133,272,3,943,52,0,2,3,0,0
15842,47,889,410,198,237,31,55,97,441,11,63,38,72,74,110,414,683,6,4293,238,0,2,3,0,0
15843,61,2747,1455,414,1257,16,76,112,1471,5,41,23,46,46,69,231,381,2,1069,59,0,2,5,3,0
15844,99,2075,773,419,590,28,0,166,801,10,204,113,217,214,330,1598,2554,5,13587,754,0,2,0,9,0
15845,99,2075,421,273,302,44,34,57,465,17,81,59,107,98,166,583,1098,11,12329,684,0,2,0,9,0
15846,28,545,2,2,2,0,0,0,2,0,0,0,0,0,0,0,0,0,0,0,0,2,1,1,0
15847,28,545,99,48,90,1,3,5,100,0,0,0,0,0,0,0,0,0,0,0,0,2,1,1,0
15848,28,545,8,5,5,2,0,1,10,0,0,0,0,0,0,0,0,0,0,0,0,2,1,1,0
15849,28,545,1217,716,841,84,126,174,1301,14,185,118,215,199,333,1446,2542,8,20687,1149,0,2,1,1,0
15850,28,545,160,89,115,0,13,31,160,7,15,11,17,22,28,78,124,3,495,27,0,2,1,1,0
15851,28,545,10,10,9,9,0,0,19,0,0,0,0,0,0,0,0,0,0,0,0,2,1,1,0
15852,28,545,173,84,99,8,29,36,181,5,12,7,13,17,20,54,81,2,221,12,0,2,1,1,0
15853,28,545,3,1,1,3,0,0,6,0,0,0,0,0,0,0,0,0,0,0,0,2,1,1,0
15854,162,5067,1660,832,1314,41,38,274,1701,20,312,209,395,332,604,2671,5058,12,64042,3557,1,2,4,5,0
15855,162,5067,1057,646,719,113,100,145,1170,18,215,134,248,233,382,1740,3004,10,31186,1732,1,2,4,5,0
15856,47,896,207,111,150,11,0,50,218,5,26,19,36,31,55,133,272,3,943,52,0,2,16,5,0
15857,47,896,410,198,237,31,55,97,441,11,63,38,72,74,110,414,683,6,4293,238,0,2,16,5,0
15858,344,6953,1457,730,1242,11,6,188,1468,10,292,166,329,302,495,2424,4078,5,22973,1276,1,2,58,21,0
15859,344,6953,74,35,59,1,0,14,75,3,14,7,14,17,21,58,85,1,128,7,0,2,58,21,0
15860,344,6953,245,125,200,5,7,34,250,7,30,17,34,37,51,166,265,3,1053,58,0,2,58,21,0
15861,24,834,74,35,59,1,0,14,75,3,14,7,14,17,21,58,85,1,128,7,0,2,1,1,0
15862,24,834,245,125,200,5,7,34,250,7,30,17,34,37,51,166,265,3,1053,58,0,2,1,1,0
15863,72,2129,1523,757,1297,19,12,193,1542,12,193,117,230,205,347,1508,2664,7,19053,1058,0,2,3,0,0
15864,72,2129,701,378,504,33,58,109,734,13,110,68,126,123,194,794,1346,7,10027,557,0,2,3,0,0
15865,177,4149,77,34,69,0,0,8,77,3,24,16,29,27,45,114,213,1,387,21,0,2,15,19,0
15866,177,4149,712,438,573,51,9,84,763,14,102,71,128,116,199,733,1364,8,11988,666,0,2,15,19,0
15867,223,5018,722,423,573,19,0,135,741,12,172,101,199,184,300,1320,2257,6,15668,870,0,2,1,0,0
15868,223,5018,1508,847,911,44,250,301,1552,14,148,88,169,162,257,1120,1886,7,15077,837,0,2,1,0,0
15869,335,7111,72,33,56,0,4,12,72,1,1,1,1,2,2,0,2,0,1,0,0,2,2,8,0
15870,335,7111,1454,835,1044,76,110,219,1530,17,275,158,296,292,454,2297,3718,9,34017,1889,1,2,2,8,0
15871,41,940,386,256,301,16,9,68,402,4,59,35,69,63,104,355,621,2,1453,80,0,2,4,1,0
15872,41,940,264,131,164,11,41,46,275,6,38,22,40,44,62,214,338,3,1068,59,0,2,4,1,0
15873,20,400,294,64,250,0,0,43,294,1,20,10,20,21,30,86,131,0,65,3,0,2,2,2,0
15874,20,400,78,46,62,3,0,14,81,3,8,4,8,11,12,28,41,1,62,3,0,2,2,2,0
15875,14,476,42,7,35,4,0,5,46,1,2,1,2,3,3,2,4,0,2,0,0,2,1,1,0
15876,14,476,11,6,10,0,0,1,11,2,4,2,4,6,6,10,15,1,15,0,0,2,1,1,0
15877,47,2495,520,294,400,33,13,81,553,10,261,204,367,271,571,2128,4614,7,32445,1802,1,2,33,8,0
15878,147,4008,1660,832,1314,41,38,274,1701,20,312,209,395,332,604,2671,5058,12,64042,3557,1,2,13,0,0
15879,5,138,207,111,150,11,0,50,218,5,26,19,36,31,55,133,272,3,943,52,0,0,50,0,0
15880,75,3862,1457,730,1242,11,6,188,1468,10,292,166,329,302,495,2424,4078,5,22973,1276,1,2,32,1,0
15881,38,2269,652,304,544,16,6,88,668,6,89,51,101,95,152,591,998,3,3399,188,0,2,25,0,0
15882,62,2852,1455,414,1257,16,76,112,1471,5,41,23,46,46,69,231,381,2,1069,59,0,2,5,3,0
15883,82,4147,1523,757,1297,19,12,193,1542,12,193,117,230,205,347,1508,2664,7,19053,1058,0,2,4,0,0
15884,36,1940,384,251,317,7,8,52,391,11,70,44,84,81,128,467,811,6,5355,297,0,2,21,1,0
15885,30,1362,386,256,301,16,9,68,402,4,59,35,69,63,104,355,621,2,1453,80,0,2,28,5,0
15886,99,2075,773,419,590,28,0,166,801,10,204,113,217,214,330,1598,2554,5,13587,754,0,2,0,9,0
15887,99,2075,421,273,302,44,34,57,465,17,81,59,107,98,166,583,1098,11,12329,684,0,2,0,9,0
15888,28,545,2,2,2,0,0,0,2,0,0,0,0,0,0,0,0,0,0,0,0,2,1,1,0
15889,28,545,99,48,90,1,3,5,100,0,0,0,0,0,0,0,0,0,0,0,0,2,1,1,0
15890,28,545,8,5,5,2,0,1,10,0,0,0,0,0,0,0,0,0,0,0,0,2,1,1,0
15891,28,545,1217,716,841,84,126,174,1301,14,185,118,215,199,333,1446,2542,8,20687,1149,0,2,1,1,0
15892,28,545,160,89,115,0,13,31,160,7,15,11,17,22,28,78,124,3,495,27,0,2,1,1,0
15893,28,545,10,10,9,9,0,0,19,0,0,0,0,0,0,0,0,0,0,0,0,2,1,1,0
15894,28,545,173,84,99,8,29,36,181,5,12,7,13,17,20,54,81,2,221,12,0,2,1,1,0
15895,28,545,3,1,1,3,0,0,6,0,0,0,0,0,0,0,0,0,0,0,0,2,1,1,0
15896,162,5067,1660,832,1314,41,38,274,1701,20,312,209,395,332,604,2671,5058,12,64042,3557,1,2,4,5,0
15897,162,5067,1057,646,719,113,100,145,1170,18,215,134,248,233,382,1740,3004,10,31186,1732,1,2,4,5,0
15898,47,896,207,111,150,11,0,50,218,5,26,19,36,31,55,133,272,3,943,52,0,2,16,5,0
15899,47,896,410,198,237,31,55,97,441,11,63,38,72,74,110,414,683,6,4293,238,0,2,16,5,0
15900,344,6953,1457,730,1242,11,6,188,1468,10,292,166,329,302,495,2424,4078,5,22973,1276,1,2,58,21,0
15901,344,6953,74,35,59,1,0,14,75,3,14,7,14,17,21,58,85,1,128,7,0,2,58,21,0
15902,344,6953,245,125,200,5,7,34,250,7,30,17,34,37,51,166,265,3,1053,58,0,2,58,21,0
15903,24,834,74,35,59,1,0,14,75,3,14,7,14,17,21,58,85,1,128,7,0,2,1,1,0
15904,24,834,245,125,200,5,7,34,250,7,30,17,34,37,51,166,265,3,1053,58,0,2,1,1,0
15905,72,2129,1523,757,1297,19,12,193,1542,12,193,117,230,205,347,1508,2664,7,19053,1058,0,2,3,0,0
15906,72,2129,701,378,504,33,58,109,734,13,110,68,126,123,194,794,1346,7,10027,557,0,2,3,0,0
15907,177,4149,77,34,69,0,0,8,77,3,24,16,29,27,45,114,213,1,387,21,0,2,15,19,0
15908,177,4149,712,438,573,51,9,84,763,14,102,71,128,116,199,733,1364,8,11988,666,0,2,15,19,0
15909,223,5018,722,423,573,19,0,135,741,12,172,101,199,184,300,1320,2257,6,15668,870,0,2,1,0,0
15910,223,5018,1508,847,911,44,250,301,1552,14,148,88,169,162,257,1120,1886,7,15077,837,0,2,1,0,0
15911,335,7111,72,33,56,0,4,12,72,1,1,1,1,2,2,0,2,0,1,0,0,2,2,8,0
15912,335,7111,1454,835,1044,76,110,219,1530,17,275,158,296,292,454,2297,3718,9,34017,1889,1,2,2,8,0
15913,41,940,386,256,301,16,9,68,402,4,59,35,69,63,104,355,621,2,1453,80,0,2,4,1,0
15914,41,940,264,131,164,11,41,46,275,6,38,22,40,44,62,214,338,3,1068,59,0,2,4,1,0
15915,20,400,294,64,250,0,0,43,294,1,20,10,20,21,30,86,131,0,65,3,0,2,2,2,0
15916,20,400,78,46,62,3,0,14,81,3,8,4,8,11,12,28,41,1,62,3,0,2,2,2,0
15917,14,476,42,7,35,4,0,5,46,1,2,1,2,3,3,2,4,0,2,0,0,2,1,1,0
15918,14,476,11,6,10,0,0,1,11,2,4,2,4,6,6,10,15,1,15,0,0,2,1,1,0
15919,47,2495,520,294,400,33,13,81,553,10,261,204,367,271,571,2128,4614,7,32445,1802,1,2,33,8,0
15920,147,4008,1660,832,1314,41,38,274,1701,20,312,209,395,332,604,2671,5058,12,64042,3557,1,2,13,0,0
15921,5,138,207,111,150,11,0,50,218,5,26,19,36,31,55,133,272,3,943,52,0,0,50,0,0
15922,75,3862,1457,730,1242,11,6,188,1468,10,292,166,329,302,495,2424,4078,5,22973,1276,1,2,32,1,0
15923,38,2269,652,304,544,16,6,88,668,6,89,51,101,95,152,591,998,3,3399,188,0,2,25,0,0
15924,62,2852,1455,414,1257,16,76,112,1471,5,41,23,46,46,69,231,381,2,1069,59,0,2,5,3,0
15925,82,4147,1523,757,1297,19,12,193,1542,12,193,117,230,205,347,1508,2664,7,19053,1058,0,2,4,0,0
15926,36,1940,384,251,317,7,8,52,391,11,70,44,84,81,128,467,811,6,5355,297,0,2,21,1,0
15927,30,1362,386,256,301,16,9,68,402,4,59,35,69,63,104,355,621,2,1453,80,0,2,28,5,0
15928,1,300,382,65,130,157,2,92,539,4,10,5,10,14,15,41,57,2,114,6,0,2,1,1,1
15929,1,300,382,65,130,157,2,92,539,4,10,5,10,14,15,41,57,2,114,6,0,2,1,1,0
15930,335,7133,72,33,56,0,4,12,72,1,1,1,1,2,2,0,2,0,1,0,0,2,8,3,1
15931,335,7133,1454,835,1044,76,110,219,1530,17,275,158,296,292,454,2297,3718,9,34017,1889,1,2,8,3,1
15932,108,5395,1782,648,1425,9,47,279,1791,8,171,97,189,179,286,1292,2140,4,9462,525,0,2,49,9,1
15933,103,1969,1178,367,1042,6,15,115,1184,9,94,51,95,103,146,644,976,4,4439,246,0,2,1,1,1
15934,103,1969,177,108,140,8,0,27,185,6,30,16,32,36,48,162,248,3,794,44,0,2,1,1,1
15935,335,7133,72,33,56,0,4,12,72,1,1,1,1,2,2,0,2,0,1,0,0,2,8,3,0
15936,335,7133,1454,835,1044,76,110,219,1530,17,275,158,296,292,454,2297,3718,9,34017,1889,1,2,8,3,0
15937,108,5395,1782,648,1425,9,47,279,1791,8,171,97,189,179,286,1292,2140,4,9462,525,0,2,49,9,0
15938,42,947,386,256,301,16,9,68,402,4,59,35,69,63,104,355,621,2,1453,80,0,2,2,1,1
15939,42,947,264,131,164,11,41,46,275,6,38,22,40,44,62,214,338,3,1068,59,0,2,2,1,1
15940,31,1425,386,256,301,16,9,68,402,4,59,35,69,63,104,355,621,2,1453,80,0,2,10,0,1
15941,31,1500,386,256,301,16,9,68,402,4,59,35,69,63,104,355,621,2,1453,80,0,2,11,0,1
15942,31,1500,386,256,301,16,9,68,402,4,59,35,69,63,104,355,621,2,1453,80,0,2,1,0,0
15943,41,943,386,256,301,16,9,68,402,4,59,35,69,63,104,355,621,2,1453,80,0,2,2,2,0
15944,41,943,264,131,164,11,41,46,275,6,38,22,40,44,62,214,338,3,1068,59,0,2,2,2,0
15945,46,945,447,308,343,6,5,95,453,7,96,59,111,103,170,651,1136,4,4600,255,0,2,3,3,0
15946,46,945,322,174,179,16,74,51,338,10,41,26,46,51,72,252,408,5,2291,127,0,2,3,3,0
15947,37,1604,447,308,343,6,5,95,453,7,96,59,111,103,170,651,1136,4,4600,255,0,2,4,10,0
15948,46,945,447,308,343,6,5,95,453,7,96,59,111,103,170,651,1136,4,4600,255,0,2,3,3,0
15949,46,945,322,174,179,16,74,51,338,10,41,26,46,51,72,252,408,5,2291,127,0,2,3,3,0
15950,37,1604,447,308,343,6,5,95,453,7,96,59,111,103,170,651,1136,4,4600,255,0,2,4,10,0
15951,9,223,19,8,11,5,0,4,24,2,5,3,6,7,9,13,25,1,30,1,0,2,1,1,1
15952,9,223,102,59,69,5,3,24,107,6,22,15,28,28,43,113,206,3,789,43,0,2,1,1,1
15953,9,223,106,40,36,3,49,17,109,8,17,13,23,25,36,93,167,5,904,50,0,2,1,1,1
15954,28,548,2,2,2,0,0,0,2,0,0,0,0,0,0,0,0,0,0,0,0,2,1,1,1
15955,28,548,99,48,90,1,3,5,100,0,0,0,0,0,0,0,0,0,0,0,0,2,1,1,1
15956,28,548,8,5,5,2,0,1,10,0,0,0,0,0,0,0,0,0,0,0,0,2,1,1,1
15957,28,548,1217,716,841,84,126,174,1301,14,185,118,215,199,333,1446,2542,8,20687,1149,0,2,1,1,1
15958,28,548,160,89,115,0,13,31,160,7,15,11,17,22,28,78,124,3,495,27,0,2,1,1,1
15959,28,548,10,10,9,9,0,0,19,0,0,0,0,0,0,0,0,0,0,0,0,2,1,1,1
15960,28,548,173,84,99,8,29,36,181,5,12,7,13,17,20,54,81,2,221,12,0,2,1,1,1
15961,28,548,3,1,1,3,0,0,6,0,0,0,0,0,0,0,0,0,0,0,0,2,1,1,1
15962,60,1254,996,429,845,24,10,117,1020,7,76,50,88,83,138,494,879,4,3565,198,0,2,1,1,1
15963,60,1254,456,277,329,12,42,72,468,13,85,50,97,98,147,592,972,7,7212,400,0,2,1,1,1
15964,119,2420,1513,682,1277,25,13,200,1538,11,199,116,219,210,335,1557,2584,6,15641,868,0,2,6,6,1
15965,119,2420,819,519,539,24,98,155,843,15,96,57,106,111,163,690,1107,8,9171,509,0,2,6,6,1
15966,344,6968,1457,730,1242,11,6,188,1468,10,292,166,329,302,495,2424,4078,5,22973,1276,1,2,5,5,1
15967,344,6968,74,35,59,1,0,14,75,3,14,7,14,17,21,58,85,1,128,7,0,2,5,5,1
15968,344,6968,245,125,200,5,7,34,250,7,30,17,34,37,51,166,265,3,1053,58,0,2,5,5,1
15969,22,679,339,213,244,17,9,65,356,10,42,26,48,52,74,259,421,5,2410,133,0,2,2,2,1
15970,228,5119,4293,999,3693,19,54,507,4312,9,155,88,170,164,258,1156,1898,4,9368,520,0,2,6,6,1
15971,228,5119,1482,859,1002,125,135,219,1607,16,219,134,251,235,385,1766,3032,9,27804,1544,1,2,6,6,1
15972,177,4152,77,34,69,0,0,8,77,3,24,16,29,27,45,114,213,1,387,21,0,2,1,1,1
15973,177,4152,712,438,573,51,9,84,763,14,102,71,128,116,199,733,1364,8,11988,666,0,2,1,1,1
15974,69,1359,1020,354,843,12,15,144,1032,8,134,77,144,142,221,970,1580,4,6792,377,0,2,4,4,1
15975,46,955,447,308,343,6,5,95,453,7,96,59,111,103,170,651,1136,4,4600,255,0,2,2,2,1
15976,46,955,322,174,179,16,74,51,338,10,41,26,46,51,72,252,408,5,2291,127,0,2,2,2,1
15977,223,5051,722,423,573,19,0,135,741,12,172,101,199,184,300,1320,2257,6,15668,870,0,2,11,11,1
15978,223,5051,1508,847,911,44,250,301,1552,14,148,88,169,162,257,1120,1886,7,15077,837,0,2,11,11,1
15979,128,2818,1043,504,840,53,9,147,1096,9,180,112,198,189,310,1377,2344,4,11604,644,0,2,2,2,1
15980,128,2818,383,288,292,26,6,62,409,11,65,38,67,76,105,429,656,5,3719,206,0,2,2,2,1
15981,103,1959,1178,367,1042,6,15,115,1184,9,94,51,95,103,146,644,976,4,4439,246,0,2,1,1,1
15982,103,1959,177,108,140,8,0,27,185,6,30,16,32,36,48,162,248,3,794,44,0,2,1,1,1
15983,184,3747,1943,715,1694,26,18,214,1969,12,185,120,237,197,357,1436,2721,7,20915,1161,0,2,2,2,1
15984,184,3747,1168,838,957,57,25,144,1225,19,348,224,416,367,640,3018,5452,11,61921,3440,1,2,2,2,1
15985,16,471,442,244,305,14,16,103,456,11,68,45,75,79,120,452,756,6,4588,254,0,2,1,1,1
15986,16,471,182,102,99,11,40,35,193,3,11,6,11,14,17,42,64,1,97,5,0,2,1,1,1
15987,9,223,19,8,11,5,0,4,24,2,5,3,6,7,9,13,25,1,30,1,0,2,1,1,0
15988,9,223,102,59,69,5,3,24,107,6,22,15,28,28,43,113,206,3,789,43,0,2,1,1,0
15989,9,223,106,40,36,3,49,17,109,8,17,13,23,25,36,93,167,5,904,50,0,2,1,1,0
15990,28,548,2,2,2,0,0,0,2,0,0,0,0,0,0,0,0,0,0,0,0,2,1,1,0
15991,28,548,99,48,90,1,3,5,100,0,0,0,0,0,0,0,0,0,0,0,0,2,1,1,0
15992,28,548,8,5,5,2,0,1,10,0,0,0,0,0,0,0,0,0,0,0,0,2,1,1,0
15993,28,548,1217,716,841,84,126,174,1301,14,185,118,215,199,333,1446,2542,8,20687,1149,0,2,1,1,0
15994,28,548,160,89,115,0,13,31,160,7,15,11,17,22,28,78,124,3,495,27,0,2,1,1,0
15995,28,548,10,10,9,9,0,0,19,0,0,0,0,0,0,0,0,0,0,0,0,2,1,1,0
15996,28,548,173,84,99,8,29,36,181,5,12,7,13,17,20,54,81,2,221,12,0,2,1,1,0
15997,28,548,3,1,1,3,0,0,6,0,0,0,0,0,0,0,0,0,0,0,0,2,1,1,0
15998,60,1254,996,429,845,24,10,117,1020,7,76,50,88,83,138,494,879,4,3565,198,0,2,1,1,0
15999,60,1254,456,277,329,12,42,72,468,13,85,50,97,98,147,592,972,7,7212,400,0,2,1,1,0
16000,119,2420,1513,682,1277,25,13,200,1538,11,199,116,219,210,335,1557,2584,6,15641,868,0,2,6,6,0
16001,119,2420,819,519,539,24,98,155,843,15,96,57,106,111,163,690,1107,8,9171,509,0,2,6,6,0
16002,344,6968,1457,730,1242,11,6,188,1468,10,292,166,329,302,495,2424,4078,5,22973,1276,1,2,5,5,0
16003,344,6968,74,35,59,1,0,14,75,3,14,7,14,17,21,58,85,1,128,7,0,2,5,5,0
16004,344,6968,245,125,200,5,7,34,250,7,30,17,34,37,51,166,265,3,1053,58,0,2,5,5,0
16005,22,679,339,213,244,17,9,65,356,10,42,26,48,52,74,259,421,5,2410,133,0,2,2,2,0
16006,228,5119,4293,999,3693,19,54,507,4312,9,155,88,170,164,258,1156,1898,4,9368,520,0,2,6,6,0
16007,228,5119,1482,859,1002,125,135,219,1607,16,219,134,251,235,385,1766,3032,9,27804,1544,1,2,6,6,0
16008,177,4152,77,34,69,0,0,8,77,3,24,16,29,27,45,114,213,1,387,21,0,2,1,1,0
16009,177,4152,712,438,573,51,9,84,763,14,102,71,128,116,199,733,1364,8,11988,666,0,2,1,1,0
16010,69,1359,1020,354,843,12,15,144,1032,8,134,77,144,142,221,970,1580,4,6792,377,0,2,4,4,0
16011,46,955,447,308,343,6,5,95,453,7,96,59,111,103,170,651,1136,4,4600,255,0,2,2,2,0
16012,46,955,322,174,179,16,74,51,338,10,41,26,46,51,72,252,408,5,2291,127,0,2,2,2,0
16013,223,5051,722,423,573,19,0,135,741,12,172,101,199,184,300,1320,2257,6,15668,870,0,2,11,11,0
16014,223,5051,1508,847,911,44,250,301,1552,14,148,88,169,162,257,1120,1886,7,15077,837,0,2,11,11,0
16015,128,2818,1043,504,840,53,9,147,1096,9,180,112,198,189,310,1377,2344,4,11604,644,0,2,2,2,0
16016,128,2818,383,288,292,26,6,62,409,11,65,38,67,76,105,429,656,5,3719,206,0,2,2,2,0
16017,103,1959,1178,367,1042,6,15,115,1184,9,94,51,95,103,146,644,976,4,4439,246,0,2,1,1,0
16018,103,1959,177,108,140,8,0,27,185,6,30,16,32,36,48,162,248,3,794,44,0,2,1,1,0
16019,184,3747,1943,715,1694,26,18,214,1969,12,185,120,237,197,357,1436,2721,7,20915,1161,0,2,2,2,0
16020,184,3747,1168,838,957,57,25,144,1225,19,348,224,416,367,640,3018,5452,11,61921,3440,1,2,2,2,0
16021,16,471,442,244,305,14,16,103,456,11,68,45,75,79,120,452,756,6,4588,254,0,2,1,1,0
16022,16,471,182,102,99,11,40,35,193,3,11,6,11,14,17,42,64,1,97,5,0,2,1,1,0
16023,222,4984,722,423,573,19,0,135,741,12,172,101,199,184,300,1320,2257,6,15668,870,0,2,1,0,1
16024,222,4984,1508,847,911,44,250,301,1552,14,148,88,169,162,257,1120,1886,7,15077,837,0,2,1,0,1
16025,15,621,722,423,573,19,0,135,741,12,172,101,199,184,300,1320,2257,6,15668,870,0,2,7,0,1
16026,345,6966,1457,730,1242,11,6,188,1468,10,292,166,329,302,495,2424,4078,5,22973,1276,1,2,5,2,1
16027,345,6966,74,35,59,1,0,14,75,3,14,7,14,17,21,58,85,1,128,7,0,2,5,2,1
16028,345,6966,245,125,200,5,7,34,250,7,30,17,34,37,51,166,265,3,1053,58,0,2,5,2,1
16029,148,4073,1660,832,1314,41,38,274,1701,20,312,209,395,332,604,2671,5058,12,64042,3557,1,2,17,1,1
16030,346,6990,1457,730,1242,11,6,188,1468,10,292,166,329,302,495,2424,4078,5,22973,1276,1,2,24,14,0
16031,346,6990,74,35,59,1,0,14,75,3,14,7,14,17,21,58,85,1,128,7,0,2,24,14,0
16032,346,6990,245,125,200,5,7,34,250,7,30,17,34,37,51,166,265,3,1053,58,0,2,24,14,0
16033,76,3974,1457,730,1242,11,6,188,1468,10,292,166,329,302,495,2424,4078,5,22973,1276,1,2,15,0,0
16034,346,6990,1457,730,1242,11,6,188,1468,10,292,166,329,302,495,2424,4078,5,22973,1276,1,2,24,11,0
16035,346,6990,74,35,59,1,0,14,75,3,14,7,14,17,21,58,85,1,128,7,0,2,24,11,0
16036,346,6990,245,125,200,5,7,34,250,7,30,17,34,37,51,166,265,3,1053,58,0,2,24,11,0
16037,148,4073,1660,832,1314,41,38,274,1701,20,312,209,395,332,604,2671,5058,12,64042,3557,1,2,17,1,0
16038,76,3974,1457,730,1242,11,6,188,1468,10,292,166,329,302,495,2424,4078,5,22973,1276,1,2,15,0,0
16039,48,934,207,111,150,11,0,50,218,5,26,19,36,31,55,133,272,3,943,52,0,2,10,2,1
16040,48,934,410,198,237,31,55,97,441,11,63,38,72,74,110,414,683,6,4293,238,0,2,10,2,1
16041,10,228,207,111,150,11,0,50,218,5,26,19,36,31,55,133,272,3,943,52,0,2,29,4,1
16042,48,948,207,111,150,11,0,50,218,5,26,19,36,31,55,133,272,3,943,52,0,2,3,1,0
16043,48,948,410,198,237,31,55,97,441,11,63,38,72,74,110,414,683,6,4293,238,0,2,3,1,0
16044,222,4983,722,423,573,19,0,135,741,12,172,101,199,184,300,1320,2257,6,15668,870,0,2,3,3,0
16045,222,4983,1508,847,911,44,250,301,1552,14,148,88,169,162,257,1120,1886,7,15077,837,0,2,3,3,0
16046,346,6990,1457,730,1242,11,6,188,1468,10,292,166,329,302,495,2424,4078,5,22973,1276,1,2,1,1,0
16047,346,6990,74,35,59,1,0,14,75,3,14,7,14,17,21,58,85,1,128,7,0,2,1,1,0
16048,346,6990,245,125,200,5,7,34,250,7,30,17,34,37,51,166,265,3,1053,58,0,2,1,1,0
16049,93,3417,1450,624,1228,12,26,181,1462,14,306,186,354,320,540,2580,4493,8,36391,2021,1,2,17,0,0
16050,48,948,207,111,150,11,0,50,218,5,26,19,36,31,55,133,272,3,943,52,0,2,12,2,0
16051,48,948,410,198,237,31,55,97,441,11,63,38,72,74,110,414,683,6,4293,238,0,2,12,2,0
16052,10,228,207,111,150,11,0,50,218,5,26,19,36,31,55,133,272,3,943,52,0,2,29,4,0
16053,222,4984,722,423,573,19,0,135,741,12,172,101,199,184,300,1320,2257,6,15668,870,0,2,1,0,0
16054,222,4984,1508,847,911,44,250,301,1552,14,148,88,169,162,257,1120,1886,7,15077,837,0,2,1,0,0
16055,15,621,722,423,573,19,0,135,741,12,172,101,199,184,300,1320,2257,6,15668,870,0,2,7,0,0
16056,346,6990,1457,730,1242,11,6,188,1468,10,292,166,329,302,495,2424,4078,5,22973,1276,1,2,1,1,0
16057,346,6990,74,35,59,1,0,14,75,3,14,7,14,17,21,58,85,1,128,7,0,2,1,1,0
16058,346,6990,245,125,200,5,7,34,250,7,30,17,34,37,51,166,265,3,1053,58,0,2,1,1,0
16059,93,3417,1450,624,1228,12,26,181,1462,14,306,186,354,320,540,2580,4493,8,36391,2021,1,2,17,0,0
16060,179,4178,77,34,69,0,0,8,77,3,24,16,29,27,45,114,213,1,387,21,0,2,9,8,0
16061,179,4178,712,438,573,51,9,84,763,14,102,71,128,116,199,733,1364,8,11988,666,0,2,9,8,0
16062,346,6990,1457,730,1242,11,6,188,1468,10,292,166,329,302,495,2424,4078,5,22973,1276,1,2,1,1,0
16063,346,6990,74,35,59,1,0,14,75,3,14,7,14,17,21,58,85,1,128,7,0,2,1,1,0
16064,346,6990,245,125,200,5,7,34,250,7,30,17,34,37,51,166,265,3,1053,58,0,2,1,1,0
16065,222,4988,722,423,573,19,0,135,741,12,172,101,199,184,300,1320,2257,6,15668,870,0,2,1,0,0
16066,222,4988,1508,847,911,44,250,301,1552,14,148,88,169,162,257,1120,1886,7,15077,837,0,2,1,0,0
16067,93,3417,1450,624,1228,12,26,181,1462,14,306,186,354,320,540,2580,4493,8,36391,2021,1,2,17,0,0
16068,15,621,722,423,573,19,0,135,741,12,172,101,199,184,300,1320,2257,6,15668,870,0,2,7,0,0
16069,222,4988,722,423,573,19,0,135,741,12,172,101,199,184,300,1320,2257,6,15668,870,0,2,3,3,0
16070,222,4988,1508,847,911,44,250,301,1552,14,148,88,169,162,257,1120,1886,7,15077,837,0,2,3,3,0
16071,179,4176,77,34,69,0,0,8,77,3,24,16,29,27,45,114,213,1,387,21,0,2,0,2,0
16072,179,4176,712,438,573,51,9,84,763,14,102,71,128,116,199,733,1364,8,11988,666,0,2,0,2,0
16073,179,4176,77,34,69,0,0,8,77,3,24,16,29,27,45,114,213,1,387,21,0,2,30,18,0
16074,179,4176,712,438,573,51,9,84,763,14,102,71,128,116,199,733,1364,8,11988,666,0,2,30,18,0
16075,49,577,647,139,84,35,284,233,682,0,0,0,0,0,0,0,0,0,0,0,0,2,2,1,0
16076,335,7141,72,33,56,0,4,12,72,1,1,1,1,2,2,0,2,0,1,0,0,2,3,2,0
16077,335,7141,1454,835,1044,76,110,219,1530,17,275,158,296,292,454,2297,3718,9,34017,1889,1,2,3,2,0
16078,109,5438,1782,648,1425,9,47,279,1791,8,171,97,189,179,286,1292,2140,4,9462,525,0,2,23,0,0
16079,49,575,647,139,84,35,284,233,682,0,0,0,0,0,0,0,0,0,0,0,0,2,1,1,0
16080,109,5438,1782,648,1425,9,47,279,1791,8,171,97,189,179,286,1292,2140,4,9462,525,0,2,5,5,0
16081,103,1969,1178,367,1042,6,15,115,1184,9,94,51,95,103,146,644,976,4,4439,246,0,2,1,1,1
16082,103,1969,177,108,140,8,0,27,185,6,30,16,32,36,48,162,248,3,794,44,0,2,1,1,1
16083,14,472,42,7,35,4,0,5,46,1,2,1,2,3,3,2,4,0,2,0,0,2,0,1,0
16084,14,472,11,6,10,0,0,1,11,2,4,2,4,6,6,10,15,1,15,0,0,2,0,1,0
16085,103,1969,1178,367,1042,6,15,115,1184,9,94,51,95,103,146,644,976,4,4439,246,0,2,1,1,0
16086,103,1969,177,108,140,8,0,27,185,6,30,16,32,36,48,162,248,3,794,44,0,2,1,1,0
16087,14,472,42,7,35,4,0,5,46,1,2,1,2,3,3,2,4,0,2,0,0,2,0,1,0
16088,14,472,11,6,10,0,0,1,11,2,4,2,4,6,6,10,15,1,15,0,0,2,0,1,0
16089,14,472,42,7,35,4,0,5,46,1,2,1,2,3,3,2,4,0,2,0,0,2,1,1,0
16090,14,472,11,6,10,0,0,1,11,2,4,2,4,6,6,10,15,1,15,0,0,2,1,1,0
16091,14,472,42,7,35,4,0,5,46,1,2,1,2,3,3,2,4,0,2,0,0,2,1,1,0
16092,14,472,11,6,10,0,0,1,11,2,4,2,4,6,6,10,15,1,15,0,0,2,1,1,0
16093,49,575,647,139,84,35,284,233,682,0,0,0,0,0,0,0,0,0,0,0,0,2,2,1,0
16094,335,7141,72,33,56,0,4,12,72,1,1,1,1,2,2,0,2,0,1,0,0,2,3,2,0
16095,335,7141,1454,835,1044,76,110,219,1530,17,275,158,296,292,454,2297,3718,9,34017,1889,1,2,3,2,0
16096,109,5438,1782,648,1425,9,47,279,1791,8,171,97,189,179,286,1292,2140,4,9462,525,0,2,23,0,0
16097,346,7005,1457,730,1242,11,6,188,1468,10,292,166,329,302,495,2424,4078,5,22973,1276,1,2,24,11,0
16098,346,7005,74,35,59,1,0,14,75,3,14,7,14,17,21,58,85,1,128,7,0,2,24,11,0
16099,346,7005,245,125,200,5,7,34,250,7,30,17,34,37,51,166,265,3,1053,58,0,2,24,11,0
16100,178,4158,77,34,69,0,0,8,77,3,24,16,29,27,45,114,213,1,387,21,0,2,30,18,0
16101,178,4158,712,438,573,51,9,84,763,14,102,71,128,116,199,733,1364,8,11988,666,0,2,30,18,0
16102,46,951,447,308,343,6,5,95,453,7,96,59,111,103,170,651,1136,4,4600,255,0,2,3,3,0
16103,46,951,322,174,179,16,74,51,338,10,41,26,46,51,72,252,408,5,2291,127,0,2,3,3,0
16104,223,5060,722,423,573,19,0,135,741,12,172,101,199,184,300,1320,2257,6,15668,870,0,2,4,3,0
16105,223,5060,1508,847,911,44,250,301,1552,14,148,88,169,162,257,1120,1886,7,15077,837,0,2,4,3,0
16106,103,1959,1178,367,1042,6,15,115,1184,9,94,51,95,103,146,644,976,4,4439,246,0,2,1,1,0
16107,103,1959,177,108,140,8,0,27,185,6,30,16,32,36,48,162,248,3,794,44,0,2,1,1,0
16108,1,300,382,65,130,157,2,92,539,4,10,5,10,14,15,41,57,2,114,6,0,2,1,1,0
16109,14,472,42,7,35,4,0,5,46,1,2,1,2,3,3,2,4,0,2,0,0,2,1,2,0
16110,14,472,11,6,10,0,0,1,11,2,4,2,4,6,6,10,15,1,15,0,0,2,1,2,0
16111,107,4012,1450,624,1228,12,26,181,1462,14,306,186,354,320,540,2580,4493,8,36391,2021,1,2,17,0,0
16112,148,4073,1660,832,1314,41,38,274,1701,20,312,209,395,332,604,2671,5058,12,64042,3557,1,2,17,1,0
16113,76,3974,1457,730,1242,11,6,188,1468,10,292,166,329,302,495,2424,4078,5,22973,1276,1,2,15,0,0
16114,37,1604,447,308,343,6,5,95,453,7,96,59,111,103,170,651,1136,4,4600,255,0,2,4,10,0
16115,15,621,722,423,573,19,0,135,741,12,172,101,199,184,300,1320,2257,6,15668,870,0,2,7,0,0
16116,346,7005,1457,730,1242,11,6,188,1468,10,292,166,329,302,495,2424,4078,5,22973,1276,1,2,24,11,0
16117,346,7005,74,35,59,1,0,14,75,3,14,7,14,17,21,58,85,1,128,7,0,2,24,11,0
16118,346,7005,245,125,200,5,7,34,250,7,30,17,34,37,51,166,265,3,1053,58,0,2,24,11,0
16119,178,4158,77,34,69,0,0,8,77,3,24,16,29,27,45,114,213,1,387,21,0,2,30,18,0
16120,178,4158,712,438,573,51,9,84,763,14,102,71,128,116,199,733,1364,8,11988,666,0,2,30,18,0
16121,46,951,447,308,343,6,5,95,453,7,96,59,111,103,170,651,1136,4,4600,255,0,2,3,3,0
16122,46,951,322,174,179,16,74,51,338,10,41,26,46,51,72,252,408,5,2291,127,0,2,3,3,0
16123,223,5060,722,423,573,19,0,135,741,12,172,101,199,184,300,1320,2257,6,15668,870,0,2,4,3,0
16124,223,5060,1508,847,911,44,250,301,1552,14,148,88,169,162,257,1120,1886,7,15077,837,0,2,4,3,0
16125,103,1959,1178,367,1042,6,15,115,1184,9,94,51,95,103,146,644,976,4,4439,246,0,2,1,1,0
16126,103,1959,177,108,140,8,0,27,185,6,30,16,32,36,48,162,248,3,794,44,0,2,1,1,0
16127,1,300,382,65,130,157,2,92,539,4,10,5,10,14,15,41,57,2,114,6,0,2,1,1,0
16128,14,472,42,7,35,4,0,5,46,1,2,1,2,3,3,2,4,0,2,0,0,2,1,2,0
16129,14,472,11,6,10,0,0,1,11,2,4,2,4,6,6,10,15,1,15,0,0,2,1,2,0
16130,107,4012,1450,624,1228,12,26,181,1462,14,306,186,354,320,540,2580,4493,8,36391,2021,1,2,17,0,0
16131,148,4073,1660,832,1314,41,38,274,1701,20,312,209,395,332,604,2671,5058,12,64042,3557,1,2,17,1,0
16132,76,3974,1457,730,1242,11,6,188,1468,10,292,166,329,302,495,2424,4078,5,22973,1276,1,2,15,0,0
16133,37,1604,447,308,343,6,5,95,453,7,96,59,111,103,170,651,1136,4,4600,255,0,2,4,10,0
16134,15,621,722,423,573,19,0,135,741,12,172,101,199,184,300,1320,2257,6,15668,870,0,2,7,0,0
16135,59,1216,1098,241,925,5,10,155,1103,7,46,25,49,53,74,273,423,3,1580,87,0,2,12,2,1
16136,59,1216,282,202,222,14,2,44,296,8,42,24,43,50,67,250,378,4,1548,86,0,2,12,2,1
16137,31,1477,1293,570,1093,25,15,163,1318,10,195,123,241,205,364,1516,2795,6,17273,959,0,2,14,0,1
16138,59,1216,1098,241,925,5,10,155,1103,7,46,25,49,53,74,273,423,3,1580,87,0,2,2,2,0
16139,59,1216,282,202,222,14,2,44,296,8,42,24,43,50,67,250,378,4,1548,86,0,2,2,2,0
16140,335,7115,72,33,56,0,4,12,72,1,1,1,1,2,2,0,2,0,1,0,0,2,1,1,0
16141,335,7115,1454,835,1044,76,110,219,1530,17,275,158,296,292,454,2297,3718,9,34017,1889,1,2,1,1,0
16142,335,7115,72,33,56,0,4,12,72,1,1,1,1,2,2,0,2,0,1,0,0,2,1,1,0
16143,335,7115,1454,835,1044,76,110,219,1530,17,275,158,296,292,454,2297,3718,9,34017,1889,1,2,1,1,0
16144,335,7115,72,33,56,0,4,12,72,1,1,1,1,2,2,0,2,0,1,0,0,2,1,1,0
16145,335,7115,1454,835,1044,76,110,219,1530,17,275,158,296,292,454,2297,3718,9,34017,1889,1,2,1,1,0
16146,62,1244,1098,241,925,5,10,155,1103,7,46,25,49,53,74,273,423,3,1580,87,0,2,19,11,1
16147,62,1244,282,202,222,14,2,44,296,8,42,24,43,50,67,250,378,4,1548,86,0,2,19,11,1
16148,31,1478,1293,570,1093,25,15,163,1318,10,195,123,241,205,364,1516,2795,6,17273,959,0,2,1,0,1
16149,337,7189,72,33,56,0,4,12,72,1,1,1,1,2,2,0,2,0,1,0,0,2,20,4,0
16150,337,7189,1454,835,1044,76,110,219,1530,17,275,158,296,292,454,2297,3718,9,34017,1889,1,2,20,4,0
16151,20,535,256,139,192,9,7,47,265,4,23,12,24,27,36,112,171,2,357,19,0,2,15,0,0
16152,31,1490,386,256,301,16,9,68,402,4,59,35,69,63,104,355,621,2,1453,80,0,2,1,2,0
16153,20,535,256,139,192,9,7,47,265,4,23,12,24,27,36,112,171,2,357,19,0,2,1,1,0
16154,337,7189,72,33,56,0,4,12,72,1,1,1,1,2,2,0,2,0,1,0,0,2,20,4,0
16155,337,7189,1454,835,1044,76,110,219,1530,17,275,158,296,292,454,2297,3718,9,34017,1889,1,2,20,4,0
16156,20,535,256,139,192,9,7,47,265,4,23,12,24,27,36,112,171,2,357,19,0,2,15,0,0
16157,31,1490,386,256,301,16,9,68,402,4,59,35,69,63,104,355,621,2,1453,80,0,2,1,2,0
16158,104,1979,1178,367,1042,6,15,115,1184,9,94,51,95,103,146,644,976,4,4439,246,0,2,2,1,1
16159,104,1979,177,108,140,8,0,27,185,6,30,16,32,36,48,162,248,3,794,44,0,2,2,1,1
16160,71,2977,1178,367,1042,6,15,115,1184,9,94,51,95,103,146,644,976,4,4439,246,0,2,23,0,0
16161,103,1969,1178,367,1042,6,15,115,1184,9,94,51,95,103,146,644,976,4,4439,246,0,2,1,1,0
16162,103,1969,177,108,140,8,0,27,185,6,30,16,32,36,48,162,248,3,794,44,0,2,1,1,0
16163,104,1979,1178,367,1042,6,15,115,1184,9,94,51,95,103,146,644,976,4,4439,246,0,2,2,1,0
16164,104,1979,177,108,140,8,0,27,185,6,30,16,32,36,48,162,248,3,794,44,0,2,2,1,0
16165,71,2977,1178,367,1042,6,15,115,1184,9,94,51,95,103,146,644,976,4,4439,246,0,2,23,0,0
16166,227,5097,4293,999,3693,19,54,507,4312,9,155,88,170,164,258,1156,1898,4,9368,520,0,2,0,2,0
16167,227,5097,1482,859,1002,125,135,219,1607,16,219,134,251,235,385,1766,3032,9,27804,1544,1,2,0,2,0
16168,227,5099,4293,999,3693,19,54,507,4312,9,155,88,170,164,258,1156,1898,4,9368,520,0,2,4,1,0
16169,227,5099,1482,859,1002,125,135,219,1607,16,219,134,251,235,385,1766,3032,9,27804,1544,1,2,4,1,0
16170,94,4250,1338,495,1086,10,64,173,1348,11,122,82,157,133,239,883,1686,7,11934,663,0,2,10,0,0
16171,227,5099,4293,999,3693,19,54,507,4312,9,155,88,170,164,258,1156,1898,4,9368,520,0,2,4,3,0
16172,227,5099,1482,859,1002,125,135,219,1607,16,219,134,251,235,385,1766,3032,9,27804,1544,1,2,4,3,0
16173,94,4250,1338,495,1086,10,64,173,1348,11,122,82,157,133,239,883,1686,7,11934,663,0,2,10,0,0
16174,227,5099,4293,999,3693,19,54,507,4312,9,155,88,170,164,258,1156,1898,4,9368,520,0,2,4,3,0
16175,227,5099,1482,859,1002,125,135,219,1607,16,219,134,251,235,385,1766,3032,9,27804,1544,1,2,4,3,0
16176,104,1979,1178,367,1042,6,15,115,1184,9,94,51,95,103,146,644,976,4,4439,246,0,2,3,2,0
16177,104,1979,177,108,140,8,0,27,185,6,30,16,32,36,48,162,248,3,794,44,0,2,3,2,0
16178,94,4250,1338,495,1086,10,64,173,1348,11,122,82,157,133,239,883,1686,7,11934,663,0,2,10,0,0
16179,71,2977,1178,367,1042,6,15,115,1184,9,94,51,95,103,146,644,976,4,4439,246,0,2,23,0,0
16180,62,1244,1098,241,925,5,10,155,1103,7,46,25,49,53,74,273,423,3,1580,87,0,2,20,2,0
16181,62,1244,282,202,222,14,2,44,296,8,42,24,43,50,67,250,378,4,1548,86,0,2,20,2,0
16182,31,1478,1293,570,1093,25,15,163,1318,10,195,123,241,205,364,1516,2795,6,17273,959,0,2,15,0,0
16183,346,6994,1457,730,1242,11,6,188,1468,10,292,166,329,302,495,2424,4078,5,22973,1276,1,2,10,9,1
16184,346,6994,74,35,59,1,0,14,75,3,14,7,14,17,21,58,85,1,128,7,0,2,10,9,1
16185,346,6994,245,125,200,5,7,34,250,7,30,17,34,37,51,166,265,3,1053,58,0,2,10,9,1
16186,78,4037,1457,730,1242,11,6,188,1468,10,292,166,329,302,495,2424,4078,5,22973,1276,1,2,15,0,1
16187,163,5074,1660,832,1314,41,38,274,1701,20,312,209,395,332,604,2671,5058,12,64042,3557,1,2,2,1,0
16188,163,5074,1057,646,719,113,100,145,1170,18,215,134,248,233,382,1740,3004,10,31186,1732,1,2,2,1,0
16189,178,4160,77,34,69,0,0,8,77,3,24,16,29,27,45,114,213,1,387,21,0,2,1,1,1
16190,178,4160,712,438,573,51,9,84,763,14,102,71,128,116,199,733,1364,8,11988,666,0,2,1,1,1
16191,222,4989,722,423,573,19,0,135,741,12,172,101,199,184,300,1320,2257,6,15668,870,0,2,1,1,0
16192,222,4989,1508,847,911,44,250,301,1552,14,148,88,169,162,257,1120,1886,7,15077,837,0,2,1,1,0
16193,16,469,442,244,305,14,16,103,456,11,68,45,75,79,120,452,756,6,4588,254,0,2,1,1,0
16194,16,469,182,102,99,11,40,35,193,3,11,6,11,14,17,42,64,1,97,5,0,2,1,1,0
16195,60,1251,996,429,845,24,10,117,1020,7,76,50,88,83,138,494,879,4,3565,198,0,2,1,1,1
16196,60,1251,456,277,329,12,42,72,468,13,85,50,97,98,147,592,972,7,7212,400,0,2,1,1,1
16197,49,573,647,139,84,35,284,233,682,0,0,0,0,0,0,0,0,0,0,0,0,2,1,1,1
16198,179,4176,77,34,69,0,0,8,77,3,24,16,29,27,45,114,213,1,387,21,0,2,1,1,1
16199,179,4176,712,438,573,51,9,84,763,14,102,71,128,116,199,733,1364,8,11988,666,0,2,1,1,1
16200,70,1304,1020,354,843,12,15,144,1032,8,134,77,144,142,221,970,1580,4,6792,377,0,2,1,1,1
16201,222,4988,722,423,573,19,0,135,741,12,172,101,199,184,300,1320,2257,6,15668,870,0,2,3,3,1
16202,222,4988,1508,847,911,44,250,301,1552,14,148,88,169,162,257,1120,1886,7,15077,837,0,2,3,3,1
16203,335,7115,72,33,56,0,4,12,72,1,1,1,1,2,2,0,2,0,1,0,0,2,1,1,1
16204,335,7115,1454,835,1044,76,110,219,1530,17,275,158,296,292,454,2297,3718,9,34017,1889,1,2,1,1,1
16205,62,1244,1098,241,925,5,10,155,1103,7,46,25,49,53,74,273,423,3,1580,87,0,2,1,1,1
16206,62,1244,282,202,222,14,2,44,296,8,42,24,43,50,67,250,378,4,1548,86,0,2,1,1,1
16207,93,3417,1450,624,1228,12,26,181,1462,14,306,186,354,320,540,2580,4493,8,36391,2021,1,2,1,1,1
16208,148,4073,1660,832,1314,41,38,274,1701,20,312,209,395,332,604,2671,5058,12,64042,3557,1,2,1,1,1
16209,116,4563,1513,682,1277,25,13,200,1538,11,199,116,219,210,335,1557,2584,6,15641,868,0,2,1,1,1
16210,25,1016,373,158,315,8,0,51,381,5,76,44,79,81,123,486,779,2,2026,112,0,2,1,1,1
16211,178,4160,77,34,69,0,0,8,77,3,24,16,29,27,45,114,213,1,387,21,0,2,1,1,0
16212,178,4160,712,438,573,51,9,84,763,14,102,71,128,116,199,733,1364,8,11988,666,0,2,1,1,0
16213,346,6994,1457,730,1242,11,6,188,1468,10,292,166,329,302,495,2424,4078,5,22973,1276,1,2,10,9,0
16214,346,6994,74,35,59,1,0,14,75,3,14,7,14,17,21,58,85,1,128,7,0,2,10,9,0
16215,346,6994,245,125,200,5,7,34,250,7,30,17,34,37,51,166,265,3,1053,58,0,2,10,9,0
16216,78,4037,1457,730,1242,11,6,188,1468,10,292,166,329,302,495,2424,4078,5,22973,1276,1,2,15,0,0
16217,222,4989,722,423,573,19,0,135,741,12,172,101,199,184,300,1320,2257,6,15668,870,0,2,1,1,0
16218,222,4989,1508,847,911,44,250,301,1552,14,148,88,169,162,257,1120,1886,7,15077,837,0,2,1,1,0
16219,16,469,442,244,305,14,16,103,456,11,68,45,75,79,120,452,756,6,4588,254,0,2,1,1,0
16220,16,469,182,102,99,11,40,35,193,3,11,6,11,14,17,42,64,1,97,5,0,2,1,1,0
16221,60,1251,996,429,845,24,10,117,1020,7,76,50,88,83,138,494,879,4,3565,198,0,2,1,1,0
16222,60,1251,456,277,329,12,42,72,468,13,85,50,97,98,147,592,972,7,7212,400,0,2,1,1,0
16223,49,573,647,139,84,35,284,233,682,0,0,0,0,0,0,0,0,0,0,0,0,2,1,1,0
16224,179,4176,77,34,69,0,0,8,77,3,24,16,29,27,45,114,213,1,387,21,0,2,1,1,0
16225,179,4176,712,438,573,51,9,84,763,14,102,71,128,116,199,733,1364,8,11988,666,0,2,1,1,0
16226,70,1304,1020,354,843,12,15,144,1032,8,134,77,144,142,221,970,1580,4,6792,377,0,2,1,1,0
16227,222,4989,722,423,573,19,0,135,741,12,172,101,199,184,300,1320,2257,6,15668,870,0,2,3,3,0
16228,222,4989,1508,847,911,44,250,301,1552,14,148,88,169,162,257,1120,1886,7,15077,837,0,2,3,3,0
16229,335,7115,72,33,56,0,4,12,72,1,1,1,1,2,2,0,2,0,1,0,0,2,1,1,0
16230,335,7115,1454,835,1044,76,110,219,1530,17,275,158,296,292,454,2297,3718,9,34017,1889,1,2,1,1,0
16231,62,1244,1098,241,925,5,10,155,1103,7,46,25,49,53,74,273,423,3,1580,87,0,2,1,1,0
16232,62,1244,282,202,222,14,2,44,296,8,42,24,43,50,67,250,378,4,1548,86,0,2,1,1,0
16233,93,3417,1450,624,1228,12,26,181,1462,14,306,186,354,320,540,2580,4493,8,36391,2021,1,2,1,1,0
16234,148,4073,1660,832,1314,41,38,274,1701,20,312,209,395,332,604,2671,5058,12,64042,3557,1,2,1,1,0
16235,116,4563,1513,682,1277,25,13,200,1538,11,199,116,219,210,335,1557,2584,6,15641,868,0,2,1,1,0
16236,25,1016,373,158,315,8,0,51,381,5,76,44,79,81,123,486,779,2,2026,112,0,2,1,1,0
16237,60,1092,282,196,195,3,0,86,285,8,130,71,141,138,212,936,1507,4,6538,363,0,2,6,6,1
16238,7,114,44,19,17,0,16,11,44,3,14,7,14,17,21,58,85,1,128,7,0,2,1,1,1
16239,3,66,127,75,83,2,11,30,129,4,14,7,14,18,21,61,87,2,175,9,0,2,1,1,1
16240,3,66,652,304,544,16,6,88,668,6,89,51,101,95,152,591,998,3,3399,188,0,2,1,1,1
16241,3,66,2,2,2,0,0,0,2,0,0,0,0,0,0,0,0,0,0,0,0,2,1,1,1
16242,3,66,8,5,5,0,0,3,8,0,0,0,0,0,0,0,0,0,0,0,0,2,1,1,1
16243,3,66,2,2,2,0,0,0,2,0,0,0,0,0,0,0,0,0,0,0,0,2,1,1,1
16244,3,66,14,8,8,0,0,6,14,0,0,0,0,0,0,0,0,0,0,0,0,2,1,1,1
16245,3,66,6,4,4,0,0,2,6,0,0,0,0,0,0,0,0,0,0,0,0,2,1,1,1
16246,3,66,6,4,4,0,0,2,6,1,2,1,2,3,3,2,4,0,2,0,0,2,1,1,1
16247,3,66,6,4,4,0,0,2,6,0,0,0,0,0,0,0,0,0,0,0,0,2,1,1,1
16248,3,66,7,5,5,0,0,2,7,0,0,0,0,0,0,0,0,0,0,0,0,2,1,1,1
16249,3,66,6,4,4,0,0,2,6,0,0,0,0,0,0,0,0,0,0,0,0,2,1,1,1
16250,3,66,10,6,6,0,0,4,10,0,0,0,0,0,0,0,0,0,0,0,0,2,1,1,1
16251,3,66,1,1,1,0,0,0,1,0,0,0,0,0,0,0,0,0,0,0,0,2,1,1,1
16252,3,66,1,1,1,0,0,0,1,0,0,0,0,0,0,0,0,0,0,0,0,2,1,1,1
16253,3,66,14,10,10,0,0,4,14,1,1,1,1,2,2,0,2,0,1,0,0,2,1,1,1
16254,3,66,46,26,30,3,0,12,49,3,6,3,6,9,9,20,28,1,42,2,0,2,1,1,1
16255,7,301,72,33,56,0,4,12,72,1,1,1,1,2,2,0,2,0,1,0,0,2,1,1,1
16256,3,26,14,7,7,2,0,5,16,0,0,0,0,0,0,0,0,0,0,0,0,2,1,1,1
16257,78,3306,1289,550,1043,56,32,155,1345,10,167,93,185,177,278,1266,2075,5,11498,638,0,2,5,5,1
16258,34,989,182,127,129,0,0,53,182,5,39,21,42,44,63,217,343,2,926,51,0,2,3,3,1
16259,137,6592,1392,870,1177,35,17,170,1427,14,494,280,531,508,811,4473,7289,7,54850,3047,2,2,4,4,1
16260,91,3003,773,419,590,28,0,166,801,10,204,113,217,214,330,1598,2554,5,13587,754,0,2,11,11,1
16261,7,255,75,38,59,1,3,12,76,2,4,2,4,6,6,10,15,1,15,0,0,2,1,1,1
16262,47,2498,520,294,400,33,13,81,553,10,261,204,367,271,571,2128,4614,7,32445,1802,1,2,1,1,1
16263,93,4253,1338,495,1086,10,64,173,1348,11,122,82,157,133,239,883,1686,7,11934,663,0,2,24,24,1
16264,147,6760,139,89,101,2,0,35,141,7,54,34,62,61,96,330,569,4,2287,127,0,2,49,49,1
16265,147,6760,7,5,5,0,0,2,7,1,2,1,2,3,3,2,4,0,2,0,0,2,49,49,1
16266,32,948,465,148,393,5,8,60,470,4,31,20,31,35,51,161,261,2,523,29,0,2,9,9,1
16267,32,948,16,12,9,0,0,6,16,1,2,1,2,3,3,2,4,0,2,0,0,2,9,9,1
16268,109,5462,1782,648,1425,9,47,279,1791,8,171,97,189,179,286,1292,2140,4,9462,525,0,2,16,16,1
16269,20,541,256,139,192,9,7,47,265,4,23,12,24,27,36,112,171,2,357,19,0,2,2,2,1
16270,23,597,102,59,69,5,3,24,107,6,22,15,28,28,43,113,206,3,789,43,0,2,1,1,1
16271,107,4030,1450,624,1228,12,26,181,1462,14,306,186,354,320,540,2580,4493,8,36391,2021,1,2,8,8,1
16272,148,4080,1660,832,1314,41,38,274,1701,20,312,209,395,332,604,2671,5058,12,64042,3557,1,2,5,5,1
16273,116,4587,1513,682,1277,25,13,200,1538,11,199,116,219,210,335,1557,2584,6,15641,868,0,2,8,8,1
16274,59,3302,1296,573,1062,40,33,157,1336,8,201,118,231,209,349,1561,2689,4,12365,686,0,2,19,19,1
16275,76,4022,1457,730,1242,11,6,188,1468,10,292,166,329,302,495,2424,4078,5,22973,1276,1,2,16,16,1
16276,38,2278,652,304,544,16,6,88,668,6,89,51,101,95,152,591,998,3,3399,188,0,2,4,4,1
16277,62,2870,1455,414,1257,16,76,112,1471,5,41,23,46,46,69,231,381,2,1069,59,0,2,9,9,1
16278,82,4156,1523,757,1297,19,12,193,1542,12,193,117,230,205,347,1508,2664,7,19053,1058,0,2,6,6,1
16279,66,2759,1020,354,843,12,15,144,1032,8,134,77,144,142,221,970,1580,4,6792,377,0,2,15,15,1
16280,37,1616,447,308,343,6,5,95,453,7,96,59,111,103,170,651,1136,4,4600,255,0,2,4,4,1
16281,21,653,424,94,331,4,0,89,428,1,5,5,5,6,10,11,25,0,12,0,0,2,5,5,1
16282,40,2355,334,251,279,10,4,40,344,5,127,74,143,132,217,899,1528,2,4303,239,0,2,2,2,1
16283,12,484,184,100,137,2,15,30,186,6,38,20,39,44,59,214,322,3,991,55,0,2,3,3,1
16284,34,1565,1293,570,1093,25,15,163,1318,10,195,123,241,205,364,1516,2795,6,17273,959,0,2,3,3,1
16285,36,1970,384,251,317,7,8,52,391,11,70,44,84,81,128,467,811,6,5355,297,0,2,10,10,1
16286,15,630,722,423,573,19,0,135,741,12,172,101,199,184,300,1320,2257,6,15668,870,0,2,3,3,1
16287,16,1201,215,129,180,6,0,29,221,8,65,43,72,73,115,415,711,4,3153,175,0,2,1,1,1
16288,69,2852,1043,504,840,53,9,147,1096,9,180,112,198,189,310,1377,2344,4,11604,644,0,2,9,9,1
16289,14,520,295,56,236,0,4,54,295,2,9,5,10,11,15,30,51,1,57,3,0,2,8,8,1
16290,25,1019,373,158,315,8,0,51,381,5,76,44,79,81,123,486,779,2,2026,112,0,2,6,6,1
16291,68,2947,1178,367,1042,6,15,115,1184,9,94,51,95,103,146,644,976,4,4439,246,0,2,10,10,1
16292,72,3682,1943,715,1694,26,18,214,1969,12,185,120,237,197,357,1436,2721,7,20915,1161,0,2,13,13,1
16293,14,817,442,244,305,14,16,103,456,11,68,45,75,79,120,452,756,6,4588,254,0,2,2,2,1
16294,48,1776,1098,241,925,5,10,155,1103,7,46,25,49,53,74,273,423,3,1580,87,0,2,2,2,1
16295,60,1092,282,196,195,3,0,86,285,8,130,71,141,138,212,936,1507,4,6538,363,0,2,6,6,0
16296,7,114,44,19,17,0,16,11,44,3,14,7,14,17,21,58,85,1,128,7,0,2,1,1,0
16297,3,66,127,75,83,2,11,30,129,4,14,7,14,18,21,61,87,2,175,9,0,2,1,1,0
16298,3,66,652,304,544,16,6,88,668,6,89,51,101,95,152,591,998,3,3399,188,0,2,1,1,0
16299,3,66,2,2,2,0,0,0,2,0,0,0,0,0,0,0,0,0,0,0,0,2,1,1,0
16300,3,66,8,5,5,0,0,3,8,0,0,0,0,0,0,0,0,0,0,0,0,2,1,1,0
16301,3,66,2,2,2,0,0,0,2,0,0,0,0,0,0,0,0,0,0,0,0,2,1,1,0
16302,3,66,14,8,8,0,0,6,14,0,0,0,0,0,0,0,0,0,0,0,0,2,1,1,0
16303,3,66,6,4,4,0,0,2,6,0,0,0,0,0,0,0,0,0,0,0,0,2,1,1,0
16304,3,66,6,4,4,0,0,2,6,1,2,1,2,3,3,2,4,0,2,0,0,2,1,1,0
16305,3,66,6,4,4,0,0,2,6,0,0,0,0,0,0,0,0,0,0,0,0,2,1,1,0
16306,3,66,7,5,5,0,0,2,7,0,0,0,0,0,0,0,0,0,0,0,0,2,1,1,0
16307,3,66,6,4,4,0,0,2,6,0,0,0,0,0,0,0,0,0,0,0,0,2,1,1,0
16308,3,66,10,6,6,0,0,4,10,0,0,0,0,0,0,0,0,0,0,0,0,2,1,1,0
16309,3,66,1,1,1,0,0,0,1,0,0,0,0,0,0,0,0,0,0,0,0,2,1,1,0
16310,3,66,1,1,1,0,0,0,1,0,0,0,0,0,0,0,0,0,0,0,0,2,1,1,0
16311,3,66,14,10,10,0,0,4,14,1,1,1,1,2,2,0,2,0,1,0,0,2,1,1,0
16312,3,66,46,26,30,3,0,12,49,3,6,3,6,9,9,20,28,1,42,2,0,2,1,1,0
16313,7,301,72,33,56,0,4,12,72,1,1,1,1,2,2,0,2,0,1,0,0,2,1,1,0
16314,3,26,14,7,7,2,0,5,16,0,0,0,0,0,0,0,0,0,0,0,0,2,1,1,0
16315,78,3306,1289,550,1043,56,32,155,1345,10,167,93,185,177,278,1266,2075,5,11498,638,0,2,5,5,0
16316,34,989,182,127,129,0,0,53,182,5,39,21,42,44,63,217,343,2,926,51,0,2,3,3,0
16317,137,6592,1392,870,1177,35,17,170,1427,14,494,280,531,508,811,4473,7289,7,54850,3047,2,2,4,4,0
16318,91,3003,773,419,590,28,0,166,801,10,204,113,217,214,330,1598,2554,5,13587,754,0,2,11,11,0
16319,7,255,75,38,59,1,3,12,76,2,4,2,4,6,6,10,15,1,15,0,0,2,1,1,0
16320,47,2498,520,294,400,33,13,81,553,10,261,204,367,271,571,2128,4614,7,32445,1802,1,2,1,1,0
16321,93,4253,1338,495,1086,10,64,173,1348,11,122,82,157,133,239,883,1686,7,11934,663,0,2,24,24,0
16322,147,6760,139,89,101,2,0,35,141,7,54,34,62,61,96,330,569,4,2287,127,0,2,49,49,0
16323,147,6760,7,5,5,0,0,2,7,1,2,1,2,3,3,2,4,0,2,0,0,2,49,49,0
16324,32,948,465,148,393,5,8,60,470,4,31,20,31,35,51,161,261,2,523,29,0,2,9,9,0
16325,32,948,16,12,9,0,0,6,16,1,2,1,2,3,3,2,4,0,2,0,0,2,9,9,0
16326,109,5462,1782,648,1425,9,47,279,1791,8,171,97,189,179,286,1292,2140,4,9462,525,0,2,16,16,0
16327,20,541,256,139,192,9,7,47,265,4,23,12,24,27,36,112,171,2,357,19,0,2,2,2,0
16328,23,597,102,59,69,5,3,24,107,6,22,15,28,28,43,113,206,3,789,43,0,2,1,1,0
16329,107,4030,1450,624,1228,12,26,181,1462,14,306,186,354,320,540,2580,4493,8,36391,2021,1,2,8,8,0
16330,148,4080,1660,832,1314,41,38,274,1701,20,312,209,395,332,604,2671,5058,12,64042,3557,1,2,5,5,0
16331,116,4587,1513,682,1277,25,13,200,1538,11,199,116,219,210,335,1557,2584,6,15641,868,0,2,8,8,0
16332,59,3302,1296,573,1062,40,33,157,1336,8,201,118,231,209,349,1561,2689,4,12365,686,0,2,19,19,0
16333,76,4022,1457,730,1242,11,6,188,1468,10,292,166,329,302,495,2424,4078,5,22973,1276,1,2,16,16,0
16334,38,2278,652,304,544,16,6,88,668,6,89,51,101,95,152,591,998,3,3399,188,0,2,4,4,0
16335,62,2870,1455,414,1257,16,76,112,1471,5,41,23,46,46,69,231,381,2,1069,59,0,2,9,9,0
16336,82,4156,1523,757,1297,19,12,193,1542,12,193,117,230,205,347,1508,2664,7,19053,1058,0,2,6,6,0
16337,66,2759,1020,354,843,12,15,144,1032,8,134,77,144,142,221,970,1580,4,6792,377,0,2,15,15,0
16338,37,1616,447,308,343,6,5,95,453,7,96,59,111,103,170,651,1136,4,4600,255,0,2,4,4,0
16339,21,653,424,94,331,4,0,89,428,1,5,5,5,6,10,11,25,0,12,0,0,2,5,5,0
16340,40,2355,334,251,279,10,4,40,344,5,127,74,143,132,217,899,1528,2,4303,239,0,2,2,2,0
16341,12,484,184,100,137,2,15,30,186,6,38,20,39,44,59,214,322,3,991,55,0,2,3,3,0
16342,34,1565,1293,570,1093,25,15,163,1318,10,195,123,241,205,364,1516,2795,6,17273,959,0,2,3,3,0
16343,36,1970,384,251,317,7,8,52,391,11,70,44,84,81,128,467,811,6,5355,297,0,2,10,10,0
16344,15,630,722,423,573,19,0,135,741,12,172,101,199,184,300,1320,2257,6,15668,870,0,2,3,3,0
16345,16,1201,215,129,180,6,0,29,221,8,65,43,72,73,115,415,711,4,3153,175,0,2,1,1,0
16346,69,2852,1043,504,840,53,9,147,1096,9,180,112,198,189,310,1377,2344,4,11604,644,0,2,9,9,0
16347,14,520,295,56,236,0,4,54,295,2,9,5,10,11,15,30,51,1,57,3,0,2,8,8,0
16348,25,1019,373,158,315,8,0,51,381,5,76,44,79,81,123,486,779,2,2026,112,0,2,6,6,0
16349,68,2947,1178,367,1042,6,15,115,1184,9,94,51,95,103,146,644,976,4,4439,246,0,2,10,10,0
16350,72,3682,1943,715,1694,26,18,214,1969,12,185,120,237,197,357,1436,2721,7,20915,1161,0,2,13,13,0
16351,14,817,442,244,305,14,16,103,456,11,68,45,75,79,120,452,756,6,4588,254,0,2,2,2,0
16352,48,1776,1098,241,925,5,10,155,1103,7,46,25,49,53,74,273,423,3,1580,87,0,2,2,2,0
16353,49,573,647,139,84,35,284,233,682,0,0,0,0,0,0,0,0,0,0,0,0,2,1,1,0
16354,49,573,647,139,84,35,284,233,682,0,0,0,0,0,0,0,0,0,0,0,0,2,8,1,0
16355,49,573,647,139,84,35,284,233,682,0,0,0,0,0,0,0,0,0,0,0,0,2,9,2,0
16356,9,223,19,8,11,5,0,4,24,2,5,3,6,7,9,13,25,1,30,1,0,2,1,1,0
16357,9,223,102,59,69,5,3,24,107,6,22,15,28,28,43,113,206,3,789,43,0,2,1,1,0
16358,9,223,106,40,36,3,49,17,109,8,17,13,23,25,36,93,167,5,904,50,0,2,1,1,0
16359,99,2075,773,419,590,28,0,166,801,10,204,113,217,214,330,1598,2554,5,13587,754,0,2,0,9,0
16360,99,2075,421,273,302,44,34,57,465,17,81,59,107,98,166,583,1098,11,12329,684,0,2,0,9,0
16361,28,548,2,2,2,0,0,0,2,0,0,0,0,0,0,0,0,0,0,0,0,2,2,2,0
16362,28,548,99,48,90,1,3,5,100,0,0,0,0,0,0,0,0,0,0,0,0,2,2,2,0
16363,28,548,8,5,5,2,0,1,10,0,0,0,0,0,0,0,0,0,0,0,0,2,2,2,0
16364,28,548,1217,716,841,84,126,174,1301,14,185,118,215,199,333,1446,2542,8,20687,1149,0,2,2,2,0
16365,28,548,160,89,115,0,13,31,160,7,15,11,17,22,28,78,124,3,495,27,0,2,2,2,0
16366,28,548,10,10,9,9,0,0,19,0,0,0,0,0,0,0,0,0,0,0,0,2,2,2,0
16367,28,548,173,84,99,8,29,36,181,5,12,7,13,17,20,54,81,2,221,12,0,2,2,2,0
16368,28,548,3,1,1,3,0,0,6,0,0,0,0,0,0,0,0,0,0,0,0,2,2,2,0
16369,162,5067,1660,832,1314,41,38,274,1701,20,312,209,395,332,604,2671,5058,12,64042,3557,1,2,10,6,0
16370,162,5067,1057,646,719,113,100,145,1170,18,215,134,248,233,382,1740,3004,10,31186,1732,1,2,10,6,0
16371,60,1254,996,429,845,24,10,117,1020,7,76,50,88,83,138,494,879,4,3565,198,0,2,1,1,0
16372,60,1254,456,277,329,12,42,72,468,13,85,50,97,98,147,592,972,7,7212,400,0,2,1,1,0
16373,119,2420,1513,682,1277,25,13,200,1538,11,199,116,219,210,335,1557,2584,6,15641,868,0,2,6,6,0
16374,119,2420,819,519,539,24,98,155,843,15,96,57,106,111,163,690,1107,8,9171,509,0,2,6,6,0
16375,48,948,207,111,150,11,0,50,218,5,26,19,36,31,55,133,272,3,943,52,0,2,29,8,0
16376,48,948,410,198,237,31,55,97,441,11,63,38,72,74,110,414,683,6,4293,238,0,2,29,8,0
16377,346,7005,1457,730,1242,11,6,188,1468,10,292,166,329,302,495,2424,4078,5,22973,1276,1,2,87,33,0
16378,346,7005,74,35,59,1,0,14,75,3,14,7,14,17,21,58,85,1,128,7,0,2,87,33,0
16379,346,7005,245,125,200,5,7,34,250,7,30,17,34,37,51,166,265,3,1053,58,0,2,87,33,0
16380,22,679,339,213,244,17,9,65,356,10,42,26,48,52,74,259,421,5,2410,133,0,2,2,2,0
16381,56,1599,1455,414,1257,16,76,112,1471,5,41,23,46,46,69,231,381,2,1069,59,0,2,3,2,0
16382,56,1599,669,365,481,22,61,110,691,15,103,63,122,118,185,747,1273,8,11311,628,0,2,3,2,0
16383,228,5119,4293,999,3693,19,54,507,4312,9,155,88,170,164,258,1156,1898,4,9368,520,0,2,6,6,0
16384,228,5119,1482,859,1002,125,135,219,1607,16,219,134,251,235,385,1766,3032,9,27804,1544,1,2,6,6,0
16385,24,834,74,35,59,1,0,14,75,3,14,7,14,17,21,58,85,1,128,7,0,2,1,1,0
16386,24,834,245,125,200,5,7,34,250,7,30,17,34,37,51,166,265,3,1053,58,0,2,1,1,0
16387,49,575,647,139,84,35,284,233,682,0,0,0,0,0,0,0,0,0,0,0,0,2,2,1,0
16388,72,2129,1523,757,1297,19,12,193,1542,12,193,117,230,205,347,1508,2664,7,19053,1058,0,2,3,0,0
16389,72,2129,701,378,504,33,58,109,734,13,110,68,126,123,194,794,1346,7,10027,557,0,2,3,0,0
16390,178,4160,77,34,69,0,0,8,77,3,24,16,29,27,45,114,213,1,387,21,0,2,49,40,0
16391,178,4160,712,438,573,51,9,84,763,14,102,71,128,116,199,733,1364,8,11988,666,0,2,49,40,0
16392,69,1359,1020,354,843,12,15,144,1032,8,134,77,144,142,221,970,1580,4,6792,377,0,2,4,4,0
16393,46,951,447,308,343,6,5,95,453,7,96,59,111,103,170,651,1136,4,4600,255,0,2,5,5,0
16394,46,951,322,174,179,16,74,51,338,10,41,26,46,51,72,252,408,5,2291,127,0,2,5,5,0
16395,223,5060,722,423,573,19,0,135,741,12,172,101,199,184,300,1320,2257,6,15668,870,0,2,18,16,0
16396,223,5060,1508,847,911,44,250,301,1552,14,148,88,169,162,257,1120,1886,7,15077,837,0,2,18,16,0
16397,337,7189,72,33,56,0,4,12,72,1,1,1,1,2,2,0,2,0,1,0,0,2,38,17,0
16398,337,7189,1454,835,1044,76,110,219,1530,17,275,158,296,292,454,2297,3718,9,34017,1889,1,2,38,17,0
16399,41,943,386,256,301,16,9,68,402,4,59,35,69,63,104,355,621,2,1453,80,0,2,6,2,0
16400,41,943,264,131,164,11,41,46,275,6,38,22,40,44,62,214,338,3,1068,59,0,2,6,2,0
16401,128,2818,1043,504,840,53,9,147,1096,9,180,112,198,189,310,1377,2344,4,11604,644,0,2,2,2,0
16402,128,2818,383,288,292,26,6,62,409,11,65,38,67,76,105,429,656,5,3719,206,0,2,2,2,0
16403,20,400,294,64,250,0,0,43,294,1,20,10,20,21,30,86,131,0,65,3,0,2,2,2,0
16404,20,400,78,46,62,3,0,14,81,3,8,4,8,11,12,28,41,1,62,3,0,2,2,2,0
16405,103,1959,1178,367,1042,6,15,115,1184,9,94,51,95,103,146,644,976,4,4439,246,0,2,2,2,0
16406,103,1959,177,108,140,8,0,27,185,6,30,16,32,36,48,162,248,3,794,44,0,2,2,2,0
16407,184,3747,1943,715,1694,26,18,214,1969,12,185,120,237,197,357,1436,2721,7,20915,1161,0,2,2,2,0
16408,184,3747,1168,838,957,57,25,144,1225,19,348,224,416,367,640,3018,5452,11,61921,3440,1,2,2,2,0
16409,16,471,442,244,305,14,16,103,456,11,68,45,75,79,120,452,756,6,4588,254,0,2,1,1,0
16410,16,471,182,102,99,11,40,35,193,3,11,6,11,14,17,42,64,1,97,5,0,2,1,1,0
16411,1,300,382,65,130,157,2,92,539,4,10,5,10,14,15,41,57,2,114,6,0,2,1,1,0
16412,60,1092,282,196,195,3,0,86,285,8,130,71,141,138,212,936,1507,4,6538,363,0,2,6,6,0
16413,7,114,44,19,17,0,16,11,44,3,14,7,14,17,21,58,85,1,128,7,0,2,1,1,0
16414,3,66,127,75,83,2,11,30,129,4,14,7,14,18,21,61,87,2,175,9,0,2,1,1,0
16415,3,66,652,304,544,16,6,88,668,6,89,51,101,95,152,591,998,3,3399,188,0,2,1,1,0
16416,3,66,2,2,2,0,0,0,2,0,0,0,0,0,0,0,0,0,0,0,0,2,1,1,0
16417,3,66,8,5,5,0,0,3,8,0,0,0,0,0,0,0,0,0,0,0,0,2,1,1,0
16418,3,66,2,2,2,0,0,0,2,0,0,0,0,0,0,0,0,0,0,0,0,2,1,1,0
16419,3,66,14,8,8,0,0,6,14,0,0,0,0,0,0,0,0,0,0,0,0,2,1,1,0
16420,3,66,6,4,4,0,0,2,6,0,0,0,0,0,0,0,0,0,0,0,0,2,1,1,0
16421,3,66,6,4,4,0,0,2,6,1,2,1,2,3,3,2,4,0,2,0,0,2,1,1,0
16422,3,66,6,4,4,0,0,2,6,0,0,0,0,0,0,0,0,0,0,0,0,2,1,1,0
16423,3,66,7,5,5,0,0,2,7,0,0,0,0,0,0,0,0,0,0,0,0,2,1,1,0
16424,3,66,6,4,4,0,0,2,6,0,0,0,0,0,0,0,0,0,0,0,0,2,1,1,0
16425,3,66,10,6,6,0,0,4,10,0,0,0,0,0,0,0,0,0,0,0,0,2,1,1,0
16426,3,66,1,1,1,0,0,0,1,0,0,0,0,0,0,0,0,0,0,0,0,2,1,1,0
16427,3,66,1,1,1,0,0,0,1,0,0,0,0,0,0,0,0,0,0,0,0,2,1,1,0
16428,3,66,14,10,10,0,0,4,14,1,1,1,1,2,2,0,2,0,1,0,0,2,1,1,0
16429,3,66,46,26,30,3,0,12,49,3,6,3,6,9,9,20,28,1,42,2,0,2,1,1,0
16430,7,301,72,33,56,0,4,12,72,1,1,1,1,2,2,0,2,0,1,0,0,2,1,1,0
16431,3,26,14,7,7,2,0,5,16,0,0,0,0,0,0,0,0,0,0,0,0,2,1,1,0
16432,14,472,42,7,35,4,0,5,46,1,2,1,2,3,3,2,4,0,2,0,0,2,2,3,0
16433,14,472,11,6,10,0,0,1,11,2,4,2,4,6,6,10,15,1,15,0,0,2,2,3,0
16434,78,3306,1289,550,1043,56,32,155,1345,10,167,93,185,177,278,1266,2075,5,11498,638,0,2,5,5,0
16435,34,989,182,127,129,0,0,53,182,5,39,21,42,44,63,217,343,2,926,51,0,2,3,3,0
16436,137,6592,1392,870,1177,35,17,170,1427,14,494,280,531,508,811,4473,7289,7,54850,3047,2,2,4,4,0
16437,91,3003,773,419,590,28,0,166,801,10,204,113,217,214,330,1598,2554,5,13587,754,0,2,11,11,0
16438,7,255,75,38,59,1,3,12,76,2,4,2,4,6,6,10,15,1,15,0,0,2,1,1,0
16439,47,2498,520,294,400,33,13,81,553,10,261,204,367,271,571,2128,4614,7,32445,1802,1,2,34,8,0
16440,93,4253,1338,495,1086,10,64,173,1348,11,122,82,157,133,239,883,1686,7,11934,663,0,2,24,24,0
16441,147,6760,139,89,101,2,0,35,141,7,54,34,62,61,96,330,569,4,2287,127,0,2,49,49,0
16442,147,6760,7,5,5,0,0,2,7,1,2,1,2,3,3,2,4,0,2,0,0,2,49,49,0
16443,32,948,465,148,393,5,8,60,470,4,31,20,31,35,51,161,261,2,523,29,0,2,9,9,0
16444,32,948,16,12,9,0,0,6,16,1,2,1,2,3,3,2,4,0,2,0,0,2,9,9,0
16445,109,5462,1782,648,1425,9,47,279,1791,8,171,97,189,179,286,1292,2140,4,9462,525,0,2,88,25,0
16446,20,541,256,139,192,9,7,47,265,4,23,12,24,27,36,112,171,2,357,19,0,2,17,2,0
16447,23,597,102,59,69,5,3,24,107,6,22,15,28,28,43,113,206,3,789,43,0,2,1,1,0
16448,107,4030,1450,624,1228,12,26,181,1462,14,306,186,354,320,540,2580,4493,8,36391,2021,1,2,25,8,0
16449,148,4080,1660,832,1314,41,38,274,1701,20,312,209,395,332,604,2671,5058,12,64042,3557,1,2,62,5,0
16450,116,4587,1513,682,1277,25,13,200,1538,11,199,116,219,210,335,1557,2584,6,15641,868,0,2,8,8,0
16451,59,3302,1296,573,1062,40,33,157,1336,8,201,118,231,209,349,1561,2689,4,12365,686,0,2,34,18,0
16452,10,228,207,111,150,11,0,50,218,5,26,19,36,31,55,133,272,3,943,52,0,0,75,0,0
16453,76,4022,1457,730,1242,11,6,188,1468,10,292,166,329,302,495,2424,4078,5,22973,1276,1,2,72,17,0
16454,38,2278,652,304,544,16,6,88,668,6,89,51,101,95,152,591,998,3,3399,188,0,2,29,4,0
16455,62,2870,1455,414,1257,16,76,112,1471,5,41,23,46,46,69,231,381,2,1069,59,0,2,41,12,0
16456,82,4156,1523,757,1297,19,12,193,1542,12,193,117,230,205,347,1508,2664,7,19053,1058,0,2,22,6,0
16457,66,2759,1020,354,843,12,15,144,1032,8,134,77,144,142,221,970,1580,4,6792,377,0,2,15,15,0
16458,37,1616,447,308,343,6,5,95,453,7,96,59,111,103,170,651,1136,4,4600,255,0,2,8,14,0
16459,21,653,424,94,331,4,0,89,428,1,5,5,5,6,10,11,25,0,12,0,0,2,5,5,0
16460,40,2355,334,251,279,10,4,40,344,5,127,74,143,132,217,899,1528,2,4303,239,0,2,2,2,0
16461,12,484,184,100,137,2,15,30,186,6,38,20,39,44,59,214,322,3,991,55,0,2,3,3,0
16462,34,1565,1293,570,1093,25,15,163,1318,10,195,123,241,205,364,1516,2795,6,17273,959,0,2,3,3,0
16463,36,1970,384,251,317,7,8,52,391,11,70,44,84,81,128,467,811,6,5355,297,0,2,31,11,0
16464,15,630,722,423,573,19,0,135,741,12,172,101,199,184,300,1320,2257,6,15668,870,0,2,10,3,0
16465,31,1490,386,256,301,16,9,68,402,4,59,35,69,63,104,355,621,2,1453,80,0,2,50,6,0
16466,16,1201,215,129,180,6,0,29,221,8,65,43,72,73,115,415,711,4,3153,175,0,2,1,1,0
16467,69,2852,1043,504,840,53,9,147,1096,9,180,112,198,189,310,1377,2344,4,11604,644,0,2,9,9,0
16468,14,520,295,56,236,0,4,54,295,2,9,5,10,11,15,30,51,1,57,3,0,2,8,8,0
16469,25,1019,373,158,315,8,0,51,381,5,76,44,79,81,123,486,779,2,2026,112,0,2,6,6,0
16470,68,2947,1178,367,1042,6,15,115,1184,9,94,51,95,103,146,644,976,4,4439,246,0,2,10,10,0
16471,72,3682,1943,715,1694,26,18,214,1969,12,185,120,237,197,357,1436,2721,7,20915,1161,0,2,13,13,0
16472,14,817,442,244,305,14,16,103,456,11,68,45,75,79,120,452,756,6,4588,254,0,2,2,2,0
16473,48,1776,1098,241,925,5,10,155,1103,7,46,25,49,53,74,273,423,3,1580,87,0,2,2,2,0
16474,14,367,601,196,481,2,23,85,603,8,63,36,72,71,108,400,664,4,3036,168,0,2,5,23,1
16475,14,367,156,79,106,5,16,28,161,5,14,8,15,19,23,64,97,2,261,14,0,2,5,23,1
16476,8,213,601,196,481,2,23,85,603,8,63,36,72,71,108,400,664,4,3036,168,0,2,3,3,1
16477,71,2109,1523,757,1297,19,12,193,1542,12,193,117,230,205,347,1508,2664,7,19053,1058,0,2,4,5,0
16478,71,2109,701,378,504,33,58,109,734,13,110,68,126,123,194,794,1346,7,10027,557,0,2,4,5,0
16479,82,4086,1523,757,1297,19,12,193,1542,12,193,117,230,205,347,1508,2664,7,19053,1058,0,2,19,0,0
16480,71,2109,1523,757,1297,19,12,193,1542,12,193,117,230,205,347,1508,2664,7,19053,1058,0,2,4,5,0
16481,71,2109,701,378,504,33,58,109,734,13,110,68,126,123,194,794,1346,7,10027,557,0,2,4,5,0
16482,82,4086,1523,757,1297,19,12,193,1542,12,193,117,230,205,347,1508,2664,7,19053,1058,0,2,19,0,0
16483,119,2420,1513,682,1277,25,13,200,1538,11,199,116,219,210,335,1557,2584,6,15641,868,0,2,2,2,1
16484,119,2420,819,519,539,24,98,155,843,15,96,57,106,111,163,690,1107,8,9171,509,0,2,2,2,1
16485,50,1024,207,111,150,11,0,50,218,5,26,19,36,31,55,133,272,3,943,52,0,2,16,0,1
16486,50,1024,410,198,237,31,55,97,441,11,63,38,72,74,110,414,683,6,4293,238,0,2,16,0,1
16487,117,4639,1513,682,1277,25,13,200,1538,11,199,116,219,210,335,1557,2584,6,15641,868,0,2,18,6,1
16488,223,5077,722,423,573,19,0,135,741,12,172,101,199,184,300,1320,2257,6,15668,870,0,2,5,2,0
16489,223,5077,1508,847,911,44,250,301,1552,14,148,88,169,162,257,1120,1886,7,15077,837,0,2,5,2,0
16490,119,2420,1513,682,1277,25,13,200,1538,11,199,116,219,210,335,1557,2584,6,15641,868,0,2,2,2,0
16491,119,2420,819,519,539,24,98,155,843,15,96,57,106,111,163,690,1107,8,9171,509,0,2,2,2,0
16492,50,1024,207,111,150,11,0,50,218,5,26,19,36,31,55,133,272,3,943,52,0,2,16,0,0
16493,50,1024,410,198,237,31,55,97,441,11,63,38,72,74,110,414,683,6,4293,238,0,2,16,0,0
16494,223,5077,722,423,573,19,0,135,741,12,172,101,199,184,300,1320,2257,6,15668,870,0,2,5,2,0
16495,223,5077,1508,847,911,44,250,301,1552,14,148,88,169,162,257,1120,1886,7,15077,837,0,2,5,2,0
16496,117,4639,1513,682,1277,25,13,200,1538,11,199,116,219,210,335,1557,2584,6,15641,868,0,2,18,6,0
16497,60,1251,996,429,845,24,10,117,1020,7,76,50,88,83,138,494,879,4,3565,198,0,2,1,1,0
16498,60,1251,456,277,329,12,42,72,468,13,85,50,97,98,147,592,972,7,7212,400,0,2,1,1,0
16499,346,6994,1457,730,1242,11,6,188,1468,10,292,166,329,302,495,2424,4078,5,22973,1276,1,2,10,9,0
16500,346,6994,74,35,59,1,0,14,75,3,14,7,14,17,21,58,85,1,128,7,0,2,10,9,0
16501,346,6994,245,125,200,5,7,34,250,7,30,17,34,37,51,166,265,3,1053,58,0,2,10,9,0
16502,49,573,647,139,84,35,284,233,682,0,0,0,0,0,0,0,0,0,0,0,0,2,10,3,0
16503,71,2109,1523,757,1297,19,12,193,1542,12,193,117,230,205,347,1508,2664,7,19053,1058,0,2,4,5,0
16504,71,2109,701,378,504,33,58,109,734,13,110,68,126,123,194,794,1346,7,10027,557,0,2,4,5,0
16505,179,4176,77,34,69,0,0,8,77,3,24,16,29,27,45,114,213,1,387,21,0,2,1,1,0
16506,179,4176,712,438,573,51,9,84,763,14,102,71,128,116,199,733,1364,8,11988,666,0,2,1,1,0
16507,70,1304,1020,354,843,12,15,144,1032,8,134,77,144,142,221,970,1580,4,6792,377,0,2,1,1,0
16508,222,4989,722,423,573,19,0,135,741,12,172,101,199,184,300,1320,2257,6,15668,870,0,2,4,4,0
16509,222,4989,1508,847,911,44,250,301,1552,14,148,88,169,162,257,1120,1886,7,15077,837,0,2,4,4,0
16510,335,7115,72,33,56,0,4,12,72,1,1,1,1,2,2,0,2,0,1,0,0,2,1,1,0
16511,335,7115,1454,835,1044,76,110,219,1530,17,275,158,296,292,454,2297,3718,9,34017,1889,1,2,1,1,0
16512,16,469,442,244,305,14,16,103,456,11,68,45,75,79,120,452,756,6,4588,254,0,2,1,1,0
16513,16,469,182,102,99,11,40,35,193,3,11,6,11,14,17,42,64,1,97,5,0,2,1,1,0
16514,62,1244,1098,241,925,5,10,155,1103,7,46,25,49,53,74,273,423,3,1580,87,0,2,1,1,0
16515,62,1244,282,202,222,14,2,44,296,8,42,24,43,50,67,250,378,4,1548,86,0,2,1,1,0
16516,93,3417,1450,624,1228,12,26,181,1462,14,306,186,354,320,540,2580,4493,8,36391,2021,1,2,1,1,0
16517,148,4073,1660,832,1314,41,38,274,1701,20,312,209,395,332,604,2671,5058,12,64042,3557,1,2,1,1,0
16518,116,4563,1513,682,1277,25,13,200,1538,11,199,116,219,210,335,1557,2584,6,15641,868,0,2,1,1,0
16519,78,4037,1457,730,1242,11,6,188,1468,10,292,166,329,302,495,2424,4078,5,22973,1276,1,2,15,0,0
16520,82,4086,1523,757,1297,19,12,193,1542,12,193,117,230,205,347,1508,2664,7,19053,1058,0,2,19,0,0
16521,25,1016,373,158,315,8,0,51,381,5,76,44,79,81,123,486,779,2,2026,112,0,2,1,1,0
16522,163,5074,1660,832,1314,41,38,274,1701,20,312,209,395,332,604,2671,5058,12,64042,3557,1,2,2,1,0
16523,163,5074,1057,646,719,113,100,145,1170,18,215,134,248,233,382,1740,3004,10,31186,1732,1,2,2,1,0
16524,83,2325,1523,757,1297,19,12,193,1542,12,193,117,230,205,347,1508,2664,7,19053,1058,0,2,36,2,1
16525,83,2325,701,378,504,33,58,109,734,13,110,68,126,123,194,794,1346,7,10027,557,0,2,36,2,1
16526,86,4261,1523,757,1297,19,12,193,1542,12,193,117,230,205,347,1508,2664,7,19053,1058,0,2,23,0,1
16527,83,2325,1523,757,1297,19,12,193,1542,12,193,117,230,205,347,1508,2664,7,19053,1058,0,2,36,2,0
16528,83,2325,701,378,504,33,58,109,734,13,110,68,126,123,194,794,1346,7,10027,557,0,2,36,2,0
16529,86,4261,1523,757,1297,19,12,193,1542,12,193,117,230,205,347,1508,2664,7,19053,1058,0,2,23,0,0
16530,211,4515,182,127,129,0,0,53,182,5,39,21,42,44,63,217,343,2,926,51,0,2,4,2,1
16531,211,4515,1165,710,800,67,119,181,1232,18,243,153,282,261,435,2000,3492,10,36473,2026,1,2,4,2,1
16532,95,3480,1450,624,1228,12,26,181,1462,14,306,186,354,320,540,2580,4493,8,36391,2021,1,2,19,0,1
16533,211,4515,182,127,129,0,0,53,182,5,39,21,42,44,63,217,343,2,926,51,0,2,4,2,0
16534,211,4515,1165,710,800,67,119,181,1232,18,243,153,282,261,435,2000,3492,10,36473,2026,1,2,4,2,0
16535,95,3480,1450,624,1228,12,26,181,1462,14,306,186,354,320,540,2580,4493,8,36391,2021,1,2,19,0,0
16536,185,3749,1943,715,1694,26,18,214,1969,12,185,120,237,197,357,1436,2721,7,20915,1161,0,2,12,10,1
16537,185,3749,1168,838,957,57,25,144,1225,19,348,224,416,367,640,3018,5452,11,61921,3440,1,2,12,10,1
16538,13,319,601,196,481,2,23,85,603,8,63,36,72,71,108,400,664,4,3036,168,0,2,2,8,1
16539,13,319,156,79,106,5,16,28,161,5,14,8,15,19,23,64,97,2,261,14,0,2,2,8,1
16540,8,214,601,196,481,2,23,85,603,8,63,36,72,71,108,400,664,4,3036,168,0,2,7,7,1
16541,16,383,601,196,481,2,23,85,603,8,63,36,72,71,108,400,664,4,3036,168,0,2,29,3,1
16542,16,383,156,79,106,5,16,28,161,5,14,8,15,19,23,64,97,2,261,14,0,2,29,3,1
16543,9,258,601,196,481,2,23,85,603,8,63,36,72,71,108,400,664,4,3036,168,0,2,28,0,1
16544,185,3749,1943,715,1694,26,18,214,1969,12,185,120,237,197,357,1436,2721,7,20915,1161,0,2,3,3,0
16545,185,3749,1168,838,957,57,25,144,1225,19,348,224,416,367,640,3018,5452,11,61921,3440,1,2,3,3,0
16546,185,3775,1943,715,1694,26,18,214,1969,12,185,120,237,197,357,1436,2721,7,20915,1161,0,2,12,10,1
16547,185,3775,1168,838,957,57,25,144,1225,19,348,224,416,367,640,3018,5452,11,61921,3440,1,2,12,10,1
16548,16,377,601,196,481,2,23,85,603,8,63,36,72,71,108,400,664,4,3036,168,0,2,1,1,1
16549,16,377,156,79,106,5,16,28,161,5,14,8,15,19,23,64,97,2,261,14,0,2,1,1,1
16550,9,317,601,196,481,2,23,85,603,8,63,36,72,71,108,400,664,4,3036,168,0,2,31,10,1
16551,184,3743,1943,715,1694,26,18,214,1969,12,185,120,237,197,357,1436,2721,7,20915,1161,0,2,2,2,0
16552,184,3743,1168,838,957,57,25,144,1225,19,348,224,416,367,640,3018,5452,11,61921,3440,1,2,2,2,0
16553,78,4037,1457,730,1242,11,6,188,1468,10,292,166,329,302,495,2424,4078,5,22973,1276,1,2,1,1,0
16554,73,3706,1943,715,1694,26,18,214,1969,12,185,120,237,197,357,1436,2721,7,20915,1161,0,2,9,0,0
16555,184,3743,1943,715,1694,26,18,214,1969,12,185,120,237,197,357,1436,2721,7,20915,1161,0,2,2,2,0
16556,184,3743,1168,838,957,57,25,144,1225,19,348,224,416,367,640,3018,5452,11,61921,3440,1,2,2,2,0
16557,78,4037,1457,730,1242,11,6,188,1468,10,292,166,329,302,495,2424,4078,5,22973,1276,1,2,1,1,0
16558,73,3706,1943,715,1694,26,18,214,1969,12,185,120,237,197,357,1436,2721,7,20915,1161,0,2,9,0,0
16559,211,4515,182,127,129,0,0,53,182,5,39,21,42,44,63,217,343,2,926,51,0,2,4,2,0
16560,211,4515,1165,710,800,67,119,181,1232,18,243,153,282,261,435,2000,3492,10,36473,2026,1,2,4,2,0
16561,163,5074,1660,832,1314,41,38,274,1701,20,312,209,395,332,604,2671,5058,12,64042,3557,1,2,2,1,0
16562,163,5074,1057,646,719,113,100,145,1170,18,215,134,248,233,382,1740,3004,10,31186,1732,1,2,2,1,0
16563,60,1254,996,429,845,24,10,117,1020,7,76,50,88,83,138,494,879,4,3565,198,0,2,1,1,0
16564,60,1254,456,277,329,12,42,72,468,13,85,50,97,98,147,592,972,7,7212,400,0,2,1,1,0
16565,346,7009,1457,730,1242,11,6,188,1468,10,292,166,329,302,495,2424,4078,5,22973,1276,1,2,10,9,0
16566,346,7009,74,35,59,1,0,14,75,3,14,7,14,17,21,58,85,1,128,7,0,2,10,9,0
16567,346,7009,245,125,200,5,7,34,250,7,30,17,34,37,51,166,265,3,1053,58,0,2,10,9,0
16568,227,5117,4293,999,3693,19,54,507,4312,9,155,88,170,164,258,1156,1898,4,9368,520,0,2,4,3,0
16569,227,5117,1482,859,1002,125,135,219,1607,16,219,134,251,235,385,1766,3032,9,27804,1544,1,2,4,3,0
16570,49,575,647,139,84,35,284,233,682,0,0,0,0,0,0,0,0,0,0,0,0,2,10,3,0
16571,83,2321,1523,757,1297,19,12,193,1542,12,193,117,230,205,347,1508,2664,7,19053,1058,0,2,4,5,0
16572,83,2321,701,378,504,33,58,109,734,13,110,68,126,123,194,794,1346,7,10027,557,0,2,4,5,0
16573,178,4160,77,34,69,0,0,8,77,3,24,16,29,27,45,114,213,1,387,21,0,2,1,1,0
16574,178,4160,712,438,573,51,9,84,763,14,102,71,128,116,199,733,1364,8,11988,666,0,2,1,1,0
16575,69,1359,1020,354,843,12,15,144,1032,8,134,77,144,142,221,970,1580,4,6792,377,0,2,1,1,0
16576,223,5078,722,423,573,19,0,135,741,12,172,101,199,184,300,1320,2257,6,15668,870,0,2,4,4,0
16577,223,5078,1508,847,911,44,250,301,1552,14,148,88,169,162,257,1120,1886,7,15077,837,0,2,4,4,0
16578,337,7188,72,33,56,0,4,12,72,1,1,1,1,2,2,0,2,0,1,0,0,2,2,2,0
16579,337,7188,1454,835,1044,76,110,219,1530,17,275,158,296,292,454,2297,3718,9,34017,1889,1,2,2,2,0
16580,104,1969,1178,367,1042,6,15,115,1184,9,94,51,95,103,146,644,976,4,4439,246,0,2,3,2,0
16581,104,1969,177,108,140,8,0,27,185,6,30,16,32,36,48,162,248,3,794,44,0,2,3,2,0
16582,184,3749,1943,715,1694,26,18,214,1969,12,185,120,237,197,357,1436,2721,7,20915,1161,0,2,2,2,0
16583,184,3749,1168,838,957,57,25,144,1225,19,348,224,416,367,640,3018,5452,11,61921,3440,1,2,2,2,0
16584,16,472,442,244,305,14,16,103,456,11,68,45,75,79,120,452,756,6,4588,254,0,2,1,1,0
16585,16,472,182,102,99,11,40,35,193,3,11,6,11,14,17,42,64,1,97,5,0,2,1,1,0
16586,62,1244,1098,241,925,5,10,155,1103,7,46,25,49,53,74,273,423,3,1580,87,0,2,21,3,0
16587,62,1244,282,202,222,14,2,44,296,8,42,24,43,50,67,250,378,4,1548,86,0,2,21,3,0
16588,94,4280,1338,495,1086,10,64,173,1348,11,122,82,157,133,239,883,1686,7,11934,663,0,2,10,0,0
16589,109,4093,1450,624,1228,12,26,181,1462,14,306,186,354,320,540,2580,4493,8,36391,2021,1,2,20,1,0
16590,148,4080,1660,832,1314,41,38,274,1701,20,312,209,395,332,604,2671,5058,12,64042,3557,1,2,1,1,0
16591,117,4639,1513,682,1277,25,13,200,1538,11,199,116,219,210,335,1557,2584,6,15641,868,0,2,1,1,0
16592,78,4085,1457,730,1242,11,6,188,1468,10,292,166,329,302,495,2424,4078,5,22973,1276,1,2,16,1,0
16593,87,4323,1523,757,1297,19,12,193,1542,12,193,117,230,205,347,1508,2664,7,19053,1058,0,2,19,0,0
16594,35,1615,1293,570,1093,25,15,163,1318,10,195,123,241,205,364,1516,2795,6,17273,959,0,2,15,0,0
16595,25,1019,373,158,315,8,0,51,381,5,76,44,79,81,123,486,779,2,2026,112,0,2,1,1,0
16596,71,2998,1178,367,1042,6,15,115,1184,9,94,51,95,103,146,644,976,4,4439,246,0,2,23,0,0
16597,73,3730,1943,715,1694,26,18,214,1969,12,185,120,237,197,357,1436,2721,7,20915,1161,0,2,9,0,0
16598,211,4515,182,127,129,0,0,53,182,5,39,21,42,44,63,217,343,2,926,51,0,2,4,2,0
16599,211,4515,1165,710,800,67,119,181,1232,18,243,153,282,261,435,2000,3492,10,36473,2026,1,2,4,2,0
16600,163,5074,1660,832,1314,41,38,274,1701,20,312,209,395,332,604,2671,5058,12,64042,3557,1,2,2,1,0
16601,163,5074,1057,646,719,113,100,145,1170,18,215,134,248,233,382,1740,3004,10,31186,1732,1,2,2,1,0
16602,60,1254,996,429,845,24,10,117,1020,7,76,50,88,83,138,494,879,4,3565,198,0,2,1,1,0
16603,60,1254,456,277,329,12,42,72,468,13,85,50,97,98,147,592,972,7,7212,400,0,2,1,1,0
16604,346,7009,1457,730,1242,11,6,188,1468,10,292,166,329,302,495,2424,4078,5,22973,1276,1,2,10,9,0
16605,346,7009,74,35,59,1,0,14,75,3,14,7,14,17,21,58,85,1,128,7,0,2,10,9,0
16606,346,7009,245,125,200,5,7,34,250,7,30,17,34,37,51,166,265,3,1053,58,0,2,10,9,0
16607,227,5117,4293,999,3693,19,54,507,4312,9,155,88,170,164,258,1156,1898,4,9368,520,0,2,4,3,0
16608,227,5117,1482,859,1002,125,135,219,1607,16,219,134,251,235,385,1766,3032,9,27804,1544,1,2,4,3,0
16609,49,575,647,139,84,35,284,233,682,0,0,0,0,0,0,0,0,0,0,0,0,2,10,3,0
16610,83,2321,1523,757,1297,19,12,193,1542,12,193,117,230,205,347,1508,2664,7,19053,1058,0,2,4,5,0
16611,83,2321,701,378,504,33,58,109,734,13,110,68,126,123,194,794,1346,7,10027,557,0,2,4,5,0
16612,178,4160,77,34,69,0,0,8,77,3,24,16,29,27,45,114,213,1,387,21,0,2,1,1,0
16613,178,4160,712,438,573,51,9,84,763,14,102,71,128,116,199,733,1364,8,11988,666,0,2,1,1,0
16614,69,1359,1020,354,843,12,15,144,1032,8,134,77,144,142,221,970,1580,4,6792,377,0,2,1,1,0
16615,223,5078,722,423,573,19,0,135,741,12,172,101,199,184,300,1320,2257,6,15668,870,0,2,4,4,0
16616,223,5078,1508,847,911,44,250,301,1552,14,148,88,169,162,257,1120,1886,7,15077,837,0,2,4,4,0
16617,337,7188,72,33,56,0,4,12,72,1,1,1,1,2,2,0,2,0,1,0,0,2,2,2,0
16618,337,7188,1454,835,1044,76,110,219,1530,17,275,158,296,292,454,2297,3718,9,34017,1889,1,2,2,2,0
16619,104,1969,1178,367,1042,6,15,115,1184,9,94,51,95,103,146,644,976,4,4439,246,0,2,3,2,0
16620,104,1969,177,108,140,8,0,27,185,6,30,16,32,36,48,162,248,3,794,44,0,2,3,2,0
16621,184,3749,1943,715,1694,26,18,214,1969,12,185,120,237,197,357,1436,2721,7,20915,1161,0,2,2,2,0
16622,184,3749,1168,838,957,57,25,144,1225,19,348,224,416,367,640,3018,5452,11,61921,3440,1,2,2,2,0
16623,16,472,442,244,305,14,16,103,456,11,68,45,75,79,120,452,756,6,4588,254,0,2,1,1,0
16624,16,472,182,102,99,11,40,35,193,3,11,6,11,14,17,42,64,1,97,5,0,2,1,1,0
16625,62,1244,1098,241,925,5,10,155,1103,7,46,25,49,53,74,273,423,3,1580,87,0,2,21,3,0
16626,62,1244,282,202,222,14,2,44,296,8,42,24,43,50,67,250,378,4,1548,86,0,2,21,3,0
16627,94,4280,1338,495,1086,10,64,173,1348,11,122,82,157,133,239,883,1686,7,11934,663,0,2,10,0,0
16628,109,4093,1450,624,1228,12,26,181,1462,14,306,186,354,320,540,2580,4493,8,36391,2021,1,2,20,1,0
16629,148,4080,1660,832,1314,41,38,274,1701,20,312,209,395,332,604,2671,5058,12,64042,3557,1,2,1,1,0
16630,117,4639,1513,682,1277,25,13,200,1538,11,199,116,219,210,335,1557,2584,6,15641,868,0,2,1,1,0
16631,78,4085,1457,730,1242,11,6,188,1468,10,292,166,329,302,495,2424,4078,5,22973,1276,1,2,16,1,0
16632,87,4323,1523,757,1297,19,12,193,1542,12,193,117,230,205,347,1508,2664,7,19053,1058,0,2,19,0,0
16633,35,1615,1293,570,1093,25,15,163,1318,10,195,123,241,205,364,1516,2795,6,17273,959,0,2,15,0,0
16634,25,1019,373,158,315,8,0,51,381,5,76,44,79,81,123,486,779,2,2026,112,0,2,1,1,0
16635,71,2998,1178,367,1042,6,15,115,1184,9,94,51,95,103,146,644,976,4,4439,246,0,2,23,0,0
16636,73,3730,1943,715,1694,26,18,214,1969,12,185,120,237,197,357,1436,2721,7,20915,1161,0,2,9,0,0
16637,39,808,386,256,301,16,9,68,402,4,59,35,69,63,104,355,621,2,1453,80,0,2,9,33,1
16638,39,808,264,131,164,11,41,46,275,6,38,22,40,44,62,214,338,3,1068,59,0,2,9,33,1
16639,31,1462,386,256,301,16,9,68,402,4,59,35,69,63,104,355,621,2,1453,80,0,2,0,4,1
16640,31,1431,386,256,301,16,9,68,402,4,59,35,69,63,104,355,621,2,1453,80,0,2,2,10,1
16641,119,2401,1513,682,1277,25,13,200,1538,11,199,116,219,210,335,1557,2584,6,15641,868,0,2,2,1,0
16642,119,2401,819,519,539,24,98,155,843,15,96,57,106,111,163,690,1107,8,9171,509,0,2,2,1,0
16643,116,4567,1513,682,1277,25,13,200,1538,11,199,116,219,210,335,1557,2584,6,15641,868,0,2,2,1,0
16644,119,2401,1513,682,1277,25,13,200,1538,11,199,116,219,210,335,1557,2584,6,15641,868,0,2,2,1,0
16645,119,2401,819,519,539,24,98,155,843,15,96,57,106,111,163,690,1107,8,9171,509,0,2,2,1,0
16646,116,4567,1513,682,1277,25,13,200,1538,11,199,116,219,210,335,1557,2584,6,15641,868,0,2,2,1,0
16647,39,808,386,256,301,16,9,68,402,4,59,35,69,63,104,355,621,2,1453,80,0,2,9,33,0
16648,39,808,264,131,164,11,41,46,275,6,38,22,40,44,62,214,338,3,1068,59,0,2,9,33,0
16649,31,1431,386,256,301,16,9,68,402,4,59,35,69,63,104,355,621,2,1453,80,0,2,2,14,0
16650,7,255,75,38,59,1,3,12,76,2,4,2,4,6,6,10,15,1,15,0,0,2,1,1,1
16651,107,4030,1450,624,1228,12,26,181,1462,14,306,186,354,320,540,2580,4493,8,36391,2021,1,2,1,1,1
16652,76,4022,1457,730,1242,11,6,188,1468,10,292,166,329,302,495,2424,4078,5,22973,1276,1,2,4,3,1
16653,82,4161,1523,757,1297,19,12,193,1542,12,193,117,230,205,347,1508,2664,7,19053,1058,0,2,5,2,1
16654,36,1970,384,251,317,7,8,52,391,11,70,44,84,81,128,467,811,6,5355,297,0,2,2,2,1
16655,72,3682,1943,715,1694,26,18,214,1969,12,185,120,237,197,357,1436,2721,7,20915,1161,0,2,8,8,1
16656,9,317,601,196,481,2,23,85,603,8,63,36,72,71,108,400,664,4,3036,168,0,2,0,1,1
16657,211,4515,182,127,129,0,0,53,182,5,39,21,42,44,63,217,343,2,926,51,0,2,4,2,0
16658,211,4515,1165,710,800,67,119,181,1232,18,243,153,282,261,435,2000,3492,10,36473,2026,1,2,4,2,0
16659,163,5074,1660,832,1314,41,38,274,1701,20,312,209,395,332,604,2671,5058,12,64042,3557,1,2,2,1,0
16660,163,5074,1057,646,719,113,100,145,1170,18,215,134,248,233,382,1740,3004,10,31186,1732,1,2,2,1,0
16661,60,1254,996,429,845,24,10,117,1020,7,76,50,88,83,138,494,879,4,3565,198,0,2,1,1,0
16662,60,1254,456,277,329,12,42,72,468,13,85,50,97,98,147,592,972,7,7212,400,0,2,1,1,0
16663,119,2420,1513,682,1277,25,13,200,1538,11,199,116,219,210,335,1557,2584,6,15641,868,0,2,2,2,0
16664,119,2420,819,519,539,24,98,155,843,15,96,57,106,111,163,690,1107,8,9171,509,0,2,2,2,0
16665,50,1024,207,111,150,11,0,50,218,5,26,19,36,31,55,133,272,3,943,52,0,2,16,0,0
16666,50,1024,410,198,237,31,55,97,441,11,63,38,72,74,110,414,683,6,4293,238,0,2,16,0,0
16667,346,7009,1457,730,1242,11,6,188,1468,10,292,166,329,302,495,2424,4078,5,22973,1276,1,2,10,9,0
16668,346,7009,74,35,59,1,0,14,75,3,14,7,14,17,21,58,85,1,128,7,0,2,10,9,0
16669,346,7009,245,125,200,5,7,34,250,7,30,17,34,37,51,166,265,3,1053,58,0,2,10,9,0
16670,227,5117,4293,999,3693,19,54,507,4312,9,155,88,170,164,258,1156,1898,4,9368,520,0,2,4,3,0
16671,227,5117,1482,859,1002,125,135,219,1607,16,219,134,251,235,385,1766,3032,9,27804,1544,1,2,4,3,0
16672,49,575,647,139,84,35,284,233,682,0,0,0,0,0,0,0,0,0,0,0,0,2,10,3,0
16673,83,2321,1523,757,1297,19,12,193,1542,12,193,117,230,205,347,1508,2664,7,19053,1058,0,2,40,7,0
16674,83,2321,701,378,504,33,58,109,734,13,110,68,126,123,194,794,1346,7,10027,557,0,2,40,7,0
16675,178,4160,77,34,69,0,0,8,77,3,24,16,29,27,45,114,213,1,387,21,0,2,1,1,0
16676,178,4160,712,438,573,51,9,84,763,14,102,71,128,116,199,733,1364,8,11988,666,0,2,1,1,0
16677,69,1359,1020,354,843,12,15,144,1032,8,134,77,144,142,221,970,1580,4,6792,377,0,2,1,1,0
16678,223,5078,722,423,573,19,0,135,741,12,172,101,199,184,300,1320,2257,6,15668,870,0,2,9,6,0
16679,223,5078,1508,847,911,44,250,301,1552,14,148,88,169,162,257,1120,1886,7,15077,837,0,2,9,6,0
16680,337,7188,72,33,56,0,4,12,72,1,1,1,1,2,2,0,2,0,1,0,0,2,2,2,0
16681,337,7188,1454,835,1044,76,110,219,1530,17,275,158,296,292,454,2297,3718,9,34017,1889,1,2,2,2,0
16682,39,808,386,256,301,16,9,68,402,4,59,35,69,63,104,355,621,2,1453,80,0,2,9,33,0
16683,39,808,264,131,164,11,41,46,275,6,38,22,40,44,62,214,338,3,1068,59,0,2,9,33,0
16684,104,1969,1178,367,1042,6,15,115,1184,9,94,51,95,103,146,644,976,4,4439,246,0,2,3,2,0
16685,104,1969,177,108,140,8,0,27,185,6,30,16,32,36,48,162,248,3,794,44,0,2,3,2,0
16686,185,3777,1943,715,1694,26,18,214,1969,12,185,120,237,197,357,1436,2721,7,20915,1161,0,2,2,2,0
16687,185,3777,1168,838,957,57,25,144,1225,19,348,224,416,367,640,3018,5452,11,61921,3440,1,2,2,2,0
16688,16,472,442,244,305,14,16,103,456,11,68,45,75,79,120,452,756,6,4588,254,0,2,1,1,0
16689,16,472,182,102,99,11,40,35,193,3,11,6,11,14,17,42,64,1,97,5,0,2,1,1,0
16690,62,1244,1098,241,925,5,10,155,1103,7,46,25,49,53,74,273,423,3,1580,87,0,2,21,3,0
16691,62,1244,282,202,222,14,2,44,296,8,42,24,43,50,67,250,378,4,1548,86,0,2,21,3,0
16692,94,4280,1338,495,1086,10,64,173,1348,11,122,82,157,133,239,883,1686,7,11934,663,0,2,10,0,0
16693,109,4093,1450,624,1228,12,26,181,1462,14,306,186,354,320,540,2580,4493,8,36391,2021,1,2,20,1,0
16694,148,4080,1660,832,1314,41,38,274,1701,20,312,209,395,332,604,2671,5058,12,64042,3557,1,2,1,1,0
16695,117,4639,1513,682,1277,25,13,200,1538,11,199,116,219,210,335,1557,2584,6,15641,868,0,2,19,7,0
16696,78,4085,1457,730,1242,11,6,188,1468,10,292,166,329,302,495,2424,4078,5,22973,1276,1,2,16,1,0
16697,87,4328,1523,757,1297,19,12,193,1542,12,193,117,230,205,347,1508,2664,7,19053,1058,0,2,42,0,0
16698,35,1615,1293,570,1093,25,15,163,1318,10,195,123,241,205,364,1516,2795,6,17273,959,0,2,15,0,0
16699,31,1431,386,256,301,16,9,68,402,4,59,35,69,63,104,355,621,2,1453,80,0,2,2,14,0
16700,25,1019,373,158,315,8,0,51,381,5,76,44,79,81,123,486,779,2,2026,112,0,2,1,1,0
16701,71,2998,1178,367,1042,6,15,115,1184,9,94,51,95,103,146,644,976,4,4439,246,0,2,23,0,0
16702,73,3730,1943,715,1694,26,18,214,1969,12,185,120,237,197,357,1436,2721,7,20915,1161,0,2,9,0,0
16703,39,784,386,256,301,16,9,68,402,4,59,35,69,63,104,355,621,2,1453,80,0,2,0,2,0
16704,39,784,264,131,164,11,41,46,275,6,38,22,40,44,62,214,338,3,1068,59,0,2,0,2,0
16705,14,331,601,196,481,2,23,85,603,8,63,36,72,71,108,400,664,4,3036,168,0,2,7,21,0
16706,14,331,156,79,106,5,16,28,161,5,14,8,15,19,23,64,97,2,261,14,0,2,7,21,0
16707,31,1431,386,256,301,16,9,68,402,4,59,35,69,63,104,355,621,2,1453,80,0,2,3,1,0
16708,346,7013,1457,730,1242,11,6,188,1468,10,292,166,329,302,495,2424,4078,5,22973,1276,1,2,2,2,1
16709,346,7013,74,35,59,1,0,14,75,3,14,7,14,17,21,58,85,1,128,7,0,2,2,2,1
16710,346,7013,245,125,200,5,7,34,250,7,30,17,34,37,51,166,265,3,1053,58,0,2,2,2,1
16711,227,5121,4293,999,3693,19,54,507,4312,9,155,88,170,164,258,1156,1898,4,9368,520,0,2,1,1,1
16712,227,5121,1482,859,1002,125,135,219,1607,16,219,134,251,235,385,1766,3032,9,27804,1544,1,2,1,1,1
16713,191,3884,1943,715,1694,26,18,214,1969,12,185,120,237,197,357,1436,2721,7,20915,1161,0,2,36,7,1
16714,191,3884,1168,838,957,57,25,144,1225,19,348,224,416,367,640,3018,5452,11,61921,3440,1,2,36,7,1
16715,7,255,75,38,59,1,3,12,76,2,4,2,4,6,6,10,15,1,15,0,0,2,1,1,1
16716,94,4283,1338,495,1086,10,64,173,1348,11,122,82,157,133,239,883,1686,7,11934,663,0,2,5,5,1
16717,109,4098,1450,624,1228,12,26,181,1462,14,306,186,354,320,540,2580,4493,8,36391,2021,1,2,4,1,1
16718,78,4085,1457,730,1242,11,6,188,1468,10,292,166,329,302,495,2424,4078,5,22973,1276,1,2,1,1,1
16719,87,4328,1523,757,1297,19,12,193,1542,12,193,117,230,205,347,1508,2664,7,19053,1058,0,2,1,1,1
16720,9,317,601,196,481,2,23,85,603,8,63,36,72,71,108,400,664,4,3036,168,0,2,4,4,1
16721,9,231,19,8,11,5,0,4,24,2,5,3,6,7,9,13,25,1,30,1,0,2,1,1,1
16722,9,231,102,59,69,5,3,24,107,6,22,15,28,28,43,113,206,3,789,43,0,2,1,1,1
16723,9,231,106,40,36,3,49,17,109,8,17,13,23,25,36,93,167,5,904,50,0,2,1,1,1
16724,211,4523,182,127,129,0,0,53,182,5,39,21,42,44,63,217,343,2,926,51,0,2,1,0,1
16725,211,4523,1165,710,800,67,119,181,1232,18,243,153,282,261,435,2000,3492,10,36473,2026,1,2,1,0,1
16726,99,2081,773,419,590,28,0,166,801,10,204,113,217,214,330,1598,2554,5,13587,754,0,2,1,1,1
16727,99,2081,421,273,302,44,34,57,465,17,81,59,107,98,166,583,1098,11,12329,684,0,2,1,1,1
16728,28,556,2,2,2,0,0,0,2,0,0,0,0,0,0,0,0,0,0,0,0,2,1,0,1
16729,28,556,99,48,90,1,3,5,100,0,0,0,0,0,0,0,0,0,0,0,0,2,1,0,1
16730,28,556,8,5,5,2,0,1,10,0,0,0,0,0,0,0,0,0,0,0,0,2,1,0,1
16731,28,556,1217,716,841,84,126,174,1301,14,185,118,215,199,333,1446,2542,8,20687,1149,0,2,1,0,1
16732,28,556,160,89,115,0,13,31,160,7,15,11,17,22,28,78,124,3,495,27,0,2,1,0,1
16733,28,556,10,10,9,9,0,0,19,0,0,0,0,0,0,0,0,0,0,0,0,2,1,0,1
16734,28,556,173,84,99,8,29,36,181,5,12,7,13,17,20,54,81,2,221,12,0,2,1,0,1
16735,28,556,3,1,1,3,0,0,6,0,0,0,0,0,0,0,0,0,0,0,0,2,1,0,1
16736,163,5082,1660,832,1314,41,38,274,1701,20,312,209,395,332,604,2671,5058,12,64042,3557,1,2,1,1,1
16737,163,5082,1057,646,719,113,100,145,1170,18,215,134,248,233,382,1740,3004,10,31186,1732,1,2,1,1,1
16738,17,349,95,58,50,9,16,20,104,12,33,24,45,45,69,209,378,8,3100,172,0,2,1,1,1
16739,82,1800,477,336,357,30,23,73,507,16,194,134,250,210,384,1538,2962,10,30538,1696,0,2,1,0,1
16740,60,1262,996,429,845,24,10,117,1020,7,76,50,88,83,138,494,879,4,3565,198,0,2,1,1,1
16741,60,1262,456,277,329,12,42,72,468,13,85,50,97,98,147,592,972,7,7212,400,0,2,1,1,1
16742,119,2424,1513,682,1277,25,13,200,1538,11,199,116,219,210,335,1557,2584,6,15641,868,0,2,1,1,1
16743,119,2424,819,519,539,24,98,155,843,15,96,57,106,111,163,690,1107,8,9171,509,0,2,1,1,1
16744,50,1032,207,111,150,11,0,50,218,5,26,19,36,31,55,133,272,3,943,52,0,2,1,0,1
16745,50,1032,410,198,237,31,55,97,441,11,63,38,72,74,110,414,683,6,4293,238,0,2,1,0,1
16746,346,7017,1457,730,1242,11,6,188,1468,10,292,166,329,302,495,2424,4078,5,22973,1276,1,2,1,0,1
16747,346,7017,74,35,59,1,0,14,75,3,14,7,14,17,21,58,85,1,128,7,0,2,1,0,1
16748,346,7017,245,125,200,5,7,34,250,7,30,17,34,37,51,166,265,3,1053,58,0,2,1,0,1
16749,22,683,339,213,244,17,9,65,356,10,42,26,48,52,74,259,421,5,2410,133,0,2,1,1,1
16750,56,1603,1455,414,1257,16,76,112,1471,5,41,23,46,46,69,231,381,2,1069,59,0,2,1,1,1
16751,56,1603,669,365,481,22,61,110,691,15,103,63,122,118,185,747,1273,8,11311,628,0,2,1,1,1
16752,227,5125,4293,999,3693,19,54,507,4312,9,155,88,170,164,258,1156,1898,4,9368,520,0,2,1,0,1
16753,227,5125,1482,859,1002,125,135,219,1607,16,219,134,251,235,385,1766,3032,9,27804,1544,1,2,1,0,1
16754,7,147,44,22,19,0,19,6,44,2,10,6,12,12,18,35,64,1,77,4,0,2,3,1,1
16755,24,842,74,35,59,1,0,14,75,3,14,7,14,17,21,58,85,1,128,7,0,2,2,0,1
16756,24,842,245,125,200,5,7,34,250,7,30,17,34,37,51,166,265,3,1053,58,0,2,2,0,1
16757,83,2329,1523,757,1297,19,12,193,1542,12,193,117,230,205,347,1508,2664,7,19053,1058,0,2,4,2,1
16758,83,2329,701,378,504,33,58,109,734,13,110,68,126,123,194,794,1346,7,10027,557,0,2,4,2,1
16759,178,4168,77,34,69,0,0,8,77,3,24,16,29,27,45,114,213,1,387,21,0,2,2,0,1
16760,178,4168,712,438,573,51,9,84,763,14,102,71,128,116,199,733,1364,8,11988,666,0,2,2,0,1
16761,69,1367,1020,354,843,12,15,144,1032,8,134,77,144,142,221,970,1580,4,6792,377,0,2,2,0,1
16762,46,959,447,308,343,6,5,95,453,7,96,59,111,103,170,651,1136,4,4600,255,0,2,1,0,1
16763,46,959,322,174,179,16,74,51,338,10,41,26,46,51,72,252,408,5,2291,127,0,2,1,0,1
16764,23,382,424,94,331,4,0,89,428,1,5,5,5,6,10,11,25,0,12,0,0,2,1,0,1
16765,23,382,38,23,23,6,0,8,44,3,11,7,11,14,18,42,68,1,102,5,0,2,1,0,1
16766,17,518,184,100,137,2,15,30,186,6,38,20,39,44,59,214,322,3,991,55,0,2,2,0,1
16767,17,518,103,65,74,8,5,16,111,7,17,9,17,24,26,89,119,3,417,23,0,2,2,0,1
16768,223,5086,722,423,573,19,0,135,741,12,172,101,199,184,300,1320,2257,6,15668,870,0,2,2,0,1
16769,223,5086,1508,847,911,44,250,301,1552,14,148,88,169,162,257,1120,1886,7,15077,837,0,2,2,0,1
16770,337,7196,72,33,56,0,4,12,72,1,1,1,1,2,2,0,2,0,1,0,0,2,1,0,1
16771,337,7196,1454,835,1044,76,110,219,1530,17,275,158,296,292,454,2297,3718,9,34017,1889,1,2,1,0,1
16772,39,816,386,256,301,16,9,68,402,4,59,35,69,63,104,355,621,2,1453,80,0,2,2,0,1
16773,39,816,264,131,164,11,41,46,275,6,38,22,40,44,62,214,338,3,1068,59,0,2,2,0,1
16774,30,657,215,129,180,6,0,29,221,8,65,43,72,73,115,415,711,4,3153,175,0,2,1,0,1
16775,30,657,97,69,77,3,3,16,100,6,22,13,23,28,36,113,173,3,542,30,0,2,1,0,1
16776,128,2826,1043,504,840,53,9,147,1096,9,180,112,198,189,310,1377,2344,4,11604,644,0,2,2,0,1
16777,128,2826,383,288,292,26,6,62,409,11,65,38,67,76,105,429,656,5,3719,206,0,2,2,0,1
16778,20,408,294,64,250,0,0,43,294,1,20,10,20,21,30,86,131,0,65,3,0,2,2,0,1
16779,20,408,78,46,62,3,0,14,81,3,8,4,8,11,12,28,41,1,62,3,0,2,2,0,1
16780,5,118,110,30,77,3,13,16,113,4,21,15,30,25,45,100,208,2,597,33,0,2,2,0,1
16781,5,118,28,15,21,1,0,6,29,0,0,0,0,0,0,0,0,0,0,0,0,2,2,0,1
16782,104,1977,1178,367,1042,6,15,115,1184,9,94,51,95,103,146,644,976,4,4439,246,0,2,2,0,1
16783,104,1977,177,108,140,8,0,27,185,6,30,16,32,36,48,162,248,3,794,44,0,2,2,0,1
16784,184,3757,1943,715,1694,26,18,214,1969,12,185,120,237,197,357,1436,2721,7,20915,1161,0,2,2,0,1
16785,184,3757,1168,838,957,57,25,144,1225,19,348,224,416,367,640,3018,5452,11,61921,3440,1,2,2,0,1
16786,16,480,442,244,305,14,16,103,456,11,68,45,75,79,120,452,756,6,4588,254,0,2,2,0,1
16787,16,480,182,102,99,11,40,35,193,3,11,6,11,14,17,42,64,1,97,5,0,2,2,0,1
16788,62,1248,1098,241,925,5,10,155,1103,7,46,25,49,53,74,273,423,3,1580,87,0,2,1,1,1
16789,62,1248,282,202,222,14,2,44,296,8,42,24,43,50,67,250,378,4,1548,86,0,2,1,1,1
16790,78,3314,1289,550,1043,56,32,155,1345,10,167,93,185,177,278,1266,2075,5,11498,638,0,2,1,0,1
16791,34,997,182,127,129,0,0,53,182,5,39,21,42,44,63,217,343,2,926,51,0,2,1,0,1
16792,137,6600,1392,870,1177,35,17,170,1427,14,494,280,531,508,811,4473,7289,7,54850,3047,2,2,1,0,1
16793,91,3011,773,419,590,28,0,166,801,10,204,113,217,214,330,1598,2554,5,13587,754,0,2,1,0,1
16794,7,263,75,38,59,1,3,12,76,2,4,2,4,6,6,10,15,1,15,0,0,2,1,0,1
16795,23,601,102,59,69,5,3,24,107,6,22,15,28,28,43,113,206,3,789,43,0,2,1,1,1
16796,109,4101,1450,624,1228,12,26,181,1462,14,306,186,354,320,540,2580,4493,8,36391,2021,1,2,1,0,1
16797,148,4088,1660,832,1314,41,38,274,1701,20,312,209,395,332,604,2671,5058,12,64042,3557,1,2,1,0,1
16798,117,4647,1513,682,1277,25,13,200,1538,11,199,116,219,210,335,1557,2584,6,15641,868,0,2,1,0,1
16799,59,3310,1296,573,1062,40,33,157,1336,8,201,118,231,209,349,1561,2689,4,12365,686,0,2,1,0,1
16800,10,236,207,111,150,11,0,50,218,5,26,19,36,31,55,133,272,3,943,52,0,2,1,0,1
16801,78,4093,1457,730,1242,11,6,188,1468,10,292,166,329,302,495,2424,4078,5,22973,1276,1,2,1,0,1
16802,38,2286,652,304,544,16,6,88,668,6,89,51,101,95,152,591,998,3,3399,188,0,2,1,0,1
16803,62,2878,1455,414,1257,16,76,112,1471,5,41,23,46,46,69,231,381,2,1069,59,0,2,1,0,1
16804,2,75,7,6,5,0,0,2,7,1,1,1,2,2,3,0,3,1,3,0,0,2,1,0,1
16805,8,273,74,35,59,1,0,14,75,3,14,7,14,17,21,58,85,1,128,7,0,2,1,0,1
16806,87,4331,1523,757,1297,19,12,193,1542,12,193,117,230,205,347,1508,2664,7,19053,1058,0,2,2,2,1
16807,66,2767,1020,354,843,12,15,144,1032,8,134,77,144,142,221,970,1580,4,6792,377,0,2,1,0,1
16808,37,1624,447,308,343,6,5,95,453,7,96,59,111,103,170,651,1136,4,4600,255,0,2,1,0,1
16809,21,661,424,94,331,4,0,89,428,1,5,5,5,6,10,11,25,0,12,0,0,2,1,0,1
16810,40,2359,334,251,279,10,4,40,344,5,127,74,143,132,217,899,1528,2,4303,239,0,2,1,1,1
16811,12,492,184,100,137,2,15,30,186,6,38,20,39,44,59,214,322,3,991,55,0,2,1,0,1
16812,35,1623,1293,570,1093,25,15,163,1318,10,195,123,241,205,364,1516,2795,6,17273,959,0,2,1,0,1
16813,36,1978,384,251,317,7,8,52,391,11,70,44,84,81,128,467,811,6,5355,297,0,2,1,0,1
16814,15,638,722,423,573,19,0,135,741,12,172,101,199,184,300,1320,2257,6,15668,870,0,2,1,0,1
16815,31,1439,386,256,301,16,9,68,402,4,59,35,69,63,104,355,621,2,1453,80,0,2,1,0,1
16816,16,1209,215,129,180,6,0,29,221,8,65,43,72,73,115,415,711,4,3153,175,0,2,1,0,1
16817,69,2856,1043,504,840,53,9,147,1096,9,180,112,198,189,310,1377,2344,4,11604,644,0,2,1,1,1
16818,14,529,295,56,236,0,4,54,295,2,9,5,10,11,15,30,51,1,57,3,0,2,5,3,1
16819,25,1027,373,158,315,8,0,51,381,5,76,44,79,81,123,486,779,2,2026,112,0,2,1,0,1
16820,71,3006,1178,367,1042,6,15,115,1184,9,94,51,95,103,146,644,976,4,4439,246,0,2,1,0,1
16821,73,3738,1943,715,1694,26,18,214,1969,12,185,120,237,197,357,1436,2721,7,20915,1161,0,2,1,0,1
16822,14,825,442,244,305,14,16,103,456,11,68,45,75,79,120,452,756,6,4588,254,0,2,1,0,1
16823,48,1784,1098,241,925,5,10,155,1103,7,46,25,49,53,74,273,423,3,1580,87,0,2,1,0,1
16824,223,5076,722,423,573,19,0,135,741,12,172,101,199,184,300,1320,2257,6,15668,870,0,2,7,9,1
16825,223,5076,1508,847,911,44,250,301,1552,14,148,88,169,162,257,1120,1886,7,15077,837,0,2,7,9,1
16826,30,649,215,129,180,6,0,29,221,8,65,43,72,73,115,415,711,4,3153,175,0,2,2,2,1
16827,30,649,97,69,77,3,3,16,100,6,22,13,23,28,36,113,173,3,542,30,0,2,2,2,1
16828,94,4280,1338,495,1086,10,64,173,1348,11,122,82,157,133,239,883,1686,7,11934,663,0,2,6,4,1
16829,117,4641,1513,682,1277,25,13,200,1538,11,199,116,219,210,335,1557,2584,6,15641,868,0,2,3,3,1
16830,66,2763,1020,354,843,12,15,144,1032,8,134,77,144,142,221,970,1580,4,6792,377,0,2,1,1,1
16831,137,6599,1392,870,1177,35,17,170,1427,14,494,280,531,508,811,4473,7289,7,54850,3047,2,2,1,1,0
16832,9,231,19,8,11,5,0,4,24,2,5,3,6,7,9,13,25,1,30,1,0,2,1,1,0
16833,9,231,102,59,69,5,3,24,107,6,22,15,28,28,43,113,206,3,789,43,0,2,1,1,0
16834,9,231,106,40,36,3,49,17,109,8,17,13,23,25,36,93,167,5,904,50,0,2,1,1,0
16835,211,4523,182,127,129,0,0,53,182,5,39,21,42,44,63,217,343,2,926,51,0,2,1,0,0
16836,211,4523,1165,710,800,67,119,181,1232,18,243,153,282,261,435,2000,3492,10,36473,2026,1,2,1,0,0
16837,99,2081,773,419,590,28,0,166,801,10,204,113,217,214,330,1598,2554,5,13587,754,0,2,1,1,0
16838,99,2081,421,273,302,44,34,57,465,17,81,59,107,98,166,583,1098,11,12329,684,0,2,1,1,0
16839,28,556,2,2,2,0,0,0,2,0,0,0,0,0,0,0,0,0,0,0,0,2,1,0,0
16840,28,556,99,48,90,1,3,5,100,0,0,0,0,0,0,0,0,0,0,0,0,2,1,0,0
16841,28,556,8,5,5,2,0,1,10,0,0,0,0,0,0,0,0,0,0,0,0,2,1,0,0
16842,28,556,1217,716,841,84,126,174,1301,14,185,118,215,199,333,1446,2542,8,20687,1149,0,2,1,0,0
16843,28,556,160,89,115,0,13,31,160,7,15,11,17,22,28,78,124,3,495,27,0,2,1,0,0
16844,28,556,10,10,9,9,0,0,19,0,0,0,0,0,0,0,0,0,0,0,0,2,1,0,0
16845,28,556,173,84,99,8,29,36,181,5,12,7,13,17,20,54,81,2,221,12,0,2,1,0,0
16846,28,556,3,1,1,3,0,0,6,0,0,0,0,0,0,0,0,0,0,0,0,2,1,0,0
16847,163,5082,1660,832,1314,41,38,274,1701,20,312,209,395,332,604,2671,5058,12,64042,3557,1,2,1,1,0
16848,163,5082,1057,646,719,113,100,145,1170,18,215,134,248,233,382,1740,3004,10,31186,1732,1,2,1,1,0
16849,17,349,95,58,50,9,16,20,104,12,33,24,45,45,69,209,378,8,3100,172,0,2,1,1,0
16850,82,1800,477,336,357,30,23,73,507,16,194,134,250,210,384,1538,2962,10,30538,1696,0,2,1,0,0
16851,60,1262,996,429,845,24,10,117,1020,7,76,50,88,83,138,494,879,4,3565,198,0,2,1,1,0
16852,60,1262,456,277,329,12,42,72,468,13,85,50,97,98,147,592,972,7,7212,400,0,2,1,1,0
16853,119,2424,1513,682,1277,25,13,200,1538,11,199,116,219,210,335,1557,2584,6,15641,868,0,2,1,1,0
16854,119,2424,819,519,539,24,98,155,843,15,96,57,106,111,163,690,1107,8,9171,509,0,2,1,1,0
16855,50,1032,207,111,150,11,0,50,218,5,26,19,36,31,55,133,272,3,943,52,0,2,1,0,0
16856,50,1032,410,198,237,31,55,97,441,11,63,38,72,74,110,414,683,6,4293,238,0,2,1,0,0
16857,346,7017,1457,730,1242,11,6,188,1468,10,292,166,329,302,495,2424,4078,5,22973,1276,1,2,1,0,0
16858,346,7017,74,35,59,1,0,14,75,3,14,7,14,17,21,58,85,1,128,7,0,2,1,0,0
16859,346,7017,245,125,200,5,7,34,250,7,30,17,34,37,51,166,265,3,1053,58,0,2,1,0,0
16860,22,683,339,213,244,17,9,65,356,10,42,26,48,52,74,259,421,5,2410,133,0,2,1,1,0
16861,56,1603,1455,414,1257,16,76,112,1471,5,41,23,46,46,69,231,381,2,1069,59,0,2,1,1,0
16862,56,1603,669,365,481,22,61,110,691,15,103,63,122,118,185,747,1273,8,11311,628,0,2,1,1,0
16863,227,5125,4293,999,3693,19,54,507,4312,9,155,88,170,164,258,1156,1898,4,9368,520,0,2,1,0,0
16864,227,5125,1482,859,1002,125,135,219,1607,16,219,134,251,235,385,1766,3032,9,27804,1544,1,2,1,0,0
16865,7,147,44,22,19,0,19,6,44,2,10,6,12,12,18,35,64,1,77,4,0,2,3,1,0
16866,24,842,74,35,59,1,0,14,75,3,14,7,14,17,21,58,85,1,128,7,0,2,2,0,0
16867,24,842,245,125,200,5,7,34,250,7,30,17,34,37,51,166,265,3,1053,58,0,2,2,0,0
16868,83,2329,1523,757,1297,19,12,193,1542,12,193,117,230,205,347,1508,2664,7,19053,1058,0,2,4,2,0
16869,83,2329,701,378,504,33,58,109,734,13,110,68,126,123,194,794,1346,7,10027,557,0,2,4,2,0
16870,178,4168,77,34,69,0,0,8,77,3,24,16,29,27,45,114,213,1,387,21,0,2,2,0,0
16871,178,4168,712,438,573,51,9,84,763,14,102,71,128,116,199,733,1364,8,11988,666,0,2,2,0,0
16872,69,1367,1020,354,843,12,15,144,1032,8,134,77,144,142,221,970,1580,4,6792,377,0,2,2,0,0
16873,46,959,447,308,343,6,5,95,453,7,96,59,111,103,170,651,1136,4,4600,255,0,2,1,0,0
16874,46,959,322,174,179,16,74,51,338,10,41,26,46,51,72,252,408,5,2291,127,0,2,1,0,0
16875,23,382,424,94,331,4,0,89,428,1,5,5,5,6,10,11,25,0,12,0,0,2,1,0,0
16876,23,382,38,23,23,6,0,8,44,3,11,7,11,14,18,42,68,1,102,5,0,2,1,0,0
16877,17,518,184,100,137,2,15,30,186,6,38,20,39,44,59,214,322,3,991,55,0,2,2,0,0
16878,17,518,103,65,74,8,5,16,111,7,17,9,17,24,26,89,119,3,417,23,0,2,2,0,0
16879,223,5076,722,423,573,19,0,135,741,12,172,101,199,184,300,1320,2257,6,15668,870,0,2,9,9,0
16880,223,5076,1508,847,911,44,250,301,1552,14,148,88,169,162,257,1120,1886,7,15077,837,0,2,9,9,0
16881,337,7196,72,33,56,0,4,12,72,1,1,1,1,2,2,0,2,0,1,0,0,2,1,0,0
16882,337,7196,1454,835,1044,76,110,219,1530,17,275,158,296,292,454,2297,3718,9,34017,1889,1,2,1,0,0
16883,39,816,386,256,301,16,9,68,402,4,59,35,69,63,104,355,621,2,1453,80,0,2,2,0,0
16884,39,816,264,131,164,11,41,46,275,6,38,22,40,44,62,214,338,3,1068,59,0,2,2,0,0
16885,30,649,215,129,180,6,0,29,221,8,65,43,72,73,115,415,711,4,3153,175,0,2,3,2,0
16886,30,649,97,69,77,3,3,16,100,6,22,13,23,28,36,113,173,3,542,30,0,2,3,2,0
16887,128,2826,1043,504,840,53,9,147,1096,9,180,112,198,189,310,1377,2344,4,11604,644,0,2,2,0,0
16888,128,2826,383,288,292,26,6,62,409,11,65,38,67,76,105,429,656,5,3719,206,0,2,2,0,0
16889,20,408,294,64,250,0,0,43,294,1,20,10,20,21,30,86,131,0,65,3,0,2,2,0,0
16890,20,408,78,46,62,3,0,14,81,3,8,4,8,11,12,28,41,1,62,3,0,2,2,0,0
16891,5,118,110,30,77,3,13,16,113,4,21,15,30,25,45,100,208,2,597,33,0,2,2,0,0
16892,5,118,28,15,21,1,0,6,29,0,0,0,0,0,0,0,0,0,0,0,0,2,2,0,0
16893,104,1977,1178,367,1042,6,15,115,1184,9,94,51,95,103,146,644,976,4,4439,246,0,2,2,0,0
16894,104,1977,177,108,140,8,0,27,185,6,30,16,32,36,48,162,248,3,794,44,0,2,2,0,0
16895,184,3757,1943,715,1694,26,18,214,1969,12,185,120,237,197,357,1436,2721,7,20915,1161,0,2,2,0,0
16896,184,3757,1168,838,957,57,25,144,1225,19,348,224,416,367,640,3018,5452,11,61921,3440,1,2,2,0,0
16897,16,480,442,244,305,14,16,103,456,11,68,45,75,79,120,452,756,6,4588,254,0,2,2,0,0
16898,16,480,182,102,99,11,40,35,193,3,11,6,11,14,17,42,64,1,97,5,0,2,2,0,0
16899,62,1248,1098,241,925,5,10,155,1103,7,46,25,49,53,74,273,423,3,1580,87,0,2,1,1,0
16900,62,1248,282,202,222,14,2,44,296,8,42,24,43,50,67,250,378,4,1548,86,0,2,1,1,0
16901,78,3314,1289,550,1043,56,32,155,1345,10,167,93,185,177,278,1266,2075,5,11498,638,0,2,1,0,0
16902,34,997,182,127,129,0,0,53,182,5,39,21,42,44,63,217,343,2,926,51,0,2,1,0,0
16903,137,6599,1392,870,1177,35,17,170,1427,14,494,280,531,508,811,4473,7289,7,54850,3047,2,2,2,1,0
16904,91,3011,773,419,590,28,0,166,801,10,204,113,217,214,330,1598,2554,5,13587,754,0,2,1,0,0
16905,7,263,75,38,59,1,3,12,76,2,4,2,4,6,6,10,15,1,15,0,0,2,1,0,0
16906,94,4280,1338,495,1086,10,64,173,1348,11,122,82,157,133,239,883,1686,7,11934,663,0,2,6,4,0
16907,23,601,102,59,69,5,3,24,107,6,22,15,28,28,43,113,206,3,789,43,0,2,1,1,0
16908,109,4101,1450,624,1228,12,26,181,1462,14,306,186,354,320,540,2580,4493,8,36391,2021,1,2,1,0,0
16909,148,4088,1660,832,1314,41,38,274,1701,20,312,209,395,332,604,2671,5058,12,64042,3557,1,2,1,0,0
16910,117,4641,1513,682,1277,25,13,200,1538,11,199,116,219,210,335,1557,2584,6,15641,868,0,2,4,3,0
16911,59,3310,1296,573,1062,40,33,157,1336,8,201,118,231,209,349,1561,2689,4,12365,686,0,2,1,0,0
16912,10,236,207,111,150,11,0,50,218,5,26,19,36,31,55,133,272,3,943,52,0,2,1,0,0
16913,78,4093,1457,730,1242,11,6,188,1468,10,292,166,329,302,495,2424,4078,5,22973,1276,1,2,1,0,0
16914,38,2286,652,304,544,16,6,88,668,6,89,51,101,95,152,591,998,3,3399,188,0,2,1,0,0
16915,62,2878,1455,414,1257,16,76,112,1471,5,41,23,46,46,69,231,381,2,1069,59,0,2,1,0,0
16916,2,75,7,6,5,0,0,2,7,1,1,1,2,2,3,0,3,1,3,0,0,2,1,0,0
16917,8,273,74,35,59,1,0,14,75,3,14,7,14,17,21,58,85,1,128,7,0,2,1,0,0
16918,87,4331,1523,757,1297,19,12,193,1542,12,193,117,230,205,347,1508,2664,7,19053,1058,0,2,2,2,0
16919,66,2763,1020,354,843,12,15,144,1032,8,134,77,144,142,221,970,1580,4,6792,377,0,2,2,1,0
16920,37,1624,447,308,343,6,5,95,453,7,96,59,111,103,170,651,1136,4,4600,255,0,2,1,0,0
16921,21,661,424,94,331,4,0,89,428,1,5,5,5,6,10,11,25,0,12,0,0,2,1,0,0
16922,40,2359,334,251,279,10,4,40,344,5,127,74,143,132,217,899,1528,2,4303,239,0,2,1,1,0
16923,12,492,184,100,137,2,15,30,186,6,38,20,39,44,59,214,322,3,991,55,0,2,1,0,0
16924,35,1623,1293,570,1093,25,15,163,1318,10,195,123,241,205,364,1516,2795,6,17273,959,0,2,1,0,0
16925,36,1978,384,251,317,7,8,52,391,11,70,44,84,81,128,467,811,6,5355,297,0,2,1,0,0
16926,15,638,722,423,573,19,0,135,741,12,172,101,199,184,300,1320,2257,6,15668,870,0,2,1,0,0
16927,31,1439,386,256,301,16,9,68,402,4,59,35,69,63,104,355,621,2,1453,80,0,2,1,0,0
16928,16,1209,215,129,180,6,0,29,221,8,65,43,72,73,115,415,711,4,3153,175,0,2,1,0,0
16929,69,2856,1043,504,840,53,9,147,1096,9,180,112,198,189,310,1377,2344,4,11604,644,0,2,1,1,0
16930,14,529,295,56,236,0,4,54,295,2,9,5,10,11,15,30,51,1,57,3,0,2,5,3,0
16931,25,1027,373,158,315,8,0,51,381,5,76,44,79,81,123,486,779,2,2026,112,0,2,1,0,0
16932,71,3006,1178,367,1042,6,15,115,1184,9,94,51,95,103,146,644,976,4,4439,246,0,2,1,0,0
16933,73,3738,1943,715,1694,26,18,214,1969,12,185,120,237,197,357,1436,2721,7,20915,1161,0,2,1,0,0
16934,14,825,442,244,305,14,16,103,456,11,68,45,75,79,120,452,756,6,4588,254,0,2,1,0,0
16935,48,1784,1098,241,925,5,10,155,1103,7,46,25,49,53,74,273,423,3,1580,87,0,2,1,0,0
16936,79,1563,1020,354,843,12,15,144,1032,8,134,77,144,142,221,970,1580,4,6792,377,0,2,62,15,1
16937,336,7198,72,33,56,0,4,12,72,1,1,1,1,2,2,0,2,0,1,0,0,2,36,35,1
16938,336,7198,1454,835,1044,76,110,219,1530,17,275,158,296,292,454,2297,3718,9,34017,1889,1,2,36,35,1
16939,112,5702,1782,648,1425,9,47,279,1791,8,171,97,189,179,286,1292,2140,4,9462,525,0,2,68,31,1
16940,67,2928,1020,354,843,12,15,144,1032,8,134,77,144,142,221,970,1580,4,6792,377,0,2,22,6,1
16941,79,1563,1020,354,843,12,15,144,1032,8,134,77,144,142,221,970,1580,4,6792,377,0,2,62,15,0
16942,336,7198,72,33,56,0,4,12,72,1,1,1,1,2,2,0,2,0,1,0,0,2,36,35,0
16943,336,7198,1454,835,1044,76,110,219,1530,17,275,158,296,292,454,2297,3718,9,34017,1889,1,2,36,35,0
16944,112,5702,1782,648,1425,9,47,279,1791,8,171,97,189,179,286,1292,2140,4,9462,525,0,2,68,31,0
16945,67,2928,1020,354,843,12,15,144,1032,8,134,77,144,142,221,970,1580,4,6792,377,0,2,22,6,0
16946,9,231,19,8,11,5,0,4,24,2,5,3,6,7,9,13,25,1,30,1,0,2,1,1,0
16947,9,231,102,59,69,5,3,24,107,6,22,15,28,28,43,113,206,3,789,43,0,2,1,1,0
16948,9,231,106,40,36,3,49,17,109,8,17,13,23,25,36,93,167,5,904,50,0,2,1,1,0
16949,211,4523,182,127,129,0,0,53,182,5,39,21,42,44,63,217,343,2,926,51,0,2,1,0,0
16950,211,4523,1165,710,800,67,119,181,1232,18,243,153,282,261,435,2000,3492,10,36473,2026,1,2,1,0,0
16951,99,2081,773,419,590,28,0,166,801,10,204,113,217,214,330,1598,2554,5,13587,754,0,2,1,1,0
16952,99,2081,421,273,302,44,34,57,465,17,81,59,107,98,166,583,1098,11,12329,684,0,2,1,1,0
16953,28,556,2,2,2,0,0,0,2,0,0,0,0,0,0,0,0,0,0,0,0,2,1,0,0
16954,28,556,99,48,90,1,3,5,100,0,0,0,0,0,0,0,0,0,0,0,0,2,1,0,0
16955,28,556,8,5,5,2,0,1,10,0,0,0,0,0,0,0,0,0,0,0,0,2,1,0,0
16956,28,556,1217,716,841,84,126,174,1301,14,185,118,215,199,333,1446,2542,8,20687,1149,0,2,1,0,0
16957,28,556,160,89,115,0,13,31,160,7,15,11,17,22,28,78,124,3,495,27,0,2,1,0,0
16958,28,556,10,10,9,9,0,0,19,0,0,0,0,0,0,0,0,0,0,0,0,2,1,0,0
16959,28,556,173,84,99,8,29,36,181,5,12,7,13,17,20,54,81,2,221,12,0,2,1,0,0
16960,28,556,3,1,1,3,0,0,6,0,0,0,0,0,0,0,0,0,0,0,0,2,1,0,0
16961,163,5082,1660,832,1314,41,38,274,1701,20,312,209,395,332,604,2671,5058,12,64042,3557,1,2,1,1,0
16962,163,5082,1057,646,719,113,100,145,1170,18,215,134,248,233,382,1740,3004,10,31186,1732,1,2,1,1,0
16963,17,349,95,58,50,9,16,20,104,12,33,24,45,45,69,209,378,8,3100,172,0,2,1,1,0
16964,82,1800,477,336,357,30,23,73,507,16,194,134,250,210,384,1538,2962,10,30538,1696,0,2,1,0,0
16965,60,1262,996,429,845,24,10,117,1020,7,76,50,88,83,138,494,879,4,3565,198,0,2,1,1,0
16966,60,1262,456,277,329,12,42,72,468,13,85,50,97,98,147,592,972,7,7212,400,0,2,1,1,0
16967,119,2424,1513,682,1277,25,13,200,1538,11,199,116,219,210,335,1557,2584,6,15641,868,0,2,1,1,0
16968,119,2424,819,519,539,24,98,155,843,15,96,57,106,111,163,690,1107,8,9171,509,0,2,1,1,0
16969,50,1032,207,111,150,11,0,50,218,5,26,19,36,31,55,133,272,3,943,52,0,2,1,0,0
16970,50,1032,410,198,237,31,55,97,441,11,63,38,72,74,110,414,683,6,4293,238,0,2,1,0,0
16971,346,7021,1457,730,1242,11,6,188,1468,10,292,166,329,302,495,2424,4078,5,22973,1276,1,2,1,0,0
16972,346,7021,74,35,59,1,0,14,75,3,14,7,14,17,21,58,85,1,128,7,0,2,1,0,0
16973,346,7021,245,125,200,5,7,34,250,7,30,17,34,37,51,166,265,3,1053,58,0,2,1,0,0
16974,22,683,339,213,244,17,9,65,356,10,42,26,48,52,74,259,421,5,2410,133,0,2,1,1,0
16975,56,1603,1455,414,1257,16,76,112,1471,5,41,23,46,46,69,231,381,2,1069,59,0,2,1,1,0
16976,56,1603,669,365,481,22,61,110,691,15,103,63,122,118,185,747,1273,8,11311,628,0,2,1,1,0
16977,227,5129,4293,999,3693,19,54,507,4312,9,155,88,170,164,258,1156,1898,4,9368,520,0,2,1,0,0
16978,227,5129,1482,859,1002,125,135,219,1607,16,219,134,251,235,385,1766,3032,9,27804,1544,1,2,1,0,0
16979,7,147,44,22,19,0,19,6,44,2,10,6,12,12,18,35,64,1,77,4,0,2,3,1,0
16980,24,842,74,35,59,1,0,14,75,3,14,7,14,17,21,58,85,1,128,7,0,2,2,0,0
16981,24,842,245,125,200,5,7,34,250,7,30,17,34,37,51,166,265,3,1053,58,0,2,2,0,0
16982,83,2329,1523,757,1297,19,12,193,1542,12,193,117,230,205,347,1508,2664,7,19053,1058,0,2,4,2,0
16983,83,2329,701,378,504,33,58,109,734,13,110,68,126,123,194,794,1346,7,10027,557,0,2,4,2,0
16984,178,4168,77,34,69,0,0,8,77,3,24,16,29,27,45,114,213,1,387,21,0,2,2,0,0
16985,178,4168,712,438,573,51,9,84,763,14,102,71,128,116,199,733,1364,8,11988,666,0,2,2,0,0
16986,79,1563,1020,354,843,12,15,144,1032,8,134,77,144,142,221,970,1580,4,6792,377,0,2,64,15,0
16987,46,959,447,308,343,6,5,95,453,7,96,59,111,103,170,651,1136,4,4600,255,0,2,1,0,0
16988,46,959,322,174,179,16,74,51,338,10,41,26,46,51,72,252,408,5,2291,127,0,2,1,0,0
16989,23,382,424,94,331,4,0,89,428,1,5,5,5,6,10,11,25,0,12,0,0,2,1,0,0
16990,23,382,38,23,23,6,0,8,44,3,11,7,11,14,18,42,68,1,102,5,0,2,1,0,0
16991,17,518,184,100,137,2,15,30,186,6,38,20,39,44,59,214,322,3,991,55,0,2,2,0,0
16992,17,518,103,65,74,8,5,16,111,7,17,9,17,24,26,89,119,3,417,23,0,2,2,0,0
16993,223,5076,722,423,573,19,0,135,741,12,172,101,199,184,300,1320,2257,6,15668,870,0,2,9,9,0
16994,223,5076,1508,847,911,44,250,301,1552,14,148,88,169,162,257,1120,1886,7,15077,837,0,2,9,9,0
16995,336,7198,72,33,56,0,4,12,72,1,1,1,1,2,2,0,2,0,1,0,0,2,37,35,0
16996,336,7198,1454,835,1044,76,110,219,1530,17,275,158,296,292,454,2297,3718,9,34017,1889,1,2,37,35,0
16997,39,792,386,256,301,16,9,68,402,4,59,35,69,63,104,355,621,2,1453,80,0,2,2,0,0
16998,39,792,264,131,164,11,41,46,275,6,38,22,40,44,62,214,338,3,1068,59,0,2,2,0,0
16999,30,649,215,129,180,6,0,29,221,8,65,43,72,73,115,415,711,4,3153,175,0,2,3,2,0
17000,30,649,97,69,77,3,3,16,100,6,22,13,23,28,36,113,173,3,542,30,0,2,3,2,0
17001,128,2826,1043,504,840,53,9,147,1096,9,180,112,198,189,310,1377,2344,4,11604,644,0,2,2,0,0
17002,128,2826,383,288,292,26,6,62,409,11,65,38,67,76,105,429,656,5,3719,206,0,2,2,0,0
17003,20,408,294,64,250,0,0,43,294,1,20,10,20,21,30,86,131,0,65,3,0,2,2,0,0
17004,20,408,78,46,62,3,0,14,81,3,8,4,8,11,12,28,41,1,62,3,0,2,2,0,0
17005,5,118,110,30,77,3,13,16,113,4,21,15,30,25,45,100,208,2,597,33,0,2,2,0,0
17006,5,118,28,15,21,1,0,6,29,0,0,0,0,0,0,0,0,0,0,0,0,2,2,0,0
17007,104,1977,1178,367,1042,6,15,115,1184,9,94,51,95,103,146,644,976,4,4439,246,0,2,2,0,0
17008,104,1977,177,108,140,8,0,27,185,6,30,16,32,36,48,162,248,3,794,44,0,2,2,0,0
17009,191,3892,1943,715,1694,26,18,214,1969,12,185,120,237,197,357,1436,2721,7,20915,1161,0,2,2,1,0
17010,191,3892,1168,838,957,57,25,144,1225,19,348,224,416,367,640,3018,5452,11,61921,3440,1,2,2,1,0
17011,16,480,442,244,305,14,16,103,456,11,68,45,75,79,120,452,756,6,4588,254,0,2,2,0,0
17012,16,480,182,102,99,11,40,35,193,3,11,6,11,14,17,42,64,1,97,5,0,2,2,0,0
17013,62,1248,1098,241,925,5,10,155,1103,7,46,25,49,53,74,273,423,3,1580,87,0,2,1,1,0
17014,62,1248,282,202,222,14,2,44,296,8,42,24,43,50,67,250,378,4,1548,86,0,2,1,1,0
17015,78,3314,1289,550,1043,56,32,155,1345,10,167,93,185,177,278,1266,2075,5,11498,638,0,2,1,0,0
17016,34,997,182,127,129,0,0,53,182,5,39,21,42,44,63,217,343,2,926,51,0,2,1,0,0
17017,137,6599,1392,870,1177,35,17,170,1427,14,494,280,531,508,811,4473,7289,7,54850,3047,2,2,2,1,0
17018,91,3011,773,419,590,28,0,166,801,10,204,113,217,214,330,1598,2554,5,13587,754,0,2,1,0,0
17019,7,263,75,38,59,1,3,12,76,2,4,2,4,6,6,10,15,1,15,0,0,2,1,0,0
17020,94,4283,1338,495,1086,10,64,173,1348,11,122,82,157,133,239,883,1686,7,11934,663,0,2,6,4,0
17021,112,5702,1782,648,1425,9,47,279,1791,8,171,97,189,179,286,1292,2140,4,9462,525,0,2,68,31,0
17022,23,601,102,59,69,5,3,24,107,6,22,15,28,28,43,113,206,3,789,43,0,2,1,1,0
17023,109,4106,1450,624,1228,12,26,181,1462,14,306,186,354,320,540,2580,4493,8,36391,2021,1,2,1,0,0
17024,148,4088,1660,832,1314,41,38,274,1701,20,312,209,395,332,604,2671,5058,12,64042,3557,1,2,1,0,0
17025,117,4641,1513,682,1277,25,13,200,1538,11,199,116,219,210,335,1557,2584,6,15641,868,0,2,4,3,0
17026,59,3310,1296,573,1062,40,33,157,1336,8,201,118,231,209,349,1561,2689,4,12365,686,0,2,1,0,0
17027,10,236,207,111,150,11,0,50,218,5,26,19,36,31,55,133,272,3,943,52,0,2,1,0,0
17028,78,4093,1457,730,1242,11,6,188,1468,10,292,166,329,302,495,2424,4078,5,22973,1276,1,2,1,0,0
17029,38,2286,652,304,544,16,6,88,668,6,89,51,101,95,152,591,998,3,3399,188,0,2,1,0,0
17030,62,2878,1455,414,1257,16,76,112,1471,5,41,23,46,46,69,231,381,2,1069,59,0,2,1,0,0
17031,2,75,7,6,5,0,0,2,7,1,1,1,2,2,3,0,3,1,3,0,0,2,1,0,0
17032,8,273,74,35,59,1,0,14,75,3,14,7,14,17,21,58,85,1,128,7,0,2,1,0,0
17033,87,4336,1523,757,1297,19,12,193,1542,12,193,117,230,205,347,1508,2664,7,19053,1058,0,2,1,1,0
17034,67,2928,1020,354,843,12,15,144,1032,8,134,77,144,142,221,970,1580,4,6792,377,0,2,24,7,0
17035,37,1624,447,308,343,6,5,95,453,7,96,59,111,103,170,651,1136,4,4600,255,0,2,1,0,0
17036,21,661,424,94,331,4,0,89,428,1,5,5,5,6,10,11,25,0,12,0,0,2,1,0,0
17037,40,2359,334,251,279,10,4,40,344,5,127,74,143,132,217,899,1528,2,4303,239,0,2,1,1,0
17038,12,492,184,100,137,2,15,30,186,6,38,20,39,44,59,214,322,3,991,55,0,2,1,0,0
17039,35,1623,1293,570,1093,25,15,163,1318,10,195,123,241,205,364,1516,2795,6,17273,959,0,2,1,0,0
17040,36,1978,384,251,317,7,8,52,391,11,70,44,84,81,128,467,811,6,5355,297,0,2,1,0,0
17041,15,638,722,423,573,19,0,135,741,12,172,101,199,184,300,1320,2257,6,15668,870,0,2,1,0,0
17042,31,1439,386,256,301,16,9,68,402,4,59,35,69,63,104,355,621,2,1453,80,0,2,1,0,0
17043,16,1209,215,129,180,6,0,29,221,8,65,43,72,73,115,415,711,4,3153,175,0,2,1,0,0
17044,69,2856,1043,504,840,53,9,147,1096,9,180,112,198,189,310,1377,2344,4,11604,644,0,2,1,1,0
17045,14,529,295,56,236,0,4,54,295,2,9,5,10,11,15,30,51,1,57,3,0,2,5,3,0
17046,25,1027,373,158,315,8,0,51,381,5,76,44,79,81,123,486,779,2,2026,112,0,2,1,0,0
17047,71,3006,1178,367,1042,6,15,115,1184,9,94,51,95,103,146,644,976,4,4439,246,0,2,1,0,0
17048,73,3738,1943,715,1694,26,18,214,1969,12,185,120,237,197,357,1436,2721,7,20915,1161,0,2,1,0,0
17049,14,825,442,244,305,14,16,103,456,11,68,45,75,79,120,452,756,6,4588,254,0,2,1,0,0
17050,48,1784,1098,241,925,5,10,155,1103,7,46,25,49,53,74,273,423,3,1580,87,0,2,1,0,0
17051,14,339,601,196,481,2,23,85,603,8,63,36,72,71,108,400,664,4,3036,168,0,2,3,1,0
17052,14,339,156,79,106,5,16,28,161,5,14,8,15,19,23,64,97,2,261,14,0,2,3,1,0
17053,14,339,601,196,481,2,23,85,603,8,63,36,72,71,108,400,664,4,3036,168,0,2,1,1,0
17054,14,339,156,79,106,5,16,28,161,5,14,8,15,19,23,64,97,2,261,14,0,2,1,1,0
17055,336,7200,72,33,56,0,4,12,72,1,1,1,1,2,2,0,2,0,1,0,0,2,1,1,1
17056,336,7200,1454,835,1044,76,110,219,1530,17,275,158,296,292,454,2297,3718,9,34017,1889,1,2,1,1,1
17057,78,3324,1289,550,1043,56,32,155,1345,10,167,93,185,177,278,1266,2075,5,11498,638,0,2,9,3,1
17058,147,6797,139,89,101,2,0,35,141,7,54,34,62,61,96,330,569,4,2287,127,0,2,26,15,1
17059,147,6797,7,5,5,0,0,2,7,1,2,1,2,3,3,2,4,0,2,0,0,2,26,15,1
17060,112,5710,1782,648,1425,9,47,279,1791,8,171,97,189,179,286,1292,2140,4,9462,525,0,2,2,1,1
17061,78,4093,1457,730,1242,11,6,188,1468,10,292,166,329,302,495,2424,4078,5,22973,1276,1,2,1,1,1
17062,40,2367,334,251,279,10,4,40,344,5,127,74,143,132,217,899,1528,2,4303,239,0,2,8,7,1
17063,223,5076,722,423,573,19,0,135,741,12,172,101,199,184,300,1320,2257,6,15668,870,0,2,1,1,1
17064,223,5076,1508,847,911,44,250,301,1552,14,148,88,169,162,257,1120,1886,7,15077,837,0,2,1,1,1
17065,128,2841,1043,504,840,53,9,147,1096,9,180,112,198,189,310,1377,2344,4,11604,644,0,2,12,5,1
17066,128,2841,383,288,292,26,6,62,409,11,65,38,67,76,105,429,656,5,3719,206,0,2,12,5,1
17067,78,3341,1289,550,1043,56,32,155,1345,10,167,93,185,177,278,1266,2075,5,11498,638,0,2,6,1,0
17068,346,7021,1457,730,1242,11,6,188,1468,10,292,166,329,302,495,2424,4078,5,22973,1276,1,2,3,3,0
17069,346,7021,74,35,59,1,0,14,75,3,14,7,14,17,21,58,85,1,128,7,0,2,3,3,0
17070,346,7021,245,125,200,5,7,34,250,7,30,17,34,37,51,166,265,3,1053,58,0,2,3,3,0
17071,227,5129,4293,999,3693,19,54,507,4312,9,155,88,170,164,258,1156,1898,4,9368,520,0,2,1,1,0
17072,227,5129,1482,859,1002,125,135,219,1607,16,219,134,251,235,385,1766,3032,9,27804,1544,1,2,1,1,0
17073,223,5076,722,423,573,19,0,135,741,12,172,101,199,184,300,1320,2257,6,15668,870,0,2,1,1,0
17074,223,5076,1508,847,911,44,250,301,1552,14,148,88,169,162,257,1120,1886,7,15077,837,0,2,1,1,0
17075,336,7200,72,33,56,0,4,12,72,1,1,1,1,2,2,0,2,0,1,0,0,2,1,1,0
17076,336,7200,1454,835,1044,76,110,219,1530,17,275,158,296,292,454,2297,3718,9,34017,1889,1,2,1,1,0
17077,39,792,386,256,301,16,9,68,402,4,59,35,69,63,104,355,621,2,1453,80,0,2,0,2,0
17078,39,792,264,131,164,11,41,46,275,6,38,22,40,44,62,214,338,3,1068,59,0,2,0,2,0
17079,128,2841,1043,504,840,53,9,147,1096,9,180,112,198,189,310,1377,2344,4,11604,644,0,2,12,5,0
17080,128,2841,383,288,292,26,6,62,409,11,65,38,67,76,105,429,656,5,3719,206,0,2,12,5,0
17081,191,3892,1943,715,1694,26,18,214,1969,12,185,120,237,197,357,1436,2721,7,20915,1161,0,2,51,19,0
17082,191,3892,1168,838,957,57,25,144,1225,19,348,224,416,367,640,3018,5452,11,61921,3440,1,2,51,19,0
17083,14,339,601,196,481,2,23,85,603,8,63,36,72,71,108,400,664,4,3036,168,0,0,73,0,0
17084,14,339,156,79,106,5,16,28,161,5,14,8,15,19,23,64,97,2,261,14,0,0,73,0,0
17085,78,3341,1289,550,1043,56,32,155,1345,10,167,93,185,177,278,1266,2075,5,11498,638,0,2,15,4,0
17086,7,263,75,38,59,1,3,12,76,2,4,2,4,6,6,10,15,1,15,0,0,2,1,1,0
17087,94,4283,1338,495,1086,10,64,173,1348,11,122,82,157,133,239,883,1686,7,11934,663,0,2,5,5,0
17088,147,6797,139,89,101,2,0,35,141,7,54,34,62,61,96,330,569,4,2287,127,0,2,26,15,0
17089,147,6797,7,5,5,0,0,2,7,1,2,1,2,3,3,2,4,0,2,0,0,2,26,15,0
17090,112,5710,1782,648,1425,9,47,279,1791,8,171,97,189,179,286,1292,2140,4,9462,525,0,2,2,1,0
17091,109,4106,1450,624,1228,12,26,181,1462,14,306,186,354,320,540,2580,4493,8,36391,2021,1,2,4,1,0
17092,78,4093,1457,730,1242,11,6,188,1468,10,292,166,329,302,495,2424,4078,5,22973,1276,1,2,5,4,0
17093,87,4336,1523,757,1297,19,12,193,1542,12,193,117,230,205,347,1508,2664,7,19053,1058,0,2,4,1,0
17094,40,2367,334,251,279,10,4,40,344,5,127,74,143,132,217,899,1528,2,4303,239,0,2,8,7,0
17095,36,1978,384,251,317,7,8,52,391,11,70,44,84,81,128,467,811,6,5355,297,0,2,2,2,0
17096,31,1439,386,256,301,16,9,68,402,4,59,35,69,63,104,355,621,2,1453,80,0,2,3,1,0
17097,73,3738,1943,715,1694,26,18,214,1969,12,185,120,237,197,357,1436,2721,7,20915,1161,0,2,8,8,0
17098,9,317,601,196,481,2,23,85,603,8,63,36,72,71,108,400,664,4,3036,168,0,0,108,0,0
17099,27,545,2,2,2,0,0,0,2,0,0,0,0,0,0,0,0,0,0,0,0,2,0,3,1
17100,27,545,99,48,90,1,3,5,100,0,0,0,0,0,0,0,0,0,0,0,0,2,0,3,1
17101,27,545,8,5,5,2,0,1,10,0,0,0,0,0,0,0,0,0,0,0,0,2,0,3,1
17102,27,545,1217,716,841,84,126,174,1301,14,185,118,215,199,333,1446,2542,8,20687,1149,0,2,0,3,1
17103,27,545,160,89,115,0,13,31,160,7,15,11,17,22,28,78,124,3,495,27,0,2,0,3,1
17104,27,545,10,10,9,9,0,0,19,0,0,0,0,0,0,0,0,0,0,0,0,2,0,3,1
17105,27,545,173,84,99,8,29,36,181,5,12,7,13,17,20,54,81,2,221,12,0,2,0,3,1
17106,27,545,3,1,1,3,0,0,6,0,0,0,0,0,0,0,0,0,0,0,0,2,0,3,1
17107,346,7021,1457,730,1242,11,6,188,1468,10,292,166,329,302,495,2424,4078,5,22973,1276,1,2,1,0,1
17108,346,7021,74,35,59,1,0,14,75,3,14,7,14,17,21,58,85,1,128,7,0,2,1,0,1
17109,346,7021,245,125,200,5,7,34,250,7,30,17,34,37,51,166,265,3,1053,58,0,2,1,0,1
17110,6,136,44,22,19,0,19,6,44,2,10,6,12,12,18,35,64,1,77,4,0,2,0,3,1
17111,21,670,339,213,244,17,9,65,356,10,42,26,48,52,74,259,421,5,2410,133,0,2,8,8,1
17112,227,5121,4293,999,3693,19,54,507,4312,9,155,88,170,164,258,1156,1898,4,9368,520,0,2,0,2,1
17113,227,5121,1482,859,1002,125,135,219,1607,16,219,134,251,235,385,1766,3032,9,27804,1544,1,2,0,2,1
17114,38,777,386,256,301,16,9,68,402,4,59,35,69,63,104,355,621,2,1453,80,0,2,0,5,1
17115,38,777,264,131,164,11,41,46,275,6,38,22,40,44,62,214,338,3,1068,59,0,2,0,5,1
17116,127,2817,1043,504,840,53,9,147,1096,9,180,112,198,189,310,1377,2344,4,11604,644,0,2,0,7,1
17117,127,2817,383,288,292,26,6,62,409,11,65,38,67,76,105,429,656,5,3719,206,0,2,0,7,1
17118,80,1581,1020,354,843,12,15,144,1032,8,134,77,144,142,221,970,1580,4,6792,377,0,2,13,5,1
17119,103,1965,1178,367,1042,6,15,115,1184,9,94,51,95,103,146,644,976,4,4439,246,0,2,0,4,1
17120,103,1965,177,108,140,8,0,27,185,6,30,16,32,36,48,162,248,3,794,44,0,2,0,4,1
17121,49,575,647,139,84,35,284,233,682,0,0,0,0,0,0,0,0,0,0,0,0,2,3,1,1
17122,80,1586,1020,354,843,12,15,144,1032,8,134,77,144,142,221,970,1580,4,6792,377,0,2,1,1,1
17123,52,1103,207,111,150,11,0,50,218,5,26,19,36,31,55,133,272,3,943,52,0,2,23,0,1
17124,52,1103,410,198,237,31,55,97,441,11,63,38,72,74,110,414,683,6,4293,238,0,2,23,0,1
17125,227,5114,4293,999,3693,19,54,507,4312,9,155,88,170,164,258,1156,1898,4,9368,520,0,2,1,3,1
17126,227,5114,1482,859,1002,125,135,219,1607,16,219,134,251,235,385,1766,3032,9,27804,1544,1,2,1,3,1
17127,177,4136,77,34,69,0,0,8,77,3,24,16,29,27,45,114,213,1,387,21,0,2,0,5,1
17128,177,4136,712,438,573,51,9,84,763,14,102,71,128,116,199,733,1364,8,11988,666,0,2,0,5,1
17129,335,7153,72,33,56,0,4,12,72,1,1,1,1,2,2,0,2,0,1,0,0,2,6,16,1
17130,335,7153,1454,835,1044,76,110,219,1530,17,275,158,296,292,454,2297,3718,9,34017,1889,1,2,6,16,1
17131,226,5106,4293,999,3693,19,54,507,4312,9,155,88,170,164,258,1156,1898,4,9368,520,0,2,5,9,1
17132,226,5106,1482,859,1002,125,135,219,1607,16,219,134,251,235,385,1766,3032,9,27804,1544,1,2,5,9,1
17133,53,1123,207,111,150,11,0,50,218,5,26,19,36,31,55,133,272,3,943,52,0,2,9,0,1
17134,53,1123,410,198,237,31,55,97,441,11,63,38,72,74,110,414,683,6,4293,238,0,2,9,0,1
17135,21,668,339,213,244,17,9,65,356,10,42,26,48,52,74,259,421,5,2410,133,0,2,2,3,1
17136,225,5104,4293,999,3693,19,54,507,4312,9,155,88,170,164,258,1156,1898,4,9368,520,0,2,15,24,1
17137,225,5104,1482,859,1002,125,135,219,1607,16,219,134,251,235,385,1766,3032,9,27804,1544,1,2,15,24,1
17138,177,4124,77,34,69,0,0,8,77,3,24,16,29,27,45,114,213,1,387,21,0,2,28,22,1
17139,177,4124,712,438,573,51,9,84,763,14,102,71,128,116,199,733,1364,8,11988,666,0,2,28,22,1
17140,46,961,447,308,343,6,5,95,453,7,96,59,111,103,170,651,1136,4,4600,255,0,2,4,4,1
17141,46,961,322,174,179,16,74,51,338,10,41,26,46,51,72,252,408,5,2291,127,0,2,4,4,1
17142,335,7158,72,33,56,0,4,12,72,1,1,1,1,2,2,0,2,0,1,0,0,2,11,10,1
17143,335,7158,1454,835,1044,76,110,219,1530,17,275,158,296,292,454,2297,3718,9,34017,1889,1,2,11,10,1
17144,38,783,386,256,301,16,9,68,402,4,59,35,69,63,104,355,621,2,1453,80,0,2,8,6,1
17145,38,783,264,131,164,11,41,46,275,6,38,22,40,44,62,214,338,3,1068,59,0,2,8,6,1
17146,127,2813,1043,504,840,53,9,147,1096,9,180,112,198,189,310,1377,2344,4,11604,644,0,2,1,2,1
17147,127,2813,383,288,292,26,6,62,409,11,65,38,67,76,105,429,656,5,3719,206,0,2,1,2,1
17148,103,1960,1178,367,1042,6,15,115,1184,9,94,51,95,103,146,644,976,4,4439,246,0,2,20,18,1
17149,103,1960,177,108,140,8,0,27,185,6,30,16,32,36,48,162,248,3,794,44,0,2,20,18,1
17150,225,5102,4293,999,3693,19,54,507,4312,9,155,88,170,164,258,1156,1898,4,9368,520,0,2,3,2,1
17151,225,5102,1482,859,1002,125,135,219,1607,16,219,134,251,235,385,1766,3032,9,27804,1544,1,2,3,2,1
17152,335,7158,72,33,56,0,4,12,72,1,1,1,1,2,2,0,2,0,1,0,0,2,1,1,1
17153,335,7158,1454,835,1044,76,110,219,1530,17,275,158,296,292,454,2297,3718,9,34017,1889,1,2,1,1,1
17154,38,783,386,256,301,16,9,68,402,4,59,35,69,63,104,355,621,2,1453,80,0,2,0,1,1
17155,38,783,264,131,164,11,41,46,275,6,38,22,40,44,62,214,338,3,1068,59,0,2,0,1,1
17156,103,1956,1178,367,1042,6,15,115,1184,9,94,51,95,103,146,644,976,4,4439,246,0,2,11,5,1
17157,103,1956,177,108,140,8,0,27,185,6,30,16,32,36,48,162,248,3,794,44,0,2,11,5,1
17158,177,4127,77,34,69,0,0,8,77,3,24,16,29,27,45,114,213,1,387,21,0,2,1,1,1
17159,177,4127,712,438,573,51,9,84,763,14,102,71,128,116,199,733,1364,8,11988,666,0,2,1,1,1
17160,225,5106,4293,999,3693,19,54,507,4312,9,155,88,170,164,258,1156,1898,4,9368,520,0,2,3,3,0
17161,225,5106,1482,859,1002,125,135,219,1607,16,219,134,251,235,385,1766,3032,9,27804,1544,1,2,3,3,0
17162,23,388,424,94,331,4,0,89,428,1,5,5,5,6,10,11,25,0,12,0,0,2,9,9,1
17163,23,388,38,23,23,6,0,8,44,3,11,7,11,14,18,42,68,1,102,5,0,2,9,9,1
17164,62,1240,1098,241,925,5,10,155,1103,7,46,25,49,53,74,273,423,3,1580,87,0,2,25,21,1
17165,62,1240,282,202,222,14,2,44,296,8,42,24,43,50,67,250,378,4,1548,86,0,2,25,21,1
17166,335,7154,72,33,56,0,4,12,72,1,1,1,1,2,2,0,2,0,1,0,0,2,8,5,1
17167,335,7154,1454,835,1044,76,110,219,1530,17,275,158,296,292,454,2297,3718,9,34017,1889,1,2,8,5,1
17168,80,1593,1020,354,843,12,15,144,1032,8,134,77,144,142,221,970,1580,4,6792,377,0,2,2,4,1
17169,178,4136,77,34,69,0,0,8,77,3,24,16,29,27,45,114,213,1,387,21,0,2,10,0,1
17170,178,4136,712,438,573,51,9,84,763,14,102,71,128,116,199,733,1364,8,11988,666,0,2,10,0,1
17171,48,904,207,111,150,11,0,50,218,5,26,19,36,31,55,133,272,3,943,52,0,2,2,0,0
17172,48,904,410,198,237,31,55,97,441,11,63,38,72,74,110,414,683,6,4293,238,0,2,2,0,0
17173,335,7113,72,33,56,0,4,12,72,1,1,1,1,2,2,0,2,0,1,0,0,2,2,2,0
17174,335,7113,1454,835,1044,76,110,219,1530,17,275,158,296,292,454,2297,3718,9,34017,1889,1,2,2,2,0
17175,95,4294,1338,495,1086,10,64,173,1348,11,122,82,157,133,239,883,1686,7,11934,663,0,2,17,0,0
17176,48,904,207,111,150,11,0,50,218,5,26,19,36,31,55,133,272,3,943,52,0,2,1,1,0
17177,48,904,410,198,237,31,55,97,441,11,63,38,72,74,110,414,683,6,4293,238,0,2,1,1,0
17178,48,904,207,111,150,11,0,50,218,5,26,19,36,31,55,133,272,3,943,52,0,2,3,1,0
17179,48,904,410,198,237,31,55,97,441,11,63,38,72,74,110,414,683,6,4293,238,0,2,3,1,0
17180,335,7113,72,33,56,0,4,12,72,1,1,1,1,2,2,0,2,0,1,0,0,2,2,2,0
17181,335,7113,1454,835,1044,76,110,219,1530,17,275,158,296,292,454,2297,3718,9,34017,1889,1,2,2,2,0
17182,95,4294,1338,495,1086,10,64,173,1348,11,122,82,157,133,239,883,1686,7,11934,663,0,2,17,0,0
17183,346,7035,1457,730,1242,11,6,188,1468,10,292,166,329,302,495,2424,4078,5,22973,1276,1,2,2,1,1
17184,346,7035,74,35,59,1,0,14,75,3,14,7,14,17,21,58,85,1,128,7,0,2,2,1,1
17185,346,7035,245,125,200,5,7,34,250,7,30,17,34,37,51,166,265,3,1053,58,0,2,2,1,1
17186,79,3381,1289,550,1043,56,32,155,1345,10,167,93,185,177,278,1266,2075,5,11498,638,0,2,14,0,1
17187,346,7035,1457,730,1242,11,6,188,1468,10,292,166,329,302,495,2424,4078,5,22973,1276,1,2,2,1,0
17188,346,7035,74,35,59,1,0,14,75,3,14,7,14,17,21,58,85,1,128,7,0,2,2,1,0
17189,346,7035,245,125,200,5,7,34,250,7,30,17,34,37,51,166,265,3,1053,58,0,2,2,1,0
17190,79,3381,1289,550,1043,56,32,155,1345,10,167,93,185,177,278,1266,2075,5,11498,638,0,2,14,0,0
17191,163,5086,1660,832,1314,41,38,274,1701,20,312,209,395,332,604,2671,5058,12,64042,3557,1,2,1,1,0
17192,163,5086,1057,646,719,113,100,145,1170,18,215,134,248,233,382,1740,3004,10,31186,1732,1,2,1,1,0
17193,149,4136,1660,832,1314,41,38,274,1701,20,312,209,395,332,604,2671,5058,12,64042,3557,1,2,18,0,0
17194,9,220,19,8,11,5,0,4,24,2,5,3,6,7,9,13,25,1,30,1,0,2,1,0,1
17195,9,220,102,59,69,5,3,24,107,6,22,15,28,28,43,113,206,3,789,43,0,2,1,0,1
17196,9,220,106,40,36,3,49,17,109,8,17,13,23,25,36,93,167,5,904,50,0,2,1,0,1
17197,211,4515,182,127,129,0,0,53,182,5,39,21,42,44,63,217,343,2,926,51,0,2,23,8,1
17198,211,4515,1165,710,800,67,119,181,1232,18,243,153,282,261,435,2000,3492,10,36473,2026,1,2,23,8,1
17199,99,2075,773,419,590,28,0,166,801,10,204,113,217,214,330,1598,2554,5,13587,754,0,2,8,15,1
17200,99,2075,421,273,302,44,34,57,465,17,81,59,107,98,166,583,1098,11,12329,684,0,2,8,15,1
17201,34,625,2,2,2,0,0,0,2,0,0,0,0,0,0,0,0,0,0,0,0,2,3,1,1
17202,34,625,99,48,90,1,3,5,100,0,0,0,0,0,0,0,0,0,0,0,0,2,3,1,1
17203,34,625,8,5,5,2,0,1,10,0,0,0,0,0,0,0,0,0,0,0,0,2,3,1,1
17204,34,625,1217,716,841,84,126,174,1301,14,185,118,215,199,333,1446,2542,8,20687,1149,0,2,3,1,1
17205,34,625,160,89,115,0,13,31,160,7,15,11,17,22,28,78,124,3,495,27,0,2,3,1,1
17206,34,625,10,10,9,9,0,0,19,0,0,0,0,0,0,0,0,0,0,0,0,2,3,1,1
17207,34,625,173,84,99,8,29,36,181,5,12,7,13,17,20,54,81,2,221,12,0,2,3,1,1
17208,34,625,3,1,1,3,0,0,6,0,0,0,0,0,0,0,0,0,0,0,0,2,3,1,1
17209,163,5074,1660,832,1314,41,38,274,1701,20,312,209,395,332,604,2671,5058,12,64042,3557,1,2,17,6,1
17210,163,5074,1057,646,719,113,100,145,1170,18,215,134,248,233,382,1740,3004,10,31186,1732,1,2,17,6,1
17211,82,1800,477,336,357,30,23,73,507,16,194,134,250,210,384,1538,2962,10,30538,1696,0,2,1,1,1
17212,60,1251,996,429,845,24,10,117,1020,7,76,50,88,83,138,494,879,4,3565,198,0,2,1,1,1
17213,60,1251,456,277,329,12,42,72,468,13,85,50,97,98,147,592,972,7,7212,400,0,2,1,1,1
17214,119,2401,1513,682,1277,25,13,200,1538,11,199,116,219,210,335,1557,2584,6,15641,868,0,2,3,1,1
17215,119,2401,819,519,539,24,98,155,843,15,96,57,106,111,163,690,1107,8,9171,509,0,2,3,1,1
17216,48,904,207,111,150,11,0,50,218,5,26,19,36,31,55,133,272,3,943,52,0,2,33,6,1
17217,48,904,410,198,237,31,55,97,441,11,63,38,72,74,110,414,683,6,4293,238,0,2,33,6,1
17218,346,6994,1457,730,1242,11,6,188,1468,10,292,166,329,302,495,2424,4078,5,22973,1276,1,2,98,36,1
17219,346,6994,74,35,59,1,0,14,75,3,14,7,14,17,21,58,85,1,128,7,0,2,98,36,1
17220,346,6994,245,125,200,5,7,34,250,7,30,17,34,37,51,166,265,3,1053,58,0,2,98,36,1
17221,23,680,339,213,244,17,9,65,356,10,42,26,48,52,74,259,421,5,2410,133,0,2,2,0,1
17222,227,5099,4293,999,3693,19,54,507,4312,9,155,88,170,164,258,1156,1898,4,9368,520,0,2,29,4,1
17223,227,5099,1482,859,1002,125,135,219,1607,16,219,134,251,235,385,1766,3032,9,27804,1544,1,2,29,4,1
17224,24,834,74,35,59,1,0,14,75,3,14,7,14,17,21,58,85,1,128,7,0,2,5,3,1
17225,24,834,245,125,200,5,7,34,250,7,30,17,34,37,51,166,265,3,1053,58,0,2,5,3,1
17226,49,573,647,139,84,35,284,233,682,0,0,0,0,0,0,0,0,0,0,0,0,2,10,3,1
17227,71,2109,1523,757,1297,19,12,193,1542,12,193,117,230,205,347,1508,2664,7,19053,1058,0,2,13,6,1
17228,71,2109,701,378,504,33,58,109,734,13,110,68,126,123,194,794,1346,7,10027,557,0,2,13,6,1
17229,179,4176,77,34,69,0,0,8,77,3,24,16,29,27,45,114,213,1,387,21,0,2,48,39,1
17230,179,4176,712,438,573,51,9,84,763,14,102,71,128,116,199,733,1364,8,11988,666,0,2,48,39,1
17231,70,1304,1020,354,843,12,15,144,1032,8,134,77,144,142,221,970,1580,4,6792,377,0,2,3,1,1
17232,46,945,447,308,343,6,5,95,453,7,96,59,111,103,170,651,1136,4,4600,255,0,2,3,3,1
17233,46,945,322,174,179,16,74,51,338,10,41,26,46,51,72,252,408,5,2291,127,0,2,3,3,1
17234,17,510,184,100,137,2,15,30,186,6,38,20,39,44,59,214,322,3,991,55,0,2,6,0,1
17235,17,510,103,65,74,8,5,16,111,7,17,9,17,24,26,89,119,3,417,23,0,2,6,0,1
17236,222,4989,722,423,573,19,0,135,741,12,172,101,199,184,300,1320,2257,6,15668,870,0,2,17,9,1
17237,222,4989,1508,847,911,44,250,301,1552,14,148,88,169,162,257,1120,1886,7,15077,837,0,2,17,9,1
17238,335,7113,72,33,56,0,4,12,72,1,1,1,1,2,2,0,2,0,1,0,0,2,59,37,1
17239,335,7113,1454,835,1044,76,110,219,1530,17,275,158,296,292,454,2297,3718,9,34017,1889,1,2,59,37,1
17240,42,969,386,256,301,16,9,68,402,4,59,35,69,63,104,355,621,2,1453,80,0,2,10,2,1
17241,42,969,264,131,164,11,41,46,275,6,38,22,40,44,62,214,338,3,1068,59,0,2,10,2,1
17242,128,2805,1043,504,840,53,9,147,1096,9,180,112,198,189,310,1377,2344,4,11604,644,0,2,7,0,1
17243,128,2805,383,288,292,26,6,62,409,11,65,38,67,76,105,429,656,5,3719,206,0,2,7,0,1
17244,20,400,294,64,250,0,0,43,294,1,20,10,20,21,30,86,131,0,65,3,0,2,2,2,1
17245,20,400,78,46,62,3,0,14,81,3,8,4,8,11,12,28,41,1,62,3,0,2,2,2,1
17246,104,1979,1178,367,1042,6,15,115,1184,9,94,51,95,103,146,644,976,4,4439,246,0,2,8,3,1
17247,104,1979,177,108,140,8,0,27,185,6,30,16,32,36,48,162,248,3,794,44,0,2,8,3,1
17248,184,3743,1943,715,1694,26,18,214,1969,12,185,120,237,197,357,1436,2721,7,20915,1161,0,2,14,2,1
17249,184,3743,1168,838,957,57,25,144,1225,19,348,224,416,367,640,3018,5452,11,61921,3440,1,2,14,2,1
17250,16,469,442,244,305,14,16,103,456,11,68,45,75,79,120,452,756,6,4588,254,0,2,2,1,1
17251,16,469,182,102,99,11,40,35,193,3,11,6,11,14,17,42,64,1,97,5,0,2,2,1,1
17252,62,1244,1098,241,925,5,10,155,1103,7,46,25,49,53,74,273,423,3,1580,87,0,2,26,3,1
17253,62,1244,282,202,222,14,2,44,296,8,42,24,43,50,67,250,378,4,1548,86,0,2,26,3,1
17254,1,300,382,65,130,157,2,92,539,4,10,5,10,14,15,41,57,2,114,6,0,2,1,1,1
17255,14,472,42,7,35,4,0,5,46,1,2,1,2,3,3,2,4,0,2,0,0,2,3,3,1
17256,14,472,11,6,10,0,0,1,11,2,4,2,4,6,6,10,15,1,15,0,0,2,3,3,1
17257,78,3291,1289,550,1043,56,32,155,1345,10,167,93,185,177,278,1266,2075,5,11498,638,0,2,1,1,1
17258,34,980,182,127,129,0,0,53,182,5,39,21,42,44,63,217,343,2,926,51,0,2,5,0,1
17259,137,6580,1392,870,1177,35,17,170,1427,14,494,280,531,508,811,4473,7289,7,54850,3047,2,2,66,3,1
17260,47,2495,520,294,400,33,13,81,553,10,261,204,367,271,571,2128,4614,7,32445,1802,1,2,33,7,1
17261,95,4294,1338,495,1086,10,64,173,1348,11,122,82,157,133,239,883,1686,7,11934,663,0,2,67,1,1
17262,147,6715,139,89,101,2,0,35,141,7,54,34,62,61,96,330,569,4,2287,127,0,2,26,0,1
17263,147,6715,7,5,5,0,0,2,7,1,2,1,2,3,3,2,4,0,2,0,0,2,26,0,1
17264,32,933,465,148,393,5,8,60,470,4,31,20,31,35,51,161,261,2,523,29,0,2,10,0,1
17265,32,933,16,12,9,0,0,6,16,1,2,1,2,3,3,2,4,0,2,0,0,2,10,0,1
17266,106,5313,1782,648,1425,9,47,279,1791,8,171,97,189,179,286,1292,2140,4,9462,525,0,2,20,0,1
17267,20,468,256,139,192,9,7,47,265,4,23,12,24,27,36,112,171,2,357,19,0,2,30,0,1
17268,95,3480,1450,624,1228,12,26,181,1462,14,306,186,354,320,540,2580,4493,8,36391,2021,1,2,83,1,1
17269,148,4073,1660,832,1314,41,38,274,1701,20,312,209,395,332,604,2671,5058,12,64042,3557,1,2,171,1,1
17270,116,4567,1513,682,1277,25,13,200,1538,11,199,116,219,210,335,1557,2584,6,15641,868,0,2,3,2,1
17271,58,3234,1296,573,1062,40,33,157,1336,8,201,118,231,209,349,1561,2689,4,12365,686,0,2,5,11,1
17272,5,138,207,111,150,11,0,50,218,5,26,19,36,31,55,133,272,3,943,52,0,0,50,0,1
17273,78,4037,1457,730,1242,11,6,188,1468,10,292,166,329,302,495,2424,4078,5,22973,1276,1,2,97,2,1
17274,38,2269,652,304,544,16,6,88,668,6,89,51,101,95,152,591,998,3,3399,188,0,2,27,0,1
17275,61,2747,1455,414,1257,16,76,112,1471,5,41,23,46,46,69,231,381,2,1069,59,0,2,5,3,1
17276,82,4086,1523,757,1297,19,12,193,1542,12,193,117,230,205,347,1508,2664,7,19053,1058,0,2,59,0,1
17277,66,2745,1020,354,843,12,15,144,1032,8,134,77,144,142,221,970,1580,4,6792,377,0,2,20,1,1
17278,37,1604,447,308,343,6,5,95,453,7,96,59,111,103,170,651,1136,4,4600,255,0,2,4,10,1
17279,21,647,424,94,331,4,0,89,428,1,5,5,5,6,10,11,25,0,12,0,0,2,4,0,1
17280,40,2349,334,251,279,10,4,40,344,5,127,74,143,132,217,899,1528,2,4303,239,0,2,17,2,1
17281,12,475,184,100,137,2,15,30,186,6,38,20,39,44,59,214,322,3,991,55,0,2,2,0,1
17282,31,1478,1293,570,1093,25,15,163,1318,10,195,123,241,205,364,1516,2795,6,17273,959,0,2,38,26,1
17283,36,1940,384,251,317,7,8,52,391,11,70,44,84,81,128,467,811,6,5355,297,0,2,34,4,1
17284,15,621,722,423,573,19,0,135,741,12,172,101,199,184,300,1320,2257,6,15668,870,0,2,11,0,1
17285,30,1334,386,256,301,16,9,68,402,4,59,35,69,63,104,355,621,2,1453,80,0,2,28,5,1
17286,69,2837,1043,504,840,53,9,147,1096,9,180,112,198,189,310,1377,2344,4,11604,644,0,2,10,0,1
17287,25,1016,373,158,315,8,0,51,381,5,76,44,79,81,123,486,779,2,2026,112,0,2,1,1,1
17288,71,2977,1178,367,1042,6,15,115,1184,9,94,51,95,103,146,644,976,4,4439,246,0,2,24,1,1
17289,73,3706,1943,715,1694,26,18,214,1969,12,185,120,237,197,357,1436,2721,7,20915,1161,0,2,35,1,1
17290,48,1773,1098,241,925,5,10,155,1103,7,46,25,49,53,74,273,423,3,1580,87,0,2,23,0,1
17291,227,5099,4293,999,3693,19,54,507,4312,9,155,88,170,164,258,1156,1898,4,9368,520,0,2,10,10,1
17292,227,5099,1482,859,1002,125,135,219,1607,16,219,134,251,235,385,1766,3032,9,27804,1544,1,2,10,10,1
17293,227,5099,4293,999,3693,19,54,507,4312,9,155,88,170,164,258,1156,1898,4,9368,520,0,2,10,10,0
17294,227,5099,1482,859,1002,125,135,219,1607,16,219,134,251,235,385,1766,3032,9,27804,1544,1,2,10,10,0
17295,60,1262,996,429,845,24,10,117,1020,7,76,50,88,83,138,494,879,4,3565,198,0,2,3,3,1
17296,60,1262,456,277,329,12,42,72,468,13,85,50,97,98,147,592,972,7,7212,400,0,2,3,3,1
17297,60,1262,996,429,845,24,10,117,1020,7,76,50,88,83,138,494,879,4,3565,198,0,2,3,3,0
17298,60,1262,456,277,329,12,42,72,468,13,85,50,97,98,147,592,972,7,7212,400,0,2,3,3,0
17299,163,5086,1660,832,1314,41,38,274,1701,20,312,209,395,332,604,2671,5058,12,64042,3557,1,2,1,1,0
17300,163,5086,1057,646,719,113,100,145,1170,18,215,134,248,233,382,1740,3004,10,31186,1732,1,2,1,1,0
17301,149,4136,1660,832,1314,41,38,274,1701,20,312,209,395,332,604,2671,5058,12,64042,3557,1,2,18,0,0
17302,346,7028,1457,730,1242,11,6,188,1468,10,292,166,329,302,495,2424,4078,5,22973,1276,1,2,0,1,1
17303,346,7028,74,35,59,1,0,14,75,3,14,7,14,17,21,58,85,1,128,7,0,2,0,1,1
17304,346,7028,245,125,200,5,7,34,250,7,30,17,34,37,51,166,265,3,1053,58,0,2,0,1,1
17305,178,4177,77,34,69,0,0,8,77,3,24,16,29,27,45,114,213,1,387,21,0,2,1,0,1
17306,178,4177,712,438,573,51,9,84,763,14,102,71,128,116,199,733,1364,8,11988,666,0,2,1,0,1
17307,80,3429,1289,550,1043,56,32,155,1345,10,167,93,185,177,278,1266,2075,5,11498,638,0,2,28,0,1
17308,8,273,74,35,59,1,0,14,75,3,14,7,14,17,21,58,85,1,128,7,0,2,1,1,0
17309,223,5076,722,423,573,19,0,135,741,12,172,101,199,184,300,1320,2257,6,15668,870,0,2,1,1,0
17310,223,5076,1508,847,911,44,250,301,1552,14,148,88,169,162,257,1120,1886,7,15077,837,0,2,1,1,0
17311,211,4485,182,127,129,0,0,53,182,5,39,21,42,44,63,217,343,2,926,51,0,2,6,5,1
17312,211,4485,1165,710,800,67,119,181,1232,18,243,153,282,261,435,2000,3492,10,36473,2026,1,2,6,5,1
17313,48,919,207,111,150,11,0,50,218,5,26,19,36,31,55,133,272,3,943,52,0,2,1,0,1
17314,48,919,410,198,237,31,55,97,441,11,63,38,72,74,110,414,683,6,4293,238,0,2,1,0,1
17315,211,4485,182,127,129,0,0,53,182,5,39,21,42,44,63,217,343,2,926,51,0,2,6,5,0
17316,211,4485,1165,710,800,67,119,181,1232,18,243,153,282,261,435,2000,3492,10,36473,2026,1,2,6,5,0
17317,48,919,207,111,150,11,0,50,218,5,26,19,36,31,55,133,272,3,943,52,0,2,1,0,0
17318,48,919,410,198,237,31,55,97,441,11,63,38,72,74,110,414,683,6,4293,238,0,2,1,0,0
17319,223,5080,722,423,573,19,0,135,741,12,172,101,199,184,300,1320,2257,6,15668,870,0,2,2,1,0
17320,223,5080,1508,847,911,44,250,301,1552,14,148,88,169,162,257,1120,1886,7,15077,837,0,2,2,1,0
17321,178,4158,77,34,69,0,0,8,77,3,24,16,29,27,45,114,213,1,387,21,0,2,0,3,0
17322,178,4158,712,438,573,51,9,84,763,14,102,71,128,116,199,733,1364,8,11988,666,0,2,0,3,0
17323,191,3896,1943,715,1694,26,18,214,1969,12,185,120,237,197,357,1436,2721,7,20915,1161,0,2,3,3,0
17324,191,3896,1168,838,957,57,25,144,1225,19,348,224,416,367,640,3018,5452,11,61921,3440,1,2,3,3,0
17325,346,7028,1457,730,1242,11,6,188,1468,10,292,166,329,302,495,2424,4078,5,22973,1276,1,2,0,1,0
17326,346,7028,74,35,59,1,0,14,75,3,14,7,14,17,21,58,85,1,128,7,0,2,0,1,0
17327,346,7028,245,125,200,5,7,34,250,7,30,17,34,37,51,166,265,3,1053,58,0,2,0,1,0
17328,178,4158,77,34,69,0,0,8,77,3,24,16,29,27,45,114,213,1,387,21,0,2,1,3,0
17329,178,4158,712,438,573,51,9,84,763,14,102,71,128,116,199,733,1364,8,11988,666,0,2,1,3,0
17330,223,5080,722,423,573,19,0,135,741,12,172,101,199,184,300,1320,2257,6,15668,870,0,2,3,2,0
17331,223,5080,1508,847,911,44,250,301,1552,14,148,88,169,162,257,1120,1886,7,15077,837,0,2,3,2,0
17332,191,3896,1943,715,1694,26,18,214,1969,12,185,120,237,197,357,1436,2721,7,20915,1161,0,2,3,3,0
17333,191,3896,1168,838,957,57,25,144,1225,19,348,224,416,367,640,3018,5452,11,61921,3440,1,2,3,3,0
17334,80,3429,1289,550,1043,56,32,155,1345,10,167,93,185,177,278,1266,2075,5,11498,638,0,2,28,0,0
17335,8,273,74,35,59,1,0,14,75,3,14,7,14,17,21,58,85,1,128,7,0,2,1,1,0
17336,11,401,42,7,35,4,0,5,46,1,2,1,2,3,3,2,4,0,2,0,0,2,4,10,0
17337,11,401,11,6,10,0,0,1,11,2,4,2,4,6,6,10,15,1,15,0,0,2,4,10,0
17338,11,396,42,7,35,4,0,5,46,1,2,1,2,3,3,2,4,0,2,0,0,2,1,3,1
17339,11,396,11,6,10,0,0,1,11,2,4,2,4,6,6,10,15,1,15,0,0,2,1,3,1
17340,335,7113,72,33,56,0,4,12,72,1,1,1,1,2,2,0,2,0,1,0,0,2,2,2,1
17341,335,7113,1454,835,1044,76,110,219,1530,17,275,158,296,292,454,2297,3718,9,34017,1889,1,2,2,2,1
17342,96,4332,1338,495,1086,10,64,173,1348,11,122,82,157,133,239,883,1686,7,11934,663,0,2,28,0,1
17343,335,7113,72,33,56,0,4,12,72,1,1,1,1,2,2,0,2,0,1,0,0,2,2,2,0
17344,335,7113,1454,835,1044,76,110,219,1530,17,275,158,296,292,454,2297,3718,9,34017,1889,1,2,2,2,0
17345,96,4332,1338,495,1086,10,64,173,1348,11,122,82,157,133,239,883,1686,7,11934,663,0,2,28,0,0
17346,27,545,2,2,2,0,0,0,2,0,0,0,0,0,0,0,0,0,0,0,0,2,0,3,0
17347,27,545,99,48,90,1,3,5,100,0,0,0,0,0,0,0,0,0,0,0,0,2,0,3,0
17348,27,545,8,5,5,2,0,1,10,0,0,0,0,0,0,0,0,0,0,0,0,2,0,3,0
17349,27,545,1217,716,841,84,126,174,1301,14,185,118,215,199,333,1446,2542,8,20687,1149,0,2,0,3,0
17350,27,545,160,89,115,0,13,31,160,7,15,11,17,22,28,78,124,3,495,27,0,2,0,3,0
17351,27,545,10,10,9,9,0,0,19,0,0,0,0,0,0,0,0,0,0,0,0,2,0,3,0
17352,27,545,173,84,99,8,29,36,181,5,12,7,13,17,20,54,81,2,221,12,0,2,0,3,0
17353,27,545,3,1,1,3,0,0,6,0,0,0,0,0,0,0,0,0,0,0,0,2,0,3,0
17354,53,1123,207,111,150,11,0,50,218,5,26,19,36,31,55,133,272,3,943,52,0,2,32,0,0
17355,53,1123,410,198,237,31,55,97,441,11,63,38,72,74,110,414,683,6,4293,238,0,2,32,0,0
17356,346,7028,1457,730,1242,11,6,188,1468,10,292,166,329,302,495,2424,4078,5,22973,1276,1,2,1,0,0
17357,346,7028,74,35,59,1,0,14,75,3,14,7,14,17,21,58,85,1,128,7,0,2,1,0,0
17358,346,7028,245,125,200,5,7,34,250,7,30,17,34,37,51,166,265,3,1053,58,0,2,1,0,0
17359,21,668,339,213,244,17,9,65,356,10,42,26,48,52,74,259,421,5,2410,133,0,2,10,11,0
17360,225,5106,4293,999,3693,19,54,507,4312,9,155,88,170,164,258,1156,1898,4,9368,520,0,2,20,36,0
17361,225,5106,1482,859,1002,125,135,219,1607,16,219,134,251,235,385,1766,3032,9,27804,1544,1,2,20,36,0
17362,6,136,44,22,19,0,19,6,44,2,10,6,12,12,18,35,64,1,77,4,0,2,0,3,0
17363,49,575,647,139,84,35,284,233,682,0,0,0,0,0,0,0,0,0,0,0,0,2,3,1,0
17364,178,4126,77,34,69,0,0,8,77,3,24,16,29,27,45,114,213,1,387,21,0,2,35,24,0
17365,178,4126,712,438,573,51,9,84,763,14,102,71,128,116,199,733,1364,8,11988,666,0,2,35,24,0
17366,80,1593,1020,354,843,12,15,144,1032,8,134,77,144,142,221,970,1580,4,6792,377,0,2,15,9,0
17367,46,961,447,308,343,6,5,95,453,7,96,59,111,103,170,651,1136,4,4600,255,0,2,4,4,0
17368,46,961,322,174,179,16,74,51,338,10,41,26,46,51,72,252,408,5,2291,127,0,2,4,4,0
17369,23,388,424,94,331,4,0,89,428,1,5,5,5,6,10,11,25,0,12,0,0,2,9,9,0
17370,23,388,38,23,23,6,0,8,44,3,11,7,11,14,18,42,68,1,102,5,0,2,9,9,0
17371,335,7154,72,33,56,0,4,12,72,1,1,1,1,2,2,0,2,0,1,0,0,2,25,31,0
17372,335,7154,1454,835,1044,76,110,219,1530,17,275,158,296,292,454,2297,3718,9,34017,1889,1,2,25,31,0
17373,38,783,386,256,301,16,9,68,402,4,59,35,69,63,104,355,621,2,1453,80,0,2,7,11,0
17374,38,783,264,131,164,11,41,46,275,6,38,22,40,44,62,214,338,3,1068,59,0,2,7,11,0
17375,127,2813,1043,504,840,53,9,147,1096,9,180,112,198,189,310,1377,2344,4,11604,644,0,2,1,9,0
17376,127,2813,383,288,292,26,6,62,409,11,65,38,67,76,105,429,656,5,3719,206,0,2,1,9,0
17377,103,1956,1178,367,1042,6,15,115,1184,9,94,51,95,103,146,644,976,4,4439,246,0,2,31,27,0
17378,103,1956,177,108,140,8,0,27,185,6,30,16,32,36,48,162,248,3,794,44,0,2,31,27,0
17379,62,1240,1098,241,925,5,10,155,1103,7,46,25,49,53,74,273,423,3,1580,87,0,2,25,21,0
17380,62,1240,282,202,222,14,2,44,296,8,42,24,43,50,67,250,378,4,1548,86,0,2,25,21,0
17381,11,402,42,7,35,4,0,5,46,1,2,1,2,3,3,2,4,0,2,0,0,2,19,13,1
17382,11,402,11,6,10,0,0,1,11,2,4,2,4,6,6,10,15,1,15,0,0,2,19,13,1
17383,11,402,42,7,35,4,0,5,46,1,2,1,2,3,3,2,4,0,2,0,0,2,20,22,0
17384,11,402,11,6,10,0,0,1,11,2,4,2,4,6,6,10,15,1,15,0,0,2,20,22,0
17385,336,7127,72,33,56,0,4,12,72,1,1,1,1,2,2,0,2,0,1,0,0,2,5,1,0
17386,336,7127,1454,835,1044,76,110,219,1530,17,275,158,296,292,454,2297,3718,9,34017,1889,1,2,5,1,0
17387,67,2779,1020,354,843,12,15,144,1032,8,134,77,144,142,221,970,1580,4,6792,377,0,2,17,0,0
17388,336,7127,72,33,56,0,4,12,72,1,1,1,1,2,2,0,2,0,1,0,0,2,5,1,0
17389,336,7127,1454,835,1044,76,110,219,1530,17,275,158,296,292,454,2297,3718,9,34017,1889,1,2,5,1,0
17390,67,2779,1020,354,843,12,15,144,1032,8,134,77,144,142,221,970,1580,4,6792,377,0,2,17,0,0
17391,222,4989,722,423,573,19,0,135,741,12,172,101,199,184,300,1320,2257,6,15668,870,0,2,4,3,1
17392,222,4989,1508,847,911,44,250,301,1552,14,148,88,169,162,257,1120,1886,7,15077,837,0,2,4,3,1
17393,222,4989,722,423,573,19,0,135,741,12,172,101,199,184,300,1320,2257,6,15668,870,0,2,4,3,0
17394,222,4989,1508,847,911,44,250,301,1552,14,148,88,169,162,257,1120,1886,7,15077,837,0,2,4,3,0
17395,211,4493,182,127,129,0,0,53,182,5,39,21,42,44,63,217,343,2,926,51,0,2,6,5,0
17396,211,4493,1165,710,800,67,119,181,1232,18,243,153,282,261,435,2000,3492,10,36473,2026,1,2,6,5,0
17397,54,1153,207,111,150,11,0,50,218,5,26,19,36,31,55,133,272,3,943,52,0,2,4,1,0
17398,54,1153,410,198,237,31,55,97,441,11,63,38,72,74,110,414,683,6,4293,238,0,2,4,1,0
17399,225,5106,4293,999,3693,19,54,507,4312,9,155,88,170,164,258,1156,1898,4,9368,520,0,2,10,10,0
17400,225,5106,1482,859,1002,125,135,219,1607,16,219,134,251,235,385,1766,3032,9,27804,1544,1,2,10,10,0
17401,223,5080,722,423,573,19,0,135,741,12,172,101,199,184,300,1320,2257,6,15668,870,0,2,4,3,0
17402,223,5080,1508,847,911,44,250,301,1552,14,148,88,169,162,257,1120,1886,7,15077,837,0,2,4,3,0
17403,336,7168,72,33,56,0,4,12,72,1,1,1,1,2,2,0,2,0,1,0,0,2,9,5,0
17404,336,7168,1454,835,1044,76,110,219,1530,17,275,158,296,292,454,2297,3718,9,34017,1889,1,2,9,5,0
17405,96,4365,1338,495,1086,10,64,173,1348,11,122,82,157,133,239,883,1686,7,11934,663,0,2,44,0,0
17406,117,4645,1513,682,1277,25,13,200,1538,11,199,116,219,210,335,1557,2584,6,15641,868,0,2,2,1,0
17407,68,2962,1020,354,843,12,15,144,1032,8,134,77,144,142,221,970,1580,4,6792,377,0,2,17,0,0
17408,211,4493,182,127,129,0,0,53,182,5,39,21,42,44,63,217,343,2,926,51,0,2,6,5,0
17409,211,4493,1165,710,800,67,119,181,1232,18,243,153,282,261,435,2000,3492,10,36473,2026,1,2,6,5,0
17410,54,1153,207,111,150,11,0,50,218,5,26,19,36,31,55,133,272,3,943,52,0,2,4,1,0
17411,54,1153,410,198,237,31,55,97,441,11,63,38,72,74,110,414,683,6,4293,238,0,2,4,1,0
17412,225,5106,4293,999,3693,19,54,507,4312,9,155,88,170,164,258,1156,1898,4,9368,520,0,2,10,10,0
17413,225,5106,1482,859,1002,125,135,219,1607,16,219,134,251,235,385,1766,3032,9,27804,1544,1,2,10,10,0
17414,223,5080,722,423,573,19,0,135,741,12,172,101,199,184,300,1320,2257,6,15668,870,0,2,4,3,0
17415,223,5080,1508,847,911,44,250,301,1552,14,148,88,169,162,257,1120,1886,7,15077,837,0,2,4,3,0
17416,336,7168,72,33,56,0,4,12,72,1,1,1,1,2,2,0,2,0,1,0,0,2,9,5,0
17417,336,7168,1454,835,1044,76,110,219,1530,17,275,158,296,292,454,2297,3718,9,34017,1889,1,2,9,5,0
17418,96,4365,1338,495,1086,10,64,173,1348,11,122,82,157,133,239,883,1686,7,11934,663,0,2,44,0,0
17419,117,4645,1513,682,1277,25,13,200,1538,11,199,116,219,210,335,1557,2584,6,15641,868,0,2,2,1,0
17420,68,2962,1020,354,843,12,15,144,1032,8,134,77,144,142,221,970,1580,4,6792,377,0,2,17,0,0
17421,346,7030,1457,730,1242,11,6,188,1468,10,292,166,329,302,495,2424,4078,5,22973,1276,1,2,6,4,0
17422,346,7030,74,35,59,1,0,14,75,3,14,7,14,17,21,58,85,1,128,7,0,2,6,4,0
17423,346,7030,245,125,200,5,7,34,250,7,30,17,34,37,51,166,265,3,1053,58,0,2,6,4,0
17424,83,2370,1523,757,1297,19,12,193,1542,12,193,117,230,205,347,1508,2664,7,19053,1058,0,2,10,3,1
17425,83,2370,701,378,504,33,58,109,734,13,110,68,126,123,194,794,1346,7,10027,557,0,2,10,3,1
17426,89,4427,1523,757,1297,19,12,193,1542,12,193,117,230,205,347,1508,2664,7,19053,1058,0,2,27,0,1
17427,83,2359,1523,757,1297,19,12,193,1542,12,193,117,230,205,347,1508,2664,7,19053,1058,0,2,2,7,1
17428,83,2359,701,378,504,33,58,109,734,13,110,68,126,123,194,794,1346,7,10027,557,0,2,2,7,1
17429,89,4432,1523,757,1297,19,12,193,1542,12,193,117,230,205,347,1508,2664,7,19053,1058,0,2,3,2,1
17430,90,4427,1523,757,1297,19,12,193,1542,12,193,117,230,205,347,1508,2664,7,19053,1058,0,2,14,16,0
17431,346,7030,1457,730,1242,11,6,188,1468,10,292,166,329,302,495,2424,4078,5,22973,1276,1,2,6,4,0
17432,346,7030,74,35,59,1,0,14,75,3,14,7,14,17,21,58,85,1,128,7,0,2,6,4,0
17433,346,7030,245,125,200,5,7,34,250,7,30,17,34,37,51,166,265,3,1053,58,0,2,6,4,0
17434,83,2359,1523,757,1297,19,12,193,1542,12,193,117,230,205,347,1508,2664,7,19053,1058,0,2,5,3,0
17435,83,2359,701,378,504,33,58,109,734,13,110,68,126,123,194,794,1346,7,10027,557,0,2,5,3,0
17436,90,4427,1523,757,1297,19,12,193,1542,12,193,117,230,205,347,1508,2664,7,19053,1058,0,2,26,0,0
17437,346,7030,1457,730,1242,11,6,188,1468,10,292,166,329,302,495,2424,4078,5,22973,1276,1,2,6,4,0
17438,346,7030,74,35,59,1,0,14,75,3,14,7,14,17,21,58,85,1,128,7,0,2,6,4,0
17439,346,7030,245,125,200,5,7,34,250,7,30,17,34,37,51,166,265,3,1053,58,0,2,6,4,0
17440,83,2359,1523,757,1297,19,12,193,1542,12,193,117,230,205,347,1508,2664,7,19053,1058,0,2,5,3,0
17441,83,2359,701,378,504,33,58,109,734,13,110,68,126,123,194,794,1346,7,10027,557,0,2,5,3,0
17442,90,4427,1523,757,1297,19,12,193,1542,12,193,117,230,205,347,1508,2664,7,19053,1058,0,2,26,0,0
17443,9,228,19,8,11,5,0,4,24,2,5,3,6,7,9,13,25,1,30,1,0,2,1,1,1
17444,9,228,102,59,69,5,3,24,107,6,22,15,28,28,43,113,206,3,789,43,0,2,1,1,1
17445,9,228,106,40,36,3,49,17,109,8,17,13,23,25,36,93,167,5,904,50,0,2,1,1,1
17446,27,542,2,2,2,0,0,0,2,0,0,0,0,0,0,0,0,0,0,0,0,2,1,1,1
17447,27,542,99,48,90,1,3,5,100,0,0,0,0,0,0,0,0,0,0,0,0,2,1,1,1
17448,27,542,8,5,5,2,0,1,10,0,0,0,0,0,0,0,0,0,0,0,0,2,1,1,1
17449,27,542,1217,716,841,84,126,174,1301,14,185,118,215,199,333,1446,2542,8,20687,1149,0,2,1,1,1
17450,27,542,160,89,115,0,13,31,160,7,15,11,17,22,28,78,124,3,495,27,0,2,1,1,1
17451,27,542,10,10,9,9,0,0,19,0,0,0,0,0,0,0,0,0,0,0,0,2,1,1,1
17452,27,542,173,84,99,8,29,36,181,5,12,7,13,17,20,54,81,2,221,12,0,2,1,1,1
17453,27,542,3,1,1,3,0,0,6,0,0,0,0,0,0,0,0,0,0,0,0,2,1,1,1
17454,60,1259,996,429,845,24,10,117,1020,7,76,50,88,83,138,494,879,4,3565,198,0,2,1,1,1
17455,60,1259,456,277,329,12,42,72,468,13,85,50,97,98,147,592,972,7,7212,400,0,2,1,1,1
17456,119,2406,1513,682,1277,25,13,200,1538,11,199,116,219,210,335,1557,2584,6,15641,868,0,2,6,6,1
17457,119,2406,819,519,539,24,98,155,843,15,96,57,106,111,163,690,1107,8,9171,509,0,2,6,6,1
17458,346,7015,1457,730,1242,11,6,188,1468,10,292,166,329,302,495,2424,4078,5,22973,1276,1,2,5,5,1
17459,346,7015,74,35,59,1,0,14,75,3,14,7,14,17,21,58,85,1,128,7,0,2,5,5,1
17460,346,7015,245,125,200,5,7,34,250,7,30,17,34,37,51,166,265,3,1053,58,0,2,5,5,1
17461,21,662,339,213,244,17,9,65,356,10,42,26,48,52,74,259,421,5,2410,133,0,2,2,3,1
17462,225,5091,4293,999,3693,19,54,507,4312,9,155,88,170,164,258,1156,1898,4,9368,520,0,2,5,5,1
17463,225,5091,1482,859,1002,125,135,219,1607,16,219,134,251,235,385,1766,3032,9,27804,1544,1,2,5,5,1
17464,178,4123,77,34,69,0,0,8,77,3,24,16,29,27,45,114,213,1,387,21,0,2,1,1,1
17465,178,4123,712,438,573,51,9,84,763,14,102,71,128,116,199,733,1364,8,11988,666,0,2,1,1,1
17466,80,1581,1020,354,843,12,15,144,1032,8,134,77,144,142,221,970,1580,4,6792,377,0,2,4,5,1
17467,46,955,447,308,343,6,5,95,453,7,96,59,111,103,170,651,1136,4,4600,255,0,2,2,2,1
17468,46,955,322,174,179,16,74,51,338,10,41,26,46,51,72,252,408,5,2291,127,0,2,2,2,1
17469,223,5047,722,423,573,19,0,135,741,12,172,101,199,184,300,1320,2257,6,15668,870,0,2,11,11,1
17470,223,5047,1508,847,911,44,250,301,1552,14,148,88,169,162,257,1120,1886,7,15077,837,0,2,11,11,1
17471,127,2807,1043,504,840,53,9,147,1096,9,180,112,198,189,310,1377,2344,4,11604,644,0,2,2,2,1
17472,127,2807,383,288,292,26,6,62,409,11,65,38,67,76,105,429,656,5,3719,206,0,2,2,2,1
17473,103,1953,1178,367,1042,6,15,115,1184,9,94,51,95,103,146,644,976,4,4439,246,0,2,1,1,1
17474,103,1953,177,108,140,8,0,27,185,6,30,16,32,36,48,162,248,3,794,44,0,2,1,1,1
17475,191,3890,1943,715,1694,26,18,214,1969,12,185,120,237,197,357,1436,2721,7,20915,1161,0,2,2,2,1
17476,191,3890,1168,838,957,57,25,144,1225,19,348,224,416,367,640,3018,5452,11,61921,3440,1,2,2,2,1
17477,16,477,442,244,305,14,16,103,456,11,68,45,75,79,120,452,756,6,4588,254,0,2,1,1,1
17478,16,477,182,102,99,11,40,35,193,3,11,6,11,14,17,42,64,1,97,5,0,2,1,1,1
17479,9,228,19,8,11,5,0,4,24,2,5,3,6,7,9,13,25,1,30,1,0,2,1,1,0
17480,9,228,102,59,69,5,3,24,107,6,22,15,28,28,43,113,206,3,789,43,0,2,1,1,0
17481,9,228,106,40,36,3,49,17,109,8,17,13,23,25,36,93,167,5,904,50,0,2,1,1,0
17482,27,542,2,2,2,0,0,0,2,0,0,0,0,0,0,0,0,0,0,0,0,2,1,1,0
17483,27,542,99,48,90,1,3,5,100,0,0,0,0,0,0,0,0,0,0,0,0,2,1,1,0
17484,27,542,8,5,5,2,0,1,10,0,0,0,0,0,0,0,0,0,0,0,0,2,1,1,0
17485,27,542,1217,716,841,84,126,174,1301,14,185,118,215,199,333,1446,2542,8,20687,1149,0,2,1,1,0
17486,27,542,160,89,115,0,13,31,160,7,15,11,17,22,28,78,124,3,495,27,0,2,1,1,0
17487,27,542,10,10,9,9,0,0,19,0,0,0,0,0,0,0,0,0,0,0,0,2,1,1,0
17488,27,542,173,84,99,8,29,36,181,5,12,7,13,17,20,54,81,2,221,12,0,2,1,1,0
17489,27,542,3,1,1,3,0,0,6,0,0,0,0,0,0,0,0,0,0,0,0,2,1,1,0
17490,60,1259,996,429,845,24,10,117,1020,7,76,50,88,83,138,494,879,4,3565,198,0,2,1,1,0
17491,60,1259,456,277,329,12,42,72,468,13,85,50,97,98,147,592,972,7,7212,400,0,2,1,1,0
17492,119,2406,1513,682,1277,25,13,200,1538,11,199,116,219,210,335,1557,2584,6,15641,868,0,2,6,6,0
17493,119,2406,819,519,539,24,98,155,843,15,96,57,106,111,163,690,1107,8,9171,509,0,2,6,6,0
17494,346,7015,1457,730,1242,11,6,188,1468,10,292,166,329,302,495,2424,4078,5,22973,1276,1,2,5,5,0
17495,346,7015,74,35,59,1,0,14,75,3,14,7,14,17,21,58,85,1,128,7,0,2,5,5,0
17496,346,7015,245,125,200,5,7,34,250,7,30,17,34,37,51,166,265,3,1053,58,0,2,5,5,0
17497,21,662,339,213,244,17,9,65,356,10,42,26,48,52,74,259,421,5,2410,133,0,2,2,3,0
17498,225,5091,4293,999,3693,19,54,507,4312,9,155,88,170,164,258,1156,1898,4,9368,520,0,2,5,5,0
17499,225,5091,1482,859,1002,125,135,219,1607,16,219,134,251,235,385,1766,3032,9,27804,1544,1,2,5,5,0
17500,178,4123,77,34,69,0,0,8,77,3,24,16,29,27,45,114,213,1,387,21,0,2,1,1,0
17501,178,4123,712,438,573,51,9,84,763,14,102,71,128,116,199,733,1364,8,11988,666,0,2,1,1,0
17502,80,1581,1020,354,843,12,15,144,1032,8,134,77,144,142,221,970,1580,4,6792,377,0,2,4,5,0
17503,46,955,447,308,343,6,5,95,453,7,96,59,111,103,170,651,1136,4,4600,255,0,2,2,2,0
17504,46,955,322,174,179,16,74,51,338,10,41,26,46,51,72,252,408,5,2291,127,0,2,2,2,0
17505,223,5047,722,423,573,19,0,135,741,12,172,101,199,184,300,1320,2257,6,15668,870,0,2,11,11,0
17506,223,5047,1508,847,911,44,250,301,1552,14,148,88,169,162,257,1120,1886,7,15077,837,0,2,11,11,0
17507,127,2807,1043,504,840,53,9,147,1096,9,180,112,198,189,310,1377,2344,4,11604,644,0,2,2,2,0
17508,127,2807,383,288,292,26,6,62,409,11,65,38,67,76,105,429,656,5,3719,206,0,2,2,2,0
17509,103,1953,1178,367,1042,6,15,115,1184,9,94,51,95,103,146,644,976,4,4439,246,0,2,1,1,0
17510,103,1953,177,108,140,8,0,27,185,6,30,16,32,36,48,162,248,3,794,44,0,2,1,1,0
17511,191,3890,1943,715,1694,26,18,214,1969,12,185,120,237,197,357,1436,2721,7,20915,1161,0,2,2,2,0
17512,191,3890,1168,838,957,57,25,144,1225,19,348,224,416,367,640,3018,5452,11,61921,3440,1,2,2,2,0
17513,16,477,442,244,305,14,16,103,456,11,68,45,75,79,120,452,756,6,4588,254,0,2,1,1,0
17514,16,477,182,102,99,11,40,35,193,3,11,6,11,14,17,42,64,1,97,5,0,2,1,1,0
17515,347,7008,1457,730,1242,11,6,188,1468,10,292,166,329,302,495,2424,4078,5,22973,1276,1,2,4,1,1
17516,347,7008,74,35,59,1,0,14,75,3,14,7,14,17,21,58,85,1,128,7,0,2,4,1,1
17517,347,7008,245,125,200,5,7,34,250,7,30,17,34,37,51,166,265,3,1053,58,0,2,4,1,1
17518,347,7009,1457,730,1242,11,6,188,1468,10,292,166,329,302,495,2424,4078,5,22973,1276,1,2,23,18,0
17519,347,7009,74,35,59,1,0,14,75,3,14,7,14,17,21,58,85,1,128,7,0,2,23,18,0
17520,347,7009,245,125,200,5,7,34,250,7,30,17,34,37,51,166,265,3,1053,58,0,2,23,18,0
17521,348,7017,1457,730,1242,11,6,188,1468,10,292,166,329,302,495,2424,4078,5,22973,1276,1,2,15,7,0
17522,348,7017,74,35,59,1,0,14,75,3,14,7,14,17,21,58,85,1,128,7,0,2,15,7,0
17523,348,7017,245,125,200,5,7,34,250,7,30,17,34,37,51,166,265,3,1053,58,0,2,15,7,0
17524,348,7017,1457,730,1242,11,6,188,1468,10,292,166,329,302,495,2424,4078,5,22973,1276,1,2,9,9,1
17525,348,7017,74,35,59,1,0,14,75,3,14,7,14,17,21,58,85,1,128,7,0,2,9,9,1
17526,348,7017,245,125,200,5,7,34,250,7,30,17,34,37,51,166,265,3,1053,58,0,2,9,9,1
17527,348,7014,1457,730,1242,11,6,188,1468,10,292,166,329,302,495,2424,4078,5,22973,1276,1,2,3,4,1
17528,348,7014,74,35,59,1,0,14,75,3,14,7,14,17,21,58,85,1,128,7,0,2,3,4,1
17529,348,7014,245,125,200,5,7,34,250,7,30,17,34,37,51,166,265,3,1053,58,0,2,3,4,1
17530,348,7007,1457,730,1242,11,6,188,1468,10,292,166,329,302,495,2424,4078,5,22973,1276,1,2,3,4,0
17531,348,7007,74,35,59,1,0,14,75,3,14,7,14,17,21,58,85,1,128,7,0,2,3,4,0
17532,348,7007,245,125,200,5,7,34,250,7,30,17,34,37,51,166,265,3,1053,58,0,2,3,4,0
17533,348,7007,1457,730,1242,11,6,188,1468,10,292,166,329,302,495,2424,4078,5,22973,1276,1,2,36,22,0
17534,348,7007,74,35,59,1,0,14,75,3,14,7,14,17,21,58,85,1,128,7,0,2,36,22,0
17535,348,7007,245,125,200,5,7,34,250,7,30,17,34,37,51,166,265,3,1053,58,0,2,36,22,0
17536,9,228,19,8,11,5,0,4,24,2,5,3,6,7,9,13,25,1,30,1,0,2,1,1,0
17537,9,228,102,59,69,5,3,24,107,6,22,15,28,28,43,113,206,3,789,43,0,2,1,1,0
17538,9,228,106,40,36,3,49,17,109,8,17,13,23,25,36,93,167,5,904,50,0,2,1,1,0
17539,211,4493,182,127,129,0,0,53,182,5,39,21,42,44,63,217,343,2,926,51,0,2,1,0,0
17540,211,4493,1165,710,800,67,119,181,1232,18,243,153,282,261,435,2000,3492,10,36473,2026,1,2,1,0,0
17541,99,2081,773,419,590,28,0,166,801,10,204,113,217,214,330,1598,2554,5,13587,754,0,2,1,1,0
17542,99,2081,421,273,302,44,34,57,465,17,81,59,107,98,166,583,1098,11,12329,684,0,2,1,1,0
17543,27,542,2,2,2,0,0,0,2,0,0,0,0,0,0,0,0,0,0,0,0,2,5,20,0
17544,27,542,99,48,90,1,3,5,100,0,0,0,0,0,0,0,0,0,0,0,0,2,5,20,0
17545,27,542,8,5,5,2,0,1,10,0,0,0,0,0,0,0,0,0,0,0,0,2,5,20,0
17546,27,542,1217,716,841,84,126,174,1301,14,185,118,215,199,333,1446,2542,8,20687,1149,0,2,5,20,0
17547,27,542,160,89,115,0,13,31,160,7,15,11,17,22,28,78,124,3,495,27,0,2,5,20,0
17548,27,542,10,10,9,9,0,0,19,0,0,0,0,0,0,0,0,0,0,0,0,2,5,20,0
17549,27,542,173,84,99,8,29,36,181,5,12,7,13,17,20,54,81,2,221,12,0,2,5,20,0
17550,27,542,3,1,1,3,0,0,6,0,0,0,0,0,0,0,0,0,0,0,0,2,5,20,0
17551,163,5086,1660,832,1314,41,38,274,1701,20,312,209,395,332,604,2671,5058,12,64042,3557,1,2,2,2,0
17552,163,5086,1057,646,719,113,100,145,1170,18,215,134,248,233,382,1740,3004,10,31186,1732,1,2,2,2,0
17553,17,349,95,58,50,9,16,20,104,12,33,24,45,45,69,209,378,8,3100,172,0,0,102,0,0
17554,82,1800,477,336,357,30,23,73,507,16,194,134,250,210,384,1538,2962,10,30538,1696,0,2,4,3,0
17555,60,1259,996,429,845,24,10,117,1020,7,76,50,88,83,138,494,879,4,3565,198,0,2,4,4,0
17556,60,1259,456,277,329,12,42,72,468,13,85,50,97,98,147,592,972,7,7212,400,0,2,4,4,0
17557,119,2406,1513,682,1277,25,13,200,1538,11,199,116,219,210,335,1557,2584,6,15641,868,0,2,6,5,0
17558,119,2406,819,519,539,24,98,155,843,15,96,57,106,111,163,690,1107,8,9171,509,0,2,6,5,0
17559,54,1153,207,111,150,11,0,50,218,5,26,19,36,31,55,133,272,3,943,52,0,2,65,4,0
17560,54,1153,410,198,237,31,55,97,441,11,63,38,72,74,110,414,683,6,4293,238,0,2,65,4,0
17561,348,7028,1457,730,1242,11,6,188,1468,10,292,166,329,302,495,2424,4078,5,22973,1276,1,2,13,9,0
17562,348,7028,74,35,59,1,0,14,75,3,14,7,14,17,21,58,85,1,128,7,0,2,13,9,0
17563,348,7028,245,125,200,5,7,34,250,7,30,17,34,37,51,166,265,3,1053,58,0,2,13,9,0
17564,21,662,339,213,244,17,9,65,356,10,42,26,48,52,74,259,421,5,2410,133,0,2,19,20,0
17565,56,1603,1455,414,1257,16,76,112,1471,5,41,23,46,46,69,231,381,2,1069,59,0,2,4,3,0
17566,56,1603,669,365,481,22,61,110,691,15,103,63,122,118,185,747,1273,8,11311,628,0,2,4,3,0
17567,225,5091,4293,999,3693,19,54,507,4312,9,155,88,170,164,258,1156,1898,4,9368,520,0,2,22,37,0
17568,225,5091,1482,859,1002,125,135,219,1607,16,219,134,251,235,385,1766,3032,9,27804,1544,1,2,22,37,0
17569,6,136,44,22,19,0,19,6,44,2,10,6,12,12,18,35,64,1,77,4,0,2,2,3,0
17570,24,842,74,35,59,1,0,14,75,3,14,7,14,17,21,58,85,1,128,7,0,2,2,0,0
17571,24,842,245,125,200,5,7,34,250,7,30,17,34,37,51,166,265,3,1053,58,0,2,2,0,0
17572,49,575,647,139,84,35,284,233,682,0,0,0,0,0,0,0,0,0,0,0,0,2,5,2,0
17573,83,2359,1523,757,1297,19,12,193,1542,12,193,117,230,205,347,1508,2664,7,19053,1058,0,2,47,7,0
17574,83,2359,701,378,504,33,58,109,734,13,110,68,126,123,194,794,1346,7,10027,557,0,2,47,7,0
17575,178,4123,77,34,69,0,0,8,77,3,24,16,29,27,45,114,213,1,387,21,0,2,39,32,0
17576,178,4123,712,438,573,51,9,84,763,14,102,71,128,116,199,733,1364,8,11988,666,0,2,39,32,0
17577,80,1581,1020,354,843,12,15,144,1032,8,134,77,144,142,221,970,1580,4,6792,377,0,2,119,56,0
17578,46,955,447,308,343,6,5,95,453,7,96,59,111,103,170,651,1136,4,4600,255,0,2,5,4,0
17579,46,955,322,174,179,16,74,51,338,10,41,26,46,51,72,252,408,5,2291,127,0,2,5,4,0
17580,23,388,424,94,331,4,0,89,428,1,5,5,5,6,10,11,25,0,12,0,0,2,10,9,0
17581,23,388,38,23,23,6,0,8,44,3,11,7,11,14,18,42,68,1,102,5,0,2,10,9,0
17582,17,518,184,100,137,2,15,30,186,6,38,20,39,44,59,214,322,3,991,55,0,2,2,0,0
17583,17,518,103,65,74,8,5,16,111,7,17,9,17,24,26,89,119,3,417,23,0,2,2,0,0
17584,223,5047,722,423,573,19,0,135,741,12,172,101,199,184,300,1320,2257,6,15668,870,0,2,26,16,0
17585,223,5047,1508,847,911,44,250,301,1552,14,148,88,169,162,257,1120,1886,7,15077,837,0,2,26,16,0
17586,336,7168,72,33,56,0,4,12,72,1,1,1,1,2,2,0,2,0,1,0,0,2,95,80,0
17587,336,7168,1454,835,1044,76,110,219,1530,17,275,158,296,292,454,2297,3718,9,34017,1889,1,2,95,80,0
17588,38,783,386,256,301,16,9,68,402,4,59,35,69,63,104,355,621,2,1453,80,0,2,19,51,0
17589,38,783,264,131,164,11,41,46,275,6,38,22,40,44,62,214,338,3,1068,59,0,2,19,51,0
17590,30,649,215,129,180,6,0,29,221,8,65,43,72,73,115,415,711,4,3153,175,0,2,3,2,0
17591,30,649,97,69,77,3,3,16,100,6,22,13,23,28,36,113,173,3,542,30,0,2,3,2,0
17592,127,2807,1043,504,840,53,9,147,1096,9,180,112,198,189,310,1377,2344,4,11604,644,0,2,18,16,0
17593,127,2807,383,288,292,26,6,62,409,11,65,38,67,76,105,429,656,5,3719,206,0,2,18,16,0
17594,20,408,294,64,250,0,0,43,294,1,20,10,20,21,30,86,131,0,65,3,0,2,2,0,0
17595,20,408,78,46,62,3,0,14,81,3,8,4,8,11,12,28,41,1,62,3,0,2,2,0,0
17596,5,118,110,30,77,3,13,16,113,4,21,15,30,25,45,100,208,2,597,33,0,2,2,0,0
17597,5,118,28,15,21,1,0,6,29,0,0,0,0,0,0,0,0,0,0,0,0,2,2,0,0
17598,103,1953,1178,367,1042,6,15,115,1184,9,94,51,95,103,146,644,976,4,4439,246,0,2,36,32,0
17599,103,1953,177,108,140,8,0,27,185,6,30,16,32,36,48,162,248,3,794,44,0,2,36,32,0
17600,191,3890,1943,715,1694,26,18,214,1969,12,185,120,237,197,357,1436,2721,7,20915,1161,0,2,53,19,0
17601,191,3890,1168,838,957,57,25,144,1225,19,348,224,416,367,640,3018,5452,11,61921,3440,1,2,53,19,0
17602,16,477,442,244,305,14,16,103,456,11,68,45,75,79,120,452,756,6,4588,254,0,2,2,0,0
17603,16,477,182,102,99,11,40,35,193,3,11,6,11,14,17,42,64,1,97,5,0,2,2,0,0
17604,62,1240,1098,241,925,5,10,155,1103,7,46,25,49,53,74,273,423,3,1580,87,0,2,26,22,0
17605,62,1240,282,202,222,14,2,44,296,8,42,24,43,50,67,250,378,4,1548,86,0,2,26,22,0
17606,14,339,601,196,481,2,23,85,603,8,63,36,72,71,108,400,664,4,3036,168,0,0,73,0,0
17607,14,339,156,79,106,5,16,28,161,5,14,8,15,19,23,64,97,2,261,14,0,0,73,0,0
17608,60,1092,282,196,195,3,0,86,285,8,130,71,141,138,212,936,1507,4,6538,363,0,2,6,6,0
17609,7,114,44,19,17,0,16,11,44,3,14,7,14,17,21,58,85,1,128,7,0,2,1,1,0
17610,3,66,127,75,83,2,11,30,129,4,14,7,14,18,21,61,87,2,175,9,0,2,1,1,0
17611,3,66,652,304,544,16,6,88,668,6,89,51,101,95,152,591,998,3,3399,188,0,2,1,1,0
17612,3,66,2,2,2,0,0,0,2,0,0,0,0,0,0,0,0,0,0,0,0,2,1,1,0
17613,3,66,8,5,5,0,0,3,8,0,0,0,0,0,0,0,0,0,0,0,0,2,1,1,0
17614,3,66,2,2,2,0,0,0,2,0,0,0,0,0,0,0,0,0,0,0,0,2,1,1,0
17615,3,66,14,8,8,0,0,6,14,0,0,0,0,0,0,0,0,0,0,0,0,2,1,1,0
17616,3,66,6,4,4,0,0,2,6,0,0,0,0,0,0,0,0,0,0,0,0,2,1,1,0
17617,3,66,6,4,4,0,0,2,6,1,2,1,2,3,3,2,4,0,2,0,0,2,1,1,0
17618,3,66,6,4,4,0,0,2,6,0,0,0,0,0,0,0,0,0,0,0,0,2,1,1,0
17619,3,66,7,5,5,0,0,2,7,0,0,0,0,0,0,0,0,0,0,0,0,2,1,1,0
17620,3,66,6,4,4,0,0,2,6,0,0,0,0,0,0,0,0,0,0,0,0,2,1,1,0
17621,3,66,10,6,6,0,0,4,10,0,0,0,0,0,0,0,0,0,0,0,0,2,1,1,0
17622,3,66,1,1,1,0,0,0,1,0,0,0,0,0,0,0,0,0,0,0,0,2,1,1,0
17623,3,66,1,1,1,0,0,0,1,0,0,0,0,0,0,0,0,0,0,0,0,2,1,1,0
17624,3,66,14,10,10,0,0,4,14,1,1,1,1,2,2,0,2,0,1,0,0,2,1,1,0
17625,3,66,46,26,30,3,0,12,49,3,6,3,6,9,9,20,28,1,42,2,0,2,1,1,0
17626,7,301,72,33,56,0,4,12,72,1,1,1,1,2,2,0,2,0,1,0,0,2,1,1,0
17627,3,26,14,7,7,2,0,5,16,0,0,0,0,0,0,0,0,0,0,0,0,2,1,1,0
17628,11,402,42,7,35,4,0,5,46,1,2,1,2,3,3,2,4,0,2,0,0,2,20,22,0
17629,11,402,11,6,10,0,0,1,11,2,4,2,4,6,6,10,15,1,15,0,0,2,20,22,0
17630,80,3429,1289,550,1043,56,32,155,1345,10,167,93,185,177,278,1266,2075,5,11498,638,0,2,63,9,0
17631,34,997,182,127,129,0,0,53,182,5,39,21,42,44,63,217,343,2,926,51,0,2,4,3,0
17632,137,6599,1392,870,1177,35,17,170,1427,14,494,280,531,508,811,4473,7289,7,54850,3047,2,2,6,5,0
17633,91,3011,773,419,590,28,0,166,801,10,204,113,217,214,330,1598,2554,5,13587,754,0,2,12,11,0
17634,7,263,75,38,59,1,3,12,76,2,4,2,4,6,6,10,15,1,15,0,0,2,3,2,0
17635,47,2498,520,294,400,33,13,81,553,10,261,204,367,271,571,2128,4614,7,32445,1802,1,2,1,1,0
17636,96,4365,1338,495,1086,10,64,173,1348,11,122,82,157,133,239,883,1686,7,11934,663,0,2,35,34,0
17637,147,6797,139,89,101,2,0,35,141,7,54,34,62,61,96,330,569,4,2287,127,0,2,75,64,0
17638,147,6797,7,5,5,0,0,2,7,1,2,1,2,3,3,2,4,0,2,0,0,2,75,64,0
17639,32,948,465,148,393,5,8,60,470,4,31,20,31,35,51,161,261,2,523,29,0,2,9,9,0
17640,32,948,16,12,9,0,0,6,16,1,2,1,2,3,3,2,4,0,2,0,0,2,9,9,0
17641,112,5710,1782,648,1425,9,47,279,1791,8,171,97,189,179,286,1292,2140,4,9462,525,0,2,154,53,0
17642,20,541,256,139,192,9,7,47,265,4,23,12,24,27,36,112,171,2,357,19,0,2,17,10,0
17643,23,601,102,59,69,5,3,24,107,6,22,15,28,28,43,113,206,3,789,43,0,2,2,2,0
17644,109,4106,1450,624,1228,12,26,181,1462,14,306,186,354,320,540,2580,4493,8,36391,2021,1,2,128,45,0
17645,149,4136,1660,832,1314,41,38,274,1701,20,312,209,395,332,604,2671,5058,12,64042,3557,1,2,24,5,0
17646,117,4645,1513,682,1277,25,13,200,1538,11,199,116,219,210,335,1557,2584,6,15641,868,0,2,29,16,0
17647,59,3310,1296,573,1062,40,33,157,1336,8,201,118,231,209,349,1561,2689,4,12365,686,0,2,35,18,0
17648,10,236,207,111,150,11,0,50,218,5,26,19,36,31,55,133,272,3,943,52,0,2,30,4,0
17649,78,4093,1457,730,1242,11,6,188,1468,10,292,166,329,302,495,2424,4078,5,22973,1276,1,2,22,20,0
17650,38,2286,652,304,544,16,6,88,668,6,89,51,101,95,152,591,998,3,3399,188,0,2,5,4,0
17651,62,2878,1455,414,1257,16,76,112,1471,5,41,23,46,46,69,231,381,2,1069,59,0,2,37,9,0
17652,2,75,7,6,5,0,0,2,7,1,1,1,2,2,3,0,3,1,3,0,0,2,1,0,0
17653,8,273,74,35,59,1,0,14,75,3,14,7,14,17,21,58,85,1,128,7,0,2,2,1,0
17654,90,4427,1523,757,1297,19,12,193,1542,12,193,117,230,205,347,1508,2664,7,19053,1058,0,2,85,8,0
17655,68,2962,1020,354,843,12,15,144,1032,8,134,77,144,142,221,970,1580,4,6792,377,0,2,41,24,0
17656,37,1624,447,308,343,6,5,95,453,7,96,59,111,103,170,651,1136,4,4600,255,0,2,5,4,0
17657,21,661,424,94,331,4,0,89,428,1,5,5,5,6,10,11,25,0,12,0,0,2,6,5,0
17658,40,2367,334,251,279,10,4,40,344,5,127,74,143,132,217,899,1528,2,4303,239,0,2,11,10,0
17659,12,492,184,100,137,2,15,30,186,6,38,20,39,44,59,214,322,3,991,55,0,2,4,3,0
17660,35,1623,1293,570,1093,25,15,163,1318,10,195,123,241,205,364,1516,2795,6,17273,959,0,2,52,16,0
17661,36,1978,384,251,317,7,8,52,391,11,70,44,84,81,128,467,811,6,5355,297,0,2,13,12,0
17662,15,638,722,423,573,19,0,135,741,12,172,101,199,184,300,1320,2257,6,15668,870,0,2,4,3,0
17663,31,1439,386,256,301,16,9,68,402,4,59,35,69,63,104,355,621,2,1453,80,0,2,29,14,0
17664,16,1209,215,129,180,6,0,29,221,8,65,43,72,73,115,415,711,4,3153,175,0,2,2,1,0
17665,69,2856,1043,504,840,53,9,147,1096,9,180,112,198,189,310,1377,2344,4,11604,644,0,2,10,10,0
17666,14,529,295,56,236,0,4,54,295,2,9,5,10,11,15,30,51,1,57,3,0,2,13,11,0
17667,25,1027,373,158,315,8,0,51,381,5,76,44,79,81,123,486,779,2,2026,112,0,2,7,6,0
17668,71,3006,1178,367,1042,6,15,115,1184,9,94,51,95,103,146,644,976,4,4439,246,0,2,11,10,0
17669,73,3738,1943,715,1694,26,18,214,1969,12,185,120,237,197,357,1436,2721,7,20915,1161,0,2,22,21,0
17670,14,825,442,244,305,14,16,103,456,11,68,45,75,79,120,452,756,6,4588,254,0,2,3,2,0
17671,48,1784,1098,241,925,5,10,155,1103,7,46,25,49,53,74,273,423,3,1580,87,0,2,3,2,0
17672,9,317,601,196,481,2,23,85,603,8,63,36,72,71,108,400,664,4,3036,168,0,0,108,0,0
17673,60,1265,996,429,845,24,10,117,1020,7,76,50,88,83,138,494,879,4,3565,198,0,2,2,2,0
17674,60,1265,456,277,329,12,42,72,468,13,85,50,97,98,147,592,972,7,7212,400,0,2,2,2,0
17675,60,1265,996,429,845,24,10,117,1020,7,76,50,88,83,138,494,879,4,3565,198,0,2,2,2,0
17676,60,1265,456,277,329,12,42,72,468,13,85,50,97,98,147,592,972,7,7212,400,0,2,2,2,0
17677,14,348,601,196,481,2,23,85,603,8,63,36,72,71,108,400,664,4,3036,168,0,2,3,1,1
17678,14,348,156,79,106,5,16,28,161,5,14,8,15,19,23,64,97,2,261,14,0,2,3,1,1
17679,10,361,601,196,481,2,23,85,603,8,63,36,72,71,108,400,664,4,3036,168,0,2,29,0,1
17680,54,1161,207,111,150,11,0,50,218,5,26,19,36,31,55,133,272,3,943,52,0,2,2,0,1
17681,54,1161,410,198,237,31,55,97,441,11,63,38,72,74,110,414,683,6,4293,238,0,2,2,0,1
17682,19,407,601,196,481,2,23,85,603,8,63,36,72,71,108,400,664,4,3036,168,0,2,14,1,1
17683,19,407,156,79,106,5,16,28,161,5,14,8,15,19,23,64,97,2,261,14,0,2,14,1,1
17684,11,447,601,196,481,2,23,85,603,8,63,36,72,71,108,400,664,4,3036,168,0,2,31,0,1
17685,54,1161,207,111,150,11,0,50,218,5,26,19,36,31,55,133,272,3,943,52,0,2,2,0,0
17686,54,1161,410,198,237,31,55,97,441,11,63,38,72,74,110,414,683,6,4293,238,0,2,2,0,0
17687,19,407,601,196,481,2,23,85,603,8,63,36,72,71,108,400,664,4,3036,168,0,2,16,1,0
17688,19,407,156,79,106,5,16,28,161,5,14,8,15,19,23,64,97,2,261,14,0,2,16,1,0
17689,11,447,601,196,481,2,23,85,603,8,63,36,72,71,108,400,664,4,3036,168,0,2,60,0,0
17690,60,1689,1455,414,1257,16,76,112,1471,5,41,23,46,46,69,231,381,2,1069,59,0,2,29,0,1
17691,60,1689,669,365,481,22,61,110,691,15,103,63,122,118,185,747,1273,8,11311,628,0,2,29,0,1
17692,63,2918,1455,414,1257,16,76,112,1471,5,41,23,46,46,69,231,381,2,1069,59,0,2,22,0,1
17693,60,1689,1455,414,1257,16,76,112,1471,5,41,23,46,46,69,231,381,2,1069,59,0,2,29,0,0
17694,60,1689,669,365,481,22,61,110,691,15,103,63,122,118,185,747,1273,8,11311,628,0,2,29,0,0
17695,63,2918,1455,414,1257,16,76,112,1471,5,41,23,46,46,69,231,381,2,1069,59,0,2,22,0,0
17696,60,1265,996,429,845,24,10,117,1020,7,76,50,88,83,138,494,879,4,3565,198,0,2,2,2,0
17697,60,1265,456,277,329,12,42,72,468,13,85,50,97,98,147,592,972,7,7212,400,0,2,2,2,0
17698,54,1161,207,111,150,11,0,50,218,5,26,19,36,31,55,133,272,3,943,52,0,2,2,0,0
17699,54,1161,410,198,237,31,55,97,441,11,63,38,72,74,110,414,683,6,4293,238,0,2,2,0,0
17700,60,1689,1455,414,1257,16,76,112,1471,5,41,23,46,46,69,231,381,2,1069,59,0,2,29,0,0
17701,60,1689,669,365,481,22,61,110,691,15,103,63,122,118,185,747,1273,8,11311,628,0,2,29,0,0
17702,19,407,601,196,481,2,23,85,603,8,63,36,72,71,108,400,664,4,3036,168,0,2,16,1,0
17703,19,407,156,79,106,5,16,28,161,5,14,8,15,19,23,64,97,2,261,14,0,2,16,1,0
17704,63,2918,1455,414,1257,16,76,112,1471,5,41,23,46,46,69,231,381,2,1069,59,0,2,22,0,0
17705,11,447,601,196,481,2,23,85,603,8,63,36,72,71,108,400,664,4,3036,168,0,2,60,0,0
17706,38,787,386,256,301,16,9,68,402,4,59,35,69,63,104,355,621,2,1453,80,0,2,1,1,0
17707,38,787,264,131,164,11,41,46,275,6,38,22,40,44,62,214,338,3,1068,59,0,2,1,1,0
17708,31,1467,386,256,301,16,9,68,402,4,59,35,69,63,104,355,621,2,1453,80,0,2,10,7,0
17709,38,787,386,256,301,16,9,68,402,4,59,35,69,63,104,355,621,2,1453,80,0,2,1,1,0
17710,38,787,264,131,164,11,41,46,275,6,38,22,40,44,62,214,338,3,1068,59,0,2,1,1,0
17711,31,1467,386,256,301,16,9,68,402,4,59,35,69,63,104,355,621,2,1453,80,0,2,10,7,0
17712,19,401,601,196,481,2,23,85,603,8,63,36,72,71,108,400,664,4,3036,168,0,2,0,1,1
17713,19,401,156,79,106,5,16,28,161,5,14,8,15,19,23,64,97,2,261,14,0,2,0,1,1
17714,32,1464,386,256,301,16,9,68,402,4,59,35,69,63,104,355,621,2,1453,80,0,2,8,3,1
17715,12,476,601,196,481,2,23,85,603,8,63,36,72,71,108,400,664,4,3036,168,0,2,34,12,1
17716,19,401,601,196,481,2,23,85,603,8,63,36,72,71,108,400,664,4,3036,168,0,2,0,1,0
17717,19,401,156,79,106,5,16,28,161,5,14,8,15,19,23,64,97,2,261,14,0,2,0,1,0
17718,32,1492,386,256,301,16,9,68,402,4,59,35,69,63,104,355,621,2,1453,80,0,2,8,3,0
17719,12,476,601,196,481,2,23,85,603,8,63,36,72,71,108,400,664,4,3036,168,0,2,34,12,0
17720,150,4203,1660,832,1314,41,38,274,1701,20,312,209,395,332,604,2671,5058,12,64042,3557,1,2,14,0,1
17721,163,5080,1660,832,1314,41,38,274,1701,20,312,209,395,332,604,2671,5058,12,64042,3557,1,2,1,2,0
17722,163,5080,1057,646,719,113,100,145,1170,18,215,134,248,233,382,1740,3004,10,31186,1732,1,2,1,2,0
17723,11,402,42,7,35,4,0,5,46,1,2,1,2,3,3,2,4,0,2,0,0,2,1,1,1
17724,11,402,11,6,10,0,0,1,11,2,4,2,4,6,6,10,15,1,15,0,0,2,1,1,1
17725,38,787,386,256,301,16,9,68,402,4,59,35,69,63,104,355,621,2,1453,80,0,2,1,1,0
17726,38,787,264,131,164,11,41,46,275,6,38,22,40,44,62,214,338,3,1068,59,0,2,1,1,0
17727,19,401,601,196,481,2,23,85,603,8,63,36,72,71,108,400,664,4,3036,168,0,2,0,1,0
17728,19,401,156,79,106,5,16,28,161,5,14,8,15,19,23,64,97,2,261,14,0,2,0,1,0
17729,32,1492,386,256,301,16,9,68,402,4,59,35,69,63,104,355,621,2,1453,80,0,2,18,10,0
17730,12,476,601,196,481,2,23,85,603,8,63,36,72,71,108,400,664,4,3036,168,0,2,34,12,0
17731,163,5080,1660,832,1314,41,38,274,1701,20,312,209,395,332,604,2671,5058,12,64042,3557,1,2,1,2,0
17732,163,5080,1057,646,719,113,100,145,1170,18,215,134,248,233,382,1740,3004,10,31186,1732,1,2,1,2,0
17733,11,402,42,7,35,4,0,5,46,1,2,1,2,3,3,2,4,0,2,0,0,2,1,1,0
17734,11,402,11,6,10,0,0,1,11,2,4,2,4,6,6,10,15,1,15,0,0,2,1,1,0
17735,150,4203,1660,832,1314,41,38,274,1701,20,312,209,395,332,604,2671,5058,12,64042,3557,1,2,14,0,0
17736,349,7049,1457,730,1242,11,6,188,1468,10,292,166,329,302,495,2424,4078,5,22973,1276,1,2,17,7,1
17737,349,7049,74,35,59,1,0,14,75,3,14,7,14,17,21,58,85,1,128,7,0,2,17,7,1
17738,349,7049,245,125,200,5,7,34,250,7,30,17,34,37,51,166,265,3,1053,58,0,2,17,7,1
17739,27,953,74,35,59,1,0,14,75,3,14,7,14,17,21,58,85,1,128,7,0,2,26,1,1
17740,27,953,245,125,200,5,7,34,250,7,30,17,34,37,51,166,265,3,1053,58,0,2,26,1,1
17741,39,2355,652,304,544,16,6,88,668,6,89,51,101,95,152,591,998,3,3399,188,0,2,12,0,1
17742,27,954,74,35,59,1,0,14,75,3,14,7,14,17,21,58,85,1,128,7,0,2,8,0,0
17743,27,954,245,125,200,5,7,34,250,7,30,17,34,37,51,166,265,3,1053,58,0,2,8,0,0
17744,349,7049,1457,730,1242,11,6,188,1468,10,292,166,329,302,495,2424,4078,5,22973,1276,1,2,17,7,0
17745,349,7049,74,35,59,1,0,14,75,3,14,7,14,17,21,58,85,1,128,7,0,2,17,7,0
17746,349,7049,245,125,200,5,7,34,250,7,30,17,34,37,51,166,265,3,1053,58,0,2,17,7,0
17747,27,954,74,35,59,1,0,14,75,3,14,7,14,17,21,58,85,1,128,7,0,2,34,1,0
17748,27,954,245,125,200,5,7,34,250,7,30,17,34,37,51,166,265,3,1053,58,0,2,34,1,0
17749,39,2355,652,304,544,16,6,88,668,6,89,51,101,95,152,591,998,3,3399,188,0,2,12,0,0
17750,128,2606,1513,682,1277,25,13,200,1538,11,199,116,219,210,335,1557,2584,6,15641,868,0,2,50,1,1
17751,128,2606,819,519,539,24,98,155,843,15,96,57,106,111,163,690,1107,8,9171,509,0,2,50,1,1
17752,128,2606,1513,682,1277,25,13,200,1538,11,199,116,219,210,335,1557,2584,6,15641,868,0,2,1,1,0
17753,128,2606,819,519,539,24,98,155,843,15,96,57,106,111,163,690,1107,8,9171,509,0,2,1,1,0
17754,128,2606,1513,682,1277,25,13,200,1538,11,199,116,219,210,335,1557,2584,6,15641,868,0,2,50,1,0
17755,128,2606,819,519,539,24,98,155,843,15,96,57,106,111,163,690,1107,8,9171,509,0,2,50,1,0
17756,178,4125,77,34,69,0,0,8,77,3,24,16,29,27,45,114,213,1,387,21,0,2,5,1,1
17757,178,4125,712,438,573,51,9,84,763,14,102,71,128,116,199,733,1364,8,11988,666,0,2,5,1,1
17758,80,3427,1289,550,1043,56,32,155,1345,10,167,93,185,177,278,1266,2075,5,11498,638,0,2,2,2,1
17759,66,3414,1296,573,1062,40,33,157,1336,8,201,118,231,209,349,1561,2689,4,12365,686,0,2,14,5,1
17760,192,3902,1943,715,1694,26,18,214,1969,12,185,120,237,197,357,1436,2721,7,20915,1161,0,2,1,1,0
17761,192,3902,1168,838,957,57,25,144,1225,19,348,224,416,367,640,3018,5452,11,61921,3440,1,2,1,1,0
17762,69,2856,1043,504,840,53,9,147,1096,9,180,112,198,189,310,1377,2344,4,11604,644,0,2,2,2,0
17763,74,3770,1943,715,1694,26,18,214,1969,12,185,120,237,197,357,1436,2721,7,20915,1161,0,2,9,0,0
17764,19,408,601,196,481,2,23,85,603,8,63,36,72,71,108,400,664,4,3036,168,0,2,5,4,1
17765,19,408,156,79,106,5,16,28,161,5,14,8,15,19,23,64,97,2,261,14,0,2,5,4,1
17766,12,476,601,196,481,2,23,85,603,8,63,36,72,71,108,400,664,4,3036,168,0,2,1,1,1
17767,349,7049,1457,730,1242,11,6,188,1468,10,292,166,329,302,495,2424,4078,5,22973,1276,1,2,3,3,1
17768,349,7049,74,35,59,1,0,14,75,3,14,7,14,17,21,58,85,1,128,7,0,2,3,3,1
17769,349,7049,245,125,200,5,7,34,250,7,30,17,34,37,51,166,265,3,1053,58,0,2,3,3,1
17770,49,575,647,139,84,35,284,233,682,0,0,0,0,0,0,0,0,0,0,0,0,2,1,1,1
17771,349,7049,1457,730,1242,11,6,188,1468,10,292,166,329,302,495,2424,4078,5,22973,1276,1,2,3,3,0
17772,349,7049,74,35,59,1,0,14,75,3,14,7,14,17,21,58,85,1,128,7,0,2,3,3,0
17773,349,7049,245,125,200,5,7,34,250,7,30,17,34,37,51,166,265,3,1053,58,0,2,3,3,0
17774,49,575,647,139,84,35,284,233,682,0,0,0,0,0,0,0,0,0,0,0,0,2,1,1,0
17775,163,5080,1660,832,1314,41,38,274,1701,20,312,209,395,332,604,2671,5058,12,64042,3557,1,2,1,2,0
17776,163,5080,1057,646,719,113,100,145,1170,18,215,134,248,233,382,1740,3004,10,31186,1732,1,2,1,2,0
17777,128,2606,1513,682,1277,25,13,200,1538,11,199,116,219,210,335,1557,2584,6,15641,868,0,2,50,1,0
17778,128,2606,819,519,539,24,98,155,843,15,96,57,106,111,163,690,1107,8,9171,509,0,2,50,1,0
17779,349,7049,1457,730,1242,11,6,188,1468,10,292,166,329,302,495,2424,4078,5,22973,1276,1,2,20,10,0
17780,349,7049,74,35,59,1,0,14,75,3,14,7,14,17,21,58,85,1,128,7,0,2,20,10,0
17781,349,7049,245,125,200,5,7,34,250,7,30,17,34,37,51,166,265,3,1053,58,0,2,20,10,0
17782,27,954,74,35,59,1,0,14,75,3,14,7,14,17,21,58,85,1,128,7,0,2,34,1,0
17783,27,954,245,125,200,5,7,34,250,7,30,17,34,37,51,166,265,3,1053,58,0,2,34,1,0
17784,49,575,647,139,84,35,284,233,682,0,0,0,0,0,0,0,0,0,0,0,0,2,1,1,0
17785,11,402,42,7,35,4,0,5,46,1,2,1,2,3,3,2,4,0,2,0,0,2,1,1,0
17786,11,402,11,6,10,0,0,1,11,2,4,2,4,6,6,10,15,1,15,0,0,2,1,1,0
17787,150,4203,1660,832,1314,41,38,274,1701,20,312,209,395,332,604,2671,5058,12,64042,3557,1,2,14,0,0
17788,39,2355,652,304,544,16,6,88,668,6,89,51,101,95,152,591,998,3,3399,188,0,2,12,0,0
17789,40,834,386,256,301,16,9,68,402,4,59,35,69,63,104,355,621,2,1453,80,0,2,35,29,1
17790,40,834,264,131,164,11,41,46,275,6,38,22,40,44,62,214,338,3,1068,59,0,2,35,29,1
17791,38,1637,386,256,301,16,9,68,402,4,59,35,69,63,104,355,621,2,1453,80,0,2,48,10,1
17792,19,408,601,196,481,2,23,85,603,8,63,36,72,71,108,400,664,4,3036,168,0,2,5,4,0
17793,19,408,156,79,106,5,16,28,161,5,14,8,15,19,23,64,97,2,261,14,0,2,5,4,0
17794,12,476,601,196,481,2,23,85,603,8,63,36,72,71,108,400,664,4,3036,168,0,2,1,1,0
17795,212,4584,182,127,129,0,0,53,182,5,39,21,42,44,63,217,343,2,926,51,0,2,34,7,1
17796,212,4584,1165,710,800,67,119,181,1232,18,243,153,282,261,435,2000,3492,10,36473,2026,1,2,34,7,1
17797,143,6718,1392,870,1177,35,17,170,1427,14,494,280,531,508,811,4473,7289,7,54850,3047,2,2,33,0,1
17798,212,4584,182,127,129,0,0,53,182,5,39,21,42,44,63,217,343,2,926,51,0,2,34,7,0
17799,212,4584,1165,710,800,67,119,181,1232,18,243,153,282,261,435,2000,3492,10,36473,2026,1,2,34,7,0
17800,143,6718,1392,870,1177,35,17,170,1427,14,494,280,531,508,811,4473,7289,7,54850,3047,2,2,33,0,0
17801,212,4584,182,127,129,0,0,53,182,5,39,21,42,44,63,217,343,2,926,51,0,2,34,7,0
17802,212,4584,1165,710,800,67,119,181,1232,18,243,153,282,261,435,2000,3492,10,36473,2026,1,2,34,7,0
17803,19,408,601,196,481,2,23,85,603,8,63,36,72,71,108,400,664,4,3036,168,0,2,5,4,0
17804,19,408,156,79,106,5,16,28,161,5,14,8,15,19,23,64,97,2,261,14,0,2,5,4,0
17805,143,6718,1392,870,1177,35,17,170,1427,14,494,280,531,508,811,4473,7289,7,54850,3047,2,2,33,0,0
17806,12,476,601,196,481,2,23,85,603,8,63,36,72,71,108,400,664,4,3036,168,0,2,1,1,0
17807,213,4595,182,127,129,0,0,53,182,5,39,21,42,44,63,217,343,2,926,51,0,2,5,2,1
17808,213,4595,1165,710,800,67,119,181,1232,18,243,153,282,261,435,2000,3492,10,36473,2026,1,2,5,2,1
17809,147,6814,1392,870,1177,35,17,170,1427,14,494,280,531,508,811,4473,7289,7,54850,3047,2,2,23,0,1
17810,306,6621,72,33,56,0,4,12,72,1,1,1,1,2,2,0,2,0,1,0,0,2,0,250,0
17811,306,6621,1454,835,1044,76,110,219,1530,17,275,158,296,292,454,2297,3718,9,34017,1889,1,2,0,250,0
17812,286,6178,72,33,56,0,4,12,72,1,1,1,1,2,2,0,2,0,1,0,0,2,0,174,1
17813,286,6178,1454,835,1044,76,110,219,1530,17,275,158,296,292,454,2297,3718,9,34017,1889,1,2,0,174,1
17814,50,1010,757,253,292,73,244,162,830,13,61,38,67,74,105,409,651,7,4654,258,0,0,430,0,1
17815,286,6178,72,33,56,0,4,12,72,1,1,1,1,2,2,0,2,0,1,0,0,2,0,424,0
17816,286,6178,1454,835,1044,76,110,219,1530,17,275,158,296,292,454,2297,3718,9,34017,1889,1,2,0,424,0
17817,50,1010,757,253,292,73,244,162,830,13,61,38,67,74,105,409,651,7,4654,258,0,0,430,0,0
17818,361,7632,72,33,56,0,4,12,72,1,1,1,1,2,2,0,2,0,1,0,0,2,295,137,1
17819,361,7632,1454,835,1044,76,110,219,1530,17,275,158,296,292,454,2297,3718,9,34017,1889,1,2,295,137,1
17820,56,3288,520,294,400,33,13,81,553,10,261,204,367,271,571,2128,4614,7,32445,1802,1,2,105,26,1
17821,286,6178,72,33,56,0,4,12,72,1,1,1,1,2,2,0,2,0,1,0,0,2,0,582,1
17822,286,6178,1454,835,1044,76,110,219,1530,17,275,158,296,292,454,2297,3718,9,34017,1889,1,2,0,582,1
17823,75,1474,757,253,292,73,244,162,830,13,61,38,67,74,105,409,651,7,4654,258,0,0,588,0,1
17824,227,5124,4293,999,3693,19,54,507,4312,9,155,88,170,164,258,1156,1898,4,9368,520,0,2,8,2,1
17825,227,5124,1482,859,1002,125,135,219,1607,16,219,134,251,235,385,1766,3032,9,27804,1544,1,2,8,2,1
17826,148,6830,139,89,101,2,0,35,141,7,54,34,62,61,96,330,569,4,2287,127,0,2,26,0,1
17827,148,6830,7,5,5,0,0,2,7,1,2,1,2,3,3,2,4,0,2,0,0,2,26,0,1
17828,49,575,647,139,84,35,284,233,682,0,0,0,0,0,0,0,0,0,0,0,0,2,44,15,1
17829,49,575,647,139,84,35,284,233,682,0,0,0,0,0,0,0,0,0,0,0,0,2,44,15,0
17830,60,1673,1455,414,1257,16,76,112,1471,5,41,23,46,46,69,231,381,2,1069,59,0,2,4,5,1
17831,60,1673,669,365,481,22,61,110,691,15,103,63,122,118,185,747,1273,8,11311,628,0,2,4,5,1
17832,64,2957,1455,414,1257,16,76,112,1471,5,41,23,46,46,69,231,381,2,1069,59,0,2,19,0,1
17833,227,5129,4293,999,3693,19,54,507,4312,9,155,88,170,164,258,1156,1898,4,9368,520,0,2,4,1,1
17834,227,5129,1482,859,1002,125,135,219,1607,16,219,134,251,235,385,1766,3032,9,27804,1544,1,2,4,1,1
17835,148,6832,139,89,101,2,0,35,141,7,54,34,62,61,96,330,569,4,2287,127,0,2,13,6,1
17836,148,6832,7,5,5,0,0,2,7,1,2,1,2,3,3,2,4,0,2,0,0,2,13,6,1
17837,227,5129,4293,999,3693,19,54,507,4312,9,155,88,170,164,258,1156,1898,4,9368,520,0,2,11,2,0
17838,227,5129,1482,859,1002,125,135,219,1607,16,219,134,251,235,385,1766,3032,9,27804,1544,1,2,11,2,0
17839,148,6832,139,89,101,2,0,35,141,7,54,34,62,61,96,330,569,4,2287,127,0,2,33,0,0
17840,148,6832,7,5,5,0,0,2,7,1,2,1,2,3,3,2,4,0,2,0,0,2,33,0,0
17841,163,5080,1660,832,1314,41,38,274,1701,20,312,209,395,332,604,2671,5058,12,64042,3557,1,2,0,4,0
17842,163,5080,1057,646,719,113,100,145,1170,18,215,134,248,233,382,1740,3004,10,31186,1732,1,2,0,4,0
17843,60,1673,1455,414,1257,16,76,112,1471,5,41,23,46,46,69,231,381,2,1069,59,0,2,4,5,0
17844,60,1673,669,365,481,22,61,110,691,15,103,63,122,118,185,747,1273,8,11311,628,0,2,4,5,0
17845,64,2957,1455,414,1257,16,76,112,1471,5,41,23,46,46,69,231,381,2,1069,59,0,2,19,0,0
17846,178,4125,77,34,69,0,0,8,77,3,24,16,29,27,45,114,213,1,387,21,0,2,5,1,0
17847,178,4125,712,438,573,51,9,84,763,14,102,71,128,116,199,733,1364,8,11988,666,0,2,5,1,0
17848,192,3902,1943,715,1694,26,18,214,1969,12,185,120,237,197,357,1436,2721,7,20915,1161,0,2,1,1,0
17849,192,3902,1168,838,957,57,25,144,1225,19,348,224,416,367,640,3018,5452,11,61921,3440,1,2,1,1,0
17850,80,3427,1289,550,1043,56,32,155,1345,10,167,93,185,177,278,1266,2075,5,11498,638,0,2,2,2,0
17851,66,3414,1296,573,1062,40,33,157,1336,8,201,118,231,209,349,1561,2689,4,12365,686,0,2,14,5,0
17852,69,2856,1043,504,840,53,9,147,1096,9,180,112,198,189,310,1377,2344,4,11604,644,0,2,2,2,0
17853,74,3770,1943,715,1694,26,18,214,1969,12,185,120,237,197,357,1436,2721,7,20915,1161,0,2,9,0,0
17854,54,1166,207,111,150,11,0,50,218,5,26,19,36,31,55,133,272,3,943,52,0,2,2,1,1
17855,54,1166,410,198,237,31,55,97,441,11,63,38,72,74,110,414,683,6,4293,238,0,2,2,1,1
17856,74,1464,757,253,292,73,244,162,830,13,61,38,67,74,105,409,651,7,4654,258,0,2,149,121,1
17857,53,3332,520,294,400,33,13,81,553,10,261,204,367,271,571,2128,4614,7,32445,1802,1,2,23,31,1
17858,74,1464,757,253,292,73,244,162,830,13,61,38,67,74,105,409,651,7,4654,258,0,2,2,1,1
17859,53,3320,520,294,400,33,13,81,553,10,261,204,367,271,571,2128,4614,7,32445,1802,1,2,1,2,1
17860,74,1467,757,253,292,73,244,162,830,13,61,38,67,74,105,409,651,7,4654,258,0,2,3,3,1
17861,74,1473,757,253,292,73,244,162,830,13,61,38,67,74,105,409,651,7,4654,258,0,2,1,1,0
17862,90,1694,1020,354,843,12,15,144,1032,8,134,77,144,142,221,970,1580,4,6792,377,0,2,29,0,1
17863,276,6071,72,33,56,0,4,12,72,1,1,1,1,2,2,0,2,0,1,0,0,2,1,30,1
17864,276,6071,1454,835,1044,76,110,219,1530,17,275,158,296,292,454,2297,3718,9,34017,1889,1,2,1,30,1
17865,90,1746,1020,354,843,12,15,144,1032,8,134,77,144,142,221,970,1580,4,6792,377,0,2,40,30,1
17866,90,1754,1020,354,843,12,15,144,1032,8,134,77,144,142,221,970,1580,4,6792,377,0,2,1,0,1
17867,70,3035,1020,354,843,12,15,144,1032,8,134,77,144,142,221,970,1580,4,6792,377,0,2,23,1,1
17868,213,4595,182,127,129,0,0,53,182,5,39,21,42,44,63,217,343,2,926,51,0,2,5,2,0
17869,213,4595,1165,710,800,67,119,181,1232,18,243,153,282,261,435,2000,3492,10,36473,2026,1,2,5,2,0
17870,147,6814,1392,870,1177,35,17,170,1427,14,494,280,531,508,811,4473,7289,7,54850,3047,2,2,23,0,0
17871,40,837,386,256,301,16,9,68,402,4,59,35,69,63,104,355,621,2,1453,80,0,2,2,1,0
17872,40,837,264,131,164,11,41,46,275,6,38,22,40,44,62,214,338,3,1068,59,0,2,2,1,0
17873,92,1807,1020,354,843,12,15,144,1032,8,134,77,144,142,221,970,1580,4,6792,377,0,2,12,6,1
17874,40,837,386,256,301,16,9,68,402,4,59,35,69,63,104,355,621,2,1453,80,0,2,36,29,0
17875,40,837,264,131,164,11,41,46,275,6,38,22,40,44,62,214,338,3,1068,59,0,2,36,29,0
17876,38,1637,386,256,301,16,9,68,402,4,59,35,69,63,104,355,621,2,1453,80,0,2,48,10,0
17877,93,1798,1020,354,843,12,15,144,1032,8,134,77,144,142,221,970,1580,4,6792,377,0,2,31,23,1
17878,276,6071,72,33,56,0,4,12,72,1,1,1,1,2,2,0,2,0,1,0,0,2,1,0,0
17879,276,6071,1454,835,1044,76,110,219,1530,17,275,158,296,292,454,2297,3718,9,34017,1889,1,2,1,0,0
17880,93,1798,1020,354,843,12,15,144,1032,8,134,77,144,142,221,970,1580,4,6792,377,0,2,75,21,0
17881,276,6071,72,33,56,0,4,12,72,1,1,1,1,2,2,0,2,0,1,0,0,2,1,29,0
17882,276,6071,1454,835,1044,76,110,219,1530,17,275,158,296,292,454,2297,3718,9,34017,1889,1,2,1,29,0
17883,70,3035,1020,354,843,12,15,144,1032,8,134,77,144,142,221,970,1580,4,6792,377,0,2,23,1,0
17884,94,1809,1020,354,843,12,15,144,1032,8,134,77,144,142,221,970,1580,4,6792,377,0,2,4,1,1
17885,94,1809,1020,354,843,12,15,144,1032,8,134,77,144,142,221,970,1580,4,6792,377,0,2,4,1,0
17886,213,4595,182,127,129,0,0,53,182,5,39,21,42,44,63,217,343,2,926,51,0,2,5,2,0
17887,213,4595,1165,710,800,67,119,181,1232,18,243,153,282,261,435,2000,3492,10,36473,2026,1,2,5,2,0
17888,163,5080,1660,832,1314,41,38,274,1701,20,312,209,395,332,604,2671,5058,12,64042,3557,1,2,0,4,0
17889,163,5080,1057,646,719,113,100,145,1170,18,215,134,248,233,382,1740,3004,10,31186,1732,1,2,0,4,0
17890,60,1673,1455,414,1257,16,76,112,1471,5,41,23,46,46,69,231,381,2,1069,59,0,2,4,5,0
17891,60,1673,669,365,481,22,61,110,691,15,103,63,122,118,185,747,1273,8,11311,628,0,2,4,5,0
17892,227,5129,4293,999,3693,19,54,507,4312,9,155,88,170,164,258,1156,1898,4,9368,520,0,2,11,2,0
17893,227,5129,1482,859,1002,125,135,219,1607,16,219,134,251,235,385,1766,3032,9,27804,1544,1,2,11,2,0
17894,49,575,647,139,84,35,284,233,682,0,0,0,0,0,0,0,0,0,0,0,0,2,44,15,0
17895,178,4125,77,34,69,0,0,8,77,3,24,16,29,27,45,114,213,1,387,21,0,2,5,1,0
17896,178,4125,712,438,573,51,9,84,763,14,102,71,128,116,199,733,1364,8,11988,666,0,2,5,1,0
17897,40,837,386,256,301,16,9,68,402,4,59,35,69,63,104,355,621,2,1453,80,0,2,36,29,0
17898,40,837,264,131,164,11,41,46,275,6,38,22,40,44,62,214,338,3,1068,59,0,2,36,29,0
17899,192,3902,1943,715,1694,26,18,214,1969,12,185,120,237,197,357,1436,2721,7,20915,1161,0,2,1,1,0
17900,192,3902,1168,838,957,57,25,144,1225,19,348,224,416,367,640,3018,5452,11,61921,3440,1,2,1,1,0
17901,80,3427,1289,550,1043,56,32,155,1345,10,167,93,185,177,278,1266,2075,5,11498,638,0,2,2,2,0
17902,147,6814,1392,870,1177,35,17,170,1427,14,494,280,531,508,811,4473,7289,7,54850,3047,2,2,23,0,0
17903,148,6832,139,89,101,2,0,35,141,7,54,34,62,61,96,330,569,4,2287,127,0,2,33,0,0
17904,148,6832,7,5,5,0,0,2,7,1,2,1,2,3,3,2,4,0,2,0,0,2,33,0,0
17905,66,3414,1296,573,1062,40,33,157,1336,8,201,118,231,209,349,1561,2689,4,12365,686,0,2,14,5,0
17906,64,2957,1455,414,1257,16,76,112,1471,5,41,23,46,46,69,231,381,2,1069,59,0,2,19,0,0
17907,38,1637,386,256,301,16,9,68,402,4,59,35,69,63,104,355,621,2,1453,80,0,2,48,10,0
17908,69,2856,1043,504,840,53,9,147,1096,9,180,112,198,189,310,1377,2344,4,11604,644,0,2,2,2,0
17909,74,3770,1943,715,1694,26,18,214,1969,12,185,120,237,197,357,1436,2721,7,20915,1161,0,2,9,0,0
17910,178,4127,77,34,69,0,0,8,77,3,24,16,29,27,45,114,213,1,387,21,0,2,2,3,0
17911,178,4127,712,438,573,51,9,84,763,14,102,71,128,116,199,733,1364,8,11988,666,0,2,2,3,0
17912,213,4595,182,127,129,0,0,53,182,5,39,21,42,44,63,217,343,2,926,51,0,2,5,2,0
17913,213,4595,1165,710,800,67,119,181,1232,18,243,153,282,261,435,2000,3492,10,36473,2026,1,2,5,2,0
17914,163,5080,1660,832,1314,41,38,274,1701,20,312,209,395,332,604,2671,5058,12,64042,3557,1,2,0,4,0
17915,163,5080,1057,646,719,113,100,145,1170,18,215,134,248,233,382,1740,3004,10,31186,1732,1,2,0,4,0
17916,60,1673,1455,414,1257,16,76,112,1471,5,41,23,46,46,69,231,381,2,1069,59,0,2,4,5,0
17917,60,1673,669,365,481,22,61,110,691,15,103,63,122,118,185,747,1273,8,11311,628,0,2,4,5,0
17918,227,5129,4293,999,3693,19,54,507,4312,9,155,88,170,164,258,1156,1898,4,9368,520,0,2,11,2,0
17919,227,5129,1482,859,1002,125,135,219,1607,16,219,134,251,235,385,1766,3032,9,27804,1544,1,2,11,2,0
17920,49,575,647,139,84,35,284,233,682,0,0,0,0,0,0,0,0,0,0,0,0,2,44,15,0
17921,178,4125,77,34,69,0,0,8,77,3,24,16,29,27,45,114,213,1,387,21,0,2,5,1,0
17922,178,4125,712,438,573,51,9,84,763,14,102,71,128,116,199,733,1364,8,11988,666,0,2,5,1,0
17923,40,837,386,256,301,16,9,68,402,4,59,35,69,63,104,355,621,2,1453,80,0,2,36,29,0
17924,40,837,264,131,164,11,41,46,275,6,38,22,40,44,62,214,338,3,1068,59,0,2,36,29,0
17925,192,3902,1943,715,1694,26,18,214,1969,12,185,120,237,197,357,1436,2721,7,20915,1161,0,2,1,1,0
17926,192,3902,1168,838,957,57,25,144,1225,19,348,224,416,367,640,3018,5452,11,61921,3440,1,2,1,1,0
17927,80,3427,1289,550,1043,56,32,155,1345,10,167,93,185,177,278,1266,2075,5,11498,638,0,2,2,2,0
17928,147,6814,1392,870,1177,35,17,170,1427,14,494,280,531,508,811,4473,7289,7,54850,3047,2,2,23,0,0
17929,148,6832,139,89,101,2,0,35,141,7,54,34,62,61,96,330,569,4,2287,127,0,2,33,0,0
17930,148,6832,7,5,5,0,0,2,7,1,2,1,2,3,3,2,4,0,2,0,0,2,33,0,0
17931,66,3414,1296,573,1062,40,33,157,1336,8,201,118,231,209,349,1561,2689,4,12365,686,0,2,14,5,0
17932,64,2957,1455,414,1257,16,76,112,1471,5,41,23,46,46,69,231,381,2,1069,59,0,2,19,0,0
17933,38,1637,386,256,301,16,9,68,402,4,59,35,69,63,104,355,621,2,1453,80,0,2,48,10,0
17934,69,2856,1043,504,840,53,9,147,1096,9,180,112,198,189,310,1377,2344,4,11604,644,0,2,2,2,0
17935,74,3770,1943,715,1694,26,18,214,1969,12,185,120,237,197,357,1436,2721,7,20915,1161,0,2,9,0,0
17936,278,6113,72,33,56,0,4,12,72,1,1,1,1,2,2,0,2,0,1,0,0,2,13,4,1
17937,278,6113,1454,835,1044,76,110,219,1530,17,275,158,296,292,454,2297,3718,9,34017,1889,1,2,13,4,1
17938,98,4425,1338,495,1086,10,64,173,1348,11,122,82,157,133,239,883,1686,7,11934,663,0,2,20,0,1
17939,278,6113,72,33,56,0,4,12,72,1,1,1,1,2,2,0,2,0,1,0,0,2,13,4,0
17940,278,6113,1454,835,1044,76,110,219,1530,17,275,158,296,292,454,2297,3718,9,34017,1889,1,2,13,4,0
17941,98,4425,1338,495,1086,10,64,173,1348,11,122,82,157,133,239,883,1686,7,11934,663,0,2,20,0,0
17942,178,4129,77,34,69,0,0,8,77,3,24,16,29,27,45,114,213,1,387,21,0,2,2,3,0
17943,178,4129,712,438,573,51,9,84,763,14,102,71,128,116,199,733,1364,8,11988,666,0,2,2,3,0
17944,74,1479,757,253,292,73,244,162,830,13,61,38,67,74,105,409,651,7,4654,258,0,2,3,3,1
17945,53,3320,520,294,400,33,13,81,553,10,261,204,367,271,571,2128,4614,7,32445,1802,1,2,4,4,1
17946,76,1520,757,253,292,73,244,162,830,13,61,38,67,74,105,409,651,7,4654,258,0,2,16,9,0
17947,178,4129,77,34,69,0,0,8,77,3,24,16,29,27,45,114,213,1,387,21,0,2,2,3,0
17948,178,4129,712,438,573,51,9,84,763,14,102,71,128,116,199,733,1364,8,11988,666,0,2,2,3,0
17949,76,1520,757,253,292,73,244,162,830,13,61,38,67,74,105,409,651,7,4654,258,0,2,1,1,0
17950,178,4129,77,34,69,0,0,8,77,3,24,16,29,27,45,114,213,1,387,21,0,2,1,1,1
17951,178,4129,712,438,573,51,9,84,763,14,102,71,128,116,199,733,1364,8,11988,666,0,2,1,1,1
17952,71,3006,1178,367,1042,6,15,115,1184,9,94,51,95,103,146,644,976,4,4439,246,0,2,1,1,1
17953,178,4129,77,34,69,0,0,8,77,3,24,16,29,27,45,114,213,1,387,21,0,2,1,1,0
17954,178,4129,712,438,573,51,9,84,763,14,102,71,128,116,199,733,1364,8,11988,666,0,2,1,1,0
17955,71,3006,1178,367,1042,6,15,115,1184,9,94,51,95,103,146,644,976,4,4439,246,0,2,1,1,0
17956,49,575,647,139,84,35,284,233,682,0,0,0,0,0,0,0,0,0,0,0,0,2,11,3,0
17957,49,575,647,139,84,35,284,233,682,0,0,0,0,0,0,0,0,0,0,0,0,2,11,3,0
17958,54,1166,207,111,150,11,0,50,218,5,26,19,36,31,55,133,272,3,943,52,0,2,2,1,0
17959,54,1166,410,198,237,31,55,97,441,11,63,38,72,74,110,414,683,6,4293,238,0,2,2,1,0
17960,76,1520,757,253,292,73,244,162,830,13,61,38,67,74,105,409,651,7,4654,258,0,2,328,134,0
17961,53,3320,520,294,400,33,13,81,553,10,261,204,367,271,571,2128,4614,7,32445,1802,1,2,109,39,0
17962,62,1345,996,429,845,24,10,117,1020,7,76,50,88,83,138,494,879,4,3565,198,0,2,15,1,0
17963,62,1345,456,277,329,12,42,72,468,13,85,50,97,98,147,592,972,7,7212,400,0,2,15,1,0
17964,54,1161,207,111,150,11,0,50,218,5,26,19,36,31,55,133,272,3,943,52,0,2,2,2,1
17965,54,1161,410,198,237,31,55,97,441,11,63,38,72,74,110,414,683,6,4293,238,0,2,2,2,1
17966,336,7168,72,33,56,0,4,12,72,1,1,1,1,2,2,0,2,0,1,0,0,2,5,5,1
17967,336,7168,1454,835,1044,76,110,219,1530,17,275,158,296,292,454,2297,3718,9,34017,1889,1,2,5,5,1
17968,336,7160,72,33,56,0,4,12,72,1,1,1,1,2,2,0,2,0,1,0,0,2,1,1,1
17969,336,7160,1454,835,1044,76,110,219,1530,17,275,158,296,292,454,2297,3718,9,34017,1889,1,2,1,1,1
17970,7,278,75,38,59,1,3,12,76,2,4,2,4,6,6,10,15,1,15,0,0,2,4,0,1
17971,62,1345,996,429,845,24,10,117,1020,7,76,50,88,83,138,494,879,4,3565,198,0,2,15,1,0
17972,62,1345,456,277,329,12,42,72,468,13,85,50,97,98,147,592,972,7,7212,400,0,2,15,1,0
17973,54,1161,207,111,150,11,0,50,218,5,26,19,36,31,55,133,272,3,943,52,0,2,2,2,0
17974,54,1161,410,198,237,31,55,97,441,11,63,38,72,74,110,414,683,6,4293,238,0,2,2,2,0
17975,336,7168,72,33,56,0,4,12,72,1,1,1,1,2,2,0,2,0,1,0,0,2,5,5,0
17976,336,7168,1454,835,1044,76,110,219,1530,17,275,158,296,292,454,2297,3718,9,34017,1889,1,2,5,5,0
17977,54,1166,207,111,150,11,0,50,218,5,26,19,36,31,55,133,272,3,943,52,0,2,2,2,0
17978,54,1166,410,198,237,31,55,97,441,11,63,38,72,74,110,414,683,6,4293,238,0,2,2,2,0
17979,49,575,647,139,84,35,284,233,682,0,0,0,0,0,0,0,0,0,0,0,0,2,11,3,0
17980,178,4129,77,34,69,0,0,8,77,3,24,16,29,27,45,114,213,1,387,21,0,2,1,1,0
17981,178,4129,712,438,573,51,9,84,763,14,102,71,128,116,199,733,1364,8,11988,666,0,2,1,1,0
17982,278,6113,72,33,56,0,4,12,72,1,1,1,1,2,2,0,2,0,1,0,0,2,5,5,0
17983,278,6113,1454,835,1044,76,110,219,1530,17,275,158,296,292,454,2297,3718,9,34017,1889,1,2,5,5,0
17984,71,3006,1178,367,1042,6,15,115,1184,9,94,51,95,103,146,644,976,4,4439,246,0,2,1,1,0
17985,180,4191,77,34,69,0,0,8,77,3,24,16,29,27,45,114,213,1,387,21,0,2,12,0,1
17986,180,4191,712,438,573,51,9,84,763,14,102,71,128,116,199,733,1364,8,11988,666,0,2,12,0,1
17987,180,4191,77,34,69,0,0,8,77,3,24,16,29,27,45,114,213,1,387,21,0,2,1,1,1
17988,180,4191,712,438,573,51,9,84,763,14,102,71,128,116,199,733,1364,8,11988,666,0,2,1,1,1
17989,184,4250,77,34,69,0,0,8,77,3,24,16,29,27,45,114,213,1,387,21,0,2,14,4,0
17990,184,4250,712,438,573,51,9,84,763,14,102,71,128,116,199,733,1364,8,11988,666,0,2,14,4,0
17991,178,4130,77,34,69,0,0,8,77,3,24,16,29,27,45,114,213,1,387,21,0,2,15,0,0
17992,178,4130,712,438,573,51,9,84,763,14,102,71,128,116,199,733,1364,8,11988,666,0,2,15,0,0
17993,184,4240,77,34,69,0,0,8,77,3,24,16,29,27,45,114,213,1,387,21,0,2,2,6,1
17994,184,4240,712,438,573,51,9,84,763,14,102,71,128,116,199,733,1364,8,11988,666,0,2,2,6,1
17995,72,3755,1296,573,1062,40,33,157,1336,8,201,118,231,209,349,1561,2689,4,12365,686,0,2,48,1,1
17996,184,4240,77,34,69,0,0,8,77,3,24,16,29,27,45,114,213,1,387,21,0,2,18,0,0
17997,184,4240,712,438,573,51,9,84,763,14,102,71,128,116,199,733,1364,8,11988,666,0,2,18,0,0
17998,72,3755,1296,573,1062,40,33,157,1336,8,201,118,231,209,349,1561,2689,4,12365,686,0,2,48,1,0
17999,336,7160,72,33,56,0,4,12,72,1,1,1,1,2,2,0,2,0,1,0,0,2,1,1,0
18000,336,7160,1454,835,1044,76,110,219,1530,17,275,158,296,292,454,2297,3718,9,34017,1889,1,2,1,1,0
18001,7,278,75,38,59,1,3,12,76,2,4,2,4,6,6,10,15,1,15,0,0,2,4,0,0
18002,178,4130,77,34,69,0,0,8,77,3,24,16,29,27,45,114,213,1,387,21,0,2,15,0,0
18003,178,4130,712,438,573,51,9,84,763,14,102,71,128,116,199,733,1364,8,11988,666,0,2,15,0,0
18004,192,3908,1943,715,1694,26,18,214,1969,12,185,120,237,197,357,1436,2721,7,20915,1161,0,2,3,0,0
18005,192,3908,1168,838,957,57,25,144,1225,19,348,224,416,367,640,3018,5452,11,61921,3440,1,2,3,0,0
18006,192,3908,1943,715,1694,26,18,214,1969,12,185,120,237,197,357,1436,2721,7,20915,1161,0,2,3,0,0
18007,192,3908,1168,838,957,57,25,144,1225,19,348,224,416,367,640,3018,5452,11,61921,3440,1,2,3,0,0
18008,339,7202,72,33,56,0,4,12,72,1,1,1,1,2,2,0,2,0,1,0,0,2,20,6,1
18009,339,7202,1454,835,1044,76,110,219,1530,17,275,158,296,292,454,2297,3718,9,34017,1889,1,2,20,6,1
18010,151,6958,139,89,101,2,0,35,141,7,54,34,62,61,96,330,569,4,2287,127,0,2,61,4,1
18011,151,6958,7,5,5,0,0,2,7,1,2,1,2,3,3,2,4,0,2,0,0,2,61,4,1
18012,55,1182,207,111,150,11,0,50,218,5,26,19,36,31,55,133,272,3,943,52,0,2,10,1,1
18013,55,1182,410,198,237,31,55,97,441,11,63,38,72,74,110,414,683,6,4293,238,0,2,10,1,1
18014,118,4686,1513,682,1277,25,13,200,1538,11,199,116,219,210,335,1557,2584,6,15641,868,0,2,9,0,1
18015,213,4595,182,127,129,0,0,53,182,5,39,21,42,44,63,217,343,2,926,51,0,2,1,1,1
18016,213,4595,1165,710,800,67,119,181,1232,18,243,153,282,261,435,2000,3492,10,36473,2026,1,2,1,1,1
18017,99,2081,773,419,590,28,0,166,801,10,204,113,217,214,330,1598,2554,5,13587,754,0,2,0,2,1
18018,99,2081,421,273,302,44,34,57,465,17,81,59,107,98,166,583,1098,11,12329,684,0,2,0,2,1
18019,227,5129,4293,999,3693,19,54,507,4312,9,155,88,170,164,258,1156,1898,4,9368,520,0,2,0,1,1
18020,227,5129,1482,859,1002,125,135,219,1607,16,219,134,251,235,385,1766,3032,9,27804,1544,1,2,0,1,1
18021,91,3010,773,419,590,28,0,166,801,10,204,113,217,214,330,1598,2554,5,13587,754,0,2,4,1,1
18022,2,26,6,4,4,0,0,2,6,1,4,2,4,5,6,8,13,0,6,0,0,2,1,1,1
18023,47,2498,520,294,400,33,13,81,553,10,261,204,367,271,571,2128,4614,7,32445,1802,1,2,0,1,1
18024,148,6832,139,89,101,2,0,35,141,7,54,34,62,61,96,330,569,4,2287,127,0,2,0,3,1
18025,148,6832,7,5,5,0,0,2,7,1,2,1,2,3,3,2,4,0,2,0,0,2,0,3,1
18026,78,4093,1457,730,1242,11,6,188,1468,10,292,166,329,302,495,2424,4078,5,22973,1276,1,2,0,1,1
18027,64,2957,1455,414,1257,16,76,112,1471,5,41,23,46,46,69,231,381,2,1069,59,0,2,0,1,1
18028,90,4427,1523,757,1297,19,12,193,1542,12,193,117,230,205,347,1508,2664,7,19053,1058,0,2,0,1,1
18029,12,492,184,100,137,2,15,30,186,6,38,20,39,44,59,214,322,3,991,55,0,2,0,2,1
18030,16,1209,215,129,180,6,0,29,221,8,65,43,72,73,115,415,711,4,3153,175,0,2,0,2,1
18031,69,2856,1043,504,840,53,9,147,1096,9,180,112,198,189,310,1377,2344,4,11604,644,0,2,0,2,1
18032,60,1673,1455,414,1257,16,76,112,1471,5,41,23,46,46,69,231,381,2,1069,59,0,2,1,1,0
18033,60,1673,669,365,481,22,61,110,691,15,103,63,122,118,185,747,1273,8,11311,628,0,2,1,1,0
18034,223,5047,722,423,573,19,0,135,741,12,172,101,199,184,300,1320,2257,6,15668,870,0,2,5,5,0
18035,223,5047,1508,847,911,44,250,301,1552,14,148,88,169,162,257,1120,1886,7,15077,837,0,2,5,5,0
18036,336,7160,72,33,56,0,4,12,72,1,1,1,1,2,2,0,2,0,1,0,0,2,1,1,0
18037,336,7160,1454,835,1044,76,110,219,1530,17,275,158,296,292,454,2297,3718,9,34017,1889,1,2,1,1,0
18038,39,2355,652,304,544,16,6,88,668,6,89,51,101,95,152,591,998,3,3399,188,0,2,4,4,0
18039,64,2957,1455,414,1257,16,76,112,1471,5,41,23,46,46,69,231,381,2,1069,59,0,2,1,1,0
18040,37,1624,447,308,343,6,5,95,453,7,96,59,111,103,170,651,1136,4,4600,255,0,2,1,1,0
18041,48,1784,1098,241,925,5,10,155,1103,7,46,25,49,53,74,273,423,3,1580,87,0,2,1,1,0
18042,12,476,601,196,481,2,23,85,603,8,63,36,72,71,108,400,664,4,3036,168,0,2,2,2,0
18043,227,5129,4293,999,3693,19,54,507,4312,9,155,88,170,164,258,1156,1898,4,9368,520,0,2,1,1,0
18044,227,5129,1482,859,1002,125,135,219,1607,16,219,134,251,235,385,1766,3032,9,27804,1544,1,2,1,1,0
18045,40,837,386,256,301,16,9,68,402,4,59,35,69,63,104,355,621,2,1453,80,0,2,1,1,0
18046,40,837,264,131,164,11,41,46,275,6,38,22,40,44,62,214,338,3,1068,59,0,2,1,1,0
18047,127,2807,1043,504,840,53,9,147,1096,9,180,112,198,189,310,1377,2344,4,11604,644,0,2,1,1,0
18048,127,2807,383,288,292,26,6,62,409,11,65,38,67,76,105,429,656,5,3719,206,0,2,1,1,0
18049,47,2498,520,294,400,33,13,81,553,10,261,204,367,271,571,2128,4614,7,32445,1802,1,2,9,9,0
18050,148,6832,139,89,101,2,0,35,141,7,54,34,62,61,96,330,569,4,2287,127,0,2,6,8,0
18051,148,6832,7,5,5,0,0,2,7,1,2,1,2,3,3,2,4,0,2,0,0,2,6,8,0
18052,74,3770,1943,715,1694,26,18,214,1969,12,185,120,237,197,357,1436,2721,7,20915,1161,0,2,3,3,0
18053,349,7049,1457,730,1242,11,6,188,1468,10,292,166,329,302,495,2424,4078,5,22973,1276,1,2,2,2,0
18054,349,7049,74,35,59,1,0,14,75,3,14,7,14,17,21,58,85,1,128,7,0,2,2,2,0
18055,349,7049,245,125,200,5,7,34,250,7,30,17,34,37,51,166,265,3,1053,58,0,2,2,2,0
18056,27,954,74,35,59,1,0,14,75,3,14,7,14,17,21,58,85,1,128,7,0,2,3,3,0
18057,27,954,245,125,200,5,7,34,250,7,30,17,34,37,51,166,265,3,1053,58,0,2,3,3,0
18058,148,6832,139,89,101,2,0,35,141,7,54,34,62,61,96,330,569,4,2287,127,0,2,1,1,0
18059,148,6832,7,5,5,0,0,2,7,1,2,1,2,3,3,2,4,0,2,0,0,2,1,1,0
18060,150,4203,1660,832,1314,41,38,274,1701,20,312,209,395,332,604,2671,5058,12,64042,3557,1,2,1,1,0
18061,74,3770,1943,715,1694,26,18,214,1969,12,185,120,237,197,357,1436,2721,7,20915,1161,0,2,2,2,0
18062,148,6832,139,89,101,2,0,35,141,7,54,34,62,61,96,330,569,4,2287,127,0,2,1,1,0
18063,148,6832,7,5,5,0,0,2,7,1,2,1,2,3,3,2,4,0,2,0,0,2,1,1,0
18064,69,2856,1043,504,840,53,9,147,1096,9,180,112,198,189,310,1377,2344,4,11604,644,0,2,5,5,0
18065,74,3770,1943,715,1694,26,18,214,1969,12,185,120,237,197,357,1436,2721,7,20915,1161,0,2,5,5,0
18066,336,7160,72,33,56,0,4,12,72,1,1,1,1,2,2,0,2,0,1,0,0,2,2,2,0
18067,336,7160,1454,835,1044,76,110,219,1530,17,275,158,296,292,454,2297,3718,9,34017,1889,1,2,2,2,0
18068,103,1953,1178,367,1042,6,15,115,1184,9,94,51,95,103,146,644,976,4,4439,246,0,2,3,3,0
18069,103,1953,177,108,140,8,0,27,185,6,30,16,32,36,48,162,248,3,794,44,0,2,3,3,0
18070,80,3427,1289,550,1043,56,32,155,1345,10,167,93,185,177,278,1266,2075,5,11498,638,0,2,1,1,0
18071,147,6814,1392,870,1177,35,17,170,1427,14,494,280,531,508,811,4473,7289,7,54850,3047,2,2,1,1,0
18072,112,5710,1782,648,1425,9,47,279,1791,8,171,97,189,179,286,1292,2140,4,9462,525,0,2,3,3,0
18073,150,4203,1660,832,1314,41,38,274,1701,20,312,209,395,332,604,2671,5058,12,64042,3557,1,2,1,1,0
18074,74,3770,1943,715,1694,26,18,214,1969,12,185,120,237,197,357,1436,2721,7,20915,1161,0,2,1,1,0
18075,213,4595,182,127,129,0,0,53,182,5,39,21,42,44,63,217,343,2,926,51,0,2,2,2,1
18076,213,4595,1165,710,800,67,119,181,1232,18,243,153,282,261,435,2000,3492,10,36473,2026,1,2,2,2,1
18077,227,5129,4293,999,3693,19,54,507,4312,9,155,88,170,164,258,1156,1898,4,9368,520,0,2,1,1,1
18078,227,5129,1482,859,1002,125,135,219,1607,16,219,134,251,235,385,1766,3032,9,27804,1544,1,2,1,1,1
18079,212,5047,722,423,573,19,0,135,741,12,172,101,199,184,300,1320,2257,6,15668,870,0,2,2,2,1
18080,212,5047,1508,847,911,44,250,301,1552,14,148,88,169,162,257,1120,1886,7,15077,837,0,2,2,2,1
18081,310,7160,72,33,56,0,4,12,72,1,1,1,1,2,2,0,2,0,1,0,0,2,1,1,1
18082,310,7160,1454,835,1044,76,110,219,1530,17,275,158,296,292,454,2297,3718,9,34017,1889,1,2,1,1,1
18083,103,1953,1178,367,1042,6,15,115,1184,9,94,51,95,103,146,644,976,4,4439,246,0,2,1,1,1
18084,103,1953,177,108,140,8,0,27,185,6,30,16,32,36,48,162,248,3,794,44,0,2,1,1,1
18085,62,1240,1098,241,925,5,10,155,1103,7,46,25,49,53,74,273,423,3,1580,87,0,2,1,1,1
18086,62,1240,282,202,222,14,2,44,296,8,42,24,43,50,67,250,378,4,1548,86,0,2,1,1,1
18087,349,7049,1457,730,1242,11,6,188,1468,10,292,166,329,302,495,2424,4078,5,22973,1276,1,2,6,6,1
18088,349,7049,74,35,59,1,0,14,75,3,14,7,14,17,21,58,85,1,128,7,0,2,6,6,1
18089,349,7049,245,125,200,5,7,34,250,7,30,17,34,37,51,166,265,3,1053,58,0,2,6,6,1
18090,227,5129,4293,999,3693,19,54,507,4312,9,155,88,170,164,258,1156,1898,4,9368,520,0,2,5,5,1
18091,227,5129,1482,859,1002,125,135,219,1607,16,219,134,251,235,385,1766,3032,9,27804,1544,1,2,5,5,1
18092,83,2359,1523,757,1297,19,12,193,1542,12,193,117,230,205,347,1508,2664,7,19053,1058,0,2,4,4,1
18093,83,2359,701,378,504,33,58,109,734,13,110,68,126,123,194,794,1346,7,10027,557,0,2,4,4,1
18094,46,955,447,308,343,6,5,95,453,7,96,59,111,103,170,651,1136,4,4600,255,0,2,3,3,1
18095,46,955,322,174,179,16,74,51,338,10,41,26,46,51,72,252,408,5,2291,127,0,2,3,3,1
18096,212,5047,722,423,573,19,0,135,741,12,172,101,199,184,300,1320,2257,6,15668,870,0,2,2,2,1
18097,212,5047,1508,847,911,44,250,301,1552,14,148,88,169,162,257,1120,1886,7,15077,837,0,2,2,2,1
18098,310,7160,72,33,56,0,4,12,72,1,1,1,1,2,2,0,2,0,1,0,0,2,2,2,1
18099,310,7160,1454,835,1044,76,110,219,1530,17,275,158,296,292,454,2297,3718,9,34017,1889,1,2,2,2,1
18100,127,2807,1043,504,840,53,9,147,1096,9,180,112,198,189,310,1377,2344,4,11604,644,0,2,4,4,1
18101,127,2807,383,288,292,26,6,62,409,11,65,38,67,76,105,429,656,5,3719,206,0,2,4,4,1
18102,91,3010,773,419,590,28,0,166,801,10,204,113,217,214,330,1598,2554,5,13587,754,0,2,1,1,1
18103,47,2498,520,294,400,33,13,81,553,10,261,204,367,271,571,2128,4614,7,32445,1802,1,2,28,28,1
18104,109,4106,1450,624,1228,12,26,181,1462,14,306,186,354,320,540,2580,4493,8,36391,2021,1,2,1,1,1
18105,68,2962,1020,354,843,12,15,144,1032,8,134,77,144,142,221,970,1580,4,6792,377,0,2,4,4,1
18106,36,1978,384,251,317,7,8,52,391,11,70,44,84,81,128,467,811,6,5355,297,0,2,1,1,1
18107,16,1209,215,129,180,6,0,29,221,8,65,43,72,73,115,415,711,4,3153,175,0,2,1,1,1
18108,163,5080,1660,832,1314,41,38,274,1701,20,312,209,395,332,604,2671,5058,12,64042,3557,1,2,1,1,1
18109,163,5080,1057,646,719,113,100,145,1170,18,215,134,248,233,382,1740,3004,10,31186,1732,1,2,1,1,1
18110,54,1161,207,111,150,11,0,50,218,5,26,19,36,31,55,133,272,3,943,52,0,2,1,1,1
18111,54,1161,410,198,237,31,55,97,441,11,63,38,72,74,110,414,683,6,4293,238,0,2,1,1,1
18112,349,7049,1457,730,1242,11,6,188,1468,10,292,166,329,302,495,2424,4078,5,22973,1276,1,2,1,1,1
18113,349,7049,74,35,59,1,0,14,75,3,14,7,14,17,21,58,85,1,128,7,0,2,1,1,1
18114,349,7049,245,125,200,5,7,34,250,7,30,17,34,37,51,166,265,3,1053,58,0,2,1,1,1
18115,60,1673,1455,414,1257,16,76,112,1471,5,41,23,46,46,69,231,381,2,1069,59,0,2,1,1,1
18116,60,1673,669,365,481,22,61,110,691,15,103,63,122,118,185,747,1273,8,11311,628,0,2,1,1,1
18117,83,2359,1523,757,1297,19,12,193,1542,12,193,117,230,205,347,1508,2664,7,19053,1058,0,2,2,2,1
18118,83,2359,701,378,504,33,58,109,734,13,110,68,126,123,194,794,1346,7,10027,557,0,2,2,2,1
18119,212,5047,722,423,573,19,0,135,741,12,172,101,199,184,300,1320,2257,6,15668,870,0,2,1,1,1
18120,212,5047,1508,847,911,44,250,301,1552,14,148,88,169,162,257,1120,1886,7,15077,837,0,2,1,1,1
18121,310,7160,72,33,56,0,4,12,72,1,1,1,1,2,2,0,2,0,1,0,0,2,1,1,1
18122,310,7160,1454,835,1044,76,110,219,1530,17,275,158,296,292,454,2297,3718,9,34017,1889,1,2,1,1,1
18123,147,6814,1392,870,1177,35,17,170,1427,14,494,280,531,508,811,4473,7289,7,54850,3047,2,2,1,1,1
18124,32,948,465,148,393,5,8,60,470,4,31,20,31,35,51,161,261,2,523,29,0,2,1,1,1
18125,32,948,16,12,9,0,0,6,16,1,2,1,2,3,3,2,4,0,2,0,0,2,1,1,1
18126,66,3414,1296,573,1062,40,33,157,1336,8,201,118,231,209,349,1561,2689,4,12365,686,0,2,1,1,1
18127,40,2367,334,251,279,10,4,40,344,5,127,74,143,132,217,899,1528,2,4303,239,0,2,1,1,1
18128,213,4595,182,127,129,0,0,53,182,5,39,21,42,44,63,217,343,2,926,51,0,2,4,4,1
18129,213,4595,1165,710,800,67,119,181,1232,18,243,153,282,261,435,2000,3492,10,36473,2026,1,2,4,4,1
18130,99,2081,773,419,590,28,0,166,801,10,204,113,217,214,330,1598,2554,5,13587,754,0,2,1,1,1
18131,99,2081,421,273,302,44,34,57,465,17,81,59,107,98,166,583,1098,11,12329,684,0,2,1,1,1
18132,60,1265,996,429,845,24,10,117,1020,7,76,50,88,83,138,494,879,4,3565,198,0,2,1,1,1
18133,60,1265,456,277,329,12,42,72,468,13,85,50,97,98,147,592,972,7,7212,400,0,2,1,1,1
18134,54,1161,207,111,150,11,0,50,218,5,26,19,36,31,55,133,272,3,943,52,0,2,1,1,1
18135,54,1161,410,198,237,31,55,97,441,11,63,38,72,74,110,414,683,6,4293,238,0,2,1,1,1
18136,349,7049,1457,730,1242,11,6,188,1468,10,292,166,329,302,495,2424,4078,5,22973,1276,1,2,9,9,1
18137,349,7049,74,35,59,1,0,14,75,3,14,7,14,17,21,58,85,1,128,7,0,2,9,9,1
18138,349,7049,245,125,200,5,7,34,250,7,30,17,34,37,51,166,265,3,1053,58,0,2,9,9,1
18139,60,1673,1455,414,1257,16,76,112,1471,5,41,23,46,46,69,231,381,2,1069,59,0,2,15,15,1
18140,60,1673,669,365,481,22,61,110,691,15,103,63,122,118,185,747,1273,8,11311,628,0,2,15,15,1
18141,227,5129,4293,999,3693,19,54,507,4312,9,155,88,170,164,258,1156,1898,4,9368,520,0,2,5,5,1
18142,227,5129,1482,859,1002,125,135,219,1607,16,219,134,251,235,385,1766,3032,9,27804,1544,1,2,5,5,1
18143,27,954,74,35,59,1,0,14,75,3,14,7,14,17,21,58,85,1,128,7,0,2,16,16,1
18144,27,954,245,125,200,5,7,34,250,7,30,17,34,37,51,166,265,3,1053,58,0,2,16,16,1
18145,178,4130,77,34,69,0,0,8,77,3,24,16,29,27,45,114,213,1,387,21,0,2,22,22,1
18146,178,4130,712,438,573,51,9,84,763,14,102,71,128,116,199,733,1364,8,11988,666,0,2,22,22,1
18147,17,518,184,100,137,2,15,30,186,6,38,20,39,44,59,214,322,3,991,55,0,2,3,3,1
18148,17,518,103,65,74,8,5,16,111,7,17,9,17,24,26,89,119,3,417,23,0,2,3,3,1
18149,212,5047,722,423,573,19,0,135,741,12,172,101,199,184,300,1320,2257,6,15668,870,0,2,10,10,1
18150,212,5047,1508,847,911,44,250,301,1552,14,148,88,169,162,257,1120,1886,7,15077,837,0,2,10,10,1
18151,310,7160,72,33,56,0,4,12,72,1,1,1,1,2,2,0,2,0,1,0,0,2,27,27,1
18152,310,7160,1454,835,1044,76,110,219,1530,17,275,158,296,292,454,2297,3718,9,34017,1889,1,2,27,27,1
18153,30,649,215,129,180,6,0,29,221,8,65,43,72,73,115,415,711,4,3153,175,0,2,2,2,1
18154,30,649,97,69,77,3,3,16,100,6,22,13,23,28,36,113,173,3,542,30,0,2,2,2,1
18155,127,2807,1043,504,840,53,9,147,1096,9,180,112,198,189,310,1377,2344,4,11604,644,0,2,6,6,1
18156,127,2807,383,288,292,26,6,62,409,11,65,38,67,76,105,429,656,5,3719,206,0,2,6,6,1
18157,103,1953,1178,367,1042,6,15,115,1184,9,94,51,95,103,146,644,976,4,4439,246,0,2,17,17,1
18158,103,1953,177,108,140,8,0,27,185,6,30,16,32,36,48,162,248,3,794,44,0,2,17,17,1
18159,192,3908,1943,715,1694,26,18,214,1969,12,185,120,237,197,357,1436,2721,7,20915,1161,0,2,18,18,1
18160,192,3908,1168,838,957,57,25,144,1225,19,348,224,416,367,640,3018,5452,11,61921,3440,1,2,18,18,1
18161,16,477,442,244,305,14,16,103,456,11,68,45,75,79,120,452,756,6,4588,254,0,2,1,1,1
18162,16,477,182,102,99,11,40,35,193,3,11,6,11,14,17,42,64,1,97,5,0,2,1,1,1
18163,62,1240,1098,241,925,5,10,155,1103,7,46,25,49,53,74,273,423,3,1580,87,0,2,2,2,1
18164,62,1240,282,202,222,14,2,44,296,8,42,24,43,50,67,250,378,4,1548,86,0,2,2,2,1
18165,147,6814,1392,870,1177,35,17,170,1427,14,494,280,531,508,811,4473,7289,7,54850,3047,2,2,1,1,1
18166,96,4365,1338,495,1086,10,64,173,1348,11,122,82,157,133,239,883,1686,7,11934,663,0,2,3,3,1
18167,112,5710,1782,648,1425,9,47,279,1791,8,171,97,189,179,286,1292,2140,4,9462,525,0,2,4,4,1
18168,23,601,102,59,69,5,3,24,107,6,22,15,28,28,43,113,206,3,789,43,0,2,4,4,1
18169,150,4203,1660,832,1314,41,38,274,1701,20,312,209,395,332,604,2671,5058,12,64042,3557,1,2,1,1,1
18170,117,4645,1513,682,1277,25,13,200,1538,11,199,116,219,210,335,1557,2584,6,15641,868,0,2,1,1,1
18171,78,4093,1457,730,1242,11,6,188,1468,10,292,166,329,302,495,2424,4078,5,22973,1276,1,2,1,1,1
18172,64,2957,1455,414,1257,16,76,112,1471,5,41,23,46,46,69,231,381,2,1069,59,0,2,4,4,1
18173,40,2367,334,251,279,10,4,40,344,5,127,74,143,132,217,899,1528,2,4303,239,0,2,1,1,1
18174,36,1978,384,251,317,7,8,52,391,11,70,44,84,81,128,467,811,6,5355,297,0,2,1,1,1
18175,74,3770,1943,715,1694,26,18,214,1969,12,185,120,237,197,357,1436,2721,7,20915,1161,0,2,4,4,1
18176,213,4595,182,127,129,0,0,53,182,5,39,21,42,44,63,217,343,2,926,51,0,2,1,1,0
18177,213,4595,1165,710,800,67,119,181,1232,18,243,153,282,261,435,2000,3492,10,36473,2026,1,2,1,1,0
18178,163,5080,1660,832,1314,41,38,274,1701,20,312,209,395,332,604,2671,5058,12,64042,3557,1,2,1,1,0
18179,163,5080,1057,646,719,113,100,145,1170,18,215,134,248,233,382,1740,3004,10,31186,1732,1,2,1,1,0
18180,62,1240,1098,241,925,5,10,155,1103,7,46,25,49,53,74,273,423,3,1580,87,0,2,1,1,0
18181,62,1240,282,202,222,14,2,44,296,8,42,24,43,50,67,250,378,4,1548,86,0,2,1,1,0
18182,349,7049,1457,730,1242,11,6,188,1468,10,292,166,329,302,495,2424,4078,5,22973,1276,1,2,3,3,1
18183,349,7049,74,35,59,1,0,14,75,3,14,7,14,17,21,58,85,1,128,7,0,2,3,3,1
18184,349,7049,245,125,200,5,7,34,250,7,30,17,34,37,51,166,265,3,1053,58,0,2,3,3,1
18185,310,7160,72,33,56,0,4,12,72,1,1,1,1,2,2,0,2,0,1,0,0,2,1,1,1
18186,310,7160,1454,835,1044,76,110,219,1530,17,275,158,296,292,454,2297,3718,9,34017,1889,1,2,1,1,1
18187,40,837,386,256,301,16,9,68,402,4,59,35,69,63,104,355,621,2,1453,80,0,2,1,1,1
18188,40,837,264,131,164,11,41,46,275,6,38,22,40,44,62,214,338,3,1068,59,0,2,1,1,1
18189,147,6814,1392,870,1177,35,17,170,1427,14,494,280,531,508,811,4473,7289,7,54850,3047,2,2,3,3,1
18190,47,2498,520,294,400,33,13,81,553,10,261,204,367,271,571,2128,4614,7,32445,1802,1,2,40,40,1
18191,109,4106,1450,624,1228,12,26,181,1462,14,306,186,354,320,540,2580,4493,8,36391,2021,1,2,5,5,1
18192,68,2962,1020,354,843,12,15,144,1032,8,134,77,144,142,221,970,1580,4,6792,377,0,2,9,9,1
18193,71,3006,1178,367,1042,6,15,115,1184,9,94,51,95,103,146,644,976,4,4439,246,0,2,1,1,1
18194,74,3770,1943,715,1694,26,18,214,1969,12,185,120,237,197,357,1436,2721,7,20915,1161,0,2,1,1,1
18195,99,2081,773,419,590,28,0,166,801,10,204,113,217,214,330,1598,2554,5,13587,754,0,2,1,1,0
18196,99,2081,421,273,302,44,34,57,465,17,81,59,107,98,166,583,1098,11,12329,684,0,2,1,1,0
18197,47,2498,520,294,400,33,13,81,553,10,261,204,367,271,571,2128,4614,7,32445,1802,1,2,1,1,0
18198,112,5710,1782,648,1425,9,47,279,1791,8,171,97,189,179,286,1292,2140,4,9462,525,0,2,1,1,0
18199,23,601,102,59,69,5,3,24,107,6,22,15,28,28,43,113,206,3,789,43,0,2,2,2,0
18200,213,4595,182,127,129,0,0,53,182,5,39,21,42,44,63,217,343,2,926,51,0,2,1,1,1
18201,213,4595,1165,710,800,67,119,181,1232,18,243,153,282,261,435,2000,3492,10,36473,2026,1,2,1,1,1
18202,147,6814,1392,870,1177,35,17,170,1427,14,494,280,531,508,811,4473,7289,7,54850,3047,2,2,1,1,1
18203,109,4106,1450,624,1228,12,26,181,1462,14,306,186,354,320,540,2580,4493,8,36391,2021,1,2,1,1,1
18204,150,4203,1660,832,1314,41,38,274,1701,20,312,209,395,332,604,2671,5058,12,64042,3557,1,2,9,9,0
18205,227,5129,4293,999,3693,19,54,507,4312,9,155,88,170,164,258,1156,1898,4,9368,520,0,2,1,1,1
18206,227,5129,1482,859,1002,125,135,219,1607,16,219,134,251,235,385,1766,3032,9,27804,1544,1,2,1,1,1
18207,212,5047,722,423,573,19,0,135,741,12,172,101,199,184,300,1320,2257,6,15668,870,0,2,1,1,1
18208,212,5047,1508,847,911,44,250,301,1552,14,148,88,169,162,257,1120,1886,7,15077,837,0,2,1,1,1
18209,19,408,601,196,481,2,23,85,603,8,63,36,72,71,108,400,664,4,3036,168,0,2,1,1,1
18210,19,408,156,79,106,5,16,28,161,5,14,8,15,19,23,64,97,2,261,14,0,2,1,1,1
18211,147,6814,1392,870,1177,35,17,170,1427,14,494,280,531,508,811,4473,7289,7,54850,3047,2,2,10,10,1
18212,213,4595,182,127,129,0,0,53,182,5,39,21,42,44,63,217,343,2,926,51,0,2,2,2,0
18213,213,4595,1165,710,800,67,119,181,1232,18,243,153,282,261,435,2000,3492,10,36473,2026,1,2,2,2,0
18214,99,2081,773,419,590,28,0,166,801,10,204,113,217,214,330,1598,2554,5,13587,754,0,2,1,1,0
18215,99,2081,421,273,302,44,34,57,465,17,81,59,107,98,166,583,1098,11,12329,684,0,2,1,1,0
18216,349,7049,1457,730,1242,11,6,188,1468,10,292,166,329,302,495,2424,4078,5,22973,1276,1,2,1,1,0
18217,349,7049,74,35,59,1,0,14,75,3,14,7,14,17,21,58,85,1,128,7,0,2,1,1,0
18218,349,7049,245,125,200,5,7,34,250,7,30,17,34,37,51,166,265,3,1053,58,0,2,1,1,0
18219,227,5129,4293,999,3693,19,54,507,4312,9,155,88,170,164,258,1156,1898,4,9368,520,0,2,4,4,0
18220,227,5129,1482,859,1002,125,135,219,1607,16,219,134,251,235,385,1766,3032,9,27804,1544,1,2,4,4,0
18221,66,3414,1296,573,1062,40,33,157,1336,8,201,118,231,209,349,1561,2689,4,12365,686,0,2,3,3,0
18222,213,4595,182,127,129,0,0,53,182,5,39,21,42,44,63,217,343,2,926,51,0,2,7,7,1
18223,213,4595,1165,710,800,67,119,181,1232,18,243,153,282,261,435,2000,3492,10,36473,2026,1,2,7,7,1
18224,163,5080,1660,832,1314,41,38,274,1701,20,312,209,395,332,604,2671,5058,12,64042,3557,1,2,1,1,1
18225,163,5080,1057,646,719,113,100,145,1170,18,215,134,248,233,382,1740,3004,10,31186,1732,1,2,1,1,1
18226,54,1161,207,111,150,11,0,50,218,5,26,19,36,31,55,133,272,3,943,52,0,2,1,1,1
18227,54,1161,410,198,237,31,55,97,441,11,63,38,72,74,110,414,683,6,4293,238,0,2,1,1,1
18228,349,7049,1457,730,1242,11,6,188,1468,10,292,166,329,302,495,2424,4078,5,22973,1276,1,2,9,9,1
18229,349,7049,74,35,59,1,0,14,75,3,14,7,14,17,21,58,85,1,128,7,0,2,9,9,1
18230,349,7049,245,125,200,5,7,34,250,7,30,17,34,37,51,166,265,3,1053,58,0,2,9,9,1
18231,227,5129,4293,999,3693,19,54,507,4312,9,155,88,170,164,258,1156,1898,4,9368,520,0,2,2,2,1
18232,227,5129,1482,859,1002,125,135,219,1607,16,219,134,251,235,385,1766,3032,9,27804,1544,1,2,2,2,1
18233,27,954,74,35,59,1,0,14,75,3,14,7,14,17,21,58,85,1,128,7,0,2,3,3,1
18234,27,954,245,125,200,5,7,34,250,7,30,17,34,37,51,166,265,3,1053,58,0,2,3,3,1
18235,178,4130,77,34,69,0,0,8,77,3,24,16,29,27,45,114,213,1,387,21,0,2,3,3,1
18236,178,4130,712,438,573,51,9,84,763,14,102,71,128,116,199,733,1364,8,11988,666,0,2,3,3,1
18237,17,518,184,100,137,2,15,30,186,6,38,20,39,44,59,214,322,3,991,55,0,2,1,1,1
18238,17,518,103,65,74,8,5,16,111,7,17,9,17,24,26,89,119,3,417,23,0,2,1,1,1
18239,212,5047,722,423,573,19,0,135,741,12,172,101,199,184,300,1320,2257,6,15668,870,0,2,3,3,1
18240,212,5047,1508,847,911,44,250,301,1552,14,148,88,169,162,257,1120,1886,7,15077,837,0,2,3,3,1
18241,310,7160,72,33,56,0,4,12,72,1,1,1,1,2,2,0,2,0,1,0,0,2,6,6,1
18242,310,7160,1454,835,1044,76,110,219,1530,17,275,158,296,292,454,2297,3718,9,34017,1889,1,2,6,6,1
18243,127,2807,1043,504,840,53,9,147,1096,9,180,112,198,189,310,1377,2344,4,11604,644,0,2,4,4,1
18244,127,2807,383,288,292,26,6,62,409,11,65,38,67,76,105,429,656,5,3719,206,0,2,4,4,1
18245,80,3427,1289,550,1043,56,32,155,1345,10,167,93,185,177,278,1266,2075,5,11498,638,0,2,1,1,1
18246,91,3010,773,419,590,28,0,166,801,10,204,113,217,214,330,1598,2554,5,13587,754,0,2,2,2,1
18247,148,6832,139,89,101,2,0,35,141,7,54,34,62,61,96,330,569,4,2287,127,0,2,2,2,1
18248,148,6832,7,5,5,0,0,2,7,1,2,1,2,3,3,2,4,0,2,0,0,2,2,2,1
18249,109,4106,1450,624,1228,12,26,181,1462,14,306,186,354,320,540,2580,4493,8,36391,2021,1,2,5,5,1
18250,39,2355,652,304,544,16,6,88,668,6,89,51,101,95,152,591,998,3,3399,188,0,2,3,3,1
18251,40,2367,334,251,279,10,4,40,344,5,127,74,143,132,217,899,1528,2,4303,239,0,2,1,1,1
18252,35,1623,1293,570,1093,25,15,163,1318,10,195,123,241,205,364,1516,2795,6,17273,959,0,2,1,1,1
18253,71,3006,1178,367,1042,6,15,115,1184,9,94,51,95,103,146,644,976,4,4439,246,0,2,1,1,1
18254,213,4595,182,127,129,0,0,53,182,5,39,21,42,44,63,217,343,2,926,51,0,2,8,8,1
18255,213,4595,1165,710,800,67,119,181,1232,18,243,153,282,261,435,2000,3492,10,36473,2026,1,2,8,8,1
18256,99,2081,773,419,590,28,0,166,801,10,204,113,217,214,330,1598,2554,5,13587,754,0,2,7,7,1
18257,99,2081,421,273,302,44,34,57,465,17,81,59,107,98,166,583,1098,11,12329,684,0,2,7,7,1
18258,82,1800,477,336,357,30,23,73,507,16,194,134,250,210,384,1538,2962,10,30538,1696,0,2,5,5,1
18259,54,1161,207,111,150,11,0,50,218,5,26,19,36,31,55,133,272,3,943,52,0,2,1,1,1
18260,54,1161,410,198,237,31,55,97,441,11,63,38,72,74,110,414,683,6,4293,238,0,2,1,1,1
18261,349,7049,1457,730,1242,11,6,188,1468,10,292,166,329,302,495,2424,4078,5,22973,1276,1,2,1,1,1
18262,349,7049,74,35,59,1,0,14,75,3,14,7,14,17,21,58,85,1,128,7,0,2,1,1,1
18263,349,7049,245,125,200,5,7,34,250,7,30,17,34,37,51,166,265,3,1053,58,0,2,1,1,1
18264,227,5129,4293,999,3693,19,54,507,4312,9,155,88,170,164,258,1156,1898,4,9368,520,0,2,6,6,1
18265,227,5129,1482,859,1002,125,135,219,1607,16,219,134,251,235,385,1766,3032,9,27804,1544,1,2,6,6,1
18266,178,4130,77,34,69,0,0,8,77,3,24,16,29,27,45,114,213,1,387,21,0,2,1,1,1
18267,178,4130,712,438,573,51,9,84,763,14,102,71,128,116,199,733,1364,8,11988,666,0,2,1,1,1
18268,212,5047,722,423,573,19,0,135,741,12,172,101,199,184,300,1320,2257,6,15668,870,0,2,3,3,1
18269,212,5047,1508,847,911,44,250,301,1552,14,148,88,169,162,257,1120,1886,7,15077,837,0,2,3,3,1
18270,310,7160,72,33,56,0,4,12,72,1,1,1,1,2,2,0,2,0,1,0,0,2,1,1,1
18271,310,7160,1454,835,1044,76,110,219,1530,17,275,158,296,292,454,2297,3718,9,34017,1889,1,2,1,1,1
18272,127,2807,1043,504,840,53,9,147,1096,9,180,112,198,189,310,1377,2344,4,11604,644,0,2,1,1,1
18273,127,2807,383,288,292,26,6,62,409,11,65,38,67,76,105,429,656,5,3719,206,0,2,1,1,1
18274,80,3427,1289,550,1043,56,32,155,1345,10,167,93,185,177,278,1266,2075,5,11498,638,0,2,1,1,1
18275,147,6814,1392,870,1177,35,17,170,1427,14,494,280,531,508,811,4473,7289,7,54850,3047,2,2,5,5,1
18276,91,3010,773,419,590,28,0,166,801,10,204,113,217,214,330,1598,2554,5,13587,754,0,2,2,2,1
18277,109,4106,1450,624,1228,12,26,181,1462,14,306,186,354,320,540,2580,4493,8,36391,2021,1,2,8,8,1
18278,16,1209,215,129,180,6,0,29,221,8,65,43,72,73,115,415,711,4,3153,175,0,2,1,1,1
18279,69,2856,1043,504,840,53,9,147,1096,9,180,112,198,189,310,1377,2344,4,11604,644,0,2,1,1,1
18280,14,529,295,56,236,0,4,54,295,2,9,5,10,11,15,30,51,1,57,3,0,2,1,1,1
18281,71,3006,1178,367,1042,6,15,115,1184,9,94,51,95,103,146,644,976,4,4439,246,0,2,1,1,1
18282,99,2081,773,419,590,28,0,166,801,10,204,113,217,214,330,1598,2554,5,13587,754,0,2,2,2,1
18283,99,2081,421,273,302,44,34,57,465,17,81,59,107,98,166,583,1098,11,12329,684,0,2,2,2,1
18284,163,5080,1660,832,1314,41,38,274,1701,20,312,209,395,332,604,2671,5058,12,64042,3557,1,2,2,2,1
18285,163,5080,1057,646,719,113,100,145,1170,18,215,134,248,233,382,1740,3004,10,31186,1732,1,2,2,2,1
18286,128,2606,1513,682,1277,25,13,200,1538,11,199,116,219,210,335,1557,2584,6,15641,868,0,2,1,1,1
18287,128,2606,819,519,539,24,98,155,843,15,96,57,106,111,163,690,1107,8,9171,509,0,2,1,1,1
18288,349,7049,1457,730,1242,11,6,188,1468,10,292,166,329,302,495,2424,4078,5,22973,1276,1,2,1,1,1
18289,349,7049,74,35,59,1,0,14,75,3,14,7,14,17,21,58,85,1,128,7,0,2,1,1,1
18290,349,7049,245,125,200,5,7,34,250,7,30,17,34,37,51,166,265,3,1053,58,0,2,1,1,1
18291,227,5129,4293,999,3693,19,54,507,4312,9,155,88,170,164,258,1156,1898,4,9368,520,0,2,1,1,1
18292,227,5129,1482,859,1002,125,135,219,1607,16,219,134,251,235,385,1766,3032,9,27804,1544,1,2,1,1,1
18293,27,954,74,35,59,1,0,14,75,3,14,7,14,17,21,58,85,1,128,7,0,2,1,1,1
18294,27,954,245,125,200,5,7,34,250,7,30,17,34,37,51,166,265,3,1053,58,0,2,1,1,1
18295,310,7160,72,33,56,0,4,12,72,1,1,1,1,2,2,0,2,0,1,0,0,2,4,4,1
18296,310,7160,1454,835,1044,76,110,219,1530,17,275,158,296,292,454,2297,3718,9,34017,1889,1,2,4,4,1
18297,127,2807,1043,504,840,53,9,147,1096,9,180,112,198,189,310,1377,2344,4,11604,644,0,2,1,1,1
18298,127,2807,383,288,292,26,6,62,409,11,65,38,67,76,105,429,656,5,3719,206,0,2,1,1,1
18299,192,3908,1943,715,1694,26,18,214,1969,12,185,120,237,197,357,1436,2721,7,20915,1161,0,2,3,3,1
18300,192,3908,1168,838,957,57,25,144,1225,19,348,224,416,367,640,3018,5452,11,61921,3440,1,2,3,3,1
18301,80,3427,1289,550,1043,56,32,155,1345,10,167,93,185,177,278,1266,2075,5,11498,638,0,2,2,2,1
18302,147,6814,1392,870,1177,35,17,170,1427,14,494,280,531,508,811,4473,7289,7,54850,3047,2,2,1,1,1
18303,91,3010,773,419,590,28,0,166,801,10,204,113,217,214,330,1598,2554,5,13587,754,0,2,5,5,1
18304,47,2498,520,294,400,33,13,81,553,10,261,204,367,271,571,2128,4614,7,32445,1802,1,2,1,1,1
18305,96,4365,1338,495,1086,10,64,173,1348,11,122,82,157,133,239,883,1686,7,11934,663,0,2,4,4,1
18306,148,6832,139,89,101,2,0,35,141,7,54,34,62,61,96,330,569,4,2287,127,0,2,9,9,1
18307,148,6832,7,5,5,0,0,2,7,1,2,1,2,3,3,2,4,0,2,0,0,2,9,9,1
18308,112,5710,1782,648,1425,9,47,279,1791,8,171,97,189,179,286,1292,2140,4,9462,525,0,2,22,22,1
18309,23,601,102,59,69,5,3,24,107,6,22,15,28,28,43,113,206,3,789,43,0,2,5,5,1
18310,109,4106,1450,624,1228,12,26,181,1462,14,306,186,354,320,540,2580,4493,8,36391,2021,1,2,2,2,1
18311,150,4203,1660,832,1314,41,38,274,1701,20,312,209,395,332,604,2671,5058,12,64042,3557,1,2,1,1,1
18312,117,4645,1513,682,1277,25,13,200,1538,11,199,116,219,210,335,1557,2584,6,15641,868,0,2,1,1,1
18313,66,3414,1296,573,1062,40,33,157,1336,8,201,118,231,209,349,1561,2689,4,12365,686,0,2,3,3,1
18314,78,4093,1457,730,1242,11,6,188,1468,10,292,166,329,302,495,2424,4078,5,22973,1276,1,2,1,1,1
18315,39,2355,652,304,544,16,6,88,668,6,89,51,101,95,152,591,998,3,3399,188,0,2,1,1,1
18316,68,2962,1020,354,843,12,15,144,1032,8,134,77,144,142,221,970,1580,4,6792,377,0,2,1,1,1
18317,40,2367,334,251,279,10,4,40,344,5,127,74,143,132,217,899,1528,2,4303,239,0,2,3,3,1
18318,12,492,184,100,137,2,15,30,186,6,38,20,39,44,59,214,322,3,991,55,0,2,2,2,1
18319,69,2856,1043,504,840,53,9,147,1096,9,180,112,198,189,310,1377,2344,4,11604,644,0,2,1,1,1
18320,74,3770,1943,715,1694,26,18,214,1969,12,185,120,237,197,357,1436,2721,7,20915,1161,0,2,5,5,1
18321,212,5047,722,423,573,19,0,135,741,12,172,101,199,184,300,1320,2257,6,15668,870,0,2,4,4,0
18322,212,5047,1508,847,911,44,250,301,1552,14,148,88,169,162,257,1120,1886,7,15077,837,0,2,4,4,0
18323,39,2355,652,304,544,16,6,88,668,6,89,51,101,95,152,591,998,3,3399,188,0,2,16,16,0
18324,64,2957,1455,414,1257,16,76,112,1471,5,41,23,46,46,69,231,381,2,1069,59,0,2,3,3,0
18325,101,2081,773,419,590,28,0,166,801,10,204,113,217,214,330,1598,2554,5,13587,754,0,2,1,2,0
18326,101,2081,421,273,302,44,34,57,465,17,81,59,107,98,166,583,1098,11,12329,684,0,2,1,2,0
18327,27,954,74,35,59,1,0,14,75,3,14,7,14,17,21,58,85,1,128,7,0,2,1,1,0
18328,27,954,245,125,200,5,7,34,250,7,30,17,34,37,51,166,265,3,1053,58,0,2,1,1,0
18329,212,5047,722,423,573,19,0,135,741,12,172,101,199,184,300,1320,2257,6,15668,870,0,2,1,1,0
18330,212,5047,1508,847,911,44,250,301,1552,14,148,88,169,162,257,1120,1886,7,15077,837,0,2,1,1,0
18331,310,7160,72,33,56,0,4,12,72,1,1,1,1,2,2,0,2,0,1,0,0,2,1,2,0
18332,310,7160,1454,835,1044,76,110,219,1530,17,275,158,296,292,454,2297,3718,9,34017,1889,1,2,1,2,0
18333,78,4093,1457,730,1242,11,6,188,1468,10,292,166,329,302,495,2424,4078,5,22973,1276,1,2,1,1,0
18334,40,2367,334,251,279,10,4,40,344,5,127,74,143,132,217,899,1528,2,4303,239,0,2,1,1,0
18335,16,1209,215,129,180,6,0,29,221,8,65,43,72,73,115,415,711,4,3153,175,0,2,4,4,0
18336,71,3006,1178,367,1042,6,15,115,1184,9,94,51,95,103,146,644,976,4,4439,246,0,2,1,1,0
18337,74,3770,1943,715,1694,26,18,214,1969,12,185,120,237,197,357,1436,2721,7,20915,1161,0,2,1,1,0
18338,9,228,19,8,11,5,0,4,24,2,5,3,6,7,9,13,25,1,30,1,0,2,1,1,1
18339,9,228,102,59,69,5,3,24,107,6,22,15,28,28,43,113,206,3,789,43,0,2,1,1,1
18340,9,228,106,40,36,3,49,17,109,8,17,13,23,25,36,93,167,5,904,50,0,2,1,1,1
18341,101,2081,773,419,590,28,0,166,801,10,204,113,217,214,330,1598,2554,5,13587,754,0,2,4,4,1
18342,101,2081,421,273,302,44,34,57,465,17,81,59,107,98,166,583,1098,11,12329,684,0,2,4,4,1
18343,163,5080,1660,832,1314,41,38,274,1701,20,312,209,395,332,604,2671,5058,12,64042,3557,1,2,4,4,1
18344,163,5080,1057,646,719,113,100,145,1170,18,215,134,248,233,382,1740,3004,10,31186,1732,1,2,4,4,1
18345,128,2606,1513,682,1277,25,13,200,1538,11,199,116,219,210,335,1557,2584,6,15641,868,0,2,1,1,1
18346,128,2606,819,519,539,24,98,155,843,15,96,57,106,111,163,690,1107,8,9171,509,0,2,1,1,1
18347,349,7049,1457,730,1242,11,6,188,1468,10,292,166,329,302,495,2424,4078,5,22973,1276,1,2,4,4,1
18348,349,7049,74,35,59,1,0,14,75,3,14,7,14,17,21,58,85,1,128,7,0,2,4,4,1
18349,349,7049,245,125,200,5,7,34,250,7,30,17,34,37,51,166,265,3,1053,58,0,2,4,4,1
18350,227,5129,4293,999,3693,19,54,507,4312,9,155,88,170,164,258,1156,1898,4,9368,520,0,2,2,2,1
18351,227,5129,1482,859,1002,125,135,219,1607,16,219,134,251,235,385,1766,3032,9,27804,1544,1,2,2,2,1
18352,178,4130,77,34,69,0,0,8,77,3,24,16,29,27,45,114,213,1,387,21,0,2,3,3,1
18353,178,4130,712,438,573,51,9,84,763,14,102,71,128,116,199,733,1364,8,11988,666,0,2,3,3,1
18354,80,1581,1020,354,843,12,15,144,1032,8,134,77,144,142,221,970,1580,4,6792,377,0,2,1,1,1
18355,212,5047,722,423,573,19,0,135,741,12,172,101,199,184,300,1320,2257,6,15668,870,0,2,4,4,1
18356,212,5047,1508,847,911,44,250,301,1552,14,148,88,169,162,257,1120,1886,7,15077,837,0,2,4,4,1
18357,310,7160,72,33,56,0,4,12,72,1,1,1,1,2,2,0,2,0,1,0,0,2,1,1,1
18358,310,7160,1454,835,1044,76,110,219,1530,17,275,158,296,292,454,2297,3718,9,34017,1889,1,2,1,1,1
18359,30,649,215,129,180,6,0,29,221,8,65,43,72,73,115,415,711,4,3153,175,0,2,2,2,1
18360,30,649,97,69,77,3,3,16,100,6,22,13,23,28,36,113,173,3,542,30,0,2,2,2,1
18361,127,2807,1043,504,840,53,9,147,1096,9,180,112,198,189,310,1377,2344,4,11604,644,0,2,2,2,1
18362,127,2807,383,288,292,26,6,62,409,11,65,38,67,76,105,429,656,5,3719,206,0,2,2,2,1
18363,192,3908,1943,715,1694,26,18,214,1969,12,185,120,237,197,357,1436,2721,7,20915,1161,0,2,3,3,1
18364,192,3908,1168,838,957,57,25,144,1225,19,348,224,416,367,640,3018,5452,11,61921,3440,1,2,3,3,1
18365,80,3427,1289,550,1043,56,32,155,1345,10,167,93,185,177,278,1266,2075,5,11498,638,0,2,3,3,1
18366,147,6814,1392,870,1177,35,17,170,1427,14,494,280,531,508,811,4473,7289,7,54850,3047,2,2,6,6,1
18367,91,3010,773,419,590,28,0,166,801,10,204,113,217,214,330,1598,2554,5,13587,754,0,2,2,2,1
18368,96,4365,1338,495,1086,10,64,173,1348,11,122,82,157,133,239,883,1686,7,11934,663,0,2,2,2,1
18369,148,6832,139,89,101,2,0,35,141,7,54,34,62,61,96,330,569,4,2287,127,0,2,1,1,1
18370,148,6832,7,5,5,0,0,2,7,1,2,1,2,3,3,2,4,0,2,0,0,2,1,1,1
18371,32,948,465,148,393,5,8,60,470,4,31,20,31,35,51,161,261,2,523,29,0,2,2,2,1
18372,32,948,16,12,9,0,0,6,16,1,2,1,2,3,3,2,4,0,2,0,0,2,2,2,1
18373,109,4106,1450,624,1228,12,26,181,1462,14,306,186,354,320,540,2580,4493,8,36391,2021,1,2,1,1,1
18374,150,4203,1660,832,1314,41,38,274,1701,20,312,209,395,332,604,2671,5058,12,64042,3557,1,2,1,1,1
18375,35,1623,1293,570,1093,25,15,163,1318,10,195,123,241,205,364,1516,2795,6,17273,959,0,2,4,4,1
18376,16,1209,215,129,180,6,0,29,221,8,65,43,72,73,115,415,711,4,3153,175,0,2,1,1,1
18377,69,2856,1043,504,840,53,9,147,1096,9,180,112,198,189,310,1377,2344,4,11604,644,0,2,2,2,1
18378,25,1027,373,158,315,8,0,51,381,5,76,44,79,81,123,486,779,2,2026,112,0,2,2,2,1
18379,71,3006,1178,367,1042,6,15,115,1184,9,94,51,95,103,146,644,976,4,4439,246,0,2,1,1,1
18380,74,3770,1943,715,1694,26,18,214,1969,12,185,120,237,197,357,1436,2721,7,20915,1161,0,2,1,1,1
18381,213,4595,182,127,129,0,0,53,182,5,39,21,42,44,63,217,343,2,926,51,0,2,6,6,0
18382,213,4595,1165,710,800,67,119,181,1232,18,243,153,282,261,435,2000,3492,10,36473,2026,1,2,6,6,0
18383,101,2081,773,419,590,28,0,166,801,10,204,113,217,214,330,1598,2554,5,13587,754,0,2,1,1,0
18384,101,2081,421,273,302,44,34,57,465,17,81,59,107,98,166,583,1098,11,12329,684,0,2,1,1,0
18385,60,1265,996,429,845,24,10,117,1020,7,76,50,88,83,138,494,879,4,3565,198,0,2,1,1,0
18386,60,1265,456,277,329,12,42,72,468,13,85,50,97,98,147,592,972,7,7212,400,0,2,1,1,0
18387,128,2606,1513,682,1277,25,13,200,1538,11,199,116,219,210,335,1557,2584,6,15641,868,0,2,1,1,0
18388,128,2606,819,519,539,24,98,155,843,15,96,57,106,111,163,690,1107,8,9171,509,0,2,1,1,0
18389,54,1161,207,111,150,11,0,50,218,5,26,19,36,31,55,133,272,3,943,52,0,2,1,1,0
18390,54,1161,410,198,237,31,55,97,441,11,63,38,72,74,110,414,683,6,4293,238,0,2,1,1,0
18391,349,7049,1457,730,1242,11,6,188,1468,10,292,166,329,302,495,2424,4078,5,22973,1276,1,2,2,2,0
18392,349,7049,74,35,59,1,0,14,75,3,14,7,14,17,21,58,85,1,128,7,0,2,2,2,0
18393,349,7049,245,125,200,5,7,34,250,7,30,17,34,37,51,166,265,3,1053,58,0,2,2,2,0
18394,178,4130,77,34,69,0,0,8,77,3,24,16,29,27,45,114,213,1,387,21,0,2,2,2,0
18395,178,4130,712,438,573,51,9,84,763,14,102,71,128,116,199,733,1364,8,11988,666,0,2,2,2,0
18396,23,388,424,94,331,4,0,89,428,1,5,5,5,6,10,11,25,0,12,0,0,2,2,2,0
18397,23,388,38,23,23,6,0,8,44,3,11,7,11,14,18,42,68,1,102,5,0,2,2,2,0
18398,212,5047,722,423,573,19,0,135,741,12,172,101,199,184,300,1320,2257,6,15668,870,0,2,5,5,0
18399,212,5047,1508,847,911,44,250,301,1552,14,148,88,169,162,257,1120,1886,7,15077,837,0,2,5,5,0
18400,310,7160,72,33,56,0,4,12,72,1,1,1,1,2,2,0,2,0,1,0,0,2,3,3,0
18401,310,7160,1454,835,1044,76,110,219,1530,17,275,158,296,292,454,2297,3718,9,34017,1889,1,2,3,3,0
18402,127,2807,1043,504,840,53,9,147,1096,9,180,112,198,189,310,1377,2344,4,11604,644,0,2,1,1,0
18403,127,2807,383,288,292,26,6,62,409,11,65,38,67,76,105,429,656,5,3719,206,0,2,1,1,0
18404,103,1953,1178,367,1042,6,15,115,1184,9,94,51,95,103,146,644,976,4,4439,246,0,2,3,3,0
18405,103,1953,177,108,140,8,0,27,185,6,30,16,32,36,48,162,248,3,794,44,0,2,3,3,0
18406,192,3908,1943,715,1694,26,18,214,1969,12,185,120,237,197,357,1436,2721,7,20915,1161,0,2,4,4,0
18407,192,3908,1168,838,957,57,25,144,1225,19,348,224,416,367,640,3018,5452,11,61921,3440,1,2,4,4,0
18408,16,477,442,244,305,14,16,103,456,11,68,45,75,79,120,452,756,6,4588,254,0,2,1,1,0
18409,16,477,182,102,99,11,40,35,193,3,11,6,11,14,17,42,64,1,97,5,0,2,1,1,0
18410,80,3427,1289,550,1043,56,32,155,1345,10,167,93,185,177,278,1266,2075,5,11498,638,0,2,3,3,0
18411,147,6814,1392,870,1177,35,17,170,1427,14,494,280,531,508,811,4473,7289,7,54850,3047,2,2,5,5,0
18412,91,3010,773,419,590,28,0,166,801,10,204,113,217,214,330,1598,2554,5,13587,754,0,2,7,7,0
18413,148,6832,139,89,101,2,0,35,141,7,54,34,62,61,96,330,569,4,2287,127,0,2,1,1,0
18414,148,6832,7,5,5,0,0,2,7,1,2,1,2,3,3,2,4,0,2,0,0,2,1,1,0
18415,109,4106,1450,624,1228,12,26,181,1462,14,306,186,354,320,540,2580,4493,8,36391,2021,1,2,1,1,0
18416,117,4645,1513,682,1277,25,13,200,1538,11,199,116,219,210,335,1557,2584,6,15641,868,0,2,1,1,0
18417,66,3414,1296,573,1062,40,33,157,1336,8,201,118,231,209,349,1561,2689,4,12365,686,0,2,3,3,0
18418,39,2355,652,304,544,16,6,88,668,6,89,51,101,95,152,591,998,3,3399,188,0,2,1,1,0
18419,64,2957,1455,414,1257,16,76,112,1471,5,41,23,46,46,69,231,381,2,1069,59,0,2,1,1,0
18420,8,273,74,35,59,1,0,14,75,3,14,7,14,17,21,58,85,1,128,7,0,2,1,1,0
18421,35,1623,1293,570,1093,25,15,163,1318,10,195,123,241,205,364,1516,2795,6,17273,959,0,2,2,2,0
18422,36,1978,384,251,317,7,8,52,391,11,70,44,84,81,128,467,811,6,5355,297,0,2,3,3,0
18423,16,1209,215,129,180,6,0,29,221,8,65,43,72,73,115,415,711,4,3153,175,0,2,1,1,0
18424,69,2856,1043,504,840,53,9,147,1096,9,180,112,198,189,310,1377,2344,4,11604,644,0,2,22,22,0
18425,25,1027,373,158,315,8,0,51,381,5,76,44,79,81,123,486,779,2,2026,112,0,2,5,5,0
18426,71,3006,1178,367,1042,6,15,115,1184,9,94,51,95,103,146,644,976,4,4439,246,0,2,3,3,0
18427,74,3770,1943,715,1694,26,18,214,1969,12,185,120,237,197,357,1436,2721,7,20915,1161,0,2,3,3,0
18428,54,1161,207,111,150,11,0,50,218,5,26,19,36,31,55,133,272,3,943,52,0,2,2,2,1
18429,54,1161,410,198,237,31,55,97,441,11,63,38,72,74,110,414,683,6,4293,238,0,2,2,2,1
18430,39,2355,652,304,544,16,6,88,668,6,89,51,101,95,152,591,998,3,3399,188,0,2,3,3,1
18431,40,2367,334,251,279,10,4,40,344,5,127,74,143,132,217,899,1528,2,4303,239,0,2,1,1,1
18432,78,4093,1457,730,1242,11,6,188,1468,10,292,166,329,302,495,2424,4078,5,22973,1276,1,2,1,1,0
18433,9,228,19,8,11,5,0,4,24,2,5,3,6,7,9,13,25,1,30,1,0,2,1,0,0
18434,9,228,102,59,69,5,3,24,107,6,22,15,28,28,43,113,206,3,789,43,0,2,1,0,0
18435,9,228,106,40,36,3,49,17,109,8,17,13,23,25,36,93,167,5,904,50,0,2,1,0,0
18436,213,4595,182,127,129,0,0,53,182,5,39,21,42,44,63,217,343,2,926,51,0,2,2,0,0
18437,213,4595,1165,710,800,67,119,181,1232,18,243,153,282,261,435,2000,3492,10,36473,2026,1,2,2,0,0
18438,101,2081,773,419,590,28,0,166,801,10,204,113,217,214,330,1598,2554,5,13587,754,0,2,1,0,0
18439,101,2081,421,273,302,44,34,57,465,17,81,59,107,98,166,583,1098,11,12329,684,0,2,1,0,0
18440,60,1265,996,429,845,24,10,117,1020,7,76,50,88,83,138,494,879,4,3565,198,0,2,1,0,0
18441,60,1265,456,277,329,12,42,72,468,13,85,50,97,98,147,592,972,7,7212,400,0,2,1,0,0
18442,128,2606,1513,682,1277,25,13,200,1538,11,199,116,219,210,335,1557,2584,6,15641,868,0,2,1,0,0
18443,128,2606,819,519,539,24,98,155,843,15,96,57,106,111,163,690,1107,8,9171,509,0,2,1,0,0
18444,349,7049,1457,730,1242,11,6,188,1468,10,292,166,329,302,495,2424,4078,5,22973,1276,1,2,5,0,0
18445,349,7049,74,35,59,1,0,14,75,3,14,7,14,17,21,58,85,1,128,7,0,2,5,0,0
18446,349,7049,245,125,200,5,7,34,250,7,30,17,34,37,51,166,265,3,1053,58,0,2,5,0,0
18447,227,5129,4293,999,3693,19,54,507,4312,9,155,88,170,164,258,1156,1898,4,9368,520,0,2,3,0,0
18448,227,5129,1482,859,1002,125,135,219,1607,16,219,134,251,235,385,1766,3032,9,27804,1544,1,2,3,0,0
18449,80,1581,1020,354,843,12,15,144,1032,8,134,77,144,142,221,970,1580,4,6792,377,0,2,4,0,0
18450,212,5047,722,423,573,19,0,135,741,12,172,101,199,184,300,1320,2257,6,15668,870,0,2,2,0,0
18451,212,5047,1508,847,911,44,250,301,1552,14,148,88,169,162,257,1120,1886,7,15077,837,0,2,2,0,0
18452,310,7160,72,33,56,0,4,12,72,1,1,1,1,2,2,0,2,0,1,0,0,2,3,0,0
18453,310,7160,1454,835,1044,76,110,219,1530,17,275,158,296,292,454,2297,3718,9,34017,1889,1,2,3,0,0
18454,127,2807,1043,504,840,53,9,147,1096,9,180,112,198,189,310,1377,2344,4,11604,644,0,2,7,0,0
18455,127,2807,383,288,292,26,6,62,409,11,65,38,67,76,105,429,656,5,3719,206,0,2,7,0,0
18456,192,3908,1943,715,1694,26,18,214,1969,12,185,120,237,197,357,1436,2721,7,20915,1161,0,2,1,0,0
18457,192,3908,1168,838,957,57,25,144,1225,19,348,224,416,367,640,3018,5452,11,61921,3440,1,2,1,0,0
18458,80,3427,1289,550,1043,56,32,155,1345,10,167,93,185,177,278,1266,2075,5,11498,638,0,2,1,0,0
18459,147,6814,1392,870,1177,35,17,170,1427,14,494,280,531,508,811,4473,7289,7,54850,3047,2,2,5,0,0
18460,91,3010,773,419,590,28,0,166,801,10,204,113,217,214,330,1598,2554,5,13587,754,0,2,1,0,0
18461,112,5710,1782,648,1425,9,47,279,1791,8,171,97,189,179,286,1292,2140,4,9462,525,0,2,1,0,0
18462,23,601,102,59,69,5,3,24,107,6,22,15,28,28,43,113,206,3,789,43,0,2,1,0,0
18463,15,638,722,423,573,19,0,135,741,12,172,101,199,184,300,1320,2257,6,15668,870,0,2,1,0,0
18464,74,3770,1943,715,1694,26,18,214,1969,12,185,120,237,197,357,1436,2721,7,20915,1161,0,2,1,0,0
18465,9,228,19,8,11,5,0,4,24,2,5,3,6,7,9,13,25,1,30,1,0,2,1,0,0
18466,9,228,102,59,69,5,3,24,107,6,22,15,28,28,43,113,206,3,789,43,0,2,1,0,0
18467,9,228,106,40,36,3,49,17,109,8,17,13,23,25,36,93,167,5,904,50,0,2,1,0,0
18468,213,4595,182,127,129,0,0,53,182,5,39,21,42,44,63,217,343,2,926,51,0,2,11,0,0
18469,213,4595,1165,710,800,67,119,181,1232,18,243,153,282,261,435,2000,3492,10,36473,2026,1,2,11,0,0
18470,101,2081,773,419,590,28,0,166,801,10,204,113,217,214,330,1598,2554,5,13587,754,0,2,2,0,0
18471,101,2081,421,273,302,44,34,57,465,17,81,59,107,98,166,583,1098,11,12329,684,0,2,2,0,0
18472,163,5080,1660,832,1314,41,38,274,1701,20,312,209,395,332,604,2671,5058,12,64042,3557,1,2,7,0,0
18473,163,5080,1057,646,719,113,100,145,1170,18,215,134,248,233,382,1740,3004,10,31186,1732,1,2,7,0,0
18474,128,2606,1513,682,1277,25,13,200,1538,11,199,116,219,210,335,1557,2584,6,15641,868,0,2,3,0,0
18475,128,2606,819,519,539,24,98,155,843,15,96,57,106,111,163,690,1107,8,9171,509,0,2,3,0,0
18476,54,1161,207,111,150,11,0,50,218,5,26,19,36,31,55,133,272,3,943,52,0,2,1,0,0
18477,54,1161,410,198,237,31,55,97,441,11,63,38,72,74,110,414,683,6,4293,238,0,2,1,0,0
18478,349,7049,1457,730,1242,11,6,188,1468,10,292,166,329,302,495,2424,4078,5,22973,1276,1,2,8,0,0
18479,349,7049,74,35,59,1,0,14,75,3,14,7,14,17,21,58,85,1,128,7,0,2,8,0,0
18480,349,7049,245,125,200,5,7,34,250,7,30,17,34,37,51,166,265,3,1053,58,0,2,8,0,0
18481,21,662,339,213,244,17,9,65,356,10,42,26,48,52,74,259,421,5,2410,133,0,2,1,0,0
18482,60,1673,1455,414,1257,16,76,112,1471,5,41,23,46,46,69,231,381,2,1069,59,0,2,2,0,0
18483,60,1673,669,365,481,22,61,110,691,15,103,63,122,118,185,747,1273,8,11311,628,0,2,2,0,0
18484,227,5129,4293,999,3693,19,54,507,4312,9,155,88,170,164,258,1156,1898,4,9368,520,0,2,5,0,0
18485,227,5129,1482,859,1002,125,135,219,1607,16,219,134,251,235,385,1766,3032,9,27804,1544,1,2,5,0,0
18486,27,954,74,35,59,1,0,14,75,3,14,7,14,17,21,58,85,1,128,7,0,2,4,0,0
18487,27,954,245,125,200,5,7,34,250,7,30,17,34,37,51,166,265,3,1053,58,0,2,4,0,0
18488,49,575,647,139,84,35,284,233,682,0,0,0,0,0,0,0,0,0,0,0,0,2,45,0,0
18489,178,4130,77,34,69,0,0,8,77,3,24,16,29,27,45,114,213,1,387,21,0,2,8,0,0
18490,178,4130,712,438,573,51,9,84,763,14,102,71,128,116,199,733,1364,8,11988,666,0,2,8,0,0
18491,80,1581,1020,354,843,12,15,144,1032,8,134,77,144,142,221,970,1580,4,6792,377,0,2,1,0,0
18492,23,388,424,94,331,4,0,89,428,1,5,5,5,6,10,11,25,0,12,0,0,2,1,0,0
18493,23,388,38,23,23,6,0,8,44,3,11,7,11,14,18,42,68,1,102,5,0,2,1,0,0
18494,212,5047,722,423,573,19,0,135,741,12,172,101,199,184,300,1320,2257,6,15668,870,0,2,8,0,0
18495,212,5047,1508,847,911,44,250,301,1552,14,148,88,169,162,257,1120,1886,7,15077,837,0,2,8,0,0
18496,310,7160,72,33,56,0,4,12,72,1,1,1,1,2,2,0,2,0,1,0,0,2,8,0,0
18497,310,7160,1454,835,1044,76,110,219,1530,17,275,158,296,292,454,2297,3718,9,34017,1889,1,2,8,0,0
18498,30,649,215,129,180,6,0,29,221,8,65,43,72,73,115,415,711,4,3153,175,0,2,5,0,0
18499,30,649,97,69,77,3,3,16,100,6,22,13,23,28,36,113,173,3,542,30,0,2,5,0,0
18500,127,2807,1043,504,840,53,9,147,1096,9,180,112,198,189,310,1377,2344,4,11604,644,0,2,26,1,0
18501,127,2807,383,288,292,26,6,62,409,11,65,38,67,76,105,429,656,5,3719,206,0,2,26,1,0
18502,103,1953,1178,367,1042,6,15,115,1184,9,94,51,95,103,146,644,976,4,4439,246,0,2,5,0,0
18503,103,1953,177,108,140,8,0,27,185,6,30,16,32,36,48,162,248,3,794,44,0,2,5,0,0
18504,192,3908,1943,715,1694,26,18,214,1969,12,185,120,237,197,357,1436,2721,7,20915,1161,0,2,6,0,0
18505,192,3908,1168,838,957,57,25,144,1225,19,348,224,416,367,640,3018,5452,11,61921,3440,1,2,6,0,0
18506,34,997,182,127,129,0,0,53,182,5,39,21,42,44,63,217,343,2,926,51,0,2,8,0,0
18507,147,6814,1392,870,1177,35,17,170,1427,14,494,280,531,508,811,4473,7289,7,54850,3047,2,2,20,0,0
18508,91,3010,773,419,590,28,0,166,801,10,204,113,217,214,330,1598,2554,5,13587,754,0,2,37,0,0
18509,2,26,6,4,4,0,0,2,6,1,4,2,4,5,6,8,13,0,6,0,0,2,1,0,0
18510,96,4365,1338,495,1086,10,64,173,1348,11,122,82,157,133,239,883,1686,7,11934,663,0,2,3,0,0
18511,148,6832,139,89,101,2,0,35,141,7,54,34,62,61,96,330,569,4,2287,127,0,2,8,0,0
18512,148,6832,7,5,5,0,0,2,7,1,2,1,2,3,3,2,4,0,2,0,0,2,8,0,0
18513,32,948,465,148,393,5,8,60,470,4,31,20,31,35,51,161,261,2,523,29,0,2,2,0,0
18514,32,948,16,12,9,0,0,6,16,1,2,1,2,3,3,2,4,0,2,0,0,2,2,0,0
18515,23,601,102,59,69,5,3,24,107,6,22,15,28,28,43,113,206,3,789,43,0,2,5,0,0
18516,109,4106,1450,624,1228,12,26,181,1462,14,306,186,354,320,540,2580,4493,8,36391,2021,1,2,17,0,0
18517,150,4203,1660,832,1314,41,38,274,1701,20,312,209,395,332,604,2671,5058,12,64042,3557,1,2,2,0,0
18518,117,4645,1513,682,1277,25,13,200,1538,11,199,116,219,210,335,1557,2584,6,15641,868,0,2,5,0,0
18519,66,3414,1296,573,1062,40,33,157,1336,8,201,118,231,209,349,1561,2689,4,12365,686,0,2,6,0,0
18520,78,4093,1457,730,1242,11,6,188,1468,10,292,166,329,302,495,2424,4078,5,22973,1276,1,2,7,0,0
18521,39,2355,652,304,544,16,6,88,668,6,89,51,101,95,152,591,998,3,3399,188,0,2,15,0,0
18522,8,273,74,35,59,1,0,14,75,3,14,7,14,17,21,58,85,1,128,7,0,2,7,0,0
18523,90,4427,1523,757,1297,19,12,193,1542,12,193,117,230,205,347,1508,2664,7,19053,1058,0,2,3,0,0
18524,68,2962,1020,354,843,12,15,144,1032,8,134,77,144,142,221,970,1580,4,6792,377,0,2,7,0,0
18525,37,1624,447,308,343,6,5,95,453,7,96,59,111,103,170,651,1136,4,4600,255,0,2,1,0,0
18526,21,661,424,94,331,4,0,89,428,1,5,5,5,6,10,11,25,0,12,0,0,2,10,0,0
18527,40,2367,334,251,279,10,4,40,344,5,127,74,143,132,217,899,1528,2,4303,239,0,2,2,0,0
18528,12,492,184,100,137,2,15,30,186,6,38,20,39,44,59,214,322,3,991,55,0,2,1,0,0
18529,36,1978,384,251,317,7,8,52,391,11,70,44,84,81,128,467,811,6,5355,297,0,2,2,0,0
18530,15,638,722,423,573,19,0,135,741,12,172,101,199,184,300,1320,2257,6,15668,870,0,2,3,0,0
18531,16,1209,215,129,180,6,0,29,221,8,65,43,72,73,115,415,711,4,3153,175,0,2,2,0,0
18532,69,2856,1043,504,840,53,9,147,1096,9,180,112,198,189,310,1377,2344,4,11604,644,0,2,15,0,0
18533,14,529,295,56,236,0,4,54,295,2,9,5,10,11,15,30,51,1,57,3,0,2,12,0,0
18534,25,1027,373,158,315,8,0,51,381,5,76,44,79,81,123,486,779,2,2026,112,0,2,5,0,0
18535,71,3006,1178,367,1042,6,15,115,1184,9,94,51,95,103,146,644,976,4,4439,246,0,2,12,0,0
18536,74,3770,1943,715,1694,26,18,214,1969,12,185,120,237,197,357,1436,2721,7,20915,1161,0,2,13,0,0
18537,14,825,442,244,305,14,16,103,456,11,68,45,75,79,120,452,756,6,4588,254,0,2,5,0,0
18538,48,1784,1098,241,925,5,10,155,1103,7,46,25,49,53,74,273,423,3,1580,87,0,2,23,0,0
18539,12,476,601,196,481,2,23,85,603,8,63,36,72,71,108,400,664,4,3036,168,0,2,1,0,0
18540,27,542,2,2,2,0,0,0,2,0,0,0,0,0,0,0,0,0,0,0,0,2,0,1,0
18541,27,542,99,48,90,1,3,5,100,0,0,0,0,0,0,0,0,0,0,0,0,2,0,1,0
18542,27,542,8,5,5,2,0,1,10,0,0,0,0,0,0,0,0,0,0,0,0,2,0,1,0
18543,27,542,1217,716,841,84,126,174,1301,14,185,118,215,199,333,1446,2542,8,20687,1149,0,2,0,1,0
18544,27,542,160,89,115,0,13,31,160,7,15,11,17,22,28,78,124,3,495,27,0,2,0,1,0
18545,27,542,10,10,9,9,0,0,19,0,0,0,0,0,0,0,0,0,0,0,0,2,0,1,0
18546,27,542,173,84,99,8,29,36,181,5,12,7,13,17,20,54,81,2,221,12,0,2,0,1,0
18547,27,542,3,1,1,3,0,0,6,0,0,0,0,0,0,0,0,0,0,0,0,2,0,1,0
18548,163,5080,1660,832,1314,41,38,274,1701,20,312,209,395,332,604,2671,5058,12,64042,3557,1,2,0,3,0
18549,163,5080,1057,646,719,113,100,145,1170,18,215,134,248,233,382,1740,3004,10,31186,1732,1,2,0,3,0
18550,60,1265,996,429,845,24,10,117,1020,7,76,50,88,83,138,494,879,4,3565,198,0,2,0,1,0
18551,60,1265,456,277,329,12,42,72,468,13,85,50,97,98,147,592,972,7,7212,400,0,2,0,1,0
18552,54,1161,207,111,150,11,0,50,218,5,26,19,36,31,55,133,272,3,943,52,0,2,0,2,0
18553,54,1161,410,198,237,31,55,97,441,11,63,38,72,74,110,414,683,6,4293,238,0,2,0,2,0
18554,349,7049,1457,730,1242,11,6,188,1468,10,292,166,329,302,495,2424,4078,5,22973,1276,1,2,0,1,0
18555,349,7049,74,35,59,1,0,14,75,3,14,7,14,17,21,58,85,1,128,7,0,2,0,1,0
18556,349,7049,245,125,200,5,7,34,250,7,30,17,34,37,51,166,265,3,1053,58,0,2,0,1,0
18557,21,662,339,213,244,17,9,65,356,10,42,26,48,52,74,259,421,5,2410,133,0,2,0,1,0
18558,227,5129,4293,999,3693,19,54,507,4312,9,155,88,170,164,258,1156,1898,4,9368,520,0,2,0,7,0
18559,227,5129,1482,859,1002,125,135,219,1607,16,219,134,251,235,385,1766,3032,9,27804,1544,1,2,0,7,0
18560,6,136,44,22,19,0,19,6,44,2,10,6,12,12,18,35,64,1,77,4,0,2,0,1,0
18561,178,4130,77,34,69,0,0,8,77,3,24,16,29,27,45,114,213,1,387,21,0,2,0,2,0
18562,178,4130,712,438,573,51,9,84,763,14,102,71,128,116,199,733,1364,8,11988,666,0,2,0,2,0
18563,80,1581,1020,354,843,12,15,144,1032,8,134,77,144,142,221,970,1580,4,6792,377,0,2,0,4,0
18564,212,5047,722,423,573,19,0,135,741,12,172,101,199,184,300,1320,2257,6,15668,870,0,2,0,1,0
18565,212,5047,1508,847,911,44,250,301,1552,14,148,88,169,162,257,1120,1886,7,15077,837,0,2,0,1,0
18566,310,7160,72,33,56,0,4,12,72,1,1,1,1,2,2,0,2,0,1,0,0,2,0,2,0
18567,310,7160,1454,835,1044,76,110,219,1530,17,275,158,296,292,454,2297,3718,9,34017,1889,1,2,0,2,0
18568,192,3908,1943,715,1694,26,18,214,1969,12,185,120,237,197,357,1436,2721,7,20915,1161,0,2,0,1,0
18569,192,3908,1168,838,957,57,25,144,1225,19,348,224,416,367,640,3018,5452,11,61921,3440,1,2,0,1,0
18570,80,3427,1289,550,1043,56,32,155,1345,10,167,93,185,177,278,1266,2075,5,11498,638,0,2,0,3,0
18571,147,6814,1392,870,1177,35,17,170,1427,14,494,280,531,508,811,4473,7289,7,54850,3047,2,2,0,3,0
18572,91,3010,773,419,590,28,0,166,801,10,204,113,217,214,330,1598,2554,5,13587,754,0,2,0,1,0
18573,96,4365,1338,495,1086,10,64,173,1348,11,122,82,157,133,239,883,1686,7,11934,663,0,2,0,4,0
18574,148,6832,139,89,101,2,0,35,141,7,54,34,62,61,96,330,569,4,2287,127,0,2,0,8,0
18575,148,6832,7,5,5,0,0,2,7,1,2,1,2,3,3,2,4,0,2,0,0,2,0,8,0
18576,112,5710,1782,648,1425,9,47,279,1791,8,171,97,189,179,286,1292,2140,4,9462,525,0,2,0,5,0
18577,20,541,256,139,192,9,7,47,265,4,23,12,24,27,36,112,171,2,357,19,0,2,0,1,0
18578,117,4645,1513,682,1277,25,13,200,1538,11,199,116,219,210,335,1557,2584,6,15641,868,0,2,0,2,0
18579,66,3414,1296,573,1062,40,33,157,1336,8,201,118,231,209,349,1561,2689,4,12365,686,0,2,0,1,0
18580,78,4093,1457,730,1242,11,6,188,1468,10,292,166,329,302,495,2424,4078,5,22973,1276,1,2,0,1,0
18581,64,2957,1455,414,1257,16,76,112,1471,5,41,23,46,46,69,231,381,2,1069,59,0,2,0,1,0
18582,68,2962,1020,354,843,12,15,144,1032,8,134,77,144,142,221,970,1580,4,6792,377,0,2,0,2,0
18583,35,1623,1293,570,1093,25,15,163,1318,10,195,123,241,205,364,1516,2795,6,17273,959,0,2,0,2,0
18584,38,1637,386,256,301,16,9,68,402,4,59,35,69,63,104,355,621,2,1453,80,0,2,0,1,0
18585,71,3006,1178,367,1042,6,15,115,1184,9,94,51,95,103,146,644,976,4,4439,246,0,2,0,1,0
18586,74,3770,1943,715,1694,26,18,214,1969,12,185,120,237,197,357,1436,2721,7,20915,1161,0,2,0,1,0
18587,12,476,601,196,481,2,23,85,603,8,63,36,72,71,108,400,664,4,3036,168,0,2,0,1,0
18588,101,2081,773,419,590,28,0,166,801,10,204,113,217,214,330,1598,2554,5,13587,754,0,2,2,1,0
18589,101,2081,421,273,302,44,34,57,465,17,81,59,107,98,166,583,1098,11,12329,684,0,2,2,1,0
18590,27,954,74,35,59,1,0,14,75,3,14,7,14,17,21,58,85,1,128,7,0,2,2,1,0
18591,27,954,245,125,200,5,7,34,250,7,30,17,34,37,51,166,265,3,1053,58,0,2,2,1,0
18592,23,601,102,59,69,5,3,24,107,6,22,15,28,28,43,113,206,3,789,43,0,2,2,1,0
18593,66,3414,1296,573,1062,40,33,157,1336,8,201,118,231,209,349,1561,2689,4,12365,686,0,2,2,1,0
18594,78,4093,1457,730,1242,11,6,188,1468,10,292,166,329,302,495,2424,4078,5,22973,1276,1,2,2,1,0
18595,40,2367,334,251,279,10,4,40,344,5,127,74,143,132,217,899,1528,2,4303,239,0,2,2,1,0
18596,147,6812,1392,870,1177,35,17,170,1427,14,494,280,531,508,811,4473,7289,7,54850,3047,2,2,4,4,0
18597,150,4203,1660,832,1314,41,38,274,1701,20,312,209,395,332,604,2671,5058,12,64042,3557,1,2,6,6,0
18598,349,7049,1457,730,1242,11,6,188,1468,10,292,166,329,302,495,2424,4078,5,22973,1276,1,2,2,1,1
18599,349,7049,74,35,59,1,0,14,75,3,14,7,14,17,21,58,85,1,128,7,0,2,2,1,1
18600,349,7049,245,125,200,5,7,34,250,7,30,17,34,37,51,166,265,3,1053,58,0,2,2,1,1
18601,178,4132,77,34,69,0,0,8,77,3,24,16,29,27,45,114,213,1,387,21,0,2,4,2,1
18602,178,4132,712,438,573,51,9,84,763,14,102,71,128,116,199,733,1364,8,11988,666,0,2,4,2,1
18603,47,2498,520,294,400,33,13,81,553,10,261,204,367,271,571,2128,4614,7,32445,1802,1,2,2,1,1
18604,112,5711,1782,648,1425,9,47,279,1791,8,171,97,189,179,286,1292,2140,4,9462,525,0,2,21,5,1
18605,34,997,182,127,129,0,0,53,182,5,39,21,42,44,63,217,343,2,926,51,0,2,10,6,1
18606,147,6812,1392,870,1177,35,17,170,1427,14,494,280,531,508,811,4473,7289,7,54850,3047,2,2,4,2,1
18607,114,5711,1782,648,1425,9,47,279,1791,8,171,97,189,179,286,1292,2140,4,9462,525,0,2,4,2,1
18608,38,1637,386,256,301,16,9,68,402,4,59,35,69,63,104,355,621,2,1453,80,0,2,4,2,1
18609,10,228,19,8,11,5,0,4,24,2,5,3,6,7,9,13,25,1,30,1,0,2,2,1,1
18610,10,228,102,59,69,5,3,24,107,6,22,15,28,28,43,113,206,3,789,43,0,2,2,1,1
18611,10,228,106,40,36,3,49,17,109,8,17,13,23,25,36,93,167,5,904,50,0,2,2,1,1
18612,153,6832,139,89,101,2,0,35,141,7,54,34,62,61,96,330,569,4,2287,127,0,2,10,5,1
18613,153,6832,7,5,5,0,0,2,7,1,2,1,2,3,3,2,4,0,2,0,0,2,10,5,1
18614,132,5711,1782,648,1425,9,47,279,1791,8,171,97,189,179,286,1292,2140,4,9462,525,0,2,48,24,1
18615,72,2856,1043,504,840,53,9,147,1096,9,180,112,198,189,310,1377,2344,4,11604,644,0,2,10,5,1
18616,227,5129,4293,999,3693,19,54,507,4312,9,155,88,170,164,258,1156,1898,4,9368,520,0,2,1,1,0
18617,227,5129,1482,859,1002,125,135,219,1607,16,219,134,251,235,385,1766,3032,9,27804,1544,1,2,1,1,0
18618,40,2367,334,251,279,10,4,40,344,5,127,74,143,132,217,899,1528,2,4303,239,0,2,4,4,0
18619,102,2083,773,419,590,28,0,166,801,10,204,113,217,214,330,1598,2554,5,13587,754,0,2,2,1,0
18620,102,2083,421,273,302,44,34,57,465,17,81,59,107,98,166,583,1098,11,12329,684,0,2,2,1,0
18621,164,5082,1660,832,1314,41,38,274,1701,20,312,209,395,332,604,2671,5058,12,64042,3557,1,2,2,1,0
18622,164,5082,1057,646,719,113,100,145,1170,18,215,134,248,233,382,1740,3004,10,31186,1732,1,2,2,1,0
18623,86,1808,477,336,357,30,23,73,507,16,194,134,250,210,384,1538,2962,10,30538,1696,0,2,11,5,0
18624,312,7164,72,33,56,0,4,12,72,1,1,1,1,2,2,0,2,0,1,0,0,2,6,2,0
18625,312,7164,1454,835,1044,76,110,219,1530,17,275,158,296,292,454,2297,3718,9,34017,1889,1,2,6,2,0
18626,26,1029,373,158,315,8,0,51,381,5,76,44,79,81,123,486,779,2,2026,112,0,2,4,1,0
18627,339,7202,72,33,56,0,4,12,72,1,1,1,1,2,2,0,2,0,1,0,0,2,20,6,0
18628,339,7202,1454,835,1044,76,110,219,1530,17,275,158,296,292,454,2297,3718,9,34017,1889,1,2,20,6,0
18629,151,6958,139,89,101,2,0,35,141,7,54,34,62,61,96,330,569,4,2287,127,0,2,61,4,0
18630,151,6958,7,5,5,0,0,2,7,1,2,1,2,3,3,2,4,0,2,0,0,2,61,4,0
18631,10,228,19,8,11,5,0,4,24,2,5,3,6,7,9,13,25,1,30,1,0,2,5,2,0
18632,10,228,102,59,69,5,3,24,107,6,22,15,28,28,43,113,206,3,789,43,0,2,5,2,0
18633,10,228,106,40,36,3,49,17,109,8,17,13,23,25,36,93,167,5,904,50,0,2,5,2,0
18634,213,4595,182,127,129,0,0,53,182,5,39,21,42,44,63,217,343,2,926,51,0,2,41,28,0
18635,213,4595,1165,710,800,67,119,181,1232,18,243,153,282,261,435,2000,3492,10,36473,2026,1,2,41,28,0
18636,102,2083,773,419,590,28,0,166,801,10,204,113,217,214,330,1598,2554,5,13587,754,0,2,24,22,0
18637,102,2083,421,273,302,44,34,57,465,17,81,59,107,98,166,583,1098,11,12329,684,0,2,24,22,0
18638,27,542,2,2,2,0,0,0,2,0,0,0,0,0,0,0,0,0,0,0,0,2,0,1,0
18639,27,542,99,48,90,1,3,5,100,0,0,0,0,0,0,0,0,0,0,0,0,2,0,1,0
18640,27,542,8,5,5,2,0,1,10,0,0,0,0,0,0,0,0,0,0,0,0,2,0,1,0
18641,27,542,1217,716,841,84,126,174,1301,14,185,118,215,199,333,1446,2542,8,20687,1149,0,2,0,1,0
18642,27,542,160,89,115,0,13,31,160,7,15,11,17,22,28,78,124,3,495,27,0,2,0,1,0
18643,27,542,10,10,9,9,0,0,19,0,0,0,0,0,0,0,0,0,0,0,0,2,0,1,0
18644,27,542,173,84,99,8,29,36,181,5,12,7,13,17,20,54,81,2,221,12,0,2,0,1,0
18645,27,542,3,1,1,3,0,0,6,0,0,0,0,0,0,0,0,0,0,0,0,2,0,1,0
18646,164,5082,1660,832,1314,41,38,274,1701,20,312,209,395,332,604,2671,5058,12,64042,3557,1,2,17,12,0
18647,164,5082,1057,646,719,113,100,145,1170,18,215,134,248,233,382,1740,3004,10,31186,1732,1,2,17,12,0
18648,86,1808,477,336,357,30,23,73,507,16,194,134,250,210,384,1538,2962,10,30538,1696,0,2,16,10,0
18649,62,1345,996,429,845,24,10,117,1020,7,76,50,88,83,138,494,879,4,3565,198,0,2,3,3,0
18650,62,1345,456,277,329,12,42,72,468,13,85,50,97,98,147,592,972,7,7212,400,0,2,3,3,0
18651,128,2606,1513,682,1277,25,13,200,1538,11,199,116,219,210,335,1557,2584,6,15641,868,0,2,7,3,0
18652,128,2606,819,519,539,24,98,155,843,15,96,57,106,111,163,690,1107,8,9171,509,0,2,7,3,0
18653,54,1166,207,111,150,11,0,50,218,5,26,19,36,31,55,133,272,3,943,52,0,2,7,8,0
18654,54,1166,410,198,237,31,55,97,441,11,63,38,72,74,110,414,683,6,4293,238,0,2,7,8,0
18655,349,7049,1457,730,1242,11,6,188,1468,10,292,166,329,302,495,2424,4078,5,22973,1276,1,2,54,41,0
18656,349,7049,74,35,59,1,0,14,75,3,14,7,14,17,21,58,85,1,128,7,0,2,54,41,0
18657,349,7049,245,125,200,5,7,34,250,7,30,17,34,37,51,166,265,3,1053,58,0,2,54,41,0
18658,21,662,339,213,244,17,9,65,356,10,42,26,48,52,74,259,421,5,2410,133,0,2,1,1,0
18659,60,1673,1455,414,1257,16,76,112,1471,5,41,23,46,46,69,231,381,2,1069,59,0,2,19,17,0
18660,60,1673,669,365,481,22,61,110,691,15,103,63,122,118,185,747,1273,8,11311,628,0,2,19,17,0
18661,227,5129,4293,999,3693,19,54,507,4312,9,155,88,170,164,258,1156,1898,4,9368,520,0,2,32,32,0
18662,227,5129,1482,859,1002,125,135,219,1607,16,219,134,251,235,385,1766,3032,9,27804,1544,1,2,32,32,0
18663,6,136,44,22,19,0,19,6,44,2,10,6,12,12,18,35,64,1,77,4,0,2,0,1,0
18664,27,954,74,35,59,1,0,14,75,3,14,7,14,17,21,58,85,1,128,7,0,2,25,20,0
18665,27,954,245,125,200,5,7,34,250,7,30,17,34,37,51,166,265,3,1053,58,0,2,25,20,0
18666,49,575,647,139,84,35,284,233,682,0,0,0,0,0,0,0,0,0,0,0,0,2,45,0,0
18667,83,2359,1523,757,1297,19,12,193,1542,12,193,117,230,205,347,1508,2664,7,19053,1058,0,2,6,6,0
18668,83,2359,701,378,504,33,58,109,734,13,110,68,126,123,194,794,1346,7,10027,557,0,2,6,6,0
18669,178,4132,77,34,69,0,0,8,77,3,24,16,29,27,45,114,213,1,387,21,0,2,57,34,0
18670,178,4132,712,438,573,51,9,84,763,14,102,71,128,116,199,733,1364,8,11988,666,0,2,57,34,0
18671,94,1809,1020,354,843,12,15,144,1032,8,134,77,144,142,221,970,1580,4,6792,377,0,2,6,2,0
18672,46,955,447,308,343,6,5,95,453,7,96,59,111,103,170,651,1136,4,4600,255,0,2,3,3,0
18673,46,955,322,174,179,16,74,51,338,10,41,26,46,51,72,252,408,5,2291,127,0,2,3,3,0
18674,23,388,424,94,331,4,0,89,428,1,5,5,5,6,10,11,25,0,12,0,0,2,3,2,0
18675,23,388,38,23,23,6,0,8,44,3,11,7,11,14,18,42,68,1,102,5,0,2,3,2,0
18676,17,518,184,100,137,2,15,30,186,6,38,20,39,44,59,214,322,3,991,55,0,2,4,4,0
18677,17,518,103,65,74,8,5,16,111,7,17,9,17,24,26,89,119,3,417,23,0,2,4,4,0
18678,212,5047,722,423,573,19,0,135,741,12,172,101,199,184,300,1320,2257,6,15668,870,0,2,47,38,0
18679,212,5047,1508,847,911,44,250,301,1552,14,148,88,169,162,257,1120,1886,7,15077,837,0,2,47,38,0
18680,304,7099,72,33,56,0,4,12,72,1,1,1,1,2,2,0,2,0,1,0,0,2,487,52,0
18681,304,7099,1454,835,1044,76,110,219,1530,17,275,158,296,292,454,2297,3718,9,34017,1889,1,2,487,52,0
18682,40,837,386,256,301,16,9,68,402,4,59,35,69,63,104,355,621,2,1453,80,0,2,2,2,0
18683,40,837,264,131,164,11,41,46,275,6,38,22,40,44,62,214,338,3,1068,59,0,2,2,2,0
18684,30,649,215,129,180,6,0,29,221,8,65,43,72,73,115,415,711,4,3153,175,0,2,9,4,0
18685,30,649,97,69,77,3,3,16,100,6,22,13,23,28,36,113,173,3,542,30,0,2,9,4,0
18686,127,2807,1043,504,840,53,9,147,1096,9,180,112,198,189,310,1377,2344,4,11604,644,0,2,53,21,0
18687,127,2807,383,288,292,26,6,62,409,11,65,38,67,76,105,429,656,5,3719,206,0,2,53,21,0
18688,103,1953,1178,367,1042,6,15,115,1184,9,94,51,95,103,146,644,976,4,4439,246,0,2,29,24,0
18689,103,1953,177,108,140,8,0,27,185,6,30,16,32,36,48,162,248,3,794,44,0,2,29,24,0
18690,192,3908,1943,715,1694,26,18,214,1969,12,185,120,237,197,357,1436,2721,7,20915,1161,0,2,38,29,0
18691,192,3908,1168,838,957,57,25,144,1225,19,348,224,416,367,640,3018,5452,11,61921,3440,1,2,38,29,0
18692,16,477,442,244,305,14,16,103,456,11,68,45,75,79,120,452,756,6,4588,254,0,2,2,2,0
18693,16,477,182,102,99,11,40,35,193,3,11,6,11,14,17,42,64,1,97,5,0,2,2,2,0
18694,62,1240,1098,241,925,5,10,155,1103,7,46,25,49,53,74,273,423,3,1580,87,0,2,3,3,0
18695,62,1240,282,202,222,14,2,44,296,8,42,24,43,50,67,250,378,4,1548,86,0,2,3,3,0
18696,19,408,601,196,481,2,23,85,603,8,63,36,72,71,108,400,664,4,3036,168,0,2,1,1,0
18697,19,408,156,79,106,5,16,28,161,5,14,8,15,19,23,64,97,2,261,14,0,2,1,1,0
18698,80,3427,1289,550,1043,56,32,155,1345,10,167,93,185,177,278,1266,2075,5,11498,638,0,2,11,13,0
18699,34,997,182,127,129,0,0,53,182,5,39,21,42,44,63,217,343,2,926,51,0,2,18,6,0
18700,147,6812,1392,870,1177,35,17,170,1427,14,494,280,531,508,811,4473,7289,7,54850,3047,2,2,67,43,0
18701,91,3010,773,419,590,28,0,166,801,10,204,113,217,214,330,1598,2554,5,13587,754,0,2,59,19,0
18702,7,278,75,38,59,1,3,12,76,2,4,2,4,6,6,10,15,1,15,0,0,2,4,0,0
18703,2,26,6,4,4,0,0,2,6,1,4,2,4,5,6,8,13,0,6,0,0,2,2,1,0
18704,53,3287,520,294,400,33,13,81,553,10,261,204,367,271,571,2128,4614,7,32445,1802,1,2,67,68,0
18705,98,4425,1338,495,1086,10,64,173,1348,11,122,82,157,133,239,883,1686,7,11934,663,0,2,12,13,0
18706,153,6832,139,89,101,2,0,35,141,7,54,34,62,61,96,330,569,4,2287,127,0,2,39,39,0
18707,153,6832,7,5,5,0,0,2,7,1,2,1,2,3,3,2,4,0,2,0,0,2,39,39,0
18708,32,948,465,148,393,5,8,60,470,4,31,20,31,35,51,161,261,2,523,29,0,2,5,3,0
18709,32,948,16,12,9,0,0,6,16,1,2,1,2,3,3,2,4,0,2,0,0,2,5,3,0
18710,132,5711,1782,648,1425,9,47,279,1791,8,171,97,189,179,286,1292,2140,4,9462,525,0,2,100,62,0
18711,20,541,256,139,192,9,7,47,265,4,23,12,24,27,36,112,171,2,357,19,0,2,0,1,0
18712,23,601,102,59,69,5,3,24,107,6,22,15,28,28,43,113,206,3,789,43,0,2,18,11,0
18713,109,4106,1450,624,1228,12,26,181,1462,14,306,186,354,320,540,2580,4493,8,36391,2021,1,2,41,24,0
18714,150,4203,1660,832,1314,41,38,274,1701,20,312,209,395,332,604,2671,5058,12,64042,3557,1,2,22,20,0
18715,117,4645,1513,682,1277,25,13,200,1538,11,199,116,219,210,335,1557,2584,6,15641,868,0,2,8,5,0
18716,66,3414,1296,573,1062,40,33,157,1336,8,201,118,231,209,349,1561,2689,4,12365,686,0,2,18,12,0
18717,78,4093,1457,730,1242,11,6,188,1468,10,292,166,329,302,495,2424,4078,5,22973,1276,1,2,13,7,0
18718,39,2355,652,304,544,16,6,88,668,6,89,51,101,95,152,591,998,3,3399,188,0,2,46,31,0
18719,64,2957,1455,414,1257,16,76,112,1471,5,41,23,46,46,69,231,381,2,1069,59,0,2,9,11,0
18720,8,273,74,35,59,1,0,14,75,3,14,7,14,17,21,58,85,1,128,7,0,2,8,1,0
18721,90,4427,1523,757,1297,19,12,193,1542,12,193,117,230,205,347,1508,2664,7,19053,1058,0,2,3,1,0
18722,70,3035,1020,354,843,12,15,144,1032,8,134,77,144,142,221,970,1580,4,6792,377,0,2,21,16,0
18723,37,1624,447,308,343,6,5,95,453,7,96,59,111,103,170,651,1136,4,4600,255,0,2,2,1,0
18724,21,661,424,94,331,4,0,89,428,1,5,5,5,6,10,11,25,0,12,0,0,2,10,0,0
18725,40,2367,334,251,279,10,4,40,344,5,127,74,143,132,217,899,1528,2,4303,239,0,2,16,13,0
18726,12,492,184,100,137,2,15,30,186,6,38,20,39,44,59,214,322,3,991,55,0,2,3,4,0
18727,35,1623,1293,570,1093,25,15,163,1318,10,195,123,241,205,364,1516,2795,6,17273,959,0,2,7,9,0
18728,36,1978,384,251,317,7,8,52,391,11,70,44,84,81,128,467,811,6,5355,297,0,2,7,5,0
18729,15,638,722,423,573,19,0,135,741,12,172,101,199,184,300,1320,2257,6,15668,870,0,2,4,0,0
18730,38,1637,386,256,301,16,9,68,402,4,59,35,69,63,104,355,621,2,1453,80,0,2,4,3,0
18731,16,1209,215,129,180,6,0,29,221,8,65,43,72,73,115,415,711,4,3153,175,0,2,10,10,0
18732,72,2856,1043,504,840,53,9,147,1096,9,180,112,198,189,310,1377,2344,4,11604,644,0,2,56,38,0
18733,14,529,295,56,236,0,4,54,295,2,9,5,10,11,15,30,51,1,57,3,0,2,13,1,0
18734,26,1029,373,158,315,8,0,51,381,5,76,44,79,81,123,486,779,2,2026,112,0,2,16,8,0
18735,71,3006,1178,367,1042,6,15,115,1184,9,94,51,95,103,146,644,976,4,4439,246,0,2,18,7,0
18736,74,3770,1943,715,1694,26,18,214,1969,12,185,120,237,197,357,1436,2721,7,20915,1161,0,2,34,21,0
18737,14,825,442,244,305,14,16,103,456,11,68,45,75,79,120,452,756,6,4588,254,0,2,5,0,0
18738,48,1784,1098,241,925,5,10,155,1103,7,46,25,49,53,74,273,423,3,1580,87,0,2,24,1,0
18739,12,476,601,196,481,2,23,85,603,8,63,36,72,71,108,400,664,4,3036,168,0,2,3,3,0
18740,94,1809,1020,354,843,12,15,144,1032,8,134,77,144,142,221,970,1580,4,6792,377,0,2,2,0,1
18741,304,7104,72,33,56,0,4,12,72,1,1,1,1,2,2,0,2,0,1,0,0,2,5,1,1
18742,304,7104,1454,835,1044,76,110,219,1530,17,275,158,296,292,454,2297,3718,9,34017,1889,1,2,5,1,1
18743,77,1522,757,253,292,73,244,162,830,13,61,38,67,74,105,409,651,7,4654,258,0,2,7,6,1
18744,147,6812,1392,870,1177,35,17,170,1427,14,494,280,531,508,811,4473,7289,7,54850,3047,2,2,8,8,1
18745,91,3010,773,419,590,28,0,166,801,10,204,113,217,214,330,1598,2554,5,13587,754,0,2,3,4,1
18746,53,3287,520,294,400,33,13,81,553,10,261,204,367,271,571,2128,4614,7,32445,1802,1,2,15,14,1
18747,98,4425,1338,495,1086,10,64,173,1348,11,122,82,157,133,239,883,1686,7,11934,663,0,2,1,1,1
18748,117,4645,1513,682,1277,25,13,200,1538,11,199,116,219,210,335,1557,2584,6,15641,868,0,2,13,13,1
18749,39,2355,652,304,544,16,6,88,668,6,89,51,101,95,152,591,998,3,3399,188,0,2,2,2,1
18750,70,3035,1020,354,843,12,15,144,1032,8,134,77,144,142,221,970,1580,4,6792,377,0,2,1,2,1
18751,72,2856,1043,504,840,53,9,147,1096,9,180,112,198,189,310,1377,2344,4,11604,644,0,2,2,2,1
18752,94,1795,1020,354,843,12,15,144,1032,8,134,77,144,142,221,970,1580,4,6792,377,0,2,4,4,0
18753,94,1795,1020,354,843,12,15,144,1032,8,134,77,144,142,221,970,1580,4,6792,377,0,2,4,4,0
18754,129,2875,1043,504,840,53,9,147,1096,9,180,112,198,189,310,1377,2344,4,11604,644,0,2,19,0,1
18755,129,2875,383,288,292,26,6,62,409,11,65,38,67,76,105,429,656,5,3719,206,0,2,19,0,1
18756,70,2942,1043,504,840,53,9,147,1096,9,180,112,198,189,310,1377,2344,4,11604,644,0,2,27,0,1
18757,129,2875,1043,504,840,53,9,147,1096,9,180,112,198,189,310,1377,2344,4,11604,644,0,2,19,0,0
18758,129,2875,383,288,292,26,6,62,409,11,65,38,67,76,105,429,656,5,3719,206,0,2,19,0,0
18759,70,2942,1043,504,840,53,9,147,1096,9,180,112,198,189,310,1377,2344,4,11604,644,0,2,27,0,0
18760,10,228,19,8,11,5,0,4,24,2,5,3,6,7,9,13,25,1,30,1,0,2,5,2,0
18761,10,228,102,59,69,5,3,24,107,6,22,15,28,28,43,113,206,3,789,43,0,2,5,2,0
18762,10,228,106,40,36,3,49,17,109,8,17,13,23,25,36,93,167,5,904,50,0,2,5,2,0
18763,213,4595,182,127,129,0,0,53,182,5,39,21,42,44,63,217,343,2,926,51,0,2,41,28,0
18764,213,4595,1165,710,800,67,119,181,1232,18,243,153,282,261,435,2000,3492,10,36473,2026,1,2,41,28,0
18765,102,2083,773,419,590,28,0,166,801,10,204,113,217,214,330,1598,2554,5,13587,754,0,2,24,22,0
18766,102,2083,421,273,302,44,34,57,465,17,81,59,107,98,166,583,1098,11,12329,684,0,2,24,22,0
18767,27,542,2,2,2,0,0,0,2,0,0,0,0,0,0,0,0,0,0,0,0,2,0,1,0
18768,27,542,99,48,90,1,3,5,100,0,0,0,0,0,0,0,0,0,0,0,0,2,0,1,0
18769,27,542,8,5,5,2,0,1,10,0,0,0,0,0,0,0,0,0,0,0,0,2,0,1,0
18770,27,542,1217,716,841,84,126,174,1301,14,185,118,215,199,333,1446,2542,8,20687,1149,0,2,0,1,0
18771,27,542,160,89,115,0,13,31,160,7,15,11,17,22,28,78,124,3,495,27,0,2,0,1,0
18772,27,542,10,10,9,9,0,0,19,0,0,0,0,0,0,0,0,0,0,0,0,2,0,1,0
18773,27,542,173,84,99,8,29,36,181,5,12,7,13,17,20,54,81,2,221,12,0,2,0,1,0
18774,27,542,3,1,1,3,0,0,6,0,0,0,0,0,0,0,0,0,0,0,0,2,0,1,0
18775,164,5082,1660,832,1314,41,38,274,1701,20,312,209,395,332,604,2671,5058,12,64042,3557,1,2,17,12,0
18776,164,5082,1057,646,719,113,100,145,1170,18,215,134,248,233,382,1740,3004,10,31186,1732,1,2,17,12,0
18777,86,1808,477,336,357,30,23,73,507,16,194,134,250,210,384,1538,2962,10,30538,1696,0,2,16,10,0
18778,60,1265,996,429,845,24,10,117,1020,7,76,50,88,83,138,494,879,4,3565,198,0,2,3,3,0
18779,60,1265,456,277,329,12,42,72,468,13,85,50,97,98,147,592,972,7,7212,400,0,2,3,3,0
18780,128,2606,1513,682,1277,25,13,200,1538,11,199,116,219,210,335,1557,2584,6,15641,868,0,2,7,3,0
18781,128,2606,819,519,539,24,98,155,843,15,96,57,106,111,163,690,1107,8,9171,509,0,2,7,3,0
18782,54,1161,207,111,150,11,0,50,218,5,26,19,36,31,55,133,272,3,943,52,0,2,7,8,0
18783,54,1161,410,198,237,31,55,97,441,11,63,38,72,74,110,414,683,6,4293,238,0,2,7,8,0
18784,349,7049,1457,730,1242,11,6,188,1468,10,292,166,329,302,495,2424,4078,5,22973,1276,1,2,54,41,0
18785,349,7049,74,35,59,1,0,14,75,3,14,7,14,17,21,58,85,1,128,7,0,2,54,41,0
18786,349,7049,245,125,200,5,7,34,250,7,30,17,34,37,51,166,265,3,1053,58,0,2,54,41,0
18787,21,662,339,213,244,17,9,65,356,10,42,26,48,52,74,259,421,5,2410,133,0,2,1,1,0
18788,60,1673,1455,414,1257,16,76,112,1471,5,41,23,46,46,69,231,381,2,1069,59,0,2,19,17,0
18789,60,1673,669,365,481,22,61,110,691,15,103,63,122,118,185,747,1273,8,11311,628,0,2,19,17,0
18790,227,5129,4293,999,3693,19,54,507,4312,9,155,88,170,164,258,1156,1898,4,9368,520,0,2,32,32,0
18791,227,5129,1482,859,1002,125,135,219,1607,16,219,134,251,235,385,1766,3032,9,27804,1544,1,2,32,32,0
18792,6,136,44,22,19,0,19,6,44,2,10,6,12,12,18,35,64,1,77,4,0,2,0,1,0
18793,27,954,74,35,59,1,0,14,75,3,14,7,14,17,21,58,85,1,128,7,0,2,25,20,0
18794,27,954,245,125,200,5,7,34,250,7,30,17,34,37,51,166,265,3,1053,58,0,2,25,20,0
18795,49,575,647,139,84,35,284,233,682,0,0,0,0,0,0,0,0,0,0,0,0,2,45,0,0
18796,83,2359,1523,757,1297,19,12,193,1542,12,193,117,230,205,347,1508,2664,7,19053,1058,0,2,6,6,0
18797,83,2359,701,378,504,33,58,109,734,13,110,68,126,123,194,794,1346,7,10027,557,0,2,6,6,0
18798,178,4132,77,34,69,0,0,8,77,3,24,16,29,27,45,114,213,1,387,21,0,2,42,34,0
18799,178,4132,712,438,573,51,9,84,763,14,102,71,128,116,199,733,1364,8,11988,666,0,2,42,34,0
18800,80,1581,1020,354,843,12,15,144,1032,8,134,77,144,142,221,970,1580,4,6792,377,0,2,6,5,0
18801,46,955,447,308,343,6,5,95,453,7,96,59,111,103,170,651,1136,4,4600,255,0,2,3,3,0
18802,46,955,322,174,179,16,74,51,338,10,41,26,46,51,72,252,408,5,2291,127,0,2,3,3,0
18803,23,388,424,94,331,4,0,89,428,1,5,5,5,6,10,11,25,0,12,0,0,2,3,2,0
18804,23,388,38,23,23,6,0,8,44,3,11,7,11,14,18,42,68,1,102,5,0,2,3,2,0
18805,17,518,184,100,137,2,15,30,186,6,38,20,39,44,59,214,322,3,991,55,0,2,4,4,0
18806,17,518,103,65,74,8,5,16,111,7,17,9,17,24,26,89,119,3,417,23,0,2,4,4,0
18807,212,5047,722,423,573,19,0,135,741,12,172,101,199,184,300,1320,2257,6,15668,870,0,2,47,38,0
18808,212,5047,1508,847,911,44,250,301,1552,14,148,88,169,162,257,1120,1886,7,15077,837,0,2,47,38,0
18809,315,7206,72,33,56,0,4,12,72,1,1,1,1,2,2,0,2,0,1,0,0,2,66,54,0
18810,315,7206,1454,835,1044,76,110,219,1530,17,275,158,296,292,454,2297,3718,9,34017,1889,1,2,66,54,0
18811,40,837,386,256,301,16,9,68,402,4,59,35,69,63,104,355,621,2,1453,80,0,2,2,2,0
18812,40,837,264,131,164,11,41,46,275,6,38,22,40,44,62,214,338,3,1068,59,0,2,2,2,0
18813,30,649,215,129,180,6,0,29,221,8,65,43,72,73,115,415,711,4,3153,175,0,2,9,4,0
18814,30,649,97,69,77,3,3,16,100,6,22,13,23,28,36,113,173,3,542,30,0,2,9,4,0
18815,127,2807,1043,504,840,53,9,147,1096,9,180,112,198,189,310,1377,2344,4,11604,644,0,2,53,21,0
18816,127,2807,383,288,292,26,6,62,409,11,65,38,67,76,105,429,656,5,3719,206,0,2,53,21,0
18817,103,1953,1178,367,1042,6,15,115,1184,9,94,51,95,103,146,644,976,4,4439,246,0,2,29,24,0
18818,103,1953,177,108,140,8,0,27,185,6,30,16,32,36,48,162,248,3,794,44,0,2,29,24,0
18819,192,3908,1943,715,1694,26,18,214,1969,12,185,120,237,197,357,1436,2721,7,20915,1161,0,2,35,29,0
18820,192,3908,1168,838,957,57,25,144,1225,19,348,224,416,367,640,3018,5452,11,61921,3440,1,2,35,29,0
18821,16,477,442,244,305,14,16,103,456,11,68,45,75,79,120,452,756,6,4588,254,0,2,2,2,0
18822,16,477,182,102,99,11,40,35,193,3,11,6,11,14,17,42,64,1,97,5,0,2,2,2,0
18823,62,1240,1098,241,925,5,10,155,1103,7,46,25,49,53,74,273,423,3,1580,87,0,2,3,3,0
18824,62,1240,282,202,222,14,2,44,296,8,42,24,43,50,67,250,378,4,1548,86,0,2,3,3,0
18825,19,408,601,196,481,2,23,85,603,8,63,36,72,71,108,400,664,4,3036,168,0,2,1,1,0
18826,19,408,156,79,106,5,16,28,161,5,14,8,15,19,23,64,97,2,261,14,0,2,1,1,0
18827,80,3427,1289,550,1043,56,32,155,1345,10,167,93,185,177,278,1266,2075,5,11498,638,0,2,11,13,0
18828,34,997,182,127,129,0,0,53,182,5,39,21,42,44,63,217,343,2,926,51,0,2,18,6,0
18829,147,6812,1392,870,1177,35,17,170,1427,14,494,280,531,508,811,4473,7289,7,54850,3047,2,2,67,43,0
18830,91,3010,773,419,590,28,0,166,801,10,204,113,217,214,330,1598,2554,5,13587,754,0,2,59,19,0
18831,2,26,6,4,4,0,0,2,6,1,4,2,4,5,6,8,13,0,6,0,0,2,2,1,0
18832,47,2498,520,294,400,33,13,81,553,10,261,204,367,271,571,2128,4614,7,32445,1802,1,2,80,80,0
18833,96,4365,1338,495,1086,10,64,173,1348,11,122,82,157,133,239,883,1686,7,11934,663,0,2,12,13,0
18834,156,6958,139,89,101,2,0,35,141,7,54,34,62,61,96,330,569,4,2287,127,0,2,39,39,0
18835,156,6958,7,5,5,0,0,2,7,1,2,1,2,3,3,2,4,0,2,0,0,2,39,39,0
18836,32,948,465,148,393,5,8,60,470,4,31,20,31,35,51,161,261,2,523,29,0,2,5,3,0
18837,32,948,16,12,9,0,0,6,16,1,2,1,2,3,3,2,4,0,2,0,0,2,5,3,0
18838,132,5711,1782,648,1425,9,47,279,1791,8,171,97,189,179,286,1292,2140,4,9462,525,0,2,100,62,0
18839,20,541,256,139,192,9,7,47,265,4,23,12,24,27,36,112,171,2,357,19,0,2,0,1,0
18840,23,601,102,59,69,5,3,24,107,6,22,15,28,28,43,113,206,3,789,43,0,2,18,11,0
18841,109,4106,1450,624,1228,12,26,181,1462,14,306,186,354,320,540,2580,4493,8,36391,2021,1,2,41,24,0
18842,150,4203,1660,832,1314,41,38,274,1701,20,312,209,395,332,604,2671,5058,12,64042,3557,1,2,22,20,0
18843,117,4645,1513,682,1277,25,13,200,1538,11,199,116,219,210,335,1557,2584,6,15641,868,0,2,8,5,0
18844,66,3414,1296,573,1062,40,33,157,1336,8,201,118,231,209,349,1561,2689,4,12365,686,0,2,18,12,0
18845,78,4093,1457,730,1242,11,6,188,1468,10,292,166,329,302,495,2424,4078,5,22973,1276,1,2,13,7,0
18846,39,2355,652,304,544,16,6,88,668,6,89,51,101,95,152,591,998,3,3399,188,0,2,46,31,0
18847,64,2957,1455,414,1257,16,76,112,1471,5,41,23,46,46,69,231,381,2,1069,59,0,2,9,11,0
18848,8,273,74,35,59,1,0,14,75,3,14,7,14,17,21,58,85,1,128,7,0,2,8,1,0
18849,90,4427,1523,757,1297,19,12,193,1542,12,193,117,230,205,347,1508,2664,7,19053,1058,0,2,3,1,0
18850,68,2962,1020,354,843,12,15,144,1032,8,134,77,144,142,221,970,1580,4,6792,377,0,2,21,16,0
18851,37,1624,447,308,343,6,5,95,453,7,96,59,111,103,170,651,1136,4,4600,255,0,2,2,1,0
18852,21,661,424,94,331,4,0,89,428,1,5,5,5,6,10,11,25,0,12,0,0,2,10,0,0
18853,40,2367,334,251,279,10,4,40,344,5,127,74,143,132,217,899,1528,2,4303,239,0,2,16,13,0
18854,12,492,184,100,137,2,15,30,186,6,38,20,39,44,59,214,322,3,991,55,0,2,3,4,0
18855,35,1623,1293,570,1093,25,15,163,1318,10,195,123,241,205,364,1516,2795,6,17273,959,0,2,7,9,0
18856,36,1978,384,251,317,7,8,52,391,11,70,44,84,81,128,467,811,6,5355,297,0,2,7,5,0
18857,15,638,722,423,573,19,0,135,741,12,172,101,199,184,300,1320,2257,6,15668,870,0,2,4,0,0
18858,38,1637,386,256,301,16,9,68,402,4,59,35,69,63,104,355,621,2,1453,80,0,2,4,3,0
18859,16,1209,215,129,180,6,0,29,221,8,65,43,72,73,115,415,711,4,3153,175,0,2,10,10,0
18860,72,2856,1043,504,840,53,9,147,1096,9,180,112,198,189,310,1377,2344,4,11604,644,0,2,56,38,0
18861,14,529,295,56,236,0,4,54,295,2,9,5,10,11,15,30,51,1,57,3,0,2,13,1,0
18862,26,1029,373,158,315,8,0,51,381,5,76,44,79,81,123,486,779,2,2026,112,0,2,16,8,0
18863,71,3006,1178,367,1042,6,15,115,1184,9,94,51,95,103,146,644,976,4,4439,246,0,2,18,7,0
18864,74,3770,1943,715,1694,26,18,214,1969,12,185,120,237,197,357,1436,2721,7,20915,1161,0,2,34,21,0
18865,14,825,442,244,305,14,16,103,456,11,68,45,75,79,120,452,756,6,4588,254,0,2,5,0,0
18866,48,1784,1098,241,925,5,10,155,1103,7,46,25,49,53,74,273,423,3,1580,87,0,2,24,1,0
18867,12,476,601,196,481,2,23,85,603,8,63,36,72,71,108,400,664,4,3036,168,0,2,3,3,0
18868,184,4243,77,34,69,0,0,8,77,3,24,16,29,27,45,114,213,1,387,21,0,2,18,0,0
18869,184,4243,712,438,573,51,9,84,763,14,102,71,128,116,199,733,1364,8,11988,666,0,2,18,0,0
18870,94,1795,1020,354,843,12,15,144,1032,8,134,77,144,142,221,970,1580,4,6792,377,0,2,4,4,0
18871,129,2875,1043,504,840,53,9,147,1096,9,180,112,198,189,310,1377,2344,4,11604,644,0,2,18,0,0
18872,129,2875,383,288,292,26,6,62,409,11,65,38,67,76,105,429,656,5,3719,206,0,2,18,0,0
18873,72,3755,1296,573,1062,40,33,157,1336,8,201,118,231,209,349,1561,2689,4,12365,686,0,2,48,1,0
18874,73,2942,1043,504,840,53,9,147,1096,9,180,112,198,189,310,1377,2344,4,11604,644,0,2,27,0,0
18875,91,3010,773,419,590,28,0,166,801,10,204,113,217,214,330,1598,2554,5,13587,754,0,2,2,1,0
18876,53,3320,520,294,400,33,13,81,553,10,261,204,367,271,571,2128,4614,7,32445,1802,1,2,3,1,0
18877,307,7146,72,33,56,0,4,12,72,1,1,1,1,2,2,0,2,0,1,0,0,2,20,6,0
18878,307,7146,1454,835,1044,76,110,219,1530,17,275,158,296,292,454,2297,3718,9,34017,1889,1,2,20,6,0
18879,156,6958,139,89,101,2,0,35,141,7,54,34,62,61,96,330,569,4,2287,127,0,2,61,4,0
18880,156,6958,7,5,5,0,0,2,7,1,2,1,2,3,3,2,4,0,2,0,0,2,61,4,0
18881,55,1182,207,111,150,11,0,50,218,5,26,19,36,31,55,133,272,3,943,52,0,2,10,1,0
18882,55,1182,410,198,237,31,55,97,441,11,63,38,72,74,110,414,683,6,4293,238,0,2,10,1,0
18883,118,4686,1513,682,1277,25,13,200,1538,11,199,116,219,210,335,1557,2584,6,15641,868,0,2,9,0,0
18884,10,228,19,8,11,5,0,4,24,2,5,3,6,7,9,13,25,1,30,1,0,2,5,2,0
18885,10,228,102,59,69,5,3,24,107,6,22,15,28,28,43,113,206,3,789,43,0,2,5,2,0
18886,10,228,106,40,36,3,49,17,109,8,17,13,23,25,36,93,167,5,904,50,0,2,5,2,0
18887,213,4595,182,127,129,0,0,53,182,5,39,21,42,44,63,217,343,2,926,51,0,2,41,28,0
18888,213,4595,1165,710,800,67,119,181,1232,18,243,153,282,261,435,2000,3492,10,36473,2026,1,2,41,28,0
18889,102,2083,773,419,590,28,0,166,801,10,204,113,217,214,330,1598,2554,5,13587,754,0,2,24,22,0
18890,102,2083,421,273,302,44,34,57,465,17,81,59,107,98,166,583,1098,11,12329,684,0,2,24,22,0
18891,27,542,2,2,2,0,0,0,2,0,0,0,0,0,0,0,0,0,0,0,0,2,0,1,0
18892,27,542,99,48,90,1,3,5,100,0,0,0,0,0,0,0,0,0,0,0,0,2,0,1,0
18893,27,542,8,5,5,2,0,1,10,0,0,0,0,0,0,0,0,0,0,0,0,2,0,1,0
18894,27,542,1217,716,841,84,126,174,1301,14,185,118,215,199,333,1446,2542,8,20687,1149,0,2,0,1,0
18895,27,542,160,89,115,0,13,31,160,7,15,11,17,22,28,78,124,3,495,27,0,2,0,1,0
18896,27,542,10,10,9,9,0,0,19,0,0,0,0,0,0,0,0,0,0,0,0,2,0,1,0
18897,27,542,173,84,99,8,29,36,181,5,12,7,13,17,20,54,81,2,221,12,0,2,0,1,0
18898,27,542,3,1,1,3,0,0,6,0,0,0,0,0,0,0,0,0,0,0,0,2,0,1,0
18899,164,5082,1660,832,1314,41,38,274,1701,20,312,209,395,332,604,2671,5058,12,64042,3557,1,2,17,12,0
18900,164,5082,1057,646,719,113,100,145,1170,18,215,134,248,233,382,1740,3004,10,31186,1732,1,2,17,12,0
18901,86,1808,477,336,357,30,23,73,507,16,194,134,250,210,384,1538,2962,10,30538,1696,0,2,16,10,0
18902,62,1345,996,429,845,24,10,117,1020,7,76,50,88,83,138,494,879,4,3565,198,0,2,3,3,0
18903,62,1345,456,277,329,12,42,72,468,13,85,50,97,98,147,592,972,7,7212,400,0,2,3,3,0
18904,128,2606,1513,682,1277,25,13,200,1538,11,199,116,219,210,335,1557,2584,6,15641,868,0,2,7,3,0
18905,128,2606,819,519,539,24,98,155,843,15,96,57,106,111,163,690,1107,8,9171,509,0,2,7,3,0
18906,54,1166,207,111,150,11,0,50,218,5,26,19,36,31,55,133,272,3,943,52,0,2,7,8,0
18907,54,1166,410,198,237,31,55,97,441,11,63,38,72,74,110,414,683,6,4293,238,0,2,7,8,0
18908,349,7049,1457,730,1242,11,6,188,1468,10,292,166,329,302,495,2424,4078,5,22973,1276,1,2,54,41,0
18909,349,7049,74,35,59,1,0,14,75,3,14,7,14,17,21,58,85,1,128,7,0,2,54,41,0
18910,349,7049,245,125,200,5,7,34,250,7,30,17,34,37,51,166,265,3,1053,58,0,2,54,41,0
18911,21,662,339,213,244,17,9,65,356,10,42,26,48,52,74,259,421,5,2410,133,0,2,1,1,0
18912,60,1673,1455,414,1257,16,76,112,1471,5,41,23,46,46,69,231,381,2,1069,59,0,2,19,17,0
18913,60,1673,669,365,481,22,61,110,691,15,103,63,122,118,185,747,1273,8,11311,628,0,2,19,17,0
18914,227,5129,4293,999,3693,19,54,507,4312,9,155,88,170,164,258,1156,1898,4,9368,520,0,2,32,32,0
18915,227,5129,1482,859,1002,125,135,219,1607,16,219,134,251,235,385,1766,3032,9,27804,1544,1,2,32,32,0
18916,6,136,44,22,19,0,19,6,44,2,10,6,12,12,18,35,64,1,77,4,0,2,0,1,0
18917,27,954,74,35,59,1,0,14,75,3,14,7,14,17,21,58,85,1,128,7,0,2,25,20,0
18918,27,954,245,125,200,5,7,34,250,7,30,17,34,37,51,166,265,3,1053,58,0,2,25,20,0
18919,49,575,647,139,84,35,284,233,682,0,0,0,0,0,0,0,0,0,0,0,0,2,45,0,0
18920,83,2359,1523,757,1297,19,12,193,1542,12,193,117,230,205,347,1508,2664,7,19053,1058,0,2,6,6,0
18921,83,2359,701,378,504,33,58,109,734,13,110,68,126,123,194,794,1346,7,10027,557,0,2,6,6,0
18922,184,4243,77,34,69,0,0,8,77,3,24,16,29,27,45,114,213,1,387,21,0,2,59,36,0
18923,184,4243,712,438,573,51,9,84,763,14,102,71,128,116,199,733,1364,8,11988,666,0,2,59,36,0
18924,94,1795,1020,354,843,12,15,144,1032,8,134,77,144,142,221,970,1580,4,6792,377,0,2,8,2,0
18925,46,955,447,308,343,6,5,95,453,7,96,59,111,103,170,651,1136,4,4600,255,0,2,3,3,0
18926,46,955,322,174,179,16,74,51,338,10,41,26,46,51,72,252,408,5,2291,127,0,2,3,3,0
18927,23,388,424,94,331,4,0,89,428,1,5,5,5,6,10,11,25,0,12,0,0,2,3,2,0
18928,23,388,38,23,23,6,0,8,44,3,11,7,11,14,18,42,68,1,102,5,0,2,3,2,0
18929,17,518,184,100,137,2,15,30,186,6,38,20,39,44,59,214,322,3,991,55,0,2,4,4,0
18930,17,518,103,65,74,8,5,16,111,7,17,9,17,24,26,89,119,3,417,23,0,2,4,4,0
18931,212,5047,722,423,573,19,0,135,741,12,172,101,199,184,300,1320,2257,6,15668,870,0,2,47,38,0
18932,212,5047,1508,847,911,44,250,301,1552,14,148,88,169,162,257,1120,1886,7,15077,837,0,2,47,38,0
18933,307,7146,72,33,56,0,4,12,72,1,1,1,1,2,2,0,2,0,1,0,0,2,512,59,0
18934,307,7146,1454,835,1044,76,110,219,1530,17,275,158,296,292,454,2297,3718,9,34017,1889,1,2,512,59,0
18935,77,1522,757,253,292,73,244,162,830,13,61,38,67,74,105,409,651,7,4654,258,0,2,7,6,0
18936,40,837,386,256,301,16,9,68,402,4,59,35,69,63,104,355,621,2,1453,80,0,2,2,2,0
18937,40,837,264,131,164,11,41,46,275,6,38,22,40,44,62,214,338,3,1068,59,0,2,2,2,0
18938,30,649,215,129,180,6,0,29,221,8,65,43,72,73,115,415,711,4,3153,175,0,2,9,4,0
18939,30,649,97,69,77,3,3,16,100,6,22,13,23,28,36,113,173,3,542,30,0,2,9,4,0
18940,129,2875,1043,504,840,53,9,147,1096,9,180,112,198,189,310,1377,2344,4,11604,644,0,2,52,21,0
18941,129,2875,383,288,292,26,6,62,409,11,65,38,67,76,105,429,656,5,3719,206,0,2,52,21,0
18942,103,1953,1178,367,1042,6,15,115,1184,9,94,51,95,103,146,644,976,4,4439,246,0,2,29,24,0
18943,103,1953,177,108,140,8,0,27,185,6,30,16,32,36,48,162,248,3,794,44,0,2,29,24,0
18944,192,3908,1943,715,1694,26,18,214,1969,12,185,120,237,197,357,1436,2721,7,20915,1161,0,2,38,29,0
18945,192,3908,1168,838,957,57,25,144,1225,19,348,224,416,367,640,3018,5452,11,61921,3440,1,2,38,29,0
18946,16,477,442,244,305,14,16,103,456,11,68,45,75,79,120,452,756,6,4588,254,0,2,2,2,0
18947,16,477,182,102,99,11,40,35,193,3,11,6,11,14,17,42,64,1,97,5,0,2,2,2,0
18948,62,1240,1098,241,925,5,10,155,1103,7,46,25,49,53,74,273,423,3,1580,87,0,2,3,3,0
18949,62,1240,282,202,222,14,2,44,296,8,42,24,43,50,67,250,378,4,1548,86,0,2,3,3,0
18950,19,408,601,196,481,2,23,85,603,8,63,36,72,71,108,400,664,4,3036,168,0,2,1,1,0
18951,19,408,156,79,106,5,16,28,161,5,14,8,15,19,23,64,97,2,261,14,0,2,1,1,0
18952,80,3427,1289,550,1043,56,32,155,1345,10,167,93,185,177,278,1266,2075,5,11498,638,0,2,11,13,0
18953,34,997,182,127,129,0,0,53,182,5,39,21,42,44,63,217,343,2,926,51,0,2,18,6,0
18954,147,6812,1392,870,1177,35,17,170,1427,14,494,280,531,508,811,4473,7289,7,54850,3047,2,2,73,49,0
18955,91,3010,773,419,590,28,0,166,801,10,204,113,217,214,330,1598,2554,5,13587,754,0,2,61,21,0
18956,7,278,75,38,59,1,3,12,76,2,4,2,4,6,6,10,15,1,15,0,0,2,4,0,0
18957,2,26,6,4,4,0,0,2,6,1,4,2,4,5,6,8,13,0,6,0,0,2,2,1,0
18958,53,3320,520,294,400,33,13,81,553,10,261,204,367,271,571,2128,4614,7,32445,1802,1,2,84,82,0
18959,98,4425,1338,495,1086,10,64,173,1348,11,122,82,157,133,239,883,1686,7,11934,663,0,2,13,14,0
18960,156,6958,139,89,101,2,0,35,141,7,54,34,62,61,96,330,569,4,2287,127,0,2,99,42,0
18961,156,6958,7,5,5,0,0,2,7,1,2,1,2,3,3,2,4,0,2,0,0,2,99,42,0
18962,32,948,465,148,393,5,8,60,470,4,31,20,31,35,51,161,261,2,523,29,0,2,5,3,0
18963,32,948,16,12,9,0,0,6,16,1,2,1,2,3,3,2,4,0,2,0,0,2,5,3,0
18964,132,5711,1782,648,1425,9,47,279,1791,8,171,97,189,179,286,1292,2140,4,9462,525,0,2,100,62,0
18965,20,541,256,139,192,9,7,47,265,4,23,12,24,27,36,112,171,2,357,19,0,2,0,1,0
18966,23,601,102,59,69,5,3,24,107,6,22,15,28,28,43,113,206,3,789,43,0,2,18,11,0
18967,109,4106,1450,624,1228,12,26,181,1462,14,306,186,354,320,540,2580,4493,8,36391,2021,1,2,41,24,0
18968,150,4203,1660,832,1314,41,38,274,1701,20,312,209,395,332,604,2671,5058,12,64042,3557,1,2,22,20,0
18969,117,4645,1513,682,1277,25,13,200,1538,11,199,116,219,210,335,1557,2584,6,15641,868,0,2,21,18,0
18970,72,3755,1296,573,1062,40,33,157,1336,8,201,118,231,209,349,1561,2689,4,12365,686,0,2,18,12,0
18971,78,4093,1457,730,1242,11,6,188,1468,10,292,166,329,302,495,2424,4078,5,22973,1276,1,2,13,7,0
18972,39,2355,652,304,544,16,6,88,668,6,89,51,101,95,152,591,998,3,3399,188,0,2,48,33,0
18973,64,2957,1455,414,1257,16,76,112,1471,5,41,23,46,46,69,231,381,2,1069,59,0,2,9,11,0
18974,8,273,74,35,59,1,0,14,75,3,14,7,14,17,21,58,85,1,128,7,0,2,8,1,0
18975,90,4427,1523,757,1297,19,12,193,1542,12,193,117,230,205,347,1508,2664,7,19053,1058,0,2,3,1,0
18976,70,3035,1020,354,843,12,15,144,1032,8,134,77,144,142,221,970,1580,4,6792,377,0,2,22,18,0
18977,37,1624,447,308,343,6,5,95,453,7,96,59,111,103,170,651,1136,4,4600,255,0,2,2,1,0
18978,21,661,424,94,331,4,0,89,428,1,5,5,5,6,10,11,25,0,12,0,0,2,10,0,0
18979,40,2367,334,251,279,10,4,40,344,5,127,74,143,132,217,899,1528,2,4303,239,0,2,16,13,0
18980,12,492,184,100,137,2,15,30,186,6,38,20,39,44,59,214,322,3,991,55,0,2,3,4,0
18981,35,1623,1293,570,1093,25,15,163,1318,10,195,123,241,205,364,1516,2795,6,17273,959,0,2,7,9,0
18982,36,1978,384,251,317,7,8,52,391,11,70,44,84,81,128,467,811,6,5355,297,0,2,7,5,0
18983,15,638,722,423,573,19,0,135,741,12,172,101,199,184,300,1320,2257,6,15668,870,0,2,4,0,0
18984,38,1637,386,256,301,16,9,68,402,4,59,35,69,63,104,355,621,2,1453,80,0,2,4,3,0
18985,16,1209,215,129,180,6,0,29,221,8,65,43,72,73,115,415,711,4,3153,175,0,2,10,10,0
18986,73,2942,1043,504,840,53,9,147,1096,9,180,112,198,189,310,1377,2344,4,11604,644,0,2,59,41,0
18987,14,529,295,56,236,0,4,54,295,2,9,5,10,11,15,30,51,1,57,3,0,2,13,1,0
18988,26,1029,373,158,315,8,0,51,381,5,76,44,79,81,123,486,779,2,2026,112,0,2,16,8,0
18989,71,3006,1178,367,1042,6,15,115,1184,9,94,51,95,103,146,644,976,4,4439,246,0,2,18,7,0
18990,74,3770,1943,715,1694,26,18,214,1969,12,185,120,237,197,357,1436,2721,7,20915,1161,0,2,34,21,0
18991,14,825,442,244,305,14,16,103,456,11,68,45,75,79,120,452,756,6,4588,254,0,2,5,0,0
18992,48,1784,1098,241,925,5,10,155,1103,7,46,25,49,53,74,273,423,3,1580,87,0,2,24,1,0
18993,12,476,601,196,481,2,23,85,603,8,63,36,72,71,108,400,664,4,3036,168,0,2,3,3,0
18994,55,1182,207,111,150,11,0,50,218,5,26,19,36,31,55,133,272,3,943,52,0,2,0,1,1
18995,55,1182,410,198,237,31,55,97,441,11,63,38,72,74,110,414,683,6,4293,238,0,2,0,1,1
18996,118,4694,1513,682,1277,25,13,200,1538,11,199,116,219,210,335,1557,2584,6,15641,868,0,2,1,1,1
18997,55,1187,207,111,150,11,0,50,218,5,26,19,36,31,55,133,272,3,943,52,0,2,9,1,0
18998,55,1187,410,198,237,31,55,97,441,11,63,38,72,74,110,414,683,6,4293,238,0,2,9,1,0
18999,118,4694,1513,682,1277,25,13,200,1538,11,199,116,219,210,335,1557,2584,6,15641,868,0,2,10,1,0
19000,147,6812,1392,870,1177,35,17,170,1427,14,494,280,531,508,811,4473,7289,7,54850,3047,2,2,8,8,1
19001,87,2932,773,419,590,28,0,166,801,10,204,113,217,214,330,1598,2554,5,13587,754,0,2,2,17,1
19002,118,4695,1513,682,1277,25,13,200,1538,11,199,116,219,210,335,1557,2584,6,15641,868,0,2,14,14,1
19003,39,2355,652,304,544,16,6,88,668,6,89,51,101,95,152,591,998,3,3399,188,0,2,2,2,1
19004,72,2856,1043,504,840,53,9,147,1096,9,180,112,198,189,310,1377,2344,4,11604,644,0,2,2,2,1
19005,21,432,601,196,481,2,23,85,603,8,63,36,72,71,108,400,664,4,3036,168,0,2,5,0,1
19006,21,432,156,79,106,5,16,28,161,5,14,8,15,19,23,64,97,2,261,14,0,2,5,0,1
19007,15,541,601,196,481,2,23,85,603,8,63,36,72,71,108,400,664,4,3036,168,0,2,29,0,1
19008,21,432,601,196,481,2,23,85,603,8,63,36,72,71,108,400,664,4,3036,168,0,2,5,0,0
19009,21,432,156,79,106,5,16,28,161,5,14,8,15,19,23,64,97,2,261,14,0,2,5,0,0
19010,15,541,601,196,481,2,23,85,603,8,63,36,72,71,108,400,664,4,3036,168,0,2,29,0,0
19011,147,6812,1392,870,1177,35,17,170,1427,14,494,280,531,508,811,4473,7289,7,54850,3047,2,2,8,8,0
19012,87,2932,773,419,590,28,0,166,801,10,204,113,217,214,330,1598,2554,5,13587,754,0,2,2,17,0
19013,118,4695,1513,682,1277,25,13,200,1538,11,199,116,219,210,335,1557,2584,6,15641,868,0,2,14,14,0
19014,39,2355,652,304,544,16,6,88,668,6,89,51,101,95,152,591,998,3,3399,188,0,2,2,2,0
19015,72,2856,1043,504,840,53,9,147,1096,9,180,112,198,189,310,1377,2344,4,11604,644,0,2,2,2,0
19016,349,7042,1457,730,1242,11,6,188,1468,10,292,166,329,302,495,2424,4078,5,22973,1276,1,2,0,1,1
19017,349,7042,74,35,59,1,0,14,75,3,14,7,14,17,21,58,85,1,128,7,0,2,0,1,1
19018,349,7042,245,125,200,5,7,34,250,7,30,17,34,37,51,166,265,3,1053,58,0,2,0,1,1
19019,95,1819,1020,354,843,12,15,144,1032,8,134,77,144,142,221,970,1580,4,6792,377,0,2,12,3,0
19020,72,3105,1020,354,843,12,15,144,1032,8,134,77,144,142,221,970,1580,4,6792,377,0,2,13,0,0
19021,19,409,601,196,481,2,23,85,603,8,63,36,72,71,108,400,664,4,3036,168,0,2,3,2,0
19022,19,409,156,79,106,5,16,28,161,5,14,8,15,19,23,64,97,2,261,14,0,2,3,2,0
19023,19,409,601,196,481,2,23,85,603,8,63,36,72,71,108,400,664,4,3036,168,0,2,3,2,0
19024,19,409,156,79,106,5,16,28,161,5,14,8,15,19,23,64,97,2,261,14,0,2,3,2,0
19025,95,1819,1020,354,843,12,15,144,1032,8,134,77,144,142,221,970,1580,4,6792,377,0,2,12,3,0
19026,72,3105,1020,354,843,12,15,144,1032,8,134,77,144,142,221,970,1580,4,6792,377,0,2,13,0,0
19027,212,5063,722,423,573,19,0,135,741,12,172,101,199,184,300,1320,2257,6,15668,870,0,2,5,2,0
19028,212,5063,1508,847,911,44,250,301,1552,14,148,88,169,162,257,1120,1886,7,15077,837,0,2,5,2,0
19029,74,1418,757,253,292,73,244,162,830,13,61,38,67,74,105,409,651,7,4654,258,0,2,8,54,1
19030,255,6154,72,33,56,0,4,12,72,1,1,1,1,2,2,0,2,0,1,0,0,2,0,432,0
19031,255,6154,1454,835,1044,76,110,219,1530,17,275,158,296,292,454,2297,3718,9,34017,1889,1,2,0,432,0
19032,74,1418,757,253,292,73,244,162,830,13,61,38,67,74,105,409,651,7,4654,258,0,2,1,1,0
19033,255,6152,72,33,56,0,4,12,72,1,1,1,1,2,2,0,2,0,1,0,0,2,0,1,0
19034,255,6152,1454,835,1044,76,110,219,1530,17,275,158,296,292,454,2297,3718,9,34017,1889,1,2,0,1,0
19035,255,6152,72,33,56,0,4,12,72,1,1,1,1,2,2,0,2,0,1,0,0,2,0,433,0
19036,255,6152,1454,835,1044,76,110,219,1530,17,275,158,296,292,454,2297,3718,9,34017,1889,1,2,0,433,0
19037,74,1418,757,253,292,73,244,162,830,13,61,38,67,74,105,409,651,7,4654,258,0,2,8,54,0
19038,98,4449,1338,495,1086,10,64,173,1348,11,122,82,157,133,239,883,1686,7,11934,663,0,2,11,1,1
19039,132,5719,1782,648,1425,9,47,279,1791,8,171,97,189,179,286,1292,2140,4,9462,525,0,2,2,1,1
19040,72,3114,1020,354,843,12,15,144,1032,8,134,77,144,142,221,970,1580,4,6792,377,0,2,1,0,1
19041,36,1591,386,256,301,16,9,68,402,4,59,35,69,63,104,355,621,2,1453,80,0,2,1,27,1
19042,48,1784,1098,241,925,5,10,155,1103,7,46,25,49,53,74,273,423,3,1580,87,0,2,7,7,1
19043,15,568,601,196,481,2,23,85,603,8,63,36,72,71,108,400,664,4,3036,168,0,2,4,0,1
19044,48,1795,1098,241,925,5,10,155,1103,7,46,25,49,53,74,273,423,3,1580,87,0,2,50,55,0
19045,98,4449,1338,495,1086,10,64,173,1348,11,122,82,157,133,239,883,1686,7,11934,663,0,2,11,1,0
19046,132,5719,1782,648,1425,9,47,279,1791,8,171,97,189,179,286,1292,2140,4,9462,525,0,2,2,1,0
19047,72,3114,1020,354,843,12,15,144,1032,8,134,77,144,142,221,970,1580,4,6792,377,0,2,1,0,0
19048,36,1591,386,256,301,16,9,68,402,4,59,35,69,63,104,355,621,2,1453,80,0,2,1,27,0
19049,48,1795,1098,241,925,5,10,155,1103,7,46,25,49,53,74,273,423,3,1580,87,0,2,57,62,0
19050,15,568,601,196,481,2,23,85,603,8,63,36,72,71,108,400,664,4,3036,168,0,2,4,0,0
19051,60,1677,1455,414,1257,16,76,112,1471,5,41,23,46,46,69,231,381,2,1069,59,0,2,1,1,0
19052,60,1677,669,365,481,22,61,110,691,15,103,63,122,118,185,747,1273,8,11311,628,0,2,1,1,0
19053,131,2635,1513,682,1277,25,13,200,1538,11,199,116,219,210,335,1557,2584,6,15641,868,0,2,19,0,1
19054,131,2635,819,519,539,24,98,155,843,15,96,57,106,111,163,690,1107,8,9171,509,0,2,19,0,1
19055,349,7042,1457,730,1242,11,6,188,1468,10,292,166,329,302,495,2424,4078,5,22973,1276,1,2,0,1,0
19056,349,7042,74,35,59,1,0,14,75,3,14,7,14,17,21,58,85,1,128,7,0,2,0,1,0
19057,349,7042,245,125,200,5,7,34,250,7,30,17,34,37,51,166,265,3,1053,58,0,2,0,1,0
19058,131,2635,1513,682,1277,25,13,200,1538,11,199,116,219,210,335,1557,2584,6,15641,868,0,2,1,1,0
19059,131,2635,819,519,539,24,98,155,843,15,96,57,106,111,163,690,1107,8,9171,509,0,2,1,1,0
19060,349,7042,1457,730,1242,11,6,188,1468,10,292,166,329,302,495,2424,4078,5,22973,1276,1,2,0,1,0
19061,349,7042,74,35,59,1,0,14,75,3,14,7,14,17,21,58,85,1,128,7,0,2,0,1,0
19062,349,7042,245,125,200,5,7,34,250,7,30,17,34,37,51,166,265,3,1053,58,0,2,0,1,0
19063,131,2635,1513,682,1277,25,13,200,1538,11,199,116,219,210,335,1557,2584,6,15641,868,0,2,19,0,0
19064,131,2635,819,519,539,24,98,155,843,15,96,57,106,111,163,690,1107,8,9171,509,0,2,19,0,0
19065,65,3005,1455,414,1257,16,76,112,1471,5,41,23,46,46,69,231,381,2,1069,59,0,2,16,0,0
19066,60,1677,1455,414,1257,16,76,112,1471,5,41,23,46,46,69,231,381,2,1069,59,0,2,1,1,0
19067,60,1677,669,365,481,22,61,110,691,15,103,63,122,118,185,747,1273,8,11311,628,0,2,1,1,0
19068,65,3005,1455,414,1257,16,76,112,1471,5,41,23,46,46,69,231,381,2,1069,59,0,2,16,0,0
19069,131,2635,1513,682,1277,25,13,200,1538,11,199,116,219,210,335,1557,2584,6,15641,868,0,2,19,0,0
19070,131,2635,819,519,539,24,98,155,843,15,96,57,106,111,163,690,1107,8,9171,509,0,2,19,0,0
19071,349,7042,1457,730,1242,11,6,188,1468,10,292,166,329,302,495,2424,4078,5,22973,1276,1,2,0,1,0
19072,349,7042,74,35,59,1,0,14,75,3,14,7,14,17,21,58,85,1,128,7,0,2,0,1,0
19073,349,7042,245,125,200,5,7,34,250,7,30,17,34,37,51,166,265,3,1053,58,0,2,0,1,0
19074,60,1677,1455,414,1257,16,76,112,1471,5,41,23,46,46,69,231,381,2,1069,59,0,2,1,1,0
19075,60,1677,669,365,481,22,61,110,691,15,103,63,122,118,185,747,1273,8,11311,628,0,2,1,1,0
19076,21,433,601,196,481,2,23,85,603,8,63,36,72,71,108,400,664,4,3036,168,0,2,3,2,0
19077,21,433,156,79,106,5,16,28,161,5,14,8,15,19,23,64,97,2,261,14,0,2,3,2,0
19078,87,2932,773,419,590,28,0,166,801,10,204,113,217,214,330,1598,2554,5,13587,754,0,2,0,15,0
19079,118,4695,1513,682,1277,25,13,200,1538,11,199,116,219,210,335,1557,2584,6,15641,868,0,2,1,1,0
19080,65,3005,1455,414,1257,16,76,112,1471,5,41,23,46,46,69,231,381,2,1069,59,0,2,16,0,0
19081,315,7207,72,33,56,0,4,12,72,1,1,1,1,2,2,0,2,0,1,0,0,2,4,3,0
19082,315,7207,1454,835,1044,76,110,219,1530,17,275,158,296,292,454,2297,3718,9,34017,1889,1,2,4,3,0
19083,103,1955,1178,367,1042,6,15,115,1184,9,94,51,95,103,146,644,976,4,4439,246,0,2,1,1,1
19084,103,1955,177,108,140,8,0,27,185,6,30,16,32,36,48,162,248,3,794,44,0,2,1,1,1
19085,71,3006,1178,367,1042,6,15,115,1184,9,94,51,95,103,146,644,976,4,4439,246,0,2,1,1,1
19086,315,7207,72,33,56,0,4,12,72,1,1,1,1,2,2,0,2,0,1,0,0,2,4,3,0
19087,315,7207,1454,835,1044,76,110,219,1530,17,275,158,296,292,454,2297,3718,9,34017,1889,1,2,4,3,0
19088,103,1955,1178,367,1042,6,15,115,1184,9,94,51,95,103,146,644,976,4,4439,246,0,2,1,1,0
19089,103,1955,177,108,140,8,0,27,185,6,30,16,32,36,48,162,248,3,794,44,0,2,1,1,0
19090,71,3006,1178,367,1042,6,15,115,1184,9,94,51,95,103,146,644,976,4,4439,246,0,2,1,1,0
19091,132,2651,1513,682,1277,25,13,200,1538,11,199,116,219,210,335,1557,2584,6,15641,868,0,2,5,0,0
19092,132,2651,819,519,539,24,98,155,843,15,96,57,106,111,163,690,1107,8,9171,509,0,2,5,0,0
19093,118,4765,1513,682,1277,25,13,200,1538,11,199,116,219,210,335,1557,2584,6,15641,868,0,2,10,0,0
19094,78,1458,757,253,292,73,244,162,830,13,61,38,67,74,105,409,651,7,4654,258,0,2,28,1,0
19095,78,1458,757,253,292,73,244,162,830,13,61,38,67,74,105,409,651,7,4654,258,0,2,2,2,0
19096,78,1458,757,253,292,73,244,162,830,13,61,38,67,74,105,409,651,7,4654,258,0,2,1,0,0
19097,75,1461,757,253,292,73,244,162,830,13,61,38,67,74,105,409,651,7,4654,258,0,2,24,15,0
19098,54,3424,520,294,400,33,13,81,553,10,261,204,367,271,571,2128,4614,7,32445,1802,1,2,14,0,0
19099,212,5063,722,423,573,19,0,135,741,12,172,101,199,184,300,1320,2257,6,15668,870,0,2,5,2,0
19100,212,5063,1508,847,911,44,250,301,1552,14,148,88,169,162,257,1120,1886,7,15077,837,0,2,5,2,0
19101,161,7070,139,89,101,2,0,35,141,7,54,34,62,61,96,330,569,4,2287,127,0,2,34,0,1
19102,161,7070,7,5,5,0,0,2,7,1,2,1,2,3,3,2,4,0,2,0,0,2,34,0,1
19103,132,2651,1513,682,1277,25,13,200,1538,11,199,116,219,210,335,1557,2584,6,15641,868,0,2,5,0,0
19104,132,2651,819,519,539,24,98,155,843,15,96,57,106,111,163,690,1107,8,9171,509,0,2,5,0,0
19105,118,4765,1513,682,1277,25,13,200,1538,11,199,116,219,210,335,1557,2584,6,15641,868,0,2,10,0,0
19106,229,5170,4293,999,3693,19,54,507,4312,9,155,88,170,164,258,1156,1898,4,9368,520,0,2,13,8,1
19107,229,5170,1482,859,1002,125,135,219,1607,16,219,134,251,235,385,1766,3032,9,27804,1544,1,2,13,8,1
19108,161,7059,139,89,101,2,0,35,141,7,54,34,62,61,96,330,569,4,2287,127,0,2,0,1,1
19109,161,7059,7,5,5,0,0,2,7,1,2,1,2,3,3,2,4,0,2,0,0,2,0,1,1
19110,11,410,42,7,35,4,0,5,46,1,2,1,2,3,3,2,4,0,2,0,0,2,2,1,1
19111,11,410,11,6,10,0,0,1,11,2,4,2,4,6,6,10,15,1,15,0,0,2,2,1,1
19112,132,2651,1513,682,1277,25,13,200,1538,11,199,116,219,210,335,1557,2584,6,15641,868,0,2,5,0,0
19113,132,2651,819,519,539,24,98,155,843,15,96,57,106,111,163,690,1107,8,9171,509,0,2,5,0,0
19114,212,5063,722,423,573,19,0,135,741,12,172,101,199,184,300,1320,2257,6,15668,870,0,2,5,2,0
19115,212,5063,1508,847,911,44,250,301,1552,14,148,88,169,162,257,1120,1886,7,15077,837,0,2,5,2,0
19116,255,6153,72,33,56,0,4,12,72,1,1,1,1,2,2,0,2,0,1,0,0,2,4,3,0
19117,255,6153,1454,835,1044,76,110,219,1530,17,275,158,296,292,454,2297,3718,9,34017,1889,1,2,4,3,0
19118,103,1955,1178,367,1042,6,15,115,1184,9,94,51,95,103,146,644,976,4,4439,246,0,2,1,1,0
19119,103,1955,177,108,140,8,0,27,185,6,30,16,32,36,48,162,248,3,794,44,0,2,1,1,0
19120,118,4765,1513,682,1277,25,13,200,1538,11,199,116,219,210,335,1557,2584,6,15641,868,0,2,10,0,0
19121,71,3006,1178,367,1042,6,15,115,1184,9,94,51,95,103,146,644,976,4,4439,246,0,2,1,1,0
19122,132,2651,1513,682,1277,25,13,200,1538,11,199,116,219,210,335,1557,2584,6,15641,868,0,2,24,0,0
19123,132,2651,819,519,539,24,98,155,843,15,96,57,106,111,163,690,1107,8,9171,509,0,2,24,0,0
19124,349,7042,1457,730,1242,11,6,188,1468,10,292,166,329,302,495,2424,4078,5,22973,1276,1,2,0,1,0
19125,349,7042,74,35,59,1,0,14,75,3,14,7,14,17,21,58,85,1,128,7,0,2,0,1,0
19126,349,7042,245,125,200,5,7,34,250,7,30,17,34,37,51,166,265,3,1053,58,0,2,0,1,0
19127,60,1677,1455,414,1257,16,76,112,1471,5,41,23,46,46,69,231,381,2,1069,59,0,2,1,1,0
19128,60,1677,669,365,481,22,61,110,691,15,103,63,122,118,185,747,1273,8,11311,628,0,2,1,1,0
19129,212,5063,722,423,573,19,0,135,741,12,172,101,199,184,300,1320,2257,6,15668,870,0,2,5,2,0
19130,212,5063,1508,847,911,44,250,301,1552,14,148,88,169,162,257,1120,1886,7,15077,837,0,2,5,2,0
19131,255,6153,72,33,56,0,4,12,72,1,1,1,1,2,2,0,2,0,1,0,0,2,4,3,0
19132,255,6153,1454,835,1044,76,110,219,1530,17,275,158,296,292,454,2297,3718,9,34017,1889,1,2,4,3,0
19133,103,1955,1178,367,1042,6,15,115,1184,9,94,51,95,103,146,644,976,4,4439,246,0,2,1,1,0
19134,103,1955,177,108,140,8,0,27,185,6,30,16,32,36,48,162,248,3,794,44,0,2,1,1,0
19135,21,433,601,196,481,2,23,85,603,8,63,36,72,71,108,400,664,4,3036,168,0,2,3,2,0
19136,21,433,156,79,106,5,16,28,161,5,14,8,15,19,23,64,97,2,261,14,0,2,3,2,0
19137,87,2932,773,419,590,28,0,166,801,10,204,113,217,214,330,1598,2554,5,13587,754,0,2,0,15,0
19138,118,4765,1513,682,1277,25,13,200,1538,11,199,116,219,210,335,1557,2584,6,15641,868,0,2,11,1,0
19139,65,3005,1455,414,1257,16,76,112,1471,5,41,23,46,46,69,231,381,2,1069,59,0,2,16,0,0
19140,71,3006,1178,367,1042,6,15,115,1184,9,94,51,95,103,146,644,976,4,4439,246,0,2,1,1,0
19141,50,586,647,139,84,35,284,233,682,0,0,0,0,0,0,0,0,0,0,0,0,2,15,1,0
19142,192,3949,1943,715,1694,26,18,214,1969,12,185,120,237,197,357,1436,2721,7,20915,1161,0,2,6,4,0
19143,192,3949,1168,838,957,57,25,144,1225,19,348,224,416,367,640,3018,5452,11,61921,3440,1,2,6,4,0
19144,75,3810,1943,715,1694,26,18,214,1969,12,185,120,237,197,357,1436,2721,7,20915,1161,0,2,17,0,0
19145,50,586,647,139,84,35,284,233,682,0,0,0,0,0,0,0,0,0,0,0,0,2,15,1,0
19146,192,3949,1943,715,1694,26,18,214,1969,12,185,120,237,197,357,1436,2721,7,20915,1161,0,2,6,4,0
19147,192,3949,1168,838,957,57,25,144,1225,19,348,224,416,367,640,3018,5452,11,61921,3440,1,2,6,4,0
19148,75,3810,1943,715,1694,26,18,214,1969,12,185,120,237,197,357,1436,2721,7,20915,1161,0,2,17,0,0
19149,57,1306,996,429,845,24,10,117,1020,7,76,50,88,83,138,494,879,4,3565,198,0,2,11,15,0
19150,57,1306,456,277,329,12,42,72,468,13,85,50,97,98,147,592,972,7,7212,400,0,2,11,15,0
19151,58,1312,996,429,845,24,10,117,1020,7,76,50,88,83,138,494,879,4,3565,198,0,2,1,1,0
19152,58,1312,456,277,329,12,42,72,468,13,85,50,97,98,147,592,972,7,7212,400,0,2,1,1,0
19153,58,1312,996,429,845,24,10,117,1020,7,76,50,88,83,138,494,879,4,3565,198,0,2,11,15,0
19154,58,1312,456,277,329,12,42,72,468,13,85,50,97,98,147,592,972,7,7212,400,0,2,11,15,0
19155,59,1352,996,429,845,24,10,117,1020,7,76,50,88,83,138,494,879,4,3565,198,0,2,9,4,0
19156,59,1352,456,277,329,12,42,72,468,13,85,50,97,98,147,592,972,7,7212,400,0,2,9,4,0
19157,50,586,647,139,84,35,284,233,682,0,0,0,0,0,0,0,0,0,0,0,0,2,4,1,0
19158,50,586,647,139,84,35,284,233,682,0,0,0,0,0,0,0,0,0,0,0,0,2,1,1,0
19159,227,5131,4293,999,3693,19,54,507,4312,9,155,88,170,164,258,1156,1898,4,9368,520,0,2,3,3,1
19160,227,5131,1482,859,1002,125,135,219,1607,16,219,134,251,235,385,1766,3032,9,27804,1544,1,2,3,3,1
19161,184,4247,77,34,69,0,0,8,77,3,24,16,29,27,45,114,213,1,387,21,0,2,2,1,1
19162,184,4247,712,438,573,51,9,84,763,14,102,71,128,116,199,733,1364,8,11988,666,0,2,2,1,1
19163,18,466,205,80,86,16,53,53,221,7,18,10,19,25,29,94,134,3,497,27,0,0,141,0,1
19164,255,6153,72,33,56,0,4,12,72,1,1,1,1,2,2,0,2,0,1,0,0,2,1,1,1
19165,255,6153,1454,835,1044,76,110,219,1530,17,275,158,296,292,454,2297,3718,9,34017,1889,1,2,1,1,1
19166,74,1418,757,253,292,73,244,162,830,13,61,38,67,74,105,409,651,7,4654,258,0,2,1,1,1
19167,40,837,386,256,301,16,9,68,402,4,59,35,69,63,104,355,621,2,1453,80,0,2,2,2,1
19168,40,837,264,131,164,11,41,46,275,6,38,22,40,44,62,214,338,3,1068,59,0,2,2,2,1
19169,112,2470,1043,504,840,53,9,147,1096,9,180,112,198,189,310,1377,2344,4,11604,644,0,2,3,122,1
19170,112,2470,383,288,292,26,6,62,409,11,65,38,67,76,105,429,656,5,3719,206,0,2,3,122,1
19171,102,1930,1178,367,1042,6,15,115,1184,9,94,51,95,103,146,644,976,4,4439,246,0,2,3,15,1
19172,102,1930,177,108,140,8,0,27,185,6,30,16,32,36,48,162,248,3,794,44,0,2,3,15,1
19173,62,1240,1098,241,925,5,10,155,1103,7,46,25,49,53,74,273,423,3,1580,87,0,2,2,2,1
19174,62,1240,282,202,222,14,2,44,296,8,42,24,43,50,67,250,378,4,1548,86,0,2,2,2,1
19175,75,2972,1043,504,840,53,9,147,1096,9,180,112,198,189,310,1377,2344,4,11604,644,0,2,11,2,1
19176,18,466,205,80,86,16,53,53,221,7,18,10,19,25,29,94,134,3,497,27,0,2,5,6,0
19177,40,837,386,256,301,16,9,68,402,4,59,35,69,63,104,355,621,2,1453,80,0,2,1,0,0
19178,40,837,264,131,164,11,41,46,275,6,38,22,40,44,62,214,338,3,1068,59,0,2,1,0,0
19179,112,2470,1043,504,840,53,9,147,1096,9,180,112,198,189,310,1377,2344,4,11604,644,0,2,1,4,0
19180,112,2470,383,288,292,26,6,62,409,11,65,38,67,76,105,429,656,5,3719,206,0,2,1,4,0
19181,102,1930,1178,367,1042,6,15,115,1184,9,94,51,95,103,146,644,976,4,4439,246,0,2,0,1,0
19182,102,1930,177,108,140,8,0,27,185,6,30,16,32,36,48,162,248,3,794,44,0,2,0,1,0
19183,75,2972,1043,504,840,53,9,147,1096,9,180,112,198,189,310,1377,2344,4,11604,644,0,2,0,1,0
19184,59,1352,996,429,845,24,10,117,1020,7,76,50,88,83,138,494,879,4,3565,198,0,2,9,4,0
19185,59,1352,456,277,329,12,42,72,468,13,85,50,97,98,147,592,972,7,7212,400,0,2,9,4,0
19186,50,586,647,139,84,35,284,233,682,0,0,0,0,0,0,0,0,0,0,0,0,2,4,1,0
19187,214,4602,182,127,129,0,0,53,182,5,39,21,42,44,63,217,343,2,926,51,0,2,1,1,1
19188,214,4602,1165,710,800,67,119,181,1232,18,243,153,282,261,435,2000,3492,10,36473,2026,1,2,1,1,1
19189,149,6984,1392,870,1177,35,17,170,1427,14,494,280,531,508,811,4473,7289,7,54850,3047,2,2,30,0,1
19190,229,5170,4293,999,3693,19,54,507,4312,9,155,88,170,164,258,1156,1898,4,9368,520,0,2,13,8,0
19191,229,5170,1482,859,1002,125,135,219,1607,16,219,134,251,235,385,1766,3032,9,27804,1544,1,2,13,8,0
19192,11,410,42,7,35,4,0,5,46,1,2,1,2,3,3,2,4,0,2,0,0,2,2,1,0
19193,11,410,11,6,10,0,0,1,11,2,4,2,4,6,6,10,15,1,15,0,0,2,2,1,0
19194,161,7059,139,89,101,2,0,35,141,7,54,34,62,61,96,330,569,4,2287,127,0,2,33,0,0
19195,161,7059,7,5,5,0,0,2,7,1,2,1,2,3,3,2,4,0,2,0,0,2,33,0,0
19196,214,4602,182,127,129,0,0,53,182,5,39,21,42,44,63,217,343,2,926,51,0,2,1,1,0
19197,214,4602,1165,710,800,67,119,181,1232,18,243,153,282,261,435,2000,3492,10,36473,2026,1,2,1,1,0
19198,149,6984,1392,870,1177,35,17,170,1427,14,494,280,531,508,811,4473,7289,7,54850,3047,2,2,30,0,0
19199,229,5172,4293,999,3693,19,54,507,4312,9,155,88,170,164,258,1156,1898,4,9368,520,0,2,3,3,0
19200,229,5172,1482,859,1002,125,135,219,1607,16,219,134,251,235,385,1766,3032,9,27804,1544,1,2,3,3,0
19201,184,4247,77,34,69,0,0,8,77,3,24,16,29,27,45,114,213,1,387,21,0,2,2,1,0
19202,184,4247,712,438,573,51,9,84,763,14,102,71,128,116,199,733,1364,8,11988,666,0,2,2,1,0
19203,18,466,205,80,86,16,53,53,221,7,18,10,19,25,29,94,134,3,497,27,0,0,140,0,0
19204,255,6153,72,33,56,0,4,12,72,1,1,1,1,2,2,0,2,0,1,0,0,2,1,1,0
19205,255,6153,1454,835,1044,76,110,219,1530,17,275,158,296,292,454,2297,3718,9,34017,1889,1,2,1,1,0
19206,74,1418,757,253,292,73,244,162,830,13,61,38,67,74,105,409,651,7,4654,258,0,2,1,1,0
19207,40,837,386,256,301,16,9,68,402,4,59,35,69,63,104,355,621,2,1453,80,0,2,2,1,0
19208,40,837,264,131,164,11,41,46,275,6,38,22,40,44,62,214,338,3,1068,59,0,2,2,1,0
19209,112,2470,1043,504,840,53,9,147,1096,9,180,112,198,189,310,1377,2344,4,11604,644,0,2,4,126,0
19210,112,2470,383,288,292,26,6,62,409,11,65,38,67,76,105,429,656,5,3719,206,0,2,4,126,0
19211,102,1930,1178,367,1042,6,15,115,1184,9,94,51,95,103,146,644,976,4,4439,246,0,2,3,16,0
19212,102,1930,177,108,140,8,0,27,185,6,30,16,32,36,48,162,248,3,794,44,0,2,3,16,0
19213,62,1240,1098,241,925,5,10,155,1103,7,46,25,49,53,74,273,423,3,1580,87,0,2,2,2,0
19214,62,1240,282,202,222,14,2,44,296,8,42,24,43,50,67,250,378,4,1548,86,0,2,2,2,0
19215,75,2972,1043,504,840,53,9,147,1096,9,180,112,198,189,310,1377,2344,4,11604,644,0,2,10,2,0
19216,75,1461,757,253,292,73,244,162,830,13,61,38,67,74,105,409,651,7,4654,258,0,2,37,0,0
19217,54,3424,520,294,400,33,13,81,553,10,261,204,367,271,571,2128,4614,7,32445,1802,1,2,14,0,0
19218,347,7012,1457,730,1242,11,6,188,1468,10,292,166,329,302,495,2424,4078,5,22973,1276,1,2,0,9,0
19219,347,7012,74,35,59,1,0,14,75,3,14,7,14,17,21,58,85,1,128,7,0,2,0,9,0
19220,347,7012,245,125,200,5,7,34,250,7,30,17,34,37,51,166,265,3,1053,58,0,2,0,9,0
19221,183,4238,77,34,69,0,0,8,77,3,24,16,29,27,45,114,213,1,387,21,0,2,0,9,0
19222,183,4238,712,438,573,51,9,84,763,14,102,71,128,116,199,733,1364,8,11988,666,0,2,0,9,0
19223,179,4137,77,34,69,0,0,8,77,3,24,16,29,27,45,114,213,1,387,21,0,2,0,18,0
19224,179,4137,712,438,573,51,9,84,763,14,102,71,128,116,199,733,1364,8,11988,666,0,2,0,18,0
19225,211,5051,722,423,573,19,0,135,741,12,172,101,199,184,300,1320,2257,6,15668,870,0,2,7,9,0
19226,211,5051,1508,847,911,44,250,301,1552,14,148,88,169,162,257,1120,1886,7,15077,837,0,2,7,9,0
19227,211,5051,722,423,573,19,0,135,741,12,172,101,199,184,300,1320,2257,6,15668,870,0,2,0,1,0
19228,211,5051,1508,847,911,44,250,301,1552,14,148,88,169,162,257,1120,1886,7,15077,837,0,2,0,1,0
19229,179,4137,77,34,69,0,0,8,77,3,24,16,29,27,45,114,213,1,387,21,0,2,0,18,0
19230,179,4137,712,438,573,51,9,84,763,14,102,71,128,116,199,733,1364,8,11988,666,0,2,0,18,0
19231,211,5051,722,423,573,19,0,135,741,12,172,101,199,184,300,1320,2257,6,15668,870,0,2,6,9,0
19232,211,5051,1508,847,911,44,250,301,1552,14,148,88,169,162,257,1120,1886,7,15077,837,0,2,6,9,0
19233,347,7012,1457,730,1242,11,6,188,1468,10,292,166,329,302,495,2424,4078,5,22973,1276,1,2,0,9,0
19234,347,7012,74,35,59,1,0,14,75,3,14,7,14,17,21,58,85,1,128,7,0,2,0,9,0
19235,347,7012,245,125,200,5,7,34,250,7,30,17,34,37,51,166,265,3,1053,58,0,2,0,9,0
19236,178,4128,77,34,69,0,0,8,77,3,24,16,29,27,45,114,213,1,387,21,0,2,0,9,0
19237,178,4128,712,438,573,51,9,84,763,14,102,71,128,116,199,733,1364,8,11988,666,0,2,0,9,0
19238,214,4602,182,127,129,0,0,53,182,5,39,21,42,44,63,217,343,2,926,51,0,2,1,1,0
19239,214,4602,1165,710,800,67,119,181,1232,18,243,153,282,261,435,2000,3492,10,36473,2026,1,2,1,1,0
19240,59,1352,996,429,845,24,10,117,1020,7,76,50,88,83,138,494,879,4,3565,198,0,2,34,19,0
19241,59,1352,456,277,329,12,42,72,468,13,85,50,97,98,147,592,972,7,7212,400,0,2,34,19,0
19242,55,1187,207,111,150,11,0,50,218,5,26,19,36,31,55,133,272,3,943,52,0,2,2,1,0
19243,55,1187,410,198,237,31,55,97,441,11,63,38,72,74,110,414,683,6,4293,238,0,2,2,1,0
19244,229,5172,4293,999,3693,19,54,507,4312,9,155,88,170,164,258,1156,1898,4,9368,520,0,2,16,11,0
19245,229,5172,1482,859,1002,125,135,219,1607,16,219,134,251,235,385,1766,3032,9,27804,1544,1,2,16,11,0
19246,50,586,647,139,84,35,284,233,682,0,0,0,0,0,0,0,0,0,0,0,0,2,18,1,0
19247,184,4247,77,34,69,0,0,8,77,3,24,16,29,27,45,114,213,1,387,21,0,2,20,1,0
19248,184,4247,712,438,573,51,9,84,763,14,102,71,128,116,199,733,1364,8,11988,666,0,2,20,1,0
19249,95,1819,1020,354,843,12,15,144,1032,8,134,77,144,142,221,970,1580,4,6792,377,0,2,91,20,0
19250,18,466,205,80,86,16,53,53,221,7,18,10,19,25,29,94,134,3,497,27,0,0,140,0,0
19251,255,6153,72,33,56,0,4,12,72,1,1,1,1,2,2,0,2,0,1,0,0,2,18,467,0
19252,255,6153,1454,835,1044,76,110,219,1530,17,275,158,296,292,454,2297,3718,9,34017,1889,1,2,18,467,0
19253,75,1461,757,253,292,73,244,162,830,13,61,38,67,74,105,409,651,7,4654,258,0,0,616,0,0
19254,40,837,386,256,301,16,9,68,402,4,59,35,69,63,104,355,621,2,1453,80,0,2,2,1,0
19255,40,837,264,131,164,11,41,46,275,6,38,22,40,44,62,214,338,3,1068,59,0,2,2,1,0
19256,112,2470,1043,504,840,53,9,147,1096,9,180,112,198,189,310,1377,2344,4,11604,644,0,2,22,126,0
19257,112,2470,383,288,292,26,6,62,409,11,65,38,67,76,105,429,656,5,3719,206,0,2,22,126,0
19258,102,1930,1178,367,1042,6,15,115,1184,9,94,51,95,103,146,644,976,4,4439,246,0,2,3,16,0
19259,102,1930,177,108,140,8,0,27,185,6,30,16,32,36,48,162,248,3,794,44,0,2,3,16,0
19260,192,3949,1943,715,1694,26,18,214,1969,12,185,120,237,197,357,1436,2721,7,20915,1161,0,2,6,4,0
19261,192,3949,1168,838,957,57,25,144,1225,19,348,224,416,367,640,3018,5452,11,61921,3440,1,2,6,4,0
19262,62,1240,1098,241,925,5,10,155,1103,7,46,25,49,53,74,273,423,3,1580,87,0,2,2,2,0
19263,62,1240,282,202,222,14,2,44,296,8,42,24,43,50,67,250,378,4,1548,86,0,2,2,2,0
19264,21,433,601,196,481,2,23,85,603,8,63,36,72,71,108,400,664,4,3036,168,0,2,5,0,0
19265,21,433,156,79,106,5,16,28,161,5,14,8,15,19,23,64,97,2,261,14,0,2,5,0,0
19266,11,410,42,7,35,4,0,5,46,1,2,1,2,3,3,2,4,0,2,0,0,2,2,1,0
19267,11,410,11,6,10,0,0,1,11,2,4,2,4,6,6,10,15,1,15,0,0,2,2,1,0
19268,149,6984,1392,870,1177,35,17,170,1427,14,494,280,531,508,811,4473,7289,7,54850,3047,2,2,30,0,0
19269,54,3424,520,294,400,33,13,81,553,10,261,204,367,271,571,2128,4614,7,32445,1802,1,2,124,38,0
19270,98,4449,1338,495,1086,10,64,173,1348,11,122,82,157,133,239,883,1686,7,11934,663,0,2,31,1,0
19271,161,7059,139,89,101,2,0,35,141,7,54,34,62,61,96,330,569,4,2287,127,0,2,33,0,0
19272,161,7059,7,5,5,0,0,2,7,1,2,1,2,3,3,2,4,0,2,0,0,2,33,0,0
19273,132,5719,1782,648,1425,9,47,279,1791,8,171,97,189,179,286,1292,2140,4,9462,525,0,2,2,1,0
19274,72,3755,1296,573,1062,40,33,157,1336,8,201,118,231,209,349,1561,2689,4,12365,686,0,2,48,1,0
19275,72,3114,1020,354,843,12,15,144,1032,8,134,77,144,142,221,970,1580,4,6792,377,0,2,36,1,0
19276,36,1591,386,256,301,16,9,68,402,4,59,35,69,63,104,355,621,2,1453,80,0,2,1,27,0
19277,75,2972,1043,504,840,53,9,147,1096,9,180,112,198,189,310,1377,2344,4,11604,644,0,2,37,2,0
19278,75,3810,1943,715,1694,26,18,214,1969,12,185,120,237,197,357,1436,2721,7,20915,1161,0,2,17,0,0
19279,48,1795,1098,241,925,5,10,155,1103,7,46,25,49,53,74,273,423,3,1580,87,0,2,57,62,0
19280,15,568,601,196,481,2,23,85,603,8,63,36,72,71,108,400,664,4,3036,168,0,2,33,0,0
19281,212,5103,722,423,573,19,0,135,741,12,172,101,199,184,300,1320,2257,6,15668,870,0,2,8,4,0
19282,212,5103,1508,847,911,44,250,301,1552,14,148,88,169,162,257,1120,1886,7,15077,837,0,2,8,4,0
19283,113,2497,1043,504,840,53,9,147,1096,9,180,112,198,189,310,1377,2344,4,11604,644,0,2,6,1,0
19284,113,2497,383,288,292,26,6,62,409,11,65,38,67,76,105,429,656,5,3719,206,0,2,6,1,0
19285,81,3461,1289,550,1043,56,32,155,1345,10,167,93,185,177,278,1266,2075,5,11498,638,0,2,14,1,0
19286,113,2492,1043,504,840,53,9,147,1096,9,180,112,198,189,310,1377,2344,4,11604,644,0,2,2,2,0
19287,113,2492,383,288,292,26,6,62,409,11,65,38,67,76,105,429,656,5,3719,206,0,2,2,2,0
19288,212,5103,722,423,573,19,0,135,741,12,172,101,199,184,300,1320,2257,6,15668,870,0,2,8,4,0
19289,212,5103,1508,847,911,44,250,301,1552,14,148,88,169,162,257,1120,1886,7,15077,837,0,2,8,4,0
19290,113,2492,1043,504,840,53,9,147,1096,9,180,112,198,189,310,1377,2344,4,11604,644,0,2,6,1,0
19291,113,2492,383,288,292,26,6,62,409,11,65,38,67,76,105,429,656,5,3719,206,0,2,6,1,0
19292,81,3461,1289,550,1043,56,32,155,1345,10,167,93,185,177,278,1266,2075,5,11498,638,0,2,14,1,0
19293,193,3988,1943,715,1694,26,18,214,1969,12,185,120,237,197,357,1436,2721,7,20915,1161,0,2,17,6,1
19294,193,3988,1168,838,957,57,25,144,1225,19,348,224,416,367,640,3018,5452,11,61921,3440,1,2,17,6,1
19295,76,3899,1943,715,1694,26,18,214,1969,12,185,120,237,197,357,1436,2721,7,20915,1161,0,2,10,0,1
19296,213,4579,182,127,129,0,0,53,182,5,39,21,42,44,63,217,343,2,926,51,0,2,1,3,1
19297,213,4579,1165,710,800,67,119,181,1232,18,243,153,282,261,435,2000,3492,10,36473,2026,1,2,1,3,1
19298,102,2083,773,419,590,28,0,166,801,10,204,113,217,214,330,1598,2554,5,13587,754,0,2,2,1,1
19299,102,2083,421,273,302,44,34,57,465,17,81,59,107,98,166,583,1098,11,12329,684,0,2,2,1,1
19300,27,540,2,2,2,0,0,0,2,0,0,0,0,0,0,0,0,0,0,0,0,2,2,2,1
19301,27,540,99,48,90,1,3,5,100,0,0,0,0,0,0,0,0,0,0,0,0,2,2,2,1
19302,27,540,8,5,5,2,0,1,10,0,0,0,0,0,0,0,0,0,0,0,0,2,2,2,1
19303,27,540,1217,716,841,84,126,174,1301,14,185,118,215,199,333,1446,2542,8,20687,1149,0,2,2,2,1
19304,27,540,160,89,115,0,13,31,160,7,15,11,17,22,28,78,124,3,495,27,0,2,2,2,1
19305,27,540,10,10,9,9,0,0,19,0,0,0,0,0,0,0,0,0,0,0,0,2,2,2,1
19306,27,540,173,84,99,8,29,36,181,5,12,7,13,17,20,54,81,2,221,12,0,2,2,2,1
19307,27,540,3,1,1,3,0,0,6,0,0,0,0,0,0,0,0,0,0,0,0,2,2,2,1
19308,164,5068,1660,832,1314,41,38,274,1701,20,312,209,395,332,604,2671,5058,12,64042,3557,1,2,12,11,1
19309,164,5068,1057,646,719,113,100,145,1170,18,215,134,248,233,382,1740,3004,10,31186,1732,1,2,12,11,1
19310,17,345,95,58,50,9,16,20,104,12,33,24,45,45,69,209,378,8,3100,172,0,2,3,3,1
19311,86,1804,477,336,357,30,23,73,507,16,194,134,250,210,384,1538,2962,10,30538,1696,0,2,4,3,1
19312,132,2644,1513,682,1277,25,13,200,1538,11,199,116,219,210,335,1557,2584,6,15641,868,0,2,4,5,1
19313,132,2644,819,519,539,24,98,155,843,15,96,57,106,111,163,690,1107,8,9171,509,0,2,4,5,1
19314,349,7034,1457,730,1242,11,6,188,1468,10,292,166,329,302,495,2424,4078,5,22973,1276,1,2,5,4,1
19315,349,7034,74,35,59,1,0,14,75,3,14,7,14,17,21,58,85,1,128,7,0,2,5,4,1
19316,349,7034,245,125,200,5,7,34,250,7,30,17,34,37,51,166,265,3,1053,58,0,2,5,4,1
19317,184,4243,77,34,69,0,0,8,77,3,24,16,29,27,45,114,213,1,387,21,0,2,2,1,1
19318,184,4243,712,438,573,51,9,84,763,14,102,71,128,116,199,733,1364,8,11988,666,0,2,2,1,1
19319,46,957,447,308,343,6,5,95,453,7,96,59,111,103,170,651,1136,4,4600,255,0,2,4,5,1
19320,46,957,322,174,179,16,74,51,338,10,41,26,46,51,72,252,408,5,2291,127,0,2,4,5,1
19321,23,382,424,94,331,4,0,89,428,1,5,5,5,6,10,11,25,0,12,0,0,2,1,2,1
19322,23,382,38,23,23,6,0,8,44,3,11,7,11,14,18,42,68,1,102,5,0,2,1,2,1
19323,17,518,184,100,137,2,15,30,186,6,38,20,39,44,59,214,322,3,991,55,0,2,2,2,1
19324,17,518,103,65,74,8,5,16,111,7,17,9,17,24,26,89,119,3,417,23,0,2,2,2,1
19325,212,5055,722,423,573,19,0,135,741,12,172,101,199,184,300,1320,2257,6,15668,870,0,2,6,5,1
19326,212,5055,1508,847,911,44,250,301,1552,14,148,88,169,162,257,1120,1886,7,15077,837,0,2,6,5,1
19327,255,6147,72,33,56,0,4,12,72,1,1,1,1,2,2,0,2,0,1,0,0,2,4,3,1
19328,255,6147,1454,835,1044,76,110,219,1530,17,275,158,296,292,454,2297,3718,9,34017,1889,1,2,4,3,1
19329,129,2871,1043,504,840,53,9,147,1096,9,180,112,198,189,310,1377,2344,4,11604,644,0,2,1,1,1
19330,129,2871,383,288,292,26,6,62,409,11,65,38,67,76,105,429,656,5,3719,206,0,2,1,1,1
19331,103,1953,1178,367,1042,6,15,115,1184,9,94,51,95,103,146,644,976,4,4439,246,0,2,2,2,1
19332,103,1953,177,108,140,8,0,27,185,6,30,16,32,36,48,162,248,3,794,44,0,2,2,2,1
19333,192,3947,1943,715,1694,26,18,214,1969,12,185,120,237,197,357,1436,2721,7,20915,1161,0,2,4,3,1
19334,192,3947,1168,838,957,57,25,144,1225,19,348,224,416,367,640,3018,5452,11,61921,3440,1,2,4,3,1
19335,11,404,42,7,35,4,0,5,46,1,2,1,2,3,3,2,4,0,2,0,0,2,1,1,1
19336,11,404,11,6,10,0,0,1,11,2,4,2,4,6,6,10,15,1,15,0,0,2,1,1,1
19337,214,4586,182,127,129,0,0,53,182,5,39,21,42,44,63,217,343,2,926,51,0,2,1,3,0
19338,214,4586,1165,710,800,67,119,181,1232,18,243,153,282,261,435,2000,3492,10,36473,2026,1,2,1,3,0
19339,102,2083,773,419,590,28,0,166,801,10,204,113,217,214,330,1598,2554,5,13587,754,0,2,2,1,0
19340,102,2083,421,273,302,44,34,57,465,17,81,59,107,98,166,583,1098,11,12329,684,0,2,2,1,0
19341,27,540,2,2,2,0,0,0,2,0,0,0,0,0,0,0,0,0,0,0,0,2,2,2,0
19342,27,540,99,48,90,1,3,5,100,0,0,0,0,0,0,0,0,0,0,0,0,2,2,2,0
19343,27,540,8,5,5,2,0,1,10,0,0,0,0,0,0,0,0,0,0,0,0,2,2,2,0
19344,27,540,1217,716,841,84,126,174,1301,14,185,118,215,199,333,1446,2542,8,20687,1149,0,2,2,2,0
19345,27,540,160,89,115,0,13,31,160,7,15,11,17,22,28,78,124,3,495,27,0,2,2,2,0
19346,27,540,10,10,9,9,0,0,19,0,0,0,0,0,0,0,0,0,0,0,0,2,2,2,0
19347,27,540,173,84,99,8,29,36,181,5,12,7,13,17,20,54,81,2,221,12,0,2,2,2,0
19348,27,540,3,1,1,3,0,0,6,0,0,0,0,0,0,0,0,0,0,0,0,2,2,2,0
19349,164,5068,1660,832,1314,41,38,274,1701,20,312,209,395,332,604,2671,5058,12,64042,3557,1,2,12,11,0
19350,164,5068,1057,646,719,113,100,145,1170,18,215,134,248,233,382,1740,3004,10,31186,1732,1,2,12,11,0
19351,17,345,95,58,50,9,16,20,104,12,33,24,45,45,69,209,378,8,3100,172,0,2,3,3,0
19352,86,1804,477,336,357,30,23,73,507,16,194,134,250,210,384,1538,2962,10,30538,1696,0,2,4,3,0
19353,132,2644,1513,682,1277,25,13,200,1538,11,199,116,219,210,335,1557,2584,6,15641,868,0,2,4,5,0
19354,132,2644,819,519,539,24,98,155,843,15,96,57,106,111,163,690,1107,8,9171,509,0,2,4,5,0
19355,347,7004,1457,730,1242,11,6,188,1468,10,292,166,329,302,495,2424,4078,5,22973,1276,1,2,5,4,0
19356,347,7004,74,35,59,1,0,14,75,3,14,7,14,17,21,58,85,1,128,7,0,2,5,4,0
19357,347,7004,245,125,200,5,7,34,250,7,30,17,34,37,51,166,265,3,1053,58,0,2,5,4,0
19358,178,4128,77,34,69,0,0,8,77,3,24,16,29,27,45,114,213,1,387,21,0,2,2,1,0
19359,178,4128,712,438,573,51,9,84,763,14,102,71,128,116,199,733,1364,8,11988,666,0,2,2,1,0
19360,46,957,447,308,343,6,5,95,453,7,96,59,111,103,170,651,1136,4,4600,255,0,2,4,5,0
19361,46,957,322,174,179,16,74,51,338,10,41,26,46,51,72,252,408,5,2291,127,0,2,4,5,0
19362,23,382,424,94,331,4,0,89,428,1,5,5,5,6,10,11,25,0,12,0,0,2,1,2,0
19363,23,382,38,23,23,6,0,8,44,3,11,7,11,14,18,42,68,1,102,5,0,2,1,2,0
19364,17,518,184,100,137,2,15,30,186,6,38,20,39,44,59,214,322,3,991,55,0,2,2,2,0
19365,17,518,103,65,74,8,5,16,111,7,17,9,17,24,26,89,119,3,417,23,0,2,2,2,0
19366,211,5043,722,423,573,19,0,135,741,12,172,101,199,184,300,1320,2257,6,15668,870,0,2,6,5,0
19367,211,5043,1508,847,911,44,250,301,1552,14,148,88,169,162,257,1120,1886,7,15077,837,0,2,6,5,0
19368,255,6147,72,33,56,0,4,12,72,1,1,1,1,2,2,0,2,0,1,0,0,2,4,3,0
19369,255,6147,1454,835,1044,76,110,219,1530,17,275,158,296,292,454,2297,3718,9,34017,1889,1,2,4,3,0
19370,112,2466,1043,504,840,53,9,147,1096,9,180,112,198,189,310,1377,2344,4,11604,644,0,2,1,1,0
19371,112,2466,383,288,292,26,6,62,409,11,65,38,67,76,105,429,656,5,3719,206,0,2,1,1,0
19372,102,1928,1178,367,1042,6,15,115,1184,9,94,51,95,103,146,644,976,4,4439,246,0,2,2,2,0
19373,102,1928,177,108,140,8,0,27,185,6,30,16,32,36,48,162,248,3,794,44,0,2,2,2,0
19374,192,3947,1943,715,1694,26,18,214,1969,12,185,120,237,197,357,1436,2721,7,20915,1161,0,2,4,3,0
19375,192,3947,1168,838,957,57,25,144,1225,19,348,224,416,367,640,3018,5452,11,61921,3440,1,2,4,3,0
19376,11,412,42,7,35,4,0,5,46,1,2,1,2,3,3,2,4,0,2,0,0,2,1,1,0
19377,11,412,11,6,10,0,0,1,11,2,4,2,4,6,6,10,15,1,15,0,0,2,1,1,0
19378,193,3988,1943,715,1694,26,18,214,1969,12,185,120,237,197,357,1436,2721,7,20915,1161,0,2,17,6,0
19379,193,3988,1168,838,957,57,25,144,1225,19,348,224,416,367,640,3018,5452,11,61921,3440,1,2,17,6,0
19380,76,3899,1943,715,1694,26,18,214,1969,12,185,120,237,197,357,1436,2721,7,20915,1161,0,2,10,0,0
19381,351,7048,1457,730,1242,11,6,188,1468,10,292,166,329,302,495,2424,4078,5,22973,1276,1,2,15,10,0
19382,351,7048,74,35,59,1,0,14,75,3,14,7,14,17,21,58,85,1,128,7,0,2,15,10,0
19383,351,7048,245,125,200,5,7,34,250,7,30,17,34,37,51,166,265,3,1053,58,0,2,15,10,0
19384,79,4191,1457,730,1242,11,6,188,1468,10,292,166,329,302,495,2424,4078,5,22973,1276,1,2,11,1,0
19385,351,7048,1457,730,1242,11,6,188,1468,10,292,166,329,302,495,2424,4078,5,22973,1276,1,2,15,10,0
19386,351,7048,74,35,59,1,0,14,75,3,14,7,14,17,21,58,85,1,128,7,0,2,15,10,0
19387,351,7048,245,125,200,5,7,34,250,7,30,17,34,37,51,166,265,3,1053,58,0,2,15,10,0
19388,79,4191,1457,730,1242,11,6,188,1468,10,292,166,329,302,495,2424,4078,5,22973,1276,1,2,11,1,0
19389,133,2659,1513,682,1277,25,13,200,1538,11,199,116,219,210,335,1557,2584,6,15641,868,0,2,11,4,0
19390,133,2659,819,519,539,24,98,155,843,15,96,57,106,111,163,690,1107,8,9171,509,0,2,11,4,0
19391,120,4833,1513,682,1277,25,13,200,1538,11,199,116,219,210,335,1557,2584,6,15641,868,0,2,17,0,0
19392,133,2659,1513,682,1277,25,13,200,1538,11,199,116,219,210,335,1557,2584,6,15641,868,0,2,11,4,0
19393,133,2659,819,519,539,24,98,155,843,15,96,57,106,111,163,690,1107,8,9171,509,0,2,11,4,0
19394,120,4833,1513,682,1277,25,13,200,1538,11,199,116,219,210,335,1557,2584,6,15641,868,0,2,17,0,0
19395,93,1794,1020,354,843,12,15,144,1032,8,134,77,144,142,221,970,1580,4,6792,377,0,2,0,4,1
19396,255,6154,72,33,56,0,4,12,72,1,1,1,1,2,2,0,2,0,1,0,0,2,14,8,1
19397,255,6154,1454,835,1044,76,110,219,1530,17,275,158,296,292,454,2297,3718,9,34017,1889,1,2,14,8,1
19398,132,5724,1782,648,1425,9,47,279,1791,8,171,97,189,179,286,1292,2140,4,9462,525,0,2,1,1,1
19399,229,5176,4293,999,3693,19,54,507,4312,9,155,88,170,164,258,1156,1898,4,9368,520,0,2,2,1,0
19400,229,5176,1482,859,1002,125,135,219,1607,16,219,134,251,235,385,1766,3032,9,27804,1544,1,2,2,1,0
19401,229,5176,4293,999,3693,19,54,507,4312,9,155,88,170,164,258,1156,1898,4,9368,520,0,2,2,1,0
19402,229,5176,1482,859,1002,125,135,219,1607,16,219,134,251,235,385,1766,3032,9,27804,1544,1,2,2,1,0
19403,106,1993,1178,367,1042,6,15,115,1184,9,94,51,95,103,146,644,976,4,4439,246,0,2,14,3,0
19404,106,1993,177,108,140,8,0,27,185,6,30,16,32,36,48,162,248,3,794,44,0,2,14,3,0
19405,72,3050,1178,367,1042,6,15,115,1184,9,94,51,95,103,146,644,976,4,4439,246,0,2,22,0,0
19406,93,1794,1020,354,843,12,15,144,1032,8,134,77,144,142,221,970,1580,4,6792,377,0,2,0,4,0
19407,255,6154,72,33,56,0,4,12,72,1,1,1,1,2,2,0,2,0,1,0,0,2,14,8,0
19408,255,6154,1454,835,1044,76,110,219,1530,17,275,158,296,292,454,2297,3718,9,34017,1889,1,2,14,8,0
19409,132,5724,1782,648,1425,9,47,279,1791,8,171,97,189,179,286,1292,2140,4,9462,525,0,2,1,1,0
19410,106,1993,1178,367,1042,6,15,115,1184,9,94,51,95,103,146,644,976,4,4439,246,0,2,14,3,0
19411,106,1993,177,108,140,8,0,27,185,6,30,16,32,36,48,162,248,3,794,44,0,2,14,3,0
19412,72,3050,1178,367,1042,6,15,115,1184,9,94,51,95,103,146,644,976,4,4439,246,0,2,22,0,0
19413,75,1461,757,253,292,73,244,162,830,13,61,38,67,74,105,409,651,7,4654,258,0,2,12,3,0
19414,75,1461,757,253,292,73,244,162,830,13,61,38,67,74,105,409,651,7,4654,258,0,2,12,3,0
19415,58,1227,207,111,150,11,0,50,218,5,26,19,36,31,55,133,272,3,943,52,0,2,4,1,1
19416,58,1227,410,198,237,31,55,97,441,11,63,38,72,74,110,414,683,6,4293,238,0,2,4,1,1
19417,228,5164,4293,999,3693,19,54,507,4312,9,155,88,170,164,258,1156,1898,4,9368,520,0,2,1,5,1
19418,228,5164,1482,859,1002,125,135,219,1607,16,219,134,251,235,385,1766,3032,9,27804,1544,1,2,1,5,1
19419,98,4450,1338,495,1086,10,64,173,1348,11,122,82,157,133,239,883,1686,7,11934,663,0,2,12,2,1
19420,162,7089,139,89,101,2,0,35,141,7,54,34,62,61,96,330,569,4,2287,127,0,2,6,0,1
19421,162,7089,7,5,5,0,0,2,7,1,2,1,2,3,3,2,4,0,2,0,0,2,6,0,1
19422,55,1193,207,111,150,11,0,50,218,5,26,19,36,31,55,133,272,3,943,52,0,2,5,2,1
19423,55,1193,410,198,237,31,55,97,441,11,63,38,72,74,110,414,683,6,4293,238,0,2,5,2,1
19424,14,341,207,111,150,11,0,50,218,5,26,19,36,31,55,133,272,3,943,52,0,2,26,1,1
19425,11,414,42,7,35,4,0,5,46,1,2,1,2,3,3,2,4,0,2,0,0,2,1,1,0
19426,11,414,11,6,10,0,0,1,11,2,4,2,4,6,6,10,15,1,15,0,0,2,1,1,0
19427,11,412,42,7,35,4,0,5,46,1,2,1,2,3,3,2,4,0,2,0,0,2,1,1,0
19428,11,412,11,6,10,0,0,1,11,2,4,2,4,6,6,10,15,1,15,0,0,2,1,1,0
19429,347,7004,1457,730,1242,11,6,188,1468,10,292,166,329,302,495,2424,4078,5,22973,1276,1,2,2,2,0
19430,347,7004,74,35,59,1,0,14,75,3,14,7,14,17,21,58,85,1,128,7,0,2,2,2,0
19431,347,7004,245,125,200,5,7,34,250,7,30,17,34,37,51,166,265,3,1053,58,0,2,2,2,0
19432,347,7002,1457,730,1242,11,6,188,1468,10,292,166,329,302,495,2424,4078,5,22973,1276,1,2,3,3,0
19433,347,7002,74,35,59,1,0,14,75,3,14,7,14,17,21,58,85,1,128,7,0,2,3,3,0
19434,347,7002,245,125,200,5,7,34,250,7,30,17,34,37,51,166,265,3,1053,58,0,2,3,3,0
19435,50,584,647,139,84,35,284,233,682,0,0,0,0,0,0,0,0,0,0,0,0,2,1,1,0
19436,255,6150,72,33,56,0,4,12,72,1,1,1,1,2,2,0,2,0,1,0,0,2,1,1,0
19437,255,6150,1454,835,1044,76,110,219,1530,17,275,158,296,292,454,2297,3718,9,34017,1889,1,2,1,1,0
19438,192,3943,1943,715,1694,26,18,214,1969,12,185,120,237,197,357,1436,2721,7,20915,1161,0,2,1,2,0
19439,192,3943,1168,838,957,57,25,144,1225,19,348,224,416,367,640,3018,5452,11,61921,3440,1,2,1,2,0
19440,75,3806,1943,715,1694,26,18,214,1969,12,185,120,237,197,357,1436,2721,7,20915,1161,0,2,1,1,0
19441,11,412,42,7,35,4,0,5,46,1,2,1,2,3,3,2,4,0,2,0,0,2,1,1,0
19442,11,412,11,6,10,0,0,1,11,2,4,2,4,6,6,10,15,1,15,0,0,2,1,1,0
19443,347,7002,1457,730,1242,11,6,188,1468,10,292,166,329,302,495,2424,4078,5,22973,1276,1,2,3,3,0
19444,347,7002,74,35,59,1,0,14,75,3,14,7,14,17,21,58,85,1,128,7,0,2,3,3,0
19445,347,7002,245,125,200,5,7,34,250,7,30,17,34,37,51,166,265,3,1053,58,0,2,3,3,0
19446,50,584,647,139,84,35,284,233,682,0,0,0,0,0,0,0,0,0,0,0,0,2,1,1,0
19447,255,6150,72,33,56,0,4,12,72,1,1,1,1,2,2,0,2,0,1,0,0,2,1,1,0
19448,255,6150,1454,835,1044,76,110,219,1530,17,275,158,296,292,454,2297,3718,9,34017,1889,1,2,1,1,0
19449,192,3943,1943,715,1694,26,18,214,1969,12,185,120,237,197,357,1436,2721,7,20915,1161,0,2,1,2,0
19450,192,3943,1168,838,957,57,25,144,1225,19,348,224,416,367,640,3018,5452,11,61921,3440,1,2,1,2,0
19451,11,412,42,7,35,4,0,5,46,1,2,1,2,3,3,2,4,0,2,0,0,2,2,2,0
19452,11,412,11,6,10,0,0,1,11,2,4,2,4,6,6,10,15,1,15,0,0,2,2,2,0
19453,75,3806,1943,715,1694,26,18,214,1969,12,185,120,237,197,357,1436,2721,7,20915,1161,0,2,1,1,0
19454,54,1170,207,111,150,11,0,50,218,5,26,19,36,31,55,133,272,3,943,52,0,2,1,8,0
19455,54,1170,410,198,237,31,55,97,441,11,63,38,72,74,110,414,683,6,4293,238,0,2,1,8,0
19456,214,4608,182,127,129,0,0,53,182,5,39,21,42,44,63,217,343,2,926,51,0,2,1,1,1
19457,214,4608,1165,710,800,67,119,181,1232,18,243,153,282,261,435,2000,3492,10,36473,2026,1,2,1,1,1
19458,36,1085,182,127,129,0,0,53,182,5,39,21,42,44,63,217,343,2,926,51,0,2,22,0,1
19459,55,1193,207,111,150,11,0,50,218,5,26,19,36,31,55,133,272,3,943,52,0,2,5,2,0
19460,55,1193,410,198,237,31,55,97,441,11,63,38,72,74,110,414,683,6,4293,238,0,2,5,2,0
19461,14,341,207,111,150,11,0,50,218,5,26,19,36,31,55,133,272,3,943,52,0,2,26,1,0
19462,214,4608,182,127,129,0,0,53,182,5,39,21,42,44,63,217,343,2,926,51,0,2,1,1,0
19463,214,4608,1165,710,800,67,119,181,1232,18,243,153,282,261,435,2000,3492,10,36473,2026,1,2,1,1,0
19464,36,1085,182,127,129,0,0,53,182,5,39,21,42,44,63,217,343,2,926,51,0,2,22,0,0
19465,212,5013,722,423,573,19,0,135,741,12,172,101,199,184,300,1320,2257,6,15668,870,0,2,11,16,1
19466,212,5013,1508,847,911,44,250,301,1552,14,148,88,169,162,257,1120,1886,7,15077,837,0,2,11,16,1
19467,16,677,722,423,573,19,0,135,741,12,172,101,199,184,300,1320,2257,6,15668,870,0,2,11,0,1
19468,7,281,75,38,59,1,3,12,76,2,4,2,4,6,6,10,15,1,15,0,0,2,4,1,0
19469,7,281,75,38,59,1,3,12,76,2,4,2,4,6,6,10,15,1,15,0,0,2,4,1,0
19470,212,5013,722,423,573,19,0,135,741,12,172,101,199,184,300,1320,2257,6,15668,870,0,2,11,16,0
19471,212,5013,1508,847,911,44,250,301,1552,14,148,88,169,162,257,1120,1886,7,15077,837,0,2,11,16,0
19472,16,677,722,423,573,19,0,135,741,12,172,101,199,184,300,1320,2257,6,15668,870,0,2,11,0,0
19473,12,424,42,7,35,4,0,5,46,1,2,1,2,3,3,2,4,0,2,0,0,2,5,1,0
19474,12,424,11,6,10,0,0,1,11,2,4,2,4,6,6,10,15,1,15,0,0,2,5,1,0
19475,345,6927,1457,730,1242,11,6,188,1468,10,292,166,329,302,495,2424,4078,5,22973,1276,1,2,0,11,1
19476,345,6927,74,35,59,1,0,14,75,3,14,7,14,17,21,58,85,1,128,7,0,2,0,11,1
19477,345,6927,245,125,200,5,7,34,250,7,30,17,34,37,51,166,265,3,1053,58,0,2,0,11,1
19478,98,4449,1338,495,1086,10,64,173,1348,11,122,82,157,133,239,883,1686,7,11934,663,0,2,5,3,1
19479,72,3755,1296,573,1062,40,33,157,1336,8,201,118,231,209,349,1561,2689,4,12365,686,0,2,5,3,1
19480,33,1889,384,251,317,7,8,52,391,11,70,44,84,81,128,467,811,6,5355,297,0,2,0,17,1
19481,75,2972,1043,504,840,53,9,147,1096,9,180,112,198,189,310,1377,2344,4,11604,644,0,2,7,5,1
19482,48,1795,1098,241,925,5,10,155,1103,7,46,25,49,53,74,273,423,3,1580,87,0,2,4,2,1
19483,39,1758,386,256,301,16,9,68,402,4,59,35,69,63,104,355,621,2,1453,80,0,2,22,0,1
19484,57,1218,207,111,150,11,0,50,218,5,26,19,36,31,55,133,272,3,943,52,0,2,15,1,0
19485,57,1218,410,198,237,31,55,97,441,11,63,38,72,74,110,414,683,6,4293,238,0,2,15,1,0
19486,210,4982,722,423,573,19,0,135,741,12,172,101,199,184,300,1320,2257,6,15668,870,0,2,1,9,0
19487,210,4982,1508,847,911,44,250,301,1552,14,148,88,169,162,257,1120,1886,7,15077,837,0,2,1,9,0
19488,72,3743,1296,573,1062,40,33,157,1336,8,201,118,231,209,349,1561,2689,4,12365,686,0,2,0,1,0
19489,210,4982,722,423,573,19,0,135,741,12,172,101,199,184,300,1320,2257,6,15668,870,0,2,1,9,0
19490,210,4982,1508,847,911,44,250,301,1552,14,148,88,169,162,257,1120,1886,7,15077,837,0,2,1,9,0
19491,72,3743,1296,573,1062,40,33,157,1336,8,201,118,231,209,349,1561,2689,4,12365,686,0,2,0,1,0
19492,72,3755,1296,573,1062,40,33,157,1336,8,201,118,231,209,349,1561,2689,4,12365,686,0,2,1,1,0
19493,58,1228,207,111,150,11,0,50,218,5,26,19,36,31,55,133,272,3,943,52,0,2,5,0,1
19494,58,1228,410,198,237,31,55,97,441,11,63,38,72,74,110,414,683,6,4293,238,0,2,5,0,1
19495,214,4592,182,127,129,0,0,53,182,5,39,21,42,44,63,217,343,2,926,51,0,2,1,1,0
19496,214,4592,1165,710,800,67,119,181,1232,18,243,153,282,261,435,2000,3492,10,36473,2026,1,2,1,1,0
19497,133,2652,1513,682,1277,25,13,200,1538,11,199,116,219,210,335,1557,2584,6,15641,868,0,2,11,4,0
19498,133,2652,819,519,539,24,98,155,843,15,96,57,106,111,163,690,1107,8,9171,509,0,2,11,4,0
19499,55,1193,207,111,150,11,0,50,218,5,26,19,36,31,55,133,272,3,943,52,0,2,5,2,0
19500,55,1193,410,198,237,31,55,97,441,11,63,38,72,74,110,414,683,6,4293,238,0,2,5,2,0
19501,349,7008,1457,730,1242,11,6,188,1468,10,292,166,329,302,495,2424,4078,5,22973,1276,1,2,15,10,0
19502,349,7008,74,35,59,1,0,14,75,3,14,7,14,17,21,58,85,1,128,7,0,2,15,10,0
19503,349,7008,245,125,200,5,7,34,250,7,30,17,34,37,51,166,265,3,1053,58,0,2,15,10,0
19504,229,5176,4293,999,3693,19,54,507,4312,9,155,88,170,164,258,1156,1898,4,9368,520,0,2,2,1,0
19505,229,5176,1482,859,1002,125,135,219,1607,16,219,134,251,235,385,1766,3032,9,27804,1544,1,2,2,1,0
19506,210,5022,722,423,573,19,0,135,741,12,172,101,199,184,300,1320,2257,6,15668,870,0,2,8,4,0
19507,210,5022,1508,847,911,44,250,301,1552,14,148,88,169,162,257,1120,1886,7,15077,837,0,2,8,4,0
19508,75,1461,757,253,292,73,244,162,830,13,61,38,67,74,105,409,651,7,4654,258,0,2,12,3,0
19509,113,2488,1043,504,840,53,9,147,1096,9,180,112,198,189,310,1377,2344,4,11604,644,0,2,6,1,0
19510,113,2488,383,288,292,26,6,62,409,11,65,38,67,76,105,429,656,5,3719,206,0,2,6,1,0
19511,193,3982,1943,715,1694,26,18,214,1969,12,185,120,237,197,357,1436,2721,7,20915,1161,0,2,17,6,0
19512,193,3982,1168,838,957,57,25,144,1225,19,348,224,416,367,640,3018,5452,11,61921,3440,1,2,17,6,0
19513,81,3461,1289,550,1043,56,32,155,1345,10,167,93,185,177,278,1266,2075,5,11498,638,0,2,14,1,0
19514,36,1085,182,127,129,0,0,53,182,5,39,21,42,44,63,217,343,2,926,51,0,2,22,0,0
19515,7,281,75,38,59,1,3,12,76,2,4,2,4,6,6,10,15,1,15,0,0,2,4,1,0
19516,120,4833,1513,682,1277,25,13,200,1538,11,199,116,219,210,335,1557,2584,6,15641,868,0,2,17,0,0
19517,14,341,207,111,150,11,0,50,218,5,26,19,36,31,55,133,272,3,943,52,0,2,26,1,0
19518,79,4191,1457,730,1242,11,6,188,1468,10,292,166,329,302,495,2424,4078,5,22973,1276,1,2,11,1,0
19519,76,3895,1943,715,1694,26,18,214,1969,12,185,120,237,197,357,1436,2721,7,20915,1161,0,2,10,0,0
19520,57,1224,207,111,150,11,0,50,218,5,26,19,36,31,55,133,272,3,943,52,0,2,15,8,0
19521,57,1224,410,198,237,31,55,97,441,11,63,38,72,74,110,414,683,6,4293,238,0,2,15,8,0
19522,58,1234,207,111,150,11,0,50,218,5,26,19,36,31,55,133,272,3,943,52,0,2,9,1,0
19523,58,1234,410,198,237,31,55,97,441,11,63,38,72,74,110,414,683,6,4293,238,0,2,9,1,0
19524,228,5164,4293,999,3693,19,54,507,4312,9,155,88,170,164,258,1156,1898,4,9368,520,0,2,1,5,0
19525,228,5164,1482,859,1002,125,135,219,1607,16,219,134,251,235,385,1766,3032,9,27804,1544,1,2,1,5,0
19526,98,4450,1338,495,1086,10,64,173,1348,11,122,82,157,133,239,883,1686,7,11934,663,0,2,12,2,0
19527,162,7089,139,89,101,2,0,35,141,7,54,34,62,61,96,330,569,4,2287,127,0,2,6,0,0
19528,162,7089,7,5,5,0,0,2,7,1,2,1,2,3,3,2,4,0,2,0,0,2,6,0,0
19529,214,4592,182,127,129,0,0,53,182,5,39,21,42,44,63,217,343,2,926,51,0,2,1,1,0
19530,214,4592,1165,710,800,67,119,181,1232,18,243,153,282,261,435,2000,3492,10,36473,2026,1,2,1,1,0
19531,133,2652,1513,682,1277,25,13,200,1538,11,199,116,219,210,335,1557,2584,6,15641,868,0,2,11,4,0
19532,133,2652,819,519,539,24,98,155,843,15,96,57,106,111,163,690,1107,8,9171,509,0,2,11,4,0
19533,57,1224,207,111,150,11,0,50,218,5,26,19,36,31,55,133,272,3,943,52,0,2,20,10,0
19534,57,1224,410,198,237,31,55,97,441,11,63,38,72,74,110,414,683,6,4293,238,0,2,20,10,0
19535,347,6933,1457,730,1242,11,6,188,1468,10,292,166,329,302,495,2424,4078,5,22973,1276,1,2,15,10,0
19536,347,6933,74,35,59,1,0,14,75,3,14,7,14,17,21,58,85,1,128,7,0,2,15,10,0
19537,347,6933,245,125,200,5,7,34,250,7,30,17,34,37,51,166,265,3,1053,58,0,2,15,10,0
19538,229,5176,4293,999,3693,19,54,507,4312,9,155,88,170,164,258,1156,1898,4,9368,520,0,2,2,1,0
19539,229,5176,1482,859,1002,125,135,219,1607,16,219,134,251,235,385,1766,3032,9,27804,1544,1,2,2,1,0
19540,210,5022,722,423,573,19,0,135,741,12,172,101,199,184,300,1320,2257,6,15668,870,0,2,9,13,0
19541,210,5022,1508,847,911,44,250,301,1552,14,148,88,169,162,257,1120,1886,7,15077,837,0,2,9,13,0
19542,75,1461,757,253,292,73,244,162,830,13,61,38,67,74,105,409,651,7,4654,258,0,2,12,3,0
19543,113,2488,1043,504,840,53,9,147,1096,9,180,112,198,189,310,1377,2344,4,11604,644,0,2,6,1,0
19544,113,2488,383,288,292,26,6,62,409,11,65,38,67,76,105,429,656,5,3719,206,0,2,6,1,0
19545,193,3982,1943,715,1694,26,18,214,1969,12,185,120,237,197,357,1436,2721,7,20915,1161,0,2,17,6,0
19546,193,3982,1168,838,957,57,25,144,1225,19,348,224,416,367,640,3018,5452,11,61921,3440,1,2,17,6,0
19547,81,3461,1289,550,1043,56,32,155,1345,10,167,93,185,177,278,1266,2075,5,11498,638,0,2,14,1,0
19548,36,1085,182,127,129,0,0,53,182,5,39,21,42,44,63,217,343,2,926,51,0,2,22,0,0
19549,7,281,75,38,59,1,3,12,76,2,4,2,4,6,6,10,15,1,15,0,0,2,4,1,0
19550,120,4833,1513,682,1277,25,13,200,1538,11,199,116,219,210,335,1557,2584,6,15641,868,0,2,17,0,0
19551,72,3743,1296,573,1062,40,33,157,1336,8,201,118,231,209,349,1561,2689,4,12365,686,0,2,0,1,0
19552,14,341,207,111,150,11,0,50,218,5,26,19,36,31,55,133,272,3,943,52,0,2,26,1,0
19553,79,4191,1457,730,1242,11,6,188,1468,10,292,166,329,302,495,2424,4078,5,22973,1276,1,2,11,1,0
19554,76,3895,1943,715,1694,26,18,214,1969,12,185,120,237,197,357,1436,2721,7,20915,1161,0,2,10,0,0
19555,347,6933,1457,730,1242,11,6,188,1468,10,292,166,329,302,495,2424,4078,5,22973,1276,1,2,0,11,0
19556,347,6933,74,35,59,1,0,14,75,3,14,7,14,17,21,58,85,1,128,7,0,2,0,11,0
19557,347,6933,245,125,200,5,7,34,250,7,30,17,34,37,51,166,265,3,1053,58,0,2,0,11,0
19558,12,424,42,7,35,4,0,5,46,1,2,1,2,3,3,2,4,0,2,0,0,2,5,1,0
19559,12,424,11,6,10,0,0,1,11,2,4,2,4,6,6,10,15,1,15,0,0,2,5,1,0
19560,98,4449,1338,495,1086,10,64,173,1348,11,122,82,157,133,239,883,1686,7,11934,663,0,2,5,3,0
19561,72,3743,1296,573,1062,40,33,157,1336,8,201,118,231,209,349,1561,2689,4,12365,686,0,2,5,3,0
19562,33,1889,384,251,317,7,8,52,391,11,70,44,84,81,128,467,811,6,5355,297,0,2,0,17,0
19563,75,2972,1043,504,840,53,9,147,1096,9,180,112,198,189,310,1377,2344,4,11604,644,0,2,7,5,0
19564,48,1795,1098,241,925,5,10,155,1103,7,46,25,49,53,74,273,423,3,1580,87,0,2,4,2,0
19565,46,954,386,256,301,16,9,68,402,4,59,35,69,63,104,355,621,2,1453,80,0,2,22,5,1
19566,46,954,264,131,164,11,41,46,275,6,38,22,40,44,62,214,338,3,1068,59,0,2,22,5,1
19567,39,1774,386,256,301,16,9,68,402,4,59,35,69,63,104,355,621,2,1453,80,0,2,10,8,1
19568,46,954,386,256,301,16,9,68,402,4,59,35,69,63,104,355,621,2,1453,80,0,2,16,0,0
19569,46,954,264,131,164,11,41,46,275,6,38,22,40,44,62,214,338,3,1068,59,0,2,16,0,0
19570,46,954,386,256,301,16,9,68,402,4,59,35,69,63,104,355,621,2,1453,80,0,2,38,5,0
19571,46,954,264,131,164,11,41,46,275,6,38,22,40,44,62,214,338,3,1068,59,0,2,38,5,0
19572,39,1774,386,256,301,16,9,68,402,4,59,35,69,63,104,355,621,2,1453,80,0,2,24,0,0
19573,11,235,19,8,11,5,0,4,24,2,5,3,6,7,9,13,25,1,30,1,0,2,3,2,0
19574,11,235,102,59,69,5,3,24,107,6,22,15,28,28,43,113,206,3,789,43,0,2,3,2,0
19575,11,235,106,40,36,3,49,17,109,8,17,13,23,25,36,93,167,5,904,50,0,2,3,2,0
19576,23,607,102,59,69,5,3,24,107,6,22,15,28,28,43,113,206,3,789,43,0,2,1,1,0
19577,60,1265,207,111,150,11,0,50,218,5,26,19,36,31,55,133,272,3,943,52,0,2,9,1,0
19578,60,1265,410,198,237,31,55,97,441,11,63,38,72,74,110,414,683,6,4293,238,0,2,9,1,0
19579,228,5164,4293,999,3693,19,54,507,4312,9,155,88,170,164,258,1156,1898,4,9368,520,0,2,1,5,0
19580,228,5164,1482,859,1002,125,135,219,1607,16,219,134,251,235,385,1766,3032,9,27804,1544,1,2,1,5,0
19581,98,4450,1338,495,1086,10,64,173,1348,11,122,82,157,133,239,883,1686,7,11934,663,0,2,12,2,0
19582,162,7089,139,89,101,2,0,35,141,7,54,34,62,61,96,330,569,4,2287,127,0,2,6,0,0
19583,162,7089,7,5,5,0,0,2,7,1,2,1,2,3,3,2,4,0,2,0,0,2,6,0,0
19584,96,1828,1020,354,843,12,15,144,1032,8,134,77,144,142,221,970,1580,4,6792,377,0,2,1,1,1
19585,73,3219,1020,354,843,12,15,144,1032,8,134,77,144,142,221,970,1580,4,6792,377,0,2,12,0,1
19586,96,1828,1020,354,843,12,15,144,1032,8,134,77,144,142,221,970,1580,4,6792,377,0,2,1,1,0
19587,73,3219,1020,354,843,12,15,144,1032,8,134,77,144,142,221,970,1580,4,6792,377,0,2,12,0,0
19588,87,2923,773,419,590,28,0,166,801,10,204,113,217,214,330,1598,2554,5,13587,754,0,2,0,1,0
19589,87,2923,773,419,590,28,0,166,801,10,204,113,217,214,330,1598,2554,5,13587,754,0,2,0,1,0
19590,189,4316,77,34,69,0,0,8,77,3,24,16,29,27,45,114,213,1,387,21,0,2,10,0,0
19591,189,4316,712,438,573,51,9,84,763,14,102,71,128,116,199,733,1364,8,11988,666,0,2,10,0,0
19592,81,3472,1289,550,1043,56,32,155,1345,10,167,93,185,177,278,1266,2075,5,11498,638,0,2,3,1,0
19593,11,235,19,8,11,5,0,4,24,2,5,3,6,7,9,13,25,1,30,1,0,2,3,2,0
19594,11,235,102,59,69,5,3,24,107,6,22,15,28,28,43,113,206,3,789,43,0,2,3,2,0
19595,11,235,106,40,36,3,49,17,109,8,17,13,23,25,36,93,167,5,904,50,0,2,3,2,0
19596,23,607,102,59,69,5,3,24,107,6,22,15,28,28,43,113,206,3,789,43,0,2,1,1,0
19597,11,235,19,8,11,5,0,4,24,2,5,3,6,7,9,13,25,1,30,1,0,2,3,2,0
19598,11,235,102,59,69,5,3,24,107,6,22,15,28,28,43,113,206,3,789,43,0,2,3,2,0
19599,11,235,106,40,36,3,49,17,109,8,17,13,23,25,36,93,167,5,904,50,0,2,3,2,0
19600,94,1803,1020,354,843,12,15,144,1032,8,134,77,144,142,221,970,1580,4,6792,377,0,2,1,1,0
19601,87,2923,773,419,590,28,0,166,801,10,204,113,217,214,330,1598,2554,5,13587,754,0,2,0,1,0
19602,23,607,102,59,69,5,3,24,107,6,22,15,28,28,43,113,206,3,789,43,0,2,1,1,0
19603,73,3219,1020,354,843,12,15,144,1032,8,134,77,144,142,221,970,1580,4,6792,377,0,2,12,0,0
19604,98,4450,1338,495,1086,10,64,173,1348,11,122,82,157,133,239,883,1686,7,11934,663,0,2,1,1,1
19605,256,6158,72,33,56,0,4,12,72,1,1,1,1,2,2,0,2,0,1,0,0,2,18,20,0
19606,256,6158,1454,835,1044,76,110,219,1530,17,275,158,296,292,454,2297,3718,9,34017,1889,1,2,18,20,0
19607,6,329,180,34,164,0,0,16,180,1,12,6,12,13,18,43,66,0,33,1,0,2,21,0,0
19608,345,6924,1457,730,1242,11,6,188,1468,10,292,166,329,302,495,2424,4078,5,22973,1276,1,2,6,6,0
19609,345,6924,74,35,59,1,0,14,75,3,14,7,14,17,21,58,85,1,128,7,0,2,6,6,0
19610,345,6924,245,125,200,5,7,34,250,7,30,17,34,37,51,166,265,3,1053,58,0,2,6,6,0
19611,33,1914,384,251,317,7,8,52,391,11,70,44,84,81,128,467,811,6,5355,297,0,2,8,3,1
19612,256,6158,72,33,56,0,4,12,72,1,1,1,1,2,2,0,2,0,1,0,0,2,18,20,0
19613,256,6158,1454,835,1044,76,110,219,1530,17,275,158,296,292,454,2297,3718,9,34017,1889,1,2,18,20,0
19614,6,329,180,34,164,0,0,16,180,1,12,6,12,13,18,43,66,0,33,1,0,2,21,0,0
19615,11,235,19,8,11,5,0,4,24,2,5,3,6,7,9,13,25,1,30,1,0,2,3,2,0
19616,11,235,102,59,69,5,3,24,107,6,22,15,28,28,43,113,206,3,789,43,0,2,3,2,0
19617,11,235,106,40,36,3,49,17,109,8,17,13,23,25,36,93,167,5,904,50,0,2,3,2,0
19618,94,1803,1020,354,843,12,15,144,1032,8,134,77,144,142,221,970,1580,4,6792,377,0,2,1,1,0
19619,87,2923,773,419,590,28,0,166,801,10,204,113,217,214,330,1598,2554,5,13587,754,0,2,0,1,0
19620,98,4450,1338,495,1086,10,64,173,1348,11,122,82,157,133,239,883,1686,7,11934,663,0,2,1,1,0
19621,23,607,102,59,69,5,3,24,107,6,22,15,28,28,43,113,206,3,789,43,0,2,1,1,0
19622,73,3219,1020,354,843,12,15,144,1032,8,134,77,144,142,221,970,1580,4,6792,377,0,2,12,0,0
19623,347,6933,1457,730,1242,11,6,188,1468,10,292,166,329,302,495,2424,4078,5,22973,1276,1,2,1,1,1
19624,347,6933,74,35,59,1,0,14,75,3,14,7,14,17,21,58,85,1,128,7,0,2,1,1,1
19625,347,6933,245,125,200,5,7,34,250,7,30,17,34,37,51,166,265,3,1053,58,0,2,1,1,1
19626,67,1798,773,422,505,30,103,129,803,14,77,46,83,91,129,535,839,7,6334,351,0,0,459,0,1
19627,67,1800,773,422,505,30,103,129,803,14,77,46,83,91,129,535,839,7,6334,351,0,2,1,1,0
19628,1,142,127,75,83,2,11,30,129,4,14,7,14,18,21,61,87,2,175,9,0,0,33,0,0
19629,1,142,652,304,544,16,6,88,668,6,89,51,101,95,152,591,998,3,3399,188,0,0,33,0,0
19630,1,142,2,2,2,0,0,0,2,0,0,0,0,0,0,0,0,0,0,0,0,0,33,0,0
19631,1,142,8,5,5,0,0,3,8,0,0,0,0,0,0,0,0,0,0,0,0,0,33,0,0
19632,1,142,2,2,2,0,0,0,2,0,0,0,0,0,0,0,0,0,0,0,0,0,33,0,0
19633,1,142,14,8,8,0,0,6,14,0,0,0,0,0,0,0,0,0,0,0,0,0,33,0,0
19634,1,142,6,4,4,0,0,2,6,0,0,0,0,0,0,0,0,0,0,0,0,0,33,0,0
19635,1,142,6,4,4,0,0,2,6,1,2,1,2,3,3,2,4,0,2,0,0,0,33,0,0
19636,1,142,6,4,4,0,0,2,6,0,0,0,0,0,0,0,0,0,0,0,0,0,33,0,0
19637,1,142,7,5,5,0,0,2,7,0,0,0,0,0,0,0,0,0,0,0,0,0,33,0,0
19638,1,142,6,4,4,0,0,2,6,0,0,0,0,0,0,0,0,0,0,0,0,0,33,0,0
19639,1,142,10,6,6,0,0,4,10,0,0,0,0,0,0,0,0,0,0,0,0,0,33,0,0
19640,1,142,1,1,1,0,0,0,1,0,0,0,0,0,0,0,0,0,0,0,0,0,33,0,0
19641,1,142,1,1,1,0,0,0,1,0,0,0,0,0,0,0,0,0,0,0,0,0,33,0,0
19642,1,142,14,10,10,0,0,4,14,1,1,1,1,2,2,0,2,0,1,0,0,0,33,0,0
19643,1,142,46,26,30,3,0,12,49,3,6,3,6,9,9,20,28,1,42,2,0,0,33,0,0
19644,3,143,207,111,150,11,0,50,218,5,26,19,36,31,55,133,272,3,943,52,0,0,80,0,0
19645,9,464,139,89,101,2,0,35,141,7,54,34,62,61,96,330,569,4,2287,127,0,0,99,0,0
19646,21,1023,1157,318,931,29,22,177,1186,6,104,63,125,110,188,712,1274,3,4596,255,0,0,398,0,0
19647,12,424,42,7,35,4,0,5,46,1,2,1,2,3,3,2,4,0,2,0,0,2,1,1,0
19648,12,424,11,6,10,0,0,1,11,2,4,2,4,6,6,10,15,1,15,0,0,2,1,1,0
19649,120,4833,1513,682,1277,25,13,200,1538,11,199,116,219,210,335,1557,2584,6,15641,868,0,2,0,2,0
19650,67,1769,773,422,505,30,103,129,803,14,77,46,83,91,129,535,839,7,6334,351,0,2,21,40,0
19651,67,1769,773,422,505,30,103,129,803,14,77,46,83,91,129,535,839,7,6334,351,0,2,2,2,0
19652,120,4833,1513,682,1277,25,13,200,1538,11,199,116,219,210,335,1557,2584,6,15641,868,0,2,0,1,0
19653,64,1733,773,422,505,30,103,129,803,14,77,46,83,91,129,535,839,7,6334,351,0,2,4,9,0
19654,63,1708,773,422,505,30,103,129,803,14,77,46,83,91,129,535,839,7,6334,351,0,2,16,23,0
19655,63,1707,773,422,505,30,103,129,803,14,77,46,83,91,129,535,839,7,6334,351,0,2,0,3,0
19656,62,1696,773,422,505,30,103,129,803,14,77,46,83,91,129,535,839,7,6334,351,0,2,20,18,1
19657,62,1696,773,422,505,30,103,129,803,14,77,46,83,91,129,535,839,7,6334,351,0,2,4,4,0
19658,62,1692,773,422,505,30,103,129,803,14,77,46,83,91,129,535,839,7,6334,351,0,2,4,4,0
19659,62,1704,773,422,505,30,103,129,803,14,77,46,83,91,129,535,839,7,6334,351,0,2,4,4,0
19660,62,1710,773,422,505,30,103,129,803,14,77,46,83,91,129,535,839,7,6334,351,0,2,7,4,0
19661,62,1694,773,422,505,30,103,129,803,14,77,46,83,91,129,535,839,7,6334,351,0,2,1,3,0
19662,62,1696,773,422,505,30,103,129,803,14,77,46,83,91,129,535,839,7,6334,351,0,2,7,8,1
19663,60,1687,773,422,505,30,103,129,803,14,77,46,83,91,129,535,839,7,6334,351,0,2,16,16,0
19664,60,1685,773,422,505,30,103,129,803,14,77,46,83,91,129,535,839,7,6334,351,0,2,1,1,0
19665,48,1364,773,422,505,30,103,129,803,14,77,46,83,91,129,535,839,7,6334,351,0,2,6,75,0
19666,7,392,139,89,101,2,0,35,141,7,54,34,62,61,96,330,569,4,2287,127,0,2,0,26,0
19667,135,2719,1513,682,1277,25,13,200,1538,11,199,116,219,210,335,1557,2584,6,15641,868,0,2,60,19,1
19668,135,2719,819,519,539,24,98,155,843,15,96,57,106,111,163,690,1107,8,9171,509,0,2,60,19,1
19669,121,4909,1513,682,1277,25,13,200,1538,11,199,116,219,210,335,1557,2584,6,15641,868,0,2,34,0,1
19670,135,2721,1513,682,1277,25,13,200,1538,11,199,116,219,210,335,1557,2584,6,15641,868,0,2,31,30,1
19671,135,2721,819,519,539,24,98,155,843,15,96,57,106,111,163,690,1107,8,9171,509,0,2,31,30,1
19672,21,662,339,213,244,17,9,65,356,10,42,26,48,52,74,259,421,5,2410,133,0,2,2,2,1
19673,20,408,294,64,250,0,0,43,294,1,20,10,20,21,30,86,131,0,65,3,0,2,2,2,1
19674,20,408,78,46,62,3,0,14,81,3,8,4,8,11,12,28,41,1,62,3,0,2,2,2,1
19675,121,4909,1513,682,1277,25,13,200,1538,11,199,116,219,210,335,1557,2584,6,15641,868,0,2,10,10,1
19676,347,6933,1457,730,1242,11,6,188,1468,10,292,166,329,302,495,2424,4078,5,22973,1276,1,2,1,1,0
19677,347,6933,74,35,59,1,0,14,75,3,14,7,14,17,21,58,85,1,128,7,0,2,1,1,0
19678,347,6933,245,125,200,5,7,34,250,7,30,17,34,37,51,166,265,3,1053,58,0,2,1,1,0
19679,21,662,339,213,244,17,9,65,356,10,42,26,48,52,74,259,421,5,2410,133,0,2,1,1,0
19680,27,954,74,35,59,1,0,14,75,3,14,7,14,17,21,58,85,1,128,7,0,2,1,1,0
19681,27,954,245,125,200,5,7,34,250,7,30,17,34,37,51,166,265,3,1053,58,0,2,1,1,0
19682,17,518,184,100,137,2,15,30,186,6,38,20,39,44,59,214,322,3,991,55,0,2,3,3,0
19683,17,518,103,65,74,8,5,16,111,7,17,9,17,24,26,89,119,3,417,23,0,2,3,3,0
19684,106,1993,1178,367,1042,6,15,115,1184,9,94,51,95,103,146,644,976,4,4439,246,0,2,2,2,0
19685,106,1993,177,108,140,8,0,27,185,6,30,16,32,36,48,162,248,3,794,44,0,2,2,2,0
19686,195,4023,1943,715,1694,26,18,214,1969,12,185,120,237,197,357,1436,2721,7,20915,1161,0,2,62,48,0
19687,195,4023,1168,838,957,57,25,144,1225,19,348,224,416,367,640,3018,5452,11,61921,3440,1,2,62,48,0
19688,347,6933,1457,730,1242,11,6,188,1468,10,292,166,329,302,495,2424,4078,5,22973,1276,1,2,1,1,0
19689,347,6933,74,35,59,1,0,14,75,3,14,7,14,17,21,58,85,1,128,7,0,2,1,1,0
19690,347,6933,245,125,200,5,7,34,250,7,30,17,34,37,51,166,265,3,1053,58,0,2,1,1,0
19691,21,662,339,213,244,17,9,65,356,10,42,26,48,52,74,259,421,5,2410,133,0,2,1,1,0
19692,27,954,74,35,59,1,0,14,75,3,14,7,14,17,21,58,85,1,128,7,0,2,1,1,0
19693,27,954,245,125,200,5,7,34,250,7,30,17,34,37,51,166,265,3,1053,58,0,2,1,1,0
19694,17,518,184,100,137,2,15,30,186,6,38,20,39,44,59,214,322,3,991,55,0,2,3,3,0
19695,17,518,103,65,74,8,5,16,111,7,17,9,17,24,26,89,119,3,417,23,0,2,3,3,0
19696,106,1993,1178,367,1042,6,15,115,1184,9,94,51,95,103,146,644,976,4,4439,246,0,2,2,2,0
19697,106,1993,177,108,140,8,0,27,185,6,30,16,32,36,48,162,248,3,794,44,0,2,2,2,0
19698,195,4023,1943,715,1694,26,18,214,1969,12,185,120,237,197,357,1436,2721,7,20915,1161,0,2,62,48,0
19699,195,4023,1168,838,957,57,25,144,1225,19,348,224,416,367,640,3018,5452,11,61921,3440,1,2,62,48,0
19700,188,4296,77,34,69,0,0,8,77,3,24,16,29,27,45,114,213,1,387,21,0,2,2,5,0
19701,188,4296,712,438,573,51,9,84,763,14,102,71,128,116,199,733,1364,8,11988,666,0,2,2,5,0
19702,135,2731,1513,682,1277,25,13,200,1538,11,199,116,219,210,335,1557,2584,6,15641,868,0,2,3,1,1
19703,135,2731,819,519,539,24,98,155,843,15,96,57,106,111,163,690,1107,8,9171,509,0,2,3,1,1
19704,123,4965,1513,682,1277,25,13,200,1538,11,199,116,219,210,335,1557,2584,6,15641,868,0,2,12,2,1
19705,96,1829,1020,354,843,12,15,144,1032,8,134,77,144,142,221,970,1580,4,6792,377,0,2,2,1,0
19706,96,1829,1020,354,843,12,15,144,1032,8,134,77,144,142,221,970,1580,4,6792,377,0,2,2,1,0
19707,20,509,205,80,86,16,53,53,221,7,18,10,19,25,29,94,134,3,497,27,0,2,9,2,0
19708,74,3107,1178,367,1042,6,15,115,1184,9,94,51,95,103,146,644,976,4,4439,246,0,2,34,0,0
19709,20,509,205,80,86,16,53,53,221,7,18,10,19,25,29,94,134,3,497,27,0,2,2,2,0
19710,21,438,601,196,481,2,23,85,603,8,63,36,72,71,108,400,664,4,3036,168,0,2,2,2,0
19711,21,438,156,79,106,5,16,28,161,5,14,8,15,19,23,64,97,2,261,14,0,2,2,2,0
19712,16,610,601,196,481,2,23,85,603,8,63,36,72,71,108,400,664,4,3036,168,0,2,21,1,0
19713,60,1265,207,111,150,11,0,50,218,5,26,19,36,31,55,133,272,3,943,52,0,2,2,2,1
19714,60,1265,410,198,237,31,55,97,441,11,63,38,72,74,110,414,683,6,4293,238,0,2,2,2,1
19715,255,6150,72,33,56,0,4,12,72,1,1,1,1,2,2,0,2,0,1,0,0,2,5,5,1
19716,255,6150,1454,835,1044,76,110,219,1530,17,275,158,296,292,454,2297,3718,9,34017,1889,1,2,5,5,1
19717,21,436,601,196,481,2,23,85,603,8,63,36,72,71,108,400,664,4,3036,168,0,2,1,1,1
19718,21,436,156,79,106,5,16,28,161,5,14,8,15,19,23,64,97,2,261,14,0,2,1,1,1
19719,16,610,601,196,481,2,23,85,603,8,63,36,72,71,108,400,664,4,3036,168,0,2,1,1,1
19720,60,1265,207,111,150,11,0,50,218,5,26,19,36,31,55,133,272,3,943,52,0,2,2,2,0
19721,60,1265,410,198,237,31,55,97,441,11,63,38,72,74,110,414,683,6,4293,238,0,2,2,2,0
19722,255,6150,72,33,56,0,4,12,72,1,1,1,1,2,2,0,2,0,1,0,0,2,5,5,0
19723,255,6150,1454,835,1044,76,110,219,1530,17,275,158,296,292,454,2297,3718,9,34017,1889,1,2,5,5,0
19724,21,436,601,196,481,2,23,85,603,8,63,36,72,71,108,400,664,4,3036,168,0,2,2,2,0
19725,21,436,156,79,106,5,16,28,161,5,14,8,15,19,23,64,97,2,261,14,0,2,2,2,0
19726,16,610,601,196,481,2,23,85,603,8,63,36,72,71,108,400,664,4,3036,168,0,2,21,1,0
19727,94,1804,1020,354,843,12,15,144,1032,8,134,77,144,142,221,970,1580,4,6792,377,0,2,2,1,0
19728,256,6155,72,33,56,0,4,12,72,1,1,1,1,2,2,0,2,0,1,0,0,2,18,20,0
19729,256,6155,1454,835,1044,76,110,219,1530,17,275,158,296,292,454,2297,3718,9,34017,1889,1,2,18,20,0
19730,6,329,180,34,164,0,0,16,180,1,12,6,12,13,18,43,66,0,33,1,0,2,21,0,0
19731,106,2001,1178,367,1042,6,15,115,1184,9,94,51,95,103,146,644,976,4,4439,246,0,2,2,1,0
19732,106,2001,177,108,140,8,0,27,185,6,30,16,32,36,48,162,248,3,794,44,0,2,2,1,0
19733,74,3124,1178,367,1042,6,15,115,1184,9,94,51,95,103,146,644,976,4,4439,246,0,2,8,3,0
19734,62,1228,1098,241,925,5,10,155,1103,7,46,25,49,53,74,273,423,3,1580,87,0,2,1,2,0
19735,62,1228,282,202,222,14,2,44,296,8,42,24,43,50,67,250,378,4,1548,86,0,2,1,2,0
19736,62,1222,1098,241,925,5,10,155,1103,7,46,25,49,53,74,273,423,3,1580,87,0,2,0,1,0
19737,62,1222,282,202,222,14,2,44,296,8,42,24,43,50,67,250,378,4,1548,86,0,2,0,1,0
19738,106,1987,1178,367,1042,6,15,115,1184,9,94,51,95,103,146,644,976,4,4439,246,0,2,4,5,1
19739,106,1987,177,108,140,8,0,27,185,6,30,16,32,36,48,162,248,3,794,44,0,2,4,5,1
19740,62,1222,1098,241,925,5,10,155,1103,7,46,25,49,53,74,273,423,3,1580,87,0,2,1,1,1
19741,62,1222,282,202,222,14,2,44,296,8,42,24,43,50,67,250,378,4,1548,86,0,2,1,1,1
19742,110,2074,1178,367,1042,6,15,115,1184,9,94,51,95,103,146,644,976,4,4439,246,0,2,59,39,1
19743,110,2074,177,108,140,8,0,27,185,6,30,16,32,36,48,162,248,3,794,44,0,2,59,39,1
19744,110,2074,1178,367,1042,6,15,115,1184,9,94,51,95,103,146,644,976,4,4439,246,0,2,1,1,0
19745,110,2074,177,108,140,8,0,27,185,6,30,16,32,36,48,162,248,3,794,44,0,2,1,1,0
19746,108,2058,1178,367,1042,6,15,115,1184,9,94,51,95,103,146,644,976,4,4439,246,0,2,3,9,0
19747,108,2058,177,108,140,8,0,27,185,6,30,16,32,36,48,162,248,3,794,44,0,2,3,9,0
19748,229,5184,4293,999,3693,19,54,507,4312,9,155,88,170,164,258,1156,1898,4,9368,520,0,2,6,2,0
19749,229,5184,1482,859,1002,125,135,219,1607,16,219,134,251,235,385,1766,3032,9,27804,1544,1,2,6,2,0
19750,229,5193,4293,999,3693,19,54,507,4312,9,155,88,170,164,258,1156,1898,4,9368,520,0,2,2,1,0
19751,229,5193,1482,859,1002,125,135,219,1607,16,219,134,251,235,385,1766,3032,9,27804,1544,1,2,2,1,0
19752,74,3250,1020,354,843,12,15,144,1032,8,134,77,144,142,221,970,1580,4,6792,377,0,2,18,0,0
19753,229,5193,4293,999,3693,19,54,507,4312,9,155,88,170,164,258,1156,1898,4,9368,520,0,2,7,2,0
19754,229,5193,1482,859,1002,125,135,219,1607,16,219,134,251,235,385,1766,3032,9,27804,1544,1,2,7,2,0
19755,74,3250,1020,354,843,12,15,144,1032,8,134,77,144,142,221,970,1580,4,6792,377,0,2,18,0,0
19756,135,2731,1513,682,1277,25,13,200,1538,11,199,116,219,210,335,1557,2584,6,15641,868,0,2,91,47,0
19757,135,2731,819,519,539,24,98,155,843,15,96,57,106,111,163,690,1107,8,9171,509,0,2,91,47,0
19758,21,662,339,213,244,17,9,65,356,10,42,26,48,52,74,259,421,5,2410,133,0,2,2,2,0
19759,20,408,294,64,250,0,0,43,294,1,20,10,20,21,30,86,131,0,65,3,0,2,2,2,0
19760,20,408,78,46,62,3,0,14,81,3,8,4,8,11,12,28,41,1,62,3,0,2,2,2,0
19761,123,4965,1513,682,1277,25,13,200,1538,11,199,116,219,210,335,1557,2584,6,15641,868,0,2,56,12,0
19762,11,394,42,7,35,4,0,5,46,1,2,1,2,3,3,2,4,0,2,0,0,2,9,8,1
19763,11,394,11,6,10,0,0,1,11,2,4,2,4,6,6,10,15,1,15,0,0,2,9,8,1
19764,108,2058,1178,367,1042,6,15,115,1184,9,94,51,95,103,146,644,976,4,4439,246,0,2,57,44,0
19765,108,2058,177,108,140,8,0,27,185,6,30,16,32,36,48,162,248,3,794,44,0,2,57,44,0
19766,62,1222,1098,241,925,5,10,155,1103,7,46,25,49,53,74,273,423,3,1580,87,0,2,1,3,0
19767,62,1222,282,202,222,14,2,44,296,8,42,24,43,50,67,250,378,4,1548,86,0,2,1,3,0
19768,58,1219,207,111,150,11,0,50,218,5,26,19,36,31,55,133,272,3,943,52,0,2,1,15,0
19769,58,1219,410,198,237,31,55,97,441,11,63,38,72,74,110,414,683,6,4293,238,0,2,1,15,0
19770,58,1219,207,111,150,11,0,50,218,5,26,19,36,31,55,133,272,3,943,52,0,2,1,15,0
19771,58,1219,410,198,237,31,55,97,441,11,63,38,72,74,110,414,683,6,4293,238,0,2,1,15,0
19772,11,394,42,7,35,4,0,5,46,1,2,1,2,3,3,2,4,0,2,0,0,2,9,8,0
19773,11,394,11,6,10,0,0,1,11,2,4,2,4,6,6,10,15,1,15,0,0,2,9,8,0
19774,11,235,19,8,11,5,0,4,24,2,5,3,6,7,9,13,25,1,30,1,0,2,0,3,1
19775,11,235,102,59,69,5,3,24,107,6,22,15,28,28,43,113,206,3,789,43,0,2,0,3,1
19776,11,235,106,40,36,3,49,17,109,8,17,13,23,25,36,93,167,5,904,50,0,2,0,3,1
19777,101,2069,773,419,590,28,0,166,801,10,204,113,217,214,330,1598,2554,5,13587,754,0,2,0,2,1
19778,101,2069,421,273,302,44,34,57,465,17,81,59,107,98,166,583,1098,11,12329,684,0,2,0,2,1
19779,26,524,2,2,2,0,0,0,2,0,0,0,0,0,0,0,0,0,0,0,0,2,2,4,1
19780,26,524,99,48,90,1,3,5,100,0,0,0,0,0,0,0,0,0,0,0,0,2,2,4,1
19781,26,524,8,5,5,2,0,1,10,0,0,0,0,0,0,0,0,0,0,0,0,2,2,4,1
19782,26,524,1217,716,841,84,126,174,1301,14,185,118,215,199,333,1446,2542,8,20687,1149,0,2,2,4,1
19783,26,524,160,89,115,0,13,31,160,7,15,11,17,22,28,78,124,3,495,27,0,2,2,4,1
19784,26,524,10,10,9,9,0,0,19,0,0,0,0,0,0,0,0,0,0,0,0,2,2,4,1
19785,26,524,173,84,99,8,29,36,181,5,12,7,13,17,20,54,81,2,221,12,0,2,2,4,1
19786,26,524,3,1,1,3,0,0,6,0,0,0,0,0,0,0,0,0,0,0,0,2,2,4,1
19787,163,5028,1660,832,1314,41,38,274,1701,20,312,209,395,332,604,2671,5058,12,64042,3557,1,2,0,5,1
19788,163,5028,1057,646,719,113,100,145,1170,18,215,134,248,233,382,1740,3004,10,31186,1732,1,2,0,5,1
19789,228,5143,4293,999,3693,19,54,507,4312,9,155,88,170,164,258,1156,1898,4,9368,520,0,2,1,4,1
19790,228,5143,1482,859,1002,125,135,219,1607,16,219,134,251,235,385,1766,3032,9,27804,1544,1,2,1,4,1
19791,210,5003,722,423,573,19,0,135,741,12,172,101,199,184,300,1320,2257,6,15668,870,0,2,2,6,1
19792,210,5003,1508,847,911,44,250,301,1552,14,148,88,169,162,257,1120,1886,7,15077,837,0,2,2,6,1
19793,73,1421,757,253,292,73,244,162,830,13,61,38,67,74,105,409,651,7,4654,258,0,2,1,9,1
19794,7,299,72,33,56,0,4,12,72,1,1,1,1,2,2,0,2,0,1,0,0,2,1,1,1
19795,11,394,42,7,35,4,0,5,46,1,2,1,2,3,3,2,4,0,2,0,0,2,1,1,1
19796,11,394,11,6,10,0,0,1,11,2,4,2,4,6,6,10,15,1,15,0,0,2,1,1,1
19797,81,3461,1289,550,1043,56,32,155,1345,10,167,93,185,177,278,1266,2075,5,11498,638,0,2,1,1,1
19798,147,6935,1392,870,1177,35,17,170,1427,14,494,280,531,508,811,4473,7289,7,54850,3047,2,2,2,8,1
19799,87,2905,773,419,590,28,0,166,801,10,204,113,217,214,330,1598,2554,5,13587,754,0,2,0,2,1
19800,52,3380,520,294,400,33,13,81,553,10,261,204,367,271,571,2128,4614,7,32445,1802,1,2,0,6,1
19801,97,4424,1338,495,1086,10,64,173,1348,11,122,82,157,133,239,883,1686,7,11934,663,0,2,4,11,1
19802,150,4203,1660,832,1314,41,38,274,1701,20,312,209,395,332,604,2671,5058,12,64042,3557,1,2,1,1,1
19803,79,4191,1457,730,1242,11,6,188,1468,10,292,166,329,302,495,2424,4078,5,22973,1276,1,2,1,1,1
19804,38,2303,334,251,279,10,4,40,344,5,127,74,143,132,217,899,1528,2,4303,239,0,2,1,7,1
19805,48,1750,1098,241,925,5,10,155,1103,7,46,25,49,53,74,273,423,3,1580,87,0,2,0,5,1
19806,147,6933,1392,870,1177,35,17,170,1427,14,494,280,531,508,811,4473,7289,7,54850,3047,2,2,0,1,0
19807,11,235,19,8,11,5,0,4,24,2,5,3,6,7,9,13,25,1,30,1,0,2,0,3,0
19808,11,235,102,59,69,5,3,24,107,6,22,15,28,28,43,113,206,3,789,43,0,2,0,3,0
19809,11,235,106,40,36,3,49,17,109,8,17,13,23,25,36,93,167,5,904,50,0,2,0,3,0
19810,101,2069,773,419,590,28,0,166,801,10,204,113,217,214,330,1598,2554,5,13587,754,0,2,0,2,0
19811,101,2069,421,273,302,44,34,57,465,17,81,59,107,98,166,583,1098,11,12329,684,0,2,0,2,0
19812,26,524,2,2,2,0,0,0,2,0,0,0,0,0,0,0,0,0,0,0,0,2,2,4,0
19813,26,524,99,48,90,1,3,5,100,0,0,0,0,0,0,0,0,0,0,0,0,2,2,4,0
19814,26,524,8,5,5,2,0,1,10,0,0,0,0,0,0,0,0,0,0,0,0,2,2,4,0
19815,26,524,1217,716,841,84,126,174,1301,14,185,118,215,199,333,1446,2542,8,20687,1149,0,2,2,4,0
19816,26,524,160,89,115,0,13,31,160,7,15,11,17,22,28,78,124,3,495,27,0,2,2,4,0
19817,26,524,10,10,9,9,0,0,19,0,0,0,0,0,0,0,0,0,0,0,0,2,2,4,0
19818,26,524,173,84,99,8,29,36,181,5,12,7,13,17,20,54,81,2,221,12,0,2,2,4,0
19819,26,524,3,1,1,3,0,0,6,0,0,0,0,0,0,0,0,0,0,0,0,2,2,4,0
19820,163,5028,1660,832,1314,41,38,274,1701,20,312,209,395,332,604,2671,5058,12,64042,3557,1,2,0,5,0
19821,163,5028,1057,646,719,113,100,145,1170,18,215,134,248,233,382,1740,3004,10,31186,1732,1,2,0,5,0
19822,228,5143,4293,999,3693,19,54,507,4312,9,155,88,170,164,258,1156,1898,4,9368,520,0,2,1,4,0
19823,228,5143,1482,859,1002,125,135,219,1607,16,219,134,251,235,385,1766,3032,9,27804,1544,1,2,1,4,0
19824,210,5003,722,423,573,19,0,135,741,12,172,101,199,184,300,1320,2257,6,15668,870,0,2,2,6,0
19825,210,5003,1508,847,911,44,250,301,1552,14,148,88,169,162,257,1120,1886,7,15077,837,0,2,2,6,0
19826,73,1421,757,253,292,73,244,162,830,13,61,38,67,74,105,409,651,7,4654,258,0,2,1,9,0
19827,7,299,72,33,56,0,4,12,72,1,1,1,1,2,2,0,2,0,1,0,0,2,1,1,0
19828,11,394,42,7,35,4,0,5,46,1,2,1,2,3,3,2,4,0,2,0,0,2,1,1,0
19829,11,394,11,6,10,0,0,1,11,2,4,2,4,6,6,10,15,1,15,0,0,2,1,1,0
19830,81,3461,1289,550,1043,56,32,155,1345,10,167,93,185,177,278,1266,2075,5,11498,638,0,2,1,1,0
19831,147,6933,1392,870,1177,35,17,170,1427,14,494,280,531,508,811,4473,7289,7,54850,3047,2,2,2,9,0
19832,87,2905,773,419,590,28,0,166,801,10,204,113,217,214,330,1598,2554,5,13587,754,0,2,0,2,0
19833,52,3380,520,294,400,33,13,81,553,10,261,204,367,271,571,2128,4614,7,32445,1802,1,2,0,6,0
19834,97,4424,1338,495,1086,10,64,173,1348,11,122,82,157,133,239,883,1686,7,11934,663,0,2,4,11,0
19835,150,4203,1660,832,1314,41,38,274,1701,20,312,209,395,332,604,2671,5058,12,64042,3557,1,2,1,1,0
19836,79,4191,1457,730,1242,11,6,188,1468,10,292,166,329,302,495,2424,4078,5,22973,1276,1,2,1,1,0
19837,38,2303,334,251,279,10,4,40,344,5,127,74,143,132,217,899,1528,2,4303,239,0,2,1,7,0
19838,48,1750,1098,241,925,5,10,155,1103,7,46,25,49,53,74,273,423,3,1580,87,0,2,0,5,0
19839,348,6936,1457,730,1242,11,6,188,1468,10,292,166,329,302,495,2424,4078,5,22973,1276,1,2,2,1,0
19840,348,6936,74,35,59,1,0,14,75,3,14,7,14,17,21,58,85,1,128,7,0,2,2,1,0
19841,348,6936,245,125,200,5,7,34,250,7,30,17,34,37,51,166,265,3,1053,58,0,2,2,1,0
19842,80,4257,1457,730,1242,11,6,188,1468,10,292,166,329,302,495,2424,4078,5,22973,1276,1,2,8,0,0
19843,80,4250,1457,730,1242,11,6,188,1468,10,292,166,329,302,495,2424,4078,5,22973,1276,1,2,1,1,0
19844,47,1325,773,422,505,30,103,129,803,14,77,46,83,91,129,535,839,7,6334,351,0,2,32,41,0
19845,45,1298,773,422,505,30,103,129,803,14,77,46,83,91,129,535,839,7,6334,351,0,2,2,12,0
19846,7,353,139,89,101,2,0,35,141,7,54,34,62,61,96,330,569,4,2287,127,0,2,4,7,0
19847,45,1298,773,422,505,30,103,129,803,14,77,46,83,91,129,535,839,7,6334,351,0,2,2,1,0
19848,21,1023,1157,318,931,29,22,177,1186,6,104,63,125,110,188,712,1274,3,4596,255,0,2,7,7,0
19849,45,1298,773,422,505,30,103,129,803,14,77,46,83,91,129,535,839,7,6334,351,0,2,1,0,0
19850,119,4767,1513,682,1277,25,13,200,1538,11,199,116,219,210,335,1557,2584,6,15641,868,0,2,0,17,0
19851,45,1297,773,422,505,30,103,129,803,14,77,46,83,91,129,535,839,7,6334,351,0,2,7,11,0
19852,20,509,205,80,86,16,53,53,221,7,18,10,19,25,29,94,134,3,497,27,0,2,9,2,0
19853,108,2066,1178,367,1042,6,15,115,1184,9,94,51,95,103,146,644,976,4,4439,246,0,2,2,1,0
19854,108,2066,177,108,140,8,0,27,185,6,30,16,32,36,48,162,248,3,794,44,0,2,2,1,0
19855,74,3124,1178,367,1042,6,15,115,1184,9,94,51,95,103,146,644,976,4,4439,246,0,2,42,3,0
19856,347,6933,1457,730,1242,11,6,188,1468,10,292,166,329,302,495,2424,4078,5,22973,1276,1,2,1,1,0
19857,347,6933,74,35,59,1,0,14,75,3,14,7,14,17,21,58,85,1,128,7,0,2,1,1,0
19858,347,6933,245,125,200,5,7,34,250,7,30,17,34,37,51,166,265,3,1053,58,0,2,1,1,0
19859,45,1297,773,422,505,30,103,129,803,14,77,46,83,91,129,535,839,7,6334,351,0,0,337,0,0
19860,11,394,42,7,35,4,0,5,46,1,2,1,2,3,3,2,4,0,2,0,0,2,1,1,0
19861,11,394,11,6,10,0,0,1,11,2,4,2,4,6,6,10,15,1,15,0,0,2,1,1,0
19862,7,353,139,89,101,2,0,35,141,7,54,34,62,61,96,330,569,4,2287,127,0,0,70,0,0
19863,21,1023,1157,318,931,29,22,177,1186,6,104,63,125,110,188,712,1274,3,4596,255,0,0,398,0,0
19864,122,4899,1513,682,1277,25,13,200,1538,11,199,116,219,210,335,1557,2584,6,15641,868,0,2,0,20,0
19865,64,1733,1455,414,1257,16,76,112,1471,5,41,23,46,46,69,231,381,2,1069,59,0,2,9,1,0
19866,64,1733,669,365,481,22,61,110,691,15,103,63,122,118,185,747,1273,8,11311,628,0,2,9,1,0
19867,64,1721,1455,414,1257,16,76,112,1471,5,41,23,46,46,69,231,381,2,1069,59,0,2,1,2,0
19868,64,1721,669,365,481,22,61,110,691,15,103,63,122,118,185,747,1273,8,11311,628,0,2,1,2,0
19869,67,3083,1455,414,1257,16,76,112,1471,5,41,23,46,46,69,231,381,2,1069,59,0,2,28,0,0
19870,64,1721,1455,414,1257,16,76,112,1471,5,41,23,46,46,69,231,381,2,1069,59,0,2,8,1,0
19871,64,1721,669,365,481,22,61,110,691,15,103,63,122,118,185,747,1273,8,11311,628,0,2,8,1,0
19872,67,3083,1455,414,1257,16,76,112,1471,5,41,23,46,46,69,231,381,2,1069,59,0,2,28,0,0
19873,181,4179,77,34,69,0,0,8,77,3,24,16,29,27,45,114,213,1,387,21,0,2,13,1,0
19874,181,4179,712,438,573,51,9,84,763,14,102,71,128,116,199,733,1364,8,11988,666,0,2,13,1,0
19875,72,3739,1296,573,1062,40,33,157,1336,8,201,118,231,209,349,1561,2689,4,12365,686,0,2,2,4,0
19876,76,3893,1943,715,1694,26,18,214,1969,12,185,120,237,197,357,1436,2721,7,20915,1161,0,2,0,1,0
19877,96,1829,1020,354,843,12,15,144,1032,8,134,77,144,142,221,970,1580,4,6792,377,0,2,1,1,0
19878,96,1829,1020,354,843,12,15,144,1032,8,134,77,144,142,221,970,1580,4,6792,377,0,2,1,1,0
19879,228,5144,4293,999,3693,19,54,507,4312,9,155,88,170,164,258,1156,1898,4,9368,520,0,2,4,0,0
19880,228,5144,1482,859,1002,125,135,219,1607,16,219,134,251,235,385,1766,3032,9,27804,1544,1,2,4,0,0
19881,348,6936,1457,730,1242,11,6,188,1468,10,292,166,329,302,495,2424,4078,5,22973,1276,1,2,2,1,0
19882,348,6936,74,35,59,1,0,14,75,3,14,7,14,17,21,58,85,1,128,7,0,2,2,1,0
19883,348,6936,245,125,200,5,7,34,250,7,30,17,34,37,51,166,265,3,1053,58,0,2,2,1,0
19884,80,4250,1457,730,1242,11,6,188,1468,10,292,166,329,302,495,2424,4078,5,22973,1276,1,2,8,0,0
19885,181,4179,77,34,69,0,0,8,77,3,24,16,29,27,45,114,213,1,387,21,0,2,13,1,0
19886,181,4179,712,438,573,51,9,84,763,14,102,71,128,116,199,733,1364,8,11988,666,0,2,13,1,0
19887,72,3739,1296,573,1062,40,33,157,1336,8,201,118,231,209,349,1561,2689,4,12365,686,0,2,2,4,0
19888,76,3893,1943,715,1694,26,18,214,1969,12,185,120,237,197,357,1436,2721,7,20915,1161,0,2,0,1,0
19889,52,1094,207,111,150,11,0,50,218,5,26,19,36,31,55,133,272,3,943,52,0,2,52,43,1
19890,52,1094,410,198,237,31,55,97,441,11,63,38,72,74,110,414,683,6,4293,238,0,2,52,43,1
19891,228,5136,4293,999,3693,19,54,507,4312,9,155,88,170,164,258,1156,1898,4,9368,520,0,2,1,2,1
19892,228,5136,1482,859,1002,125,135,219,1607,16,219,134,251,235,385,1766,3032,9,27804,1544,1,2,1,2,1
19893,12,419,42,7,35,4,0,5,46,1,2,1,2,3,3,2,4,0,2,0,0,2,4,1,1
19894,12,419,11,6,10,0,0,1,11,2,4,2,4,6,6,10,15,1,15,0,0,2,4,1,1
19895,161,7064,139,89,101,2,0,35,141,7,54,34,62,61,96,330,569,4,2287,127,0,2,1,4,1
19896,161,7064,7,5,5,0,0,2,7,1,2,1,2,3,3,2,4,0,2,0,0,2,1,4,1
19897,161,7062,139,89,101,2,0,35,141,7,54,34,62,61,96,330,569,4,2287,127,0,2,0,1,0
19898,161,7062,7,5,5,0,0,2,7,1,2,1,2,3,3,2,4,0,2,0,0,2,0,1,0
19899,52,1094,207,111,150,11,0,50,218,5,26,19,36,31,55,133,272,3,943,52,0,2,52,43,0
19900,52,1094,410,198,237,31,55,97,441,11,63,38,72,74,110,414,683,6,4293,238,0,2,52,43,0
19901,228,5136,4293,999,3693,19,54,507,4312,9,155,88,170,164,258,1156,1898,4,9368,520,0,2,1,2,0
19902,228,5136,1482,859,1002,125,135,219,1607,16,219,134,251,235,385,1766,3032,9,27804,1544,1,2,1,2,0
19903,12,419,42,7,35,4,0,5,46,1,2,1,2,3,3,2,4,0,2,0,0,2,4,1,0
19904,12,419,11,6,10,0,0,1,11,2,4,2,4,6,6,10,15,1,15,0,0,2,4,1,0
19905,161,7062,139,89,101,2,0,35,141,7,54,34,62,61,96,330,569,4,2287,127,0,2,1,5,0
19906,161,7062,7,5,5,0,0,2,7,1,2,1,2,3,3,2,4,0,2,0,0,2,1,5,0
19907,73,3848,1296,573,1062,40,33,157,1336,8,201,118,231,209,349,1561,2689,4,12365,686,0,2,26,0,1
19908,73,3850,1296,573,1062,40,33,157,1336,8,201,118,231,209,349,1561,2689,4,12365,686,0,2,2,2,0
19909,235,5317,4293,999,3693,19,54,507,4312,9,155,88,170,164,258,1156,1898,4,9368,520,0,2,35,1,1
19910,235,5317,1482,859,1002,125,135,219,1607,16,219,134,251,235,385,1766,3032,9,27804,1544,1,2,35,1,1
19911,234,5311,4293,999,3693,19,54,507,4312,9,155,88,170,164,258,1156,1898,4,9368,520,0,2,4,5,0
19912,234,5311,1482,859,1002,125,135,219,1607,16,219,134,251,235,385,1766,3032,9,27804,1544,1,2,4,5,0
19913,232,5292,4293,999,3693,19,54,507,4312,9,155,88,170,164,258,1156,1898,4,9368,520,0,2,10,10,1
19914,232,5292,1482,859,1002,125,135,219,1607,16,219,134,251,235,385,1766,3032,9,27804,1544,1,2,10,10,1
19915,232,5292,4293,999,3693,19,54,507,4312,9,155,88,170,164,258,1156,1898,4,9368,520,0,2,1,1,1
19916,232,5292,1482,859,1002,125,135,219,1607,16,219,134,251,235,385,1766,3032,9,27804,1544,1,2,1,1,1
19917,229,5195,4293,999,3693,19,54,507,4312,9,155,88,170,164,258,1156,1898,4,9368,520,0,2,8,39,1
19918,229,5195,1482,859,1002,125,135,219,1607,16,219,134,251,235,385,1766,3032,9,27804,1544,1,2,8,39,1
19919,4,95,53,23,39,0,0,13,53,2,8,4,8,10,12,26,39,1,39,2,0,0,37,0,1
19920,4,95,515,298,307,33,80,99,548,12,63,44,77,75,121,419,753,7,5527,307,0,0,37,0,1
19921,1,106,53,23,39,0,0,13,53,2,8,4,8,10,12,26,39,1,39,2,0,3,3,3,1
19922,75,1461,757,253,292,73,244,162,830,13,61,38,67,74,105,409,651,7,4654,258,0,2,2,1,1
19923,229,5199,4293,999,3693,19,54,507,4312,9,155,88,170,164,258,1156,1898,4,9368,520,0,2,4,4,0
19924,229,5199,1482,859,1002,125,135,219,1607,16,219,134,251,235,385,1766,3032,9,27804,1544,1,2,4,4,0
19925,83,2365,1523,757,1297,19,12,193,1542,12,193,117,230,205,347,1508,2664,7,19053,1058,0,2,2,1,0
19926,83,2365,701,378,504,33,58,109,734,13,110,68,126,123,194,794,1346,7,10027,557,0,2,2,1,0
19927,184,4257,77,34,69,0,0,8,77,3,24,16,29,27,45,114,213,1,387,21,0,2,5,4,0
19928,184,4257,712,438,573,51,9,84,763,14,102,71,128,116,199,733,1364,8,11988,666,0,2,5,4,0
19929,4,92,53,23,39,0,0,13,53,2,8,4,8,10,12,26,39,1,39,2,0,2,4,1,0
19930,4,92,515,298,307,33,80,99,548,12,63,44,77,75,121,419,753,7,5527,307,0,2,4,1,0
19931,193,3994,1943,715,1694,26,18,214,1969,12,185,120,237,197,357,1436,2721,7,20915,1161,0,2,2,1,0
19932,193,3994,1168,838,957,57,25,144,1225,19,348,224,416,367,640,3018,5452,11,61921,3440,1,2,2,1,0
19933,75,1461,757,253,292,73,244,162,830,13,61,38,67,74,105,409,651,7,4654,258,0,2,2,1,0
19934,4,90,53,23,39,0,0,13,53,2,8,4,8,10,12,26,39,1,39,2,0,2,0,3,0
19935,4,90,515,298,307,33,80,99,548,12,63,44,77,75,121,419,753,7,5527,307,0,2,0,3,0
19936,96,1835,1020,354,843,12,15,144,1032,8,134,77,144,142,221,970,1580,4,6792,377,0,2,3,2,1
19937,75,3288,1020,354,843,12,15,144,1032,8,134,77,144,142,221,970,1580,4,6792,377,0,2,17,0,1
19938,229,5199,4293,999,3693,19,54,507,4312,9,155,88,170,164,258,1156,1898,4,9368,520,0,2,10,8,0
19939,229,5199,1482,859,1002,125,135,219,1607,16,219,134,251,235,385,1766,3032,9,27804,1544,1,2,10,8,0
19940,83,2365,1523,757,1297,19,12,193,1542,12,193,117,230,205,347,1508,2664,7,19053,1058,0,2,2,1,0
19941,83,2365,701,378,504,33,58,109,734,13,110,68,126,123,194,794,1346,7,10027,557,0,2,2,1,0
19942,184,4257,77,34,69,0,0,8,77,3,24,16,29,27,45,114,213,1,387,21,0,2,5,4,0
19943,184,4257,712,438,573,51,9,84,763,14,102,71,128,116,199,733,1364,8,11988,666,0,2,5,4,0
19944,4,90,53,23,39,0,0,13,53,2,8,4,8,10,12,26,39,1,39,2,0,0,37,0,0
19945,4,90,515,298,307,33,80,99,548,12,63,44,77,75,121,419,753,7,5527,307,0,0,37,0,0
19946,75,1461,757,253,292,73,244,162,830,13,61,38,67,74,105,409,651,7,4654,258,0,2,2,1,0
19947,193,3994,1943,715,1694,26,18,214,1969,12,185,120,237,197,357,1436,2721,7,20915,1161,0,2,2,1,0
19948,193,3994,1168,838,957,57,25,144,1225,19,348,224,416,367,640,3018,5452,11,61921,3440,1,2,2,1,0
19949,73,3850,1296,573,1062,40,33,157,1336,8,201,118,231,209,349,1561,2689,4,12365,686,0,2,26,0,0
19950,1,106,53,23,39,0,0,13,53,2,8,4,8,10,12,26,39,1,39,2,0,0,18,0,0
19951,229,5171,4293,999,3693,19,54,507,4312,9,155,88,170,164,258,1156,1898,4,9368,520,0,2,17,10,0
19952,229,5171,1482,859,1002,125,135,219,1607,16,219,134,251,235,385,1766,3032,9,27804,1544,1,2,17,10,0
19953,83,2365,1523,757,1297,19,12,193,1542,12,193,117,230,205,347,1508,2664,7,19053,1058,0,2,2,1,0
19954,83,2365,701,378,504,33,58,109,734,13,110,68,126,123,194,794,1346,7,10027,557,0,2,2,1,0
19955,181,4189,77,34,69,0,0,8,77,3,24,16,29,27,45,114,213,1,387,21,0,2,5,4,0
19956,181,4189,712,438,573,51,9,84,763,14,102,71,128,116,199,733,1364,8,11988,666,0,2,5,4,0
19957,94,1804,1020,354,843,12,15,144,1032,8,134,77,144,142,221,970,1580,4,6792,377,0,2,1,1,0
19958,4,90,53,23,39,0,0,13,53,2,8,4,8,10,12,26,39,1,39,2,0,0,37,0,0
19959,4,90,515,298,307,33,80,99,548,12,63,44,77,75,121,419,753,7,5527,307,0,0,37,0,0
19960,73,1421,757,253,292,73,244,162,830,13,61,38,67,74,105,409,651,7,4654,258,0,2,2,1,0
19961,195,4029,1943,715,1694,26,18,214,1969,12,185,120,237,197,357,1436,2721,7,20915,1161,0,2,3,2,0
19962,195,4029,1168,838,957,57,25,144,1225,19,348,224,416,367,640,3018,5452,11,61921,3440,1,2,3,2,0
19963,73,3834,1296,573,1062,40,33,157,1336,8,201,118,231,209,349,1561,2689,4,12365,686,0,2,26,0,0
19964,74,3250,1020,354,843,12,15,144,1032,8,134,77,144,142,221,970,1580,4,6792,377,0,2,18,0,0
19965,1,106,53,23,39,0,0,13,53,2,8,4,8,10,12,26,39,1,39,2,0,0,18,0,0
19966,96,1835,1020,354,843,12,15,144,1032,8,134,77,144,142,221,970,1580,4,6792,377,0,2,3,2,0
19967,75,3288,1020,354,843,12,15,144,1032,8,134,77,144,142,221,970,1580,4,6792,377,0,2,17,0,0
19968,52,1088,207,111,150,11,0,50,218,5,26,19,36,31,55,133,272,3,943,52,0,2,4,8,0
19969,52,1088,410,198,237,31,55,97,441,11,63,38,72,74,110,414,683,6,4293,238,0,2,4,8,0
19970,210,5003,722,423,573,19,0,135,741,12,172,101,199,184,300,1320,2257,6,15668,870,0,2,1,3,0
19971,210,5003,1508,847,911,44,250,301,1552,14,148,88,169,162,257,1120,1886,7,15077,837,0,2,1,3,0
19972,46,954,386,256,301,16,9,68,402,4,59,35,69,63,104,355,621,2,1453,80,0,2,2,4,0
19973,46,954,264,131,164,11,41,46,275,6,38,22,40,44,62,214,338,3,1068,59,0,2,2,4,0
19974,7,353,139,89,101,2,0,35,141,7,54,34,62,61,96,330,569,4,2287,127,0,2,1,1,0
19975,52,1082,207,111,150,11,0,50,218,5,26,19,36,31,55,133,272,3,943,52,0,2,0,2,0
19976,52,1082,410,198,237,31,55,97,441,11,63,38,72,74,110,414,683,6,4293,238,0,2,0,2,0
19977,94,1805,1020,354,843,12,15,144,1032,8,134,77,144,142,221,970,1580,4,6792,377,0,2,2,2,0
19978,73,1425,757,253,292,73,244,162,830,13,61,38,67,74,105,409,651,7,4654,258,0,2,3,2,0
19979,346,6927,1457,730,1242,11,6,188,1468,10,292,166,329,302,495,2424,4078,5,22973,1276,1,2,6,6,0
19980,346,6927,74,35,59,1,0,14,75,3,14,7,14,17,21,58,85,1,128,7,0,2,6,6,0
19981,346,6927,245,125,200,5,7,34,250,7,30,17,34,37,51,166,265,3,1053,58,0,2,6,6,0
19982,33,1914,384,251,317,7,8,52,391,11,70,44,84,81,128,467,811,6,5355,297,0,2,8,3,0
19983,52,1082,207,111,150,11,0,50,218,5,26,19,36,31,55,133,272,3,943,52,0,2,4,10,0
19984,52,1082,410,198,237,31,55,97,441,11,63,38,72,74,110,414,683,6,4293,238,0,2,4,10,0
19985,229,5171,4293,999,3693,19,54,507,4312,9,155,88,170,164,258,1156,1898,4,9368,520,0,2,17,10,0
19986,229,5171,1482,859,1002,125,135,219,1607,16,219,134,251,235,385,1766,3032,9,27804,1544,1,2,17,10,0
19987,83,2365,1523,757,1297,19,12,193,1542,12,193,117,230,205,347,1508,2664,7,19053,1058,0,2,2,1,0
19988,83,2365,701,378,504,33,58,109,734,13,110,68,126,123,194,794,1346,7,10027,557,0,2,2,1,0
19989,181,4189,77,34,69,0,0,8,77,3,24,16,29,27,45,114,213,1,387,21,0,2,5,4,0
19990,181,4189,712,438,573,51,9,84,763,14,102,71,128,116,199,733,1364,8,11988,666,0,2,5,4,0
19991,94,1805,1020,354,843,12,15,144,1032,8,134,77,144,142,221,970,1580,4,6792,377,0,2,3,3,0
19992,4,90,53,23,39,0,0,13,53,2,8,4,8,10,12,26,39,1,39,2,0,0,37,0,0
19993,4,90,515,298,307,33,80,99,548,12,63,44,77,75,121,419,753,7,5527,307,0,0,37,0,0
19994,210,5003,722,423,573,19,0,135,741,12,172,101,199,184,300,1320,2257,6,15668,870,0,2,1,3,0
19995,210,5003,1508,847,911,44,250,301,1552,14,148,88,169,162,257,1120,1886,7,15077,837,0,2,1,3,0
19996,73,1425,757,253,292,73,244,162,830,13,61,38,67,74,105,409,651,7,4654,258,0,2,5,3,0
19997,46,954,386,256,301,16,9,68,402,4,59,35,69,63,104,355,621,2,1453,80,0,2,2,4,0
19998,46,954,264,131,164,11,41,46,275,6,38,22,40,44,62,214,338,3,1068,59,0,2,2,4,0
19999,195,4029,1943,715,1694,26,18,214,1969,12,185,120,237,197,357,1436,2721,7,20915,1161,0,2,3,2,0
20000,195,4029,1168,838,957,57,25,144,1225,19,348,224,416,367,640,3018,5452,11,61921,3440,1,2,3,2,0
20001,7,353,139,89,101,2,0,35,141,7,54,34,62,61,96,330,569,4,2287,127,0,2,1,1,0
20002,73,3834,1296,573,1062,40,33,157,1336,8,201,118,231,209,349,1561,2689,4,12365,686,0,2,26,0,0
20003,74,3250,1020,354,843,12,15,144,1032,8,134,77,144,142,221,970,1580,4,6792,377,0,2,18,0,0
20004,1,106,53,23,39,0,0,13,53,2,8,4,8,10,12,26,39,1,39,2,0,0,18,0,0
20005,167,5123,1660,832,1314,41,38,274,1701,20,312,209,395,332,604,2671,5058,12,64042,3557,1,2,8,3,0
20006,167,5123,1057,646,719,113,100,145,1170,18,215,134,248,233,382,1740,3004,10,31186,1732,1,2,8,3,0
20007,153,4268,1660,832,1314,41,38,274,1701,20,312,209,395,332,604,2671,5058,12,64042,3557,1,2,21,13,0
20008,167,5122,1660,832,1314,41,38,274,1701,20,312,209,395,332,604,2671,5058,12,64042,3557,1,2,3,2,0
20009,167,5122,1057,646,719,113,100,145,1170,18,215,134,248,233,382,1740,3004,10,31186,1732,1,2,3,2,0
20010,155,4372,1660,832,1314,41,38,274,1701,20,312,209,395,332,604,2671,5058,12,64042,3557,1,2,11,0,0
20011,155,4372,1660,832,1314,41,38,274,1701,20,312,209,395,332,604,2671,5058,12,64042,3557,1,2,3,0,0
20012,167,5122,1660,832,1314,41,38,274,1701,20,312,209,395,332,604,2671,5058,12,64042,3557,1,2,11,5,0
20013,167,5122,1057,646,719,113,100,145,1170,18,215,134,248,233,382,1740,3004,10,31186,1732,1,2,11,5,0
20014,155,4372,1660,832,1314,41,38,274,1701,20,312,209,395,332,604,2671,5058,12,64042,3557,1,2,35,13,0
20015,155,4372,1660,832,1314,41,38,274,1701,20,312,209,395,332,604,2671,5058,12,64042,3557,1,2,1,1,0
20016,100,1967,1020,354,843,12,15,144,1032,8,134,77,144,142,221,970,1580,4,6792,377,0,2,25,0,1
20017,256,6030,72,33,56,0,4,12,72,1,1,1,1,2,2,0,2,0,1,0,0,2,3,21,1
20018,256,6030,1454,835,1044,76,110,219,1530,17,275,158,296,292,454,2297,3718,9,34017,1889,1,2,3,21,1
20019,135,2748,1513,682,1277,25,13,200,1538,11,199,116,219,210,335,1557,2584,6,15641,868,0,2,6,2,0
20020,135,2748,819,519,539,24,98,155,843,15,96,57,106,111,163,690,1107,8,9171,509,0,2,6,2,0
20021,124,4990,1513,682,1277,25,13,200,1538,11,199,116,219,210,335,1557,2584,6,15641,868,0,2,16,0,0
20022,60,1682,1455,414,1257,16,76,112,1471,5,41,23,46,46,69,231,381,2,1069,59,0,2,1,1,0
20023,60,1682,669,365,481,22,61,110,691,15,103,63,122,118,185,747,1273,8,11311,628,0,2,1,1,0
20024,66,3053,1455,414,1257,16,76,112,1471,5,41,23,46,46,69,231,381,2,1069,59,0,2,28,2,0
20025,135,2748,1513,682,1277,25,13,200,1538,11,199,116,219,210,335,1557,2584,6,15641,868,0,2,6,2,0
20026,135,2748,819,519,539,24,98,155,843,15,96,57,106,111,163,690,1107,8,9171,509,0,2,6,2,0
20027,124,4990,1513,682,1277,25,13,200,1538,11,199,116,219,210,335,1557,2584,6,15641,868,0,2,16,0,0
20028,60,1682,1455,414,1257,16,76,112,1471,5,41,23,46,46,69,231,381,2,1069,59,0,2,1,1,0
20029,60,1682,669,365,481,22,61,110,691,15,103,63,122,118,185,747,1273,8,11311,628,0,2,1,1,0
20030,66,3053,1455,414,1257,16,76,112,1471,5,41,23,46,46,69,231,381,2,1069,59,0,2,28,2,0
20031,257,6191,72,33,56,0,4,12,72,1,1,1,1,2,2,0,2,0,1,0,0,2,8,1,0
20032,257,6191,1454,835,1044,76,110,219,1530,17,275,158,296,292,454,2297,3718,9,34017,1889,1,2,8,1,0
20033,231,5221,4293,999,3693,19,54,507,4312,9,155,88,170,164,258,1156,1898,4,9368,520,0,2,16,7,1
20034,231,5221,1482,859,1002,125,135,219,1607,16,219,134,251,235,385,1766,3032,9,27804,1544,1,2,16,7,1
20035,93,1852,1020,354,843,12,15,144,1032,8,134,77,144,142,221,970,1580,4,6792,377,0,2,29,21,1
20036,12,422,42,7,35,4,0,5,46,1,2,1,2,3,3,2,4,0,2,0,0,2,6,1,1
20037,12,422,11,6,10,0,0,1,11,2,4,2,4,6,6,10,15,1,15,0,0,2,6,1,1
20038,155,4372,1660,832,1314,41,38,274,1701,20,312,209,395,332,604,2671,5058,12,64042,3557,1,2,1,1,0
20039,166,5068,1660,832,1314,41,38,274,1701,20,312,209,395,332,604,2671,5058,12,64042,3557,1,2,11,5,1
20040,166,5068,1057,646,719,113,100,145,1170,18,215,134,248,233,382,1740,3004,10,31186,1732,1,2,11,5,1
20041,64,1726,1455,414,1257,16,76,112,1471,5,41,23,46,46,69,231,381,2,1069,59,0,2,1,1,1
20042,64,1726,669,365,481,22,61,110,691,15,103,63,122,118,185,747,1273,8,11311,628,0,2,1,1,1
20043,94,1811,1020,354,843,12,15,144,1032,8,134,77,144,142,221,970,1580,4,6792,377,0,2,3,2,1
20044,155,4372,1660,832,1314,41,38,274,1701,20,312,209,395,332,604,2671,5058,12,64042,3557,1,2,35,13,1
20045,68,3131,1455,414,1257,16,76,112,1471,5,41,23,46,46,69,231,381,2,1069,59,0,2,28,2,1
20046,75,3288,1020,354,843,12,15,144,1032,8,134,77,144,142,221,970,1580,4,6792,377,0,2,17,0,1
20047,100,1967,1020,354,843,12,15,144,1032,8,134,77,144,142,221,970,1580,4,6792,377,0,2,25,0,0
20048,256,6030,72,33,56,0,4,12,72,1,1,1,1,2,2,0,2,0,1,0,0,2,3,21,0
20049,256,6030,1454,835,1044,76,110,219,1530,17,275,158,296,292,454,2297,3718,9,34017,1889,1,2,3,21,0
20050,257,6066,72,33,56,0,4,12,72,1,1,1,1,2,2,0,2,0,1,0,0,2,8,1,0
20051,257,6066,1454,835,1044,76,110,219,1530,17,275,158,296,292,454,2297,3718,9,34017,1889,1,2,8,1,0
20052,166,5068,1660,832,1314,41,38,274,1701,20,312,209,395,332,604,2671,5058,12,64042,3557,1,2,11,5,0
20053,166,5068,1057,646,719,113,100,145,1170,18,215,134,248,233,382,1740,3004,10,31186,1732,1,2,11,5,0
20054,64,1726,1455,414,1257,16,76,112,1471,5,41,23,46,46,69,231,381,2,1069,59,0,2,1,1,0
20055,64,1726,669,365,481,22,61,110,691,15,103,63,122,118,185,747,1273,8,11311,628,0,2,1,1,0
20056,100,1973,1020,354,843,12,15,144,1032,8,134,77,144,142,221,970,1580,4,6792,377,0,2,3,2,0
20057,155,4372,1660,832,1314,41,38,274,1701,20,312,209,395,332,604,2671,5058,12,64042,3557,1,2,35,13,0
20058,68,3131,1455,414,1257,16,76,112,1471,5,41,23,46,46,69,231,381,2,1069,59,0,2,28,2,0
20059,75,3288,1020,354,843,12,15,144,1032,8,134,77,144,142,221,970,1580,4,6792,377,0,2,17,0,0
20060,166,5068,1660,832,1314,41,38,274,1701,20,312,209,395,332,604,2671,5058,12,64042,3557,1,2,11,5,0
20061,166,5068,1057,646,719,113,100,145,1170,18,215,134,248,233,382,1740,3004,10,31186,1732,1,2,11,5,0
20062,64,1726,1455,414,1257,16,76,112,1471,5,41,23,46,46,69,231,381,2,1069,59,0,2,1,1,0
20063,64,1726,669,365,481,22,61,110,691,15,103,63,122,118,185,747,1273,8,11311,628,0,2,1,1,0
20064,99,2020,1020,354,843,12,15,144,1032,8,134,77,144,142,221,970,1580,4,6792,377,0,2,28,2,0
20065,257,6066,72,33,56,0,4,12,72,1,1,1,1,2,2,0,2,0,1,0,0,2,11,22,0
20066,257,6066,1454,835,1044,76,110,219,1530,17,275,158,296,292,454,2297,3718,9,34017,1889,1,2,11,22,0
20067,155,4372,1660,832,1314,41,38,274,1701,20,312,209,395,332,604,2671,5058,12,64042,3557,1,2,35,13,0
20068,68,3131,1455,414,1257,16,76,112,1471,5,41,23,46,46,69,231,381,2,1069,59,0,2,28,2,0
20069,75,3288,1020,354,843,12,15,144,1032,8,134,77,144,142,221,970,1580,4,6792,377,0,2,17,0,0
20070,214,4608,182,127,129,0,0,53,182,5,39,21,42,44,63,217,343,2,926,51,0,2,4,4,1
20071,214,4608,1165,710,800,67,119,181,1232,18,243,153,282,261,435,2000,3492,10,36473,2026,1,2,4,4,1
20072,102,2083,773,419,590,28,0,166,801,10,204,113,217,214,330,1598,2554,5,13587,754,0,2,8,8,1
20073,102,2083,421,273,302,44,34,57,465,17,81,59,107,98,166,583,1098,11,12329,684,0,2,8,8,1
20074,86,1808,477,336,357,30,23,73,507,16,194,134,250,210,384,1538,2962,10,30538,1696,0,2,4,4,1
20075,351,7048,1457,730,1242,11,6,188,1468,10,292,166,329,302,495,2424,4078,5,22973,1276,1,2,6,6,1
20076,351,7048,74,35,59,1,0,14,75,3,14,7,14,17,21,58,85,1,128,7,0,2,6,6,1
20077,351,7048,245,125,200,5,7,34,250,7,30,17,34,37,51,166,265,3,1053,58,0,2,6,6,1
20078,229,5199,4293,999,3693,19,54,507,4312,9,155,88,170,164,258,1156,1898,4,9368,520,0,2,4,4,1
20079,229,5199,1482,859,1002,125,135,219,1607,16,219,134,251,235,385,1766,3032,9,27804,1544,1,2,4,4,1
20080,96,1835,1020,354,843,12,15,144,1032,8,134,77,144,142,221,970,1580,4,6792,377,0,2,2,2,1
20081,212,5103,722,423,573,19,0,135,741,12,172,101,199,184,300,1320,2257,6,15668,870,0,2,14,14,1
20082,212,5103,1508,847,911,44,250,301,1552,14,148,88,169,162,257,1120,1886,7,15077,837,0,2,14,14,1
20083,256,6158,72,33,56,0,4,12,72,1,1,1,1,2,2,0,2,0,1,0,0,2,7,7,1
20084,256,6158,1454,835,1044,76,110,219,1530,17,275,158,296,292,454,2297,3718,9,34017,1889,1,2,7,7,1
20085,102,1930,1178,367,1042,6,15,115,1184,9,94,51,95,103,146,644,976,4,4439,246,0,2,3,3,1
20086,102,1930,177,108,140,8,0,27,185,6,30,16,32,36,48,162,248,3,794,44,0,2,3,3,1
20087,193,3994,1943,715,1694,26,18,214,1969,12,185,120,237,197,357,1436,2721,7,20915,1161,0,2,12,12,1
20088,193,3994,1168,838,957,57,25,144,1225,19,348,224,416,367,640,3018,5452,11,61921,3440,1,2,12,12,1
20089,62,1240,1098,241,925,5,10,155,1103,7,46,25,49,53,74,273,423,3,1580,87,0,2,4,4,1
20090,62,1240,282,202,222,14,2,44,296,8,42,24,43,50,67,250,378,4,1548,86,0,2,4,4,1
20091,149,6984,1392,870,1177,35,17,170,1427,14,494,280,531,508,811,4473,7289,7,54850,3047,2,2,2,2,1
20092,87,2923,773,419,590,28,0,166,801,10,204,113,217,214,330,1598,2554,5,13587,754,0,2,4,4,1
20093,98,4450,1338,495,1086,10,64,173,1348,11,122,82,157,133,239,883,1686,7,11934,663,0,2,4,4,1
20094,162,7089,139,89,101,2,0,35,141,7,54,34,62,61,96,330,569,4,2287,127,0,2,201,201,1
20095,162,7089,7,5,5,0,0,2,7,1,2,1,2,3,3,2,4,0,2,0,0,2,201,201,1
20096,32,948,465,148,393,5,8,60,470,4,31,20,31,35,51,161,261,2,523,29,0,2,4,4,1
20097,32,948,16,12,9,0,0,6,16,1,2,1,2,3,3,2,4,0,2,0,0,2,4,4,1
20098,132,5719,1782,648,1425,9,47,279,1791,8,171,97,189,179,286,1292,2140,4,9462,525,0,2,3,3,1
20099,109,4106,1450,624,1228,12,26,181,1462,14,306,186,354,320,540,2580,4493,8,36391,2021,1,2,6,6,1
20100,155,4372,1660,832,1314,41,38,274,1701,20,312,209,395,332,604,2671,5058,12,64042,3557,1,2,2,2,1
20101,73,3850,1296,573,1062,40,33,157,1336,8,201,118,231,209,349,1561,2689,4,12365,686,0,2,3,3,1
20102,79,4191,1457,730,1242,11,6,188,1468,10,292,166,329,302,495,2424,4078,5,22973,1276,1,2,35,35,1
20103,39,2355,652,304,544,16,6,88,668,6,89,51,101,95,152,591,998,3,3399,188,0,2,14,14,1
20104,75,3288,1020,354,843,12,15,144,1032,8,134,77,144,142,221,970,1580,4,6792,377,0,2,14,14,1
20105,21,661,424,94,331,4,0,89,428,1,5,5,5,6,10,11,25,0,12,0,0,2,35,35,1
20106,36,1978,384,251,317,7,8,52,391,11,70,44,84,81,128,467,811,6,5355,297,0,2,18,18,1
20107,36,1591,386,256,301,16,9,68,402,4,59,35,69,63,104,355,621,2,1453,80,0,2,2,2,1
20108,75,2972,1043,504,840,53,9,147,1096,9,180,112,198,189,310,1377,2344,4,11604,644,0,2,4,4,1
20109,14,529,295,56,236,0,4,54,295,2,9,5,10,11,15,30,51,1,57,3,0,2,4,4,1
20110,26,1029,373,158,315,8,0,51,381,5,76,44,79,81,123,486,779,2,2026,112,0,2,14,14,1
20111,71,3006,1178,367,1042,6,15,115,1184,9,94,51,95,103,146,644,976,4,4439,246,0,2,3,3,1
20112,76,3899,1943,715,1694,26,18,214,1969,12,185,120,237,197,357,1436,2721,7,20915,1161,0,2,4,4,1
20113,48,1795,1098,241,925,5,10,155,1103,7,46,25,49,53,74,273,423,3,1580,87,0,2,11,11,1
20114,214,4608,182,127,129,0,0,53,182,5,39,21,42,44,63,217,343,2,926,51,0,2,3,3,1
20115,214,4608,1165,710,800,67,119,181,1232,18,243,153,282,261,435,2000,3492,10,36473,2026,1,2,3,3,1
20116,102,2083,773,419,590,28,0,166,801,10,204,113,217,214,330,1598,2554,5,13587,754,0,2,1,1,1
20117,102,2083,421,273,302,44,34,57,465,17,81,59,107,98,166,583,1098,11,12329,684,0,2,1,1,1
20118,167,5122,1660,832,1314,41,38,274,1701,20,312,209,395,332,604,2671,5058,12,64042,3557,1,2,1,1,1
20119,167,5122,1057,646,719,113,100,145,1170,18,215,134,248,233,382,1740,3004,10,31186,1732,1,2,1,1,1
20120,229,5199,4293,999,3693,19,54,507,4312,9,155,88,170,164,258,1156,1898,4,9368,520,0,2,1,1,1
20121,229,5199,1482,859,1002,125,135,219,1607,16,219,134,251,235,385,1766,3032,9,27804,1544,1,2,1,1,1
20122,184,4257,77,34,69,0,0,8,77,3,24,16,29,27,45,114,213,1,387,21,0,2,2,2,1
20123,184,4257,712,438,573,51,9,84,763,14,102,71,128,116,199,733,1364,8,11988,666,0,2,2,2,1
20124,75,1461,757,253,292,73,244,162,830,13,61,38,67,74,105,409,651,7,4654,258,0,2,1,1,1
20125,113,2492,1043,504,840,53,9,147,1096,9,180,112,198,189,310,1377,2344,4,11604,644,0,2,1,1,1
20126,113,2492,383,288,292,26,6,62,409,11,65,38,67,76,105,429,656,5,3719,206,0,2,1,1,1
20127,62,1240,1098,241,925,5,10,155,1103,7,46,25,49,53,74,273,423,3,1580,87,0,2,1,1,1
20128,62,1240,282,202,222,14,2,44,296,8,42,24,43,50,67,250,378,4,1548,86,0,2,1,1,1
20129,149,6984,1392,870,1177,35,17,170,1427,14,494,280,531,508,811,4473,7289,7,54850,3047,2,2,4,4,1
20130,231,5221,4293,999,3693,19,54,507,4312,9,155,88,170,164,258,1156,1898,4,9368,520,0,2,16,7,0
20131,231,5221,1482,859,1002,125,135,219,1607,16,219,134,251,235,385,1766,3032,9,27804,1544,1,2,16,7,0
20132,99,2020,1020,354,843,12,15,144,1032,8,134,77,144,142,221,970,1580,4,6792,377,0,2,29,21,0
20133,12,422,42,7,35,4,0,5,46,1,2,1,2,3,3,2,4,0,2,0,0,2,6,1,0
20134,12,422,11,6,10,0,0,1,11,2,4,2,4,6,6,10,15,1,15,0,0,2,6,1,0
20135,17,604,601,196,481,2,23,85,603,8,63,36,72,71,108,400,664,4,3036,168,0,2,2,0,0
20136,230,5220,4293,999,3693,19,54,507,4312,9,155,88,170,164,258,1156,1898,4,9368,520,0,2,2,2,0
20137,230,5220,1482,859,1002,125,135,219,1607,16,219,134,251,235,385,1766,3032,9,27804,1544,1,2,2,2,0
20138,112,2476,1043,504,840,53,9,147,1096,9,180,112,198,189,310,1377,2344,4,11604,644,0,2,0,5,0
20139,112,2476,383,288,292,26,6,62,409,11,65,38,67,76,105,429,656,5,3719,206,0,2,0,5,0
20140,214,4608,182,127,129,0,0,53,182,5,39,21,42,44,63,217,343,2,926,51,0,2,7,7,0
20141,214,4608,1165,710,800,67,119,181,1232,18,243,153,282,261,435,2000,3492,10,36473,2026,1,2,7,7,0
20142,102,2083,773,419,590,28,0,166,801,10,204,113,217,214,330,1598,2554,5,13587,754,0,2,9,9,0
20143,102,2083,421,273,302,44,34,57,465,17,81,59,107,98,166,583,1098,11,12329,684,0,2,9,9,0
20144,167,5122,1660,832,1314,41,38,274,1701,20,312,209,395,332,604,2671,5058,12,64042,3557,1,2,1,1,0
20145,167,5122,1057,646,719,113,100,145,1170,18,215,134,248,233,382,1740,3004,10,31186,1732,1,2,1,1,0
20146,86,1808,477,336,357,30,23,73,507,16,194,134,250,210,384,1538,2962,10,30538,1696,0,2,4,4,0
20147,351,7048,1457,730,1242,11,6,188,1468,10,292,166,329,302,495,2424,4078,5,22973,1276,1,2,6,6,0
20148,351,7048,74,35,59,1,0,14,75,3,14,7,14,17,21,58,85,1,128,7,0,2,6,6,0
20149,351,7048,245,125,200,5,7,34,250,7,30,17,34,37,51,166,265,3,1053,58,0,2,6,6,0
20150,229,5199,4293,999,3693,19,54,507,4312,9,155,88,170,164,258,1156,1898,4,9368,520,0,2,5,5,0
20151,229,5199,1482,859,1002,125,135,219,1607,16,219,134,251,235,385,1766,3032,9,27804,1544,1,2,5,5,0
20152,184,4257,77,34,69,0,0,8,77,3,24,16,29,27,45,114,213,1,387,21,0,2,2,2,0
20153,184,4257,712,438,573,51,9,84,763,14,102,71,128,116,199,733,1364,8,11988,666,0,2,2,2,0
20154,96,1835,1020,354,843,12,15,144,1032,8,134,77,144,142,221,970,1580,4,6792,377,0,2,2,2,0
20155,212,5103,722,423,573,19,0,135,741,12,172,101,199,184,300,1320,2257,6,15668,870,0,2,14,14,0
20156,212,5103,1508,847,911,44,250,301,1552,14,148,88,169,162,257,1120,1886,7,15077,837,0,2,14,14,0
20157,256,6158,72,33,56,0,4,12,72,1,1,1,1,2,2,0,2,0,1,0,0,2,7,7,0
20158,256,6158,1454,835,1044,76,110,219,1530,17,275,158,296,292,454,2297,3718,9,34017,1889,1,2,7,7,0
20159,75,1461,757,253,292,73,244,162,830,13,61,38,67,74,105,409,651,7,4654,258,0,2,1,1,0
20160,113,2492,1043,504,840,53,9,147,1096,9,180,112,198,189,310,1377,2344,4,11604,644,0,2,1,1,0
20161,113,2492,383,288,292,26,6,62,409,11,65,38,67,76,105,429,656,5,3719,206,0,2,1,1,0
20162,102,1930,1178,367,1042,6,15,115,1184,9,94,51,95,103,146,644,976,4,4439,246,0,2,3,3,0
20163,102,1930,177,108,140,8,0,27,185,6,30,16,32,36,48,162,248,3,794,44,0,2,3,3,0
20164,193,3994,1943,715,1694,26,18,214,1969,12,185,120,237,197,357,1436,2721,7,20915,1161,0,2,12,12,0
20165,193,3994,1168,838,957,57,25,144,1225,19,348,224,416,367,640,3018,5452,11,61921,3440,1,2,12,12,0
20166,62,1240,1098,241,925,5,10,155,1103,7,46,25,49,53,74,273,423,3,1580,87,0,2,5,5,0
20167,62,1240,282,202,222,14,2,44,296,8,42,24,43,50,67,250,378,4,1548,86,0,2,5,5,0
20168,149,6984,1392,870,1177,35,17,170,1427,14,494,280,531,508,811,4473,7289,7,54850,3047,2,2,6,6,0
20169,87,2923,773,419,590,28,0,166,801,10,204,113,217,214,330,1598,2554,5,13587,754,0,2,4,4,0
20170,98,4450,1338,495,1086,10,64,173,1348,11,122,82,157,133,239,883,1686,7,11934,663,0,2,4,4,0
20171,162,7089,139,89,101,2,0,35,141,7,54,34,62,61,96,330,569,4,2287,127,0,2,201,201,0
20172,162,7089,7,5,5,0,0,2,7,1,2,1,2,3,3,2,4,0,2,0,0,2,201,201,0
20173,32,948,465,148,393,5,8,60,470,4,31,20,31,35,51,161,261,2,523,29,0,2,4,4,0
20174,32,948,16,12,9,0,0,6,16,1,2,1,2,3,3,2,4,0,2,0,0,2,4,4,0
20175,132,5719,1782,648,1425,9,47,279,1791,8,171,97,189,179,286,1292,2140,4,9462,525,0,2,3,3,0
20176,109,4106,1450,624,1228,12,26,181,1462,14,306,186,354,320,540,2580,4493,8,36391,2021,1,2,6,6,0
20177,155,4372,1660,832,1314,41,38,274,1701,20,312,209,395,332,604,2671,5058,12,64042,3557,1,2,2,2,0
20178,73,3850,1296,573,1062,40,33,157,1336,8,201,118,231,209,349,1561,2689,4,12365,686,0,2,3,3,0
20179,79,4191,1457,730,1242,11,6,188,1468,10,292,166,329,302,495,2424,4078,5,22973,1276,1,2,35,35,0
20180,39,2355,652,304,544,16,6,88,668,6,89,51,101,95,152,591,998,3,3399,188,0,2,14,14,0
20181,75,3288,1020,354,843,12,15,144,1032,8,134,77,144,142,221,970,1580,4,6792,377,0,2,14,14,0
20182,21,661,424,94,331,4,0,89,428,1,5,5,5,6,10,11,25,0,12,0,0,2,35,35,0
20183,36,1978,384,251,317,7,8,52,391,11,70,44,84,81,128,467,811,6,5355,297,0,2,18,18,0
20184,36,1591,386,256,301,16,9,68,402,4,59,35,69,63,104,355,621,2,1453,80,0,2,2,2,0
20185,75,2972,1043,504,840,53,9,147,1096,9,180,112,198,189,310,1377,2344,4,11604,644,0,2,4,4,0
20186,14,529,295,56,236,0,4,54,295,2,9,5,10,11,15,30,51,1,57,3,0,2,4,4,0
20187,26,1029,373,158,315,8,0,51,381,5,76,44,79,81,123,486,779,2,2026,112,0,2,14,14,0
20188,71,3006,1178,367,1042,6,15,115,1184,9,94,51,95,103,146,644,976,4,4439,246,0,2,3,3,0
20189,76,3899,1943,715,1694,26,18,214,1969,12,185,120,237,197,357,1436,2721,7,20915,1161,0,2,4,4,0
20190,48,1795,1098,241,925,5,10,155,1103,7,46,25,49,53,74,273,423,3,1580,87,0,2,11,11,0
20191,17,604,601,196,481,2,23,85,603,8,63,36,72,71,108,400,664,4,3036,168,0,2,2,0,0
20192,214,4592,182,127,129,0,0,53,182,5,39,21,42,44,63,217,343,2,926,51,0,2,7,7,0
20193,214,4592,1165,710,800,67,119,181,1232,18,243,153,282,261,435,2000,3492,10,36473,2026,1,2,7,7,0
20194,101,2069,773,419,590,28,0,166,801,10,204,113,217,214,330,1598,2554,5,13587,754,0,2,9,9,0
20195,101,2069,421,273,302,44,34,57,465,17,81,59,107,98,166,583,1098,11,12329,684,0,2,9,9,0
20196,166,5068,1660,832,1314,41,38,274,1701,20,312,209,395,332,604,2671,5058,12,64042,3557,1,2,1,1,0
20197,166,5068,1057,646,719,113,100,145,1170,18,215,134,248,233,382,1740,3004,10,31186,1732,1,2,1,1,0
20198,86,1804,477,336,357,30,23,73,507,16,194,134,250,210,384,1538,2962,10,30538,1696,0,2,4,4,0
20199,346,6927,1457,730,1242,11,6,188,1468,10,292,166,329,302,495,2424,4078,5,22973,1276,1,2,6,6,0
20200,346,6927,74,35,59,1,0,14,75,3,14,7,14,17,21,58,85,1,128,7,0,2,6,6,0
20201,346,6927,245,125,200,5,7,34,250,7,30,17,34,37,51,166,265,3,1053,58,0,2,6,6,0
20202,231,5221,4293,999,3693,19,54,507,4312,9,155,88,170,164,258,1156,1898,4,9368,520,0,2,5,5,0
20203,231,5221,1482,859,1002,125,135,219,1607,16,219,134,251,235,385,1766,3032,9,27804,1544,1,2,5,5,0
20204,181,4189,77,34,69,0,0,8,77,3,24,16,29,27,45,114,213,1,387,21,0,2,1,1,0
20205,181,4189,712,438,573,51,9,84,763,14,102,71,128,116,199,733,1364,8,11988,666,0,2,1,1,0
20206,99,2020,1020,354,843,12,15,144,1032,8,134,77,144,142,221,970,1580,4,6792,377,0,2,2,2,0
20207,210,5003,722,423,573,19,0,135,741,12,172,101,199,184,300,1320,2257,6,15668,870,0,2,14,14,0
20208,210,5003,1508,847,911,44,250,301,1552,14,148,88,169,162,257,1120,1886,7,15077,837,0,2,14,14,0
20209,257,6066,72,33,56,0,4,12,72,1,1,1,1,2,2,0,2,0,1,0,0,2,7,7,0
20210,257,6066,1454,835,1044,76,110,219,1530,17,275,158,296,292,454,2297,3718,9,34017,1889,1,2,7,7,0
20211,73,1425,757,253,292,73,244,162,830,13,61,38,67,74,105,409,651,7,4654,258,0,2,1,1,0
20212,113,2488,1043,504,840,53,9,147,1096,9,180,112,198,189,310,1377,2344,4,11604,644,0,2,1,1,0
20213,113,2488,383,288,292,26,6,62,409,11,65,38,67,76,105,429,656,5,3719,206,0,2,1,1,0
20214,108,2066,1178,367,1042,6,15,115,1184,9,94,51,95,103,146,644,976,4,4439,246,0,2,3,3,0
20215,108,2066,177,108,140,8,0,27,185,6,30,16,32,36,48,162,248,3,794,44,0,2,3,3,0
20216,195,4029,1943,715,1694,26,18,214,1969,12,185,120,237,197,357,1436,2721,7,20915,1161,0,2,12,12,0
20217,195,4029,1168,838,957,57,25,144,1225,19,348,224,416,367,640,3018,5452,11,61921,3440,1,2,12,12,0
20218,62,1222,1098,241,925,5,10,155,1103,7,46,25,49,53,74,273,423,3,1580,87,0,2,5,5,0
20219,62,1222,282,202,222,14,2,44,296,8,42,24,43,50,67,250,378,4,1548,86,0,2,5,5,0
20220,147,6933,1392,870,1177,35,17,170,1427,14,494,280,531,508,811,4473,7289,7,54850,3047,2,2,6,6,0
20221,87,2905,773,419,590,28,0,166,801,10,204,113,217,214,330,1598,2554,5,13587,754,0,2,4,4,0
20222,97,4424,1338,495,1086,10,64,173,1348,11,122,82,157,133,239,883,1686,7,11934,663,0,2,4,4,0
20223,161,7062,139,89,101,2,0,35,141,7,54,34,62,61,96,330,569,4,2287,127,0,2,201,201,0
20224,161,7062,7,5,5,0,0,2,7,1,2,1,2,3,3,2,4,0,2,0,0,2,201,201,0
20225,32,948,465,148,393,5,8,60,470,4,31,20,31,35,51,161,261,2,523,29,0,2,4,4,0
20226,32,948,16,12,9,0,0,6,16,1,2,1,2,3,3,2,4,0,2,0,0,2,4,4,0
20227,132,5724,1782,648,1425,9,47,279,1791,8,171,97,189,179,286,1292,2140,4,9462,525,0,2,3,3,0
20228,109,4106,1450,624,1228,12,26,181,1462,14,306,186,354,320,540,2580,4493,8,36391,2021,1,2,6,6,0
20229,155,4372,1660,832,1314,41,38,274,1701,20,312,209,395,332,604,2671,5058,12,64042,3557,1,2,2,2,0
20230,73,3834,1296,573,1062,40,33,157,1336,8,201,118,231,209,349,1561,2689,4,12365,686,0,2,3,3,0
20231,80,4250,1457,730,1242,11,6,188,1468,10,292,166,329,302,495,2424,4078,5,22973,1276,1,2,35,35,0
20232,39,2355,652,304,544,16,6,88,668,6,89,51,101,95,152,591,998,3,3399,188,0,2,14,14,0
20233,75,3288,1020,354,843,12,15,144,1032,8,134,77,144,142,221,970,1580,4,6792,377,0,2,14,14,0
20234,21,661,424,94,331,4,0,89,428,1,5,5,5,6,10,11,25,0,12,0,0,2,35,35,0
20235,33,1914,384,251,317,7,8,52,391,11,70,44,84,81,128,467,811,6,5355,297,0,2,18,18,0
20236,39,1774,386,256,301,16,9,68,402,4,59,35,69,63,104,355,621,2,1453,80,0,2,2,2,0
20237,75,2972,1043,504,840,53,9,147,1096,9,180,112,198,189,310,1377,2344,4,11604,644,0,2,4,4,0
20238,14,529,295,56,236,0,4,54,295,2,9,5,10,11,15,30,51,1,57,3,0,2,4,4,0
20239,26,1029,373,158,315,8,0,51,381,5,76,44,79,81,123,486,779,2,2026,112,0,2,14,14,0
20240,74,3124,1178,367,1042,6,15,115,1184,9,94,51,95,103,146,644,976,4,4439,246,0,2,3,3,0
20241,76,3893,1943,715,1694,26,18,214,1969,12,185,120,237,197,357,1436,2721,7,20915,1161,0,2,4,4,0
20242,48,1750,1098,241,925,5,10,155,1103,7,46,25,49,53,74,273,423,3,1580,87,0,2,11,11,0
20243,18,646,601,196,481,2,23,85,603,8,63,36,72,71,108,400,664,4,3036,168,0,2,2,0,0
20244,230,5220,4293,999,3693,19,54,507,4312,9,155,88,170,164,258,1156,1898,4,9368,520,0,2,2,2,0
20245,230,5220,1482,859,1002,125,135,219,1607,16,219,134,251,235,385,1766,3032,9,27804,1544,1,2,2,2,0
20246,112,2476,1043,504,840,53,9,147,1096,9,180,112,198,189,310,1377,2344,4,11604,644,0,2,0,5,0
20247,112,2476,383,288,292,26,6,62,409,11,65,38,67,76,105,429,656,5,3719,206,0,2,0,5,0
20248,230,5208,4293,999,3693,19,54,507,4312,9,155,88,170,164,258,1156,1898,4,9368,520,0,2,3,1,0
20249,230,5208,1482,859,1002,125,135,219,1607,16,219,134,251,235,385,1766,3032,9,27804,1544,1,2,3,1,0
20250,230,5208,4293,999,3693,19,54,507,4312,9,155,88,170,164,258,1156,1898,4,9368,520,0,2,3,1,0
20251,230,5208,1482,859,1002,125,135,219,1607,16,219,134,251,235,385,1766,3032,9,27804,1544,1,2,3,1,0
20252,214,4592,182,127,129,0,0,53,182,5,39,21,42,44,63,217,343,2,926,51,0,2,7,7,0
20253,214,4592,1165,710,800,67,119,181,1232,18,243,153,282,261,435,2000,3492,10,36473,2026,1,2,7,7,0
20254,101,2069,773,419,590,28,0,166,801,10,204,113,217,214,330,1598,2554,5,13587,754,0,2,9,9,0
20255,101,2069,421,273,302,44,34,57,465,17,81,59,107,98,166,583,1098,11,12329,684,0,2,9,9,0
20256,166,5068,1660,832,1314,41,38,274,1701,20,312,209,395,332,604,2671,5058,12,64042,3557,1,2,1,1,0
20257,166,5068,1057,646,719,113,100,145,1170,18,215,134,248,233,382,1740,3004,10,31186,1732,1,2,1,1,0
20258,86,1804,477,336,357,30,23,73,507,16,194,134,250,210,384,1538,2962,10,30538,1696,0,2,4,4,0
20259,346,6927,1457,730,1242,11,6,188,1468,10,292,166,329,302,495,2424,4078,5,22973,1276,1,2,6,6,0
20260,346,6927,74,35,59,1,0,14,75,3,14,7,14,17,21,58,85,1,128,7,0,2,6,6,0
20261,346,6927,245,125,200,5,7,34,250,7,30,17,34,37,51,166,265,3,1053,58,0,2,6,6,0
20262,230,5220,4293,999,3693,19,54,507,4312,9,155,88,170,164,258,1156,1898,4,9368,520,0,2,5,5,0
20263,230,5220,1482,859,1002,125,135,219,1607,16,219,134,251,235,385,1766,3032,9,27804,1544,1,2,5,5,0
20264,181,4189,77,34,69,0,0,8,77,3,24,16,29,27,45,114,213,1,387,21,0,2,1,1,0
20265,181,4189,712,438,573,51,9,84,763,14,102,71,128,116,199,733,1364,8,11988,666,0,2,1,1,0
20266,99,2020,1020,354,843,12,15,144,1032,8,134,77,144,142,221,970,1580,4,6792,377,0,2,2,2,0
20267,210,5003,722,423,573,19,0,135,741,12,172,101,199,184,300,1320,2257,6,15668,870,0,2,14,14,0
20268,210,5003,1508,847,911,44,250,301,1552,14,148,88,169,162,257,1120,1886,7,15077,837,0,2,14,14,0
20269,257,6066,72,33,56,0,4,12,72,1,1,1,1,2,2,0,2,0,1,0,0,2,7,7,0
20270,257,6066,1454,835,1044,76,110,219,1530,17,275,158,296,292,454,2297,3718,9,34017,1889,1,2,7,7,0
20271,73,1425,757,253,292,73,244,162,830,13,61,38,67,74,105,409,651,7,4654,258,0,2,1,1,0
20272,113,2488,1043,504,840,53,9,147,1096,9,180,112,198,189,310,1377,2344,4,11604,644,0,2,1,1,0
20273,113,2488,383,288,292,26,6,62,409,11,65,38,67,76,105,429,656,5,3719,206,0,2,1,1,0
20274,108,2066,1178,367,1042,6,15,115,1184,9,94,51,95,103,146,644,976,4,4439,246,0,2,3,3,0
20275,108,2066,177,108,140,8,0,27,185,6,30,16,32,36,48,162,248,3,794,44,0,2,3,3,0
20276,195,4029,1943,715,1694,26,18,214,1969,12,185,120,237,197,357,1436,2721,7,20915,1161,0,2,12,12,0
20277,195,4029,1168,838,957,57,25,144,1225,19,348,224,416,367,640,3018,5452,11,61921,3440,1,2,12,12,0
20278,62,1222,1098,241,925,5,10,155,1103,7,46,25,49,53,74,273,423,3,1580,87,0,2,5,5,0
20279,62,1222,282,202,222,14,2,44,296,8,42,24,43,50,67,250,378,4,1548,86,0,2,5,5,0
20280,147,6933,1392,870,1177,35,17,170,1427,14,494,280,531,508,811,4473,7289,7,54850,3047,2,2,6,6,0
20281,87,2905,773,419,590,28,0,166,801,10,204,113,217,214,330,1598,2554,5,13587,754,0,2,4,4,0
20282,97,4424,1338,495,1086,10,64,173,1348,11,122,82,157,133,239,883,1686,7,11934,663,0,2,4,4,0
20283,161,7062,139,89,101,2,0,35,141,7,54,34,62,61,96,330,569,4,2287,127,0,2,201,201,0
20284,161,7062,7,5,5,0,0,2,7,1,2,1,2,3,3,2,4,0,2,0,0,2,201,201,0
20285,32,948,465,148,393,5,8,60,470,4,31,20,31,35,51,161,261,2,523,29,0,2,4,4,0
20286,32,948,16,12,9,0,0,6,16,1,2,1,2,3,3,2,4,0,2,0,0,2,4,4,0
20287,132,5724,1782,648,1425,9,47,279,1791,8,171,97,189,179,286,1292,2140,4,9462,525,0,2,3,3,0
20288,109,4106,1450,624,1228,12,26,181,1462,14,306,186,354,320,540,2580,4493,8,36391,2021,1,2,6,6,0
20289,155,4372,1660,832,1314,41,38,274,1701,20,312,209,395,332,604,2671,5058,12,64042,3557,1,2,2,2,0
20290,73,3834,1296,573,1062,40,33,157,1336,8,201,118,231,209,349,1561,2689,4,12365,686,0,2,3,3,0
20291,80,4250,1457,730,1242,11,6,188,1468,10,292,166,329,302,495,2424,4078,5,22973,1276,1,2,35,35,0
20292,39,2355,652,304,544,16,6,88,668,6,89,51,101,95,152,591,998,3,3399,188,0,2,14,14,0
20293,75,3288,1020,354,843,12,15,144,1032,8,134,77,144,142,221,970,1580,4,6792,377,0,2,14,14,0
20294,21,661,424,94,331,4,0,89,428,1,5,5,5,6,10,11,25,0,12,0,0,2,35,35,0
20295,33,1914,384,251,317,7,8,52,391,11,70,44,84,81,128,467,811,6,5355,297,0,2,18,18,0
20296,39,1774,386,256,301,16,9,68,402,4,59,35,69,63,104,355,621,2,1453,80,0,2,2,2,0
20297,75,2972,1043,504,840,53,9,147,1096,9,180,112,198,189,310,1377,2344,4,11604,644,0,2,4,4,0
20298,14,529,295,56,236,0,4,54,295,2,9,5,10,11,15,30,51,1,57,3,0,2,4,4,0
20299,26,1029,373,158,315,8,0,51,381,5,76,44,79,81,123,486,779,2,2026,112,0,2,14,14,0
20300,74,3124,1178,367,1042,6,15,115,1184,9,94,51,95,103,146,644,976,4,4439,246,0,2,3,3,0
20301,76,3893,1943,715,1694,26,18,214,1969,12,185,120,237,197,357,1436,2721,7,20915,1161,0,2,4,4,0
20302,48,1750,1098,241,925,5,10,155,1103,7,46,25,49,53,74,273,423,3,1580,87,0,2,11,11,0
20303,18,646,601,196,481,2,23,85,603,8,63,36,72,71,108,400,664,4,3036,168,0,2,2,0,0
20304,11,235,19,8,11,5,0,4,24,2,5,3,6,7,9,13,25,1,30,1,0,2,3,2,0
20305,11,235,102,59,69,5,3,24,107,6,22,15,28,28,43,113,206,3,789,43,0,2,3,2,0
20306,11,235,106,40,36,3,49,17,109,8,17,13,23,25,36,93,167,5,904,50,0,2,3,2,0
20307,214,4608,182,127,129,0,0,53,182,5,39,21,42,44,63,217,343,2,926,51,0,2,7,7,0
20308,214,4608,1165,710,800,67,119,181,1232,18,243,153,282,261,435,2000,3492,10,36473,2026,1,2,7,7,0
20309,102,2083,773,419,590,28,0,166,801,10,204,113,217,214,330,1598,2554,5,13587,754,0,2,9,9,0
20310,102,2083,421,273,302,44,34,57,465,17,81,59,107,98,166,583,1098,11,12329,684,0,2,9,9,0
20311,167,5122,1660,832,1314,41,38,274,1701,20,312,209,395,332,604,2671,5058,12,64042,3557,1,2,12,6,0
20312,167,5122,1057,646,719,113,100,145,1170,18,215,134,248,233,382,1740,3004,10,31186,1732,1,2,12,6,0
20313,86,1808,477,336,357,30,23,73,507,16,194,134,250,210,384,1538,2962,10,30538,1696,0,2,4,4,0
20314,351,7048,1457,730,1242,11,6,188,1468,10,292,166,329,302,495,2424,4078,5,22973,1276,1,2,6,6,0
20315,351,7048,74,35,59,1,0,14,75,3,14,7,14,17,21,58,85,1,128,7,0,2,6,6,0
20316,351,7048,245,125,200,5,7,34,250,7,30,17,34,37,51,166,265,3,1053,58,0,2,6,6,0
20317,60,1682,1455,414,1257,16,76,112,1471,5,41,23,46,46,69,231,381,2,1069,59,0,2,1,1,0
20318,60,1682,669,365,481,22,61,110,691,15,103,63,122,118,185,747,1273,8,11311,628,0,2,1,1,0
20319,230,5208,4293,999,3693,19,54,507,4312,9,155,88,170,164,258,1156,1898,4,9368,520,0,2,25,16,0
20320,230,5208,1482,859,1002,125,135,219,1607,16,219,134,251,235,385,1766,3032,9,27804,1544,1,2,25,16,0
20321,83,2365,1523,757,1297,19,12,193,1542,12,193,117,230,205,347,1508,2664,7,19053,1058,0,2,2,1,0
20322,83,2365,701,378,504,33,58,109,734,13,110,68,126,123,194,794,1346,7,10027,557,0,2,2,1,0
20323,188,4306,77,34,69,0,0,8,77,3,24,16,29,27,45,114,213,1,387,21,0,2,8,6,0
20324,188,4306,712,438,573,51,9,84,763,14,102,71,128,116,199,733,1364,8,11988,666,0,2,8,6,0
20325,96,1835,1020,354,843,12,15,144,1032,8,134,77,144,142,221,970,1580,4,6792,377,0,2,8,6,0
20326,4,90,53,23,39,0,0,13,53,2,8,4,8,10,12,26,39,1,39,2,0,0,37,0,0
20327,4,90,515,298,307,33,80,99,548,12,63,44,77,75,121,419,753,7,5527,307,0,0,37,0,0
20328,212,5103,722,423,573,19,0,135,741,12,172,101,199,184,300,1320,2257,6,15668,870,0,2,14,14,0
20329,212,5103,1508,847,911,44,250,301,1552,14,148,88,169,162,257,1120,1886,7,15077,837,0,2,14,14,0
20330,256,6158,72,33,56,0,4,12,72,1,1,1,1,2,2,0,2,0,1,0,0,2,25,27,0
20331,256,6158,1454,835,1044,76,110,219,1530,17,275,158,296,292,454,2297,3718,9,34017,1889,1,2,25,27,0
20332,75,1461,757,253,292,73,244,162,830,13,61,38,67,74,105,409,651,7,4654,258,0,2,3,2,0
20333,112,2476,1043,504,840,53,9,147,1096,9,180,112,198,189,310,1377,2344,4,11604,644,0,2,1,6,0
20334,112,2476,383,288,292,26,6,62,409,11,65,38,67,76,105,429,656,5,3719,206,0,2,1,6,0
20335,102,1930,1178,367,1042,6,15,115,1184,9,94,51,95,103,146,644,976,4,4439,246,0,2,3,3,0
20336,102,1930,177,108,140,8,0,27,185,6,30,16,32,36,48,162,248,3,794,44,0,2,3,3,0
20337,193,3994,1943,715,1694,26,18,214,1969,12,185,120,237,197,357,1436,2721,7,20915,1161,0,2,14,13,0
20338,193,3994,1168,838,957,57,25,144,1225,19,348,224,416,367,640,3018,5452,11,61921,3440,1,2,14,13,0
20339,62,1240,1098,241,925,5,10,155,1103,7,46,25,49,53,74,273,423,3,1580,87,0,2,5,5,0
20340,62,1240,282,202,222,14,2,44,296,8,42,24,43,50,67,250,378,4,1548,86,0,2,5,5,0
20341,149,6984,1392,870,1177,35,17,170,1427,14,494,280,531,508,811,4473,7289,7,54850,3047,2,2,6,6,0
20342,87,2923,773,419,590,28,0,166,801,10,204,113,217,214,330,1598,2554,5,13587,754,0,2,4,4,0
20343,98,4450,1338,495,1086,10,64,173,1348,11,122,82,157,133,239,883,1686,7,11934,663,0,2,4,4,0
20344,162,7089,139,89,101,2,0,35,141,7,54,34,62,61,96,330,569,4,2287,127,0,2,201,201,0
20345,162,7089,7,5,5,0,0,2,7,1,2,1,2,3,3,2,4,0,2,0,0,2,201,201,0
20346,32,948,465,148,393,5,8,60,470,4,31,20,31,35,51,161,261,2,523,29,0,2,4,4,0
20347,32,948,16,12,9,0,0,6,16,1,2,1,2,3,3,2,4,0,2,0,0,2,4,4,0
20348,132,5719,1782,648,1425,9,47,279,1791,8,171,97,189,179,286,1292,2140,4,9462,525,0,2,3,3,0
20349,6,329,180,34,164,0,0,16,180,1,12,6,12,13,18,43,66,0,33,1,0,2,21,0,0
20350,23,607,102,59,69,5,3,24,107,6,22,15,28,28,43,113,206,3,789,43,0,2,1,1,0
20351,109,4106,1450,624,1228,12,26,181,1462,14,306,186,354,320,540,2580,4493,8,36391,2021,1,2,6,6,0
20352,155,4372,1660,832,1314,41,38,274,1701,20,312,209,395,332,604,2671,5058,12,64042,3557,1,2,37,15,0
20353,73,3850,1296,573,1062,40,33,157,1336,8,201,118,231,209,349,1561,2689,4,12365,686,0,2,29,3,0
20354,79,4191,1457,730,1242,11,6,188,1468,10,292,166,329,302,495,2424,4078,5,22973,1276,1,2,35,35,0
20355,39,2355,652,304,544,16,6,88,668,6,89,51,101,95,152,591,998,3,3399,188,0,2,14,14,0
20356,66,3053,1455,414,1257,16,76,112,1471,5,41,23,46,46,69,231,381,2,1069,59,0,2,28,2,0
20357,75,3288,1020,354,843,12,15,144,1032,8,134,77,144,142,221,970,1580,4,6792,377,0,2,49,14,0
20358,1,106,53,23,39,0,0,13,53,2,8,4,8,10,12,26,39,1,39,2,0,0,18,0,0
20359,21,661,424,94,331,4,0,89,428,1,5,5,5,6,10,11,25,0,12,0,0,2,35,35,0
20360,36,1978,384,251,317,7,8,52,391,11,70,44,84,81,128,467,811,6,5355,297,0,2,18,18,0
20361,36,1591,386,256,301,16,9,68,402,4,59,35,69,63,104,355,621,2,1453,80,0,2,2,2,0
20362,75,2972,1043,504,840,53,9,147,1096,9,180,112,198,189,310,1377,2344,4,11604,644,0,2,4,4,0
20363,14,529,295,56,236,0,4,54,295,2,9,5,10,11,15,30,51,1,57,3,0,2,4,4,0
20364,26,1029,373,158,315,8,0,51,381,5,76,44,79,81,123,486,779,2,2026,112,0,2,14,14,0
20365,71,3006,1178,367,1042,6,15,115,1184,9,94,51,95,103,146,644,976,4,4439,246,0,2,3,3,0
20366,76,3899,1943,715,1694,26,18,214,1969,12,185,120,237,197,357,1436,2721,7,20915,1161,0,2,4,4,0
20367,48,1795,1098,241,925,5,10,155,1103,7,46,25,49,53,74,273,423,3,1580,87,0,2,11,11,0
20368,17,604,601,196,481,2,23,85,603,8,63,36,72,71,108,400,664,4,3036,168,0,2,2,0,0
20369,188,4306,77,34,69,0,0,8,77,3,24,16,29,27,45,114,213,1,387,21,0,2,8,0,0
20370,188,4306,712,438,573,51,9,84,763,14,102,71,128,116,199,733,1364,8,11988,666,0,2,8,0,0
20371,81,3472,1289,550,1043,56,32,155,1345,10,167,93,185,177,278,1266,2075,5,11498,638,0,2,3,1,0
20372,11,235,19,8,11,5,0,4,24,2,5,3,6,7,9,13,25,1,30,1,0,2,9,5,0
20373,11,235,102,59,69,5,3,24,107,6,22,15,28,28,43,113,206,3,789,43,0,2,9,5,0
20374,11,235,106,40,36,3,49,17,109,8,17,13,23,25,36,93,167,5,904,50,0,2,9,5,0
20375,214,4608,182,127,129,0,0,53,182,5,39,21,42,44,63,217,343,2,926,51,0,2,94,47,0
20376,214,4608,1165,710,800,67,119,181,1232,18,243,153,282,261,435,2000,3492,10,36473,2026,1,2,94,47,0
20377,102,2083,773,419,590,28,0,166,801,10,204,113,217,214,330,1598,2554,5,13587,754,0,2,34,32,0
20378,102,2083,421,273,302,44,34,57,465,17,81,59,107,98,166,583,1098,11,12329,684,0,2,34,32,0
20379,27,542,2,2,2,0,0,0,2,0,0,0,0,0,0,0,0,0,0,0,0,2,5,21,0
20380,27,542,99,48,90,1,3,5,100,0,0,0,0,0,0,0,0,0,0,0,0,2,5,21,0
20381,27,542,8,5,5,2,0,1,10,0,0,0,0,0,0,0,0,0,0,0,0,2,5,21,0
20382,27,542,1217,716,841,84,126,174,1301,14,185,118,215,199,333,1446,2542,8,20687,1149,0,2,5,21,0
20383,27,542,160,89,115,0,13,31,160,7,15,11,17,22,28,78,124,3,495,27,0,2,5,21,0
20384,27,542,10,10,9,9,0,0,19,0,0,0,0,0,0,0,0,0,0,0,0,2,5,21,0
20385,27,542,173,84,99,8,29,36,181,5,12,7,13,17,20,54,81,2,221,12,0,2,5,21,0
20386,27,542,3,1,1,3,0,0,6,0,0,0,0,0,0,0,0,0,0,0,0,2,5,21,0
20387,167,5122,1660,832,1314,41,38,274,1701,20,312,209,395,332,604,2671,5058,12,64042,3557,1,2,34,27,0
20388,167,5122,1057,646,719,113,100,145,1170,18,215,134,248,233,382,1740,3004,10,31186,1732,1,2,34,27,0
20389,17,349,95,58,50,9,16,20,104,12,33,24,45,45,69,209,378,8,3100,172,0,0,102,0,0
20390,86,1808,477,336,357,30,23,73,507,16,194,134,250,210,384,1538,2962,10,30538,1696,0,2,24,17,0
20391,59,1352,996,429,845,24,10,117,1020,7,76,50,88,83,138,494,879,4,3565,198,0,2,43,28,0
20392,59,1352,456,277,329,12,42,72,468,13,85,50,97,98,147,592,972,7,7212,400,0,2,43,28,0
20393,133,2659,1513,682,1277,25,13,200,1538,11,199,116,219,210,335,1557,2584,6,15641,868,0,2,94,8,0
20394,133,2659,819,519,539,24,98,155,843,15,96,57,106,111,163,690,1107,8,9171,509,0,2,94,8,0
20395,58,1234,207,111,150,11,0,50,218,5,26,19,36,31,55,133,272,3,943,52,0,2,118,22,0
20396,58,1234,410,198,237,31,55,97,441,11,63,38,72,74,110,414,683,6,4293,238,0,2,118,22,0
20397,351,7048,1457,730,1242,11,6,188,1468,10,292,166,329,302,495,2424,4078,5,22973,1276,1,2,197,123,0
20398,351,7048,74,35,59,1,0,14,75,3,14,7,14,17,21,58,85,1,128,7,0,2,197,123,0
20399,351,7048,245,125,200,5,7,34,250,7,30,17,34,37,51,166,265,3,1053,58,0,2,197,123,0
20400,21,662,339,213,244,17,9,65,356,10,42,26,48,52,74,259,421,5,2410,133,0,2,20,21,0
20401,60,1682,1455,414,1257,16,76,112,1471,5,41,23,46,46,69,231,381,2,1069,59,0,2,52,21,0
20402,60,1682,669,365,481,22,61,110,691,15,103,63,122,118,185,747,1273,8,11311,628,0,2,52,21,0
20403,230,5217,4293,999,3693,19,54,507,4312,9,155,88,170,164,258,1156,1898,4,9368,520,0,2,119,113,0
20404,230,5217,1482,859,1002,125,135,219,1607,16,219,134,251,235,385,1766,3032,9,27804,1544,1,2,119,113,0
20405,6,136,44,22,19,0,19,6,44,2,10,6,12,12,18,35,64,1,77,4,0,2,2,4,0
20406,27,954,74,35,59,1,0,14,75,3,14,7,14,17,21,58,85,1,128,7,0,2,61,21,0
20407,27,954,245,125,200,5,7,34,250,7,30,17,34,37,51,166,265,3,1053,58,0,2,61,21,0
20408,50,586,647,139,84,35,284,233,682,0,0,0,0,0,0,0,0,0,0,0,0,2,133,24,0
20409,83,2365,1523,757,1297,19,12,193,1542,12,193,117,230,205,347,1508,2664,7,19053,1058,0,2,57,17,0
20410,83,2365,701,378,504,33,58,109,734,13,110,68,126,123,194,794,1346,7,10027,557,0,2,57,17,0
20411,188,4306,77,34,69,0,0,8,77,3,24,16,29,27,45,114,213,1,387,21,0,2,159,86,0
20412,188,4306,712,438,573,51,9,84,763,14,102,71,128,116,199,733,1364,8,11988,666,0,2,159,86,0
20413,96,1835,1020,354,843,12,15,144,1032,8,134,77,144,142,221,970,1580,4,6792,377,0,2,214,77,0
20414,46,955,447,308,343,6,5,95,453,7,96,59,111,103,170,651,1136,4,4600,255,0,2,11,10,0
20415,46,955,322,174,179,16,74,51,338,10,41,26,46,51,72,252,408,5,2291,127,0,2,11,10,0
20416,4,90,53,23,39,0,0,13,53,2,8,4,8,10,12,26,39,1,39,2,0,0,37,0,0
20417,4,90,515,298,307,33,80,99,548,12,63,44,77,75,121,419,753,7,5527,307,0,0,37,0,0
20418,23,388,424,94,331,4,0,89,428,1,5,5,5,6,10,11,25,0,12,0,0,2,13,11,0
20419,23,388,38,23,23,6,0,8,44,3,11,7,11,14,18,42,68,1,102,5,0,2,13,11,0
20420,18,466,205,80,86,16,53,53,221,7,18,10,19,25,29,94,134,3,497,27,0,0,140,0,0
20421,17,518,184,100,137,2,15,30,186,6,38,20,39,44,59,214,322,3,991,55,0,2,6,4,0
20422,17,518,103,65,74,8,5,16,111,7,17,9,17,24,26,89,119,3,417,23,0,2,6,4,0
20423,212,5103,722,423,573,19,0,135,741,12,172,101,199,184,300,1320,2257,6,15668,870,0,2,106,78,0
20424,212,5103,1508,847,911,44,250,301,1552,14,148,88,169,162,257,1120,1886,7,15077,837,0,2,106,78,0
20425,256,6158,72,33,56,0,4,12,72,1,1,1,1,2,2,0,2,0,1,0,0,2,201,606,0
20426,256,6158,1454,835,1044,76,110,219,1530,17,275,158,296,292,454,2297,3718,9,34017,1889,1,2,201,606,0
20427,75,1461,757,253,292,73,244,162,830,13,61,38,67,74,105,409,651,7,4654,258,0,0,626,0,0
20428,40,837,386,256,301,16,9,68,402,4,59,35,69,63,104,355,621,2,1453,80,0,2,56,77,0
20429,40,837,264,131,164,11,41,46,275,6,38,22,40,44,62,214,338,3,1068,59,0,2,56,77,0
20430,30,649,215,129,180,6,0,29,221,8,65,43,72,73,115,415,711,4,3153,175,0,2,12,6,0
20431,30,649,97,69,77,3,3,16,100,6,22,13,23,28,36,113,173,3,542,30,0,2,12,6,0
20432,112,2476,1043,504,840,53,9,147,1096,9,180,112,198,189,310,1377,2344,4,11604,644,0,2,77,147,0
20433,112,2476,383,288,292,26,6,62,409,11,65,38,67,76,105,429,656,5,3719,206,0,2,77,147,0
20434,20,408,294,64,250,0,0,43,294,1,20,10,20,21,30,86,131,0,65,3,0,2,2,0,0
20435,20,408,78,46,62,3,0,14,81,3,8,4,8,11,12,28,41,1,62,3,0,2,2,0,0
20436,5,118,110,30,77,3,13,16,113,4,21,15,30,25,45,100,208,2,597,33,0,2,2,0,0
20437,5,118,28,15,21,1,0,6,29,0,0,0,0,0,0,0,0,0,0,0,0,2,2,0,0
20438,102,1930,1178,367,1042,6,15,115,1184,9,94,51,95,103,146,644,976,4,4439,246,0,2,72,75,0
20439,102,1930,177,108,140,8,0,27,185,6,30,16,32,36,48,162,248,3,794,44,0,2,72,75,0
20440,193,3994,1943,715,1694,26,18,214,1969,12,185,120,237,197,357,1436,2721,7,20915,1161,0,2,125,68,0
20441,193,3994,1168,838,957,57,25,144,1225,19,348,224,416,367,640,3018,5452,11,61921,3440,1,2,125,68,0
20442,16,477,442,244,305,14,16,103,456,11,68,45,75,79,120,452,756,6,4588,254,0,2,5,3,0
20443,16,477,182,102,99,11,40,35,193,3,11,6,11,14,17,42,64,1,97,5,0,2,5,3,0
20444,62,1240,1098,241,925,5,10,155,1103,7,46,25,49,53,74,273,423,3,1580,87,0,2,51,29,0
20445,62,1240,282,202,222,14,2,44,296,8,42,24,43,50,67,250,378,4,1548,86,0,2,51,29,0
20446,21,433,601,196,481,2,23,85,603,8,63,36,72,71,108,400,664,4,3036,168,0,0,94,0,0
20447,21,433,156,79,106,5,16,28,161,5,14,8,15,19,23,64,97,2,261,14,0,0,94,0,0
20448,1,300,382,65,130,157,2,92,539,4,10,5,10,14,15,41,57,2,114,6,0,2,1,1,0
20449,60,1092,282,196,195,3,0,86,285,8,130,71,141,138,212,936,1507,4,6538,363,0,2,6,6,0
20450,7,114,44,19,17,0,16,11,44,3,14,7,14,17,21,58,85,1,128,7,0,2,1,1,0
20451,3,66,127,75,83,2,11,30,129,4,14,7,14,18,21,61,87,2,175,9,0,2,1,1,0
20452,3,66,652,304,544,16,6,88,668,6,89,51,101,95,152,591,998,3,3399,188,0,2,1,1,0
20453,3,66,2,2,2,0,0,0,2,0,0,0,0,0,0,0,0,0,0,0,0,2,1,1,0
20454,3,66,8,5,5,0,0,3,8,0,0,0,0,0,0,0,0,0,0,0,0,2,1,1,0
20455,3,66,2,2,2,0,0,0,2,0,0,0,0,0,0,0,0,0,0,0,0,2,1,1,0
20456,3,66,14,8,8,0,0,6,14,0,0,0,0,0,0,0,0,0,0,0,0,2,1,1,0
20457,3,66,6,4,4,0,0,2,6,0,0,0,0,0,0,0,0,0,0,0,0,2,1,1,0
20458,3,66,6,4,4,0,0,2,6,1,2,1,2,3,3,2,4,0,2,0,0,2,1,1,0
20459,3,66,6,4,4,0,0,2,6,0,0,0,0,0,0,0,0,0,0,0,0,2,1,1,0
20460,3,66,7,5,5,0,0,2,7,0,0,0,0,0,0,0,0,0,0,0,0,2,1,1,0
20461,3,66,6,4,4,0,0,2,6,0,0,0,0,0,0,0,0,0,0,0,0,2,1,1,0
20462,3,66,10,6,6,0,0,4,10,0,0,0,0,0,0,0,0,0,0,0,0,2,1,1,0
20463,3,66,1,1,1,0,0,0,1,0,0,0,0,0,0,0,0,0,0,0,0,2,1,1,0
20464,3,66,1,1,1,0,0,0,1,0,0,0,0,0,0,0,0,0,0,0,0,2,1,1,0
20465,3,66,14,10,10,0,0,4,14,1,1,1,1,2,2,0,2,0,1,0,0,2,1,1,0
20466,3,66,46,26,30,3,0,12,49,3,6,3,6,9,9,20,28,1,42,2,0,2,1,1,0
20467,7,301,72,33,56,0,4,12,72,1,1,1,1,2,2,0,2,0,1,0,0,2,1,1,0
20468,3,26,14,7,7,2,0,5,16,0,0,0,0,0,0,0,0,0,0,0,0,2,1,1,0
20469,11,410,42,7,35,4,0,5,46,1,2,1,2,3,3,2,4,0,2,0,0,2,23,25,0
20470,11,410,11,6,10,0,0,1,11,2,4,2,4,6,6,10,15,1,15,0,0,2,23,25,0
20471,81,3472,1289,550,1043,56,32,155,1345,10,167,93,185,177,278,1266,2075,5,11498,638,0,2,93,26,0
20472,36,1085,182,127,129,0,0,53,182,5,39,21,42,44,63,217,343,2,926,51,0,2,44,9,0
20473,149,6984,1392,870,1177,35,17,170,1427,14,494,280,531,508,811,4473,7289,7,54850,3047,2,2,169,58,0
20474,87,2923,773,419,590,28,0,166,801,10,204,113,217,214,330,1598,2554,5,13587,754,0,2,73,48,0
20475,7,281,75,38,59,1,3,12,76,2,4,2,4,6,6,10,15,1,15,0,0,2,11,3,0
20476,2,26,6,4,4,0,0,2,6,1,4,2,4,5,6,8,13,0,6,0,0,2,2,1,0
20477,54,3424,520,294,400,33,13,81,553,10,261,204,367,271,571,2128,4614,7,32445,1802,1,2,190,104,0
20478,98,4450,1338,495,1086,10,64,173,1348,11,122,82,157,133,239,883,1686,7,11934,663,0,2,145,50,0
20479,164,7175,139,89,101,2,0,35,141,7,54,34,62,61,96,330,569,4,2287,127,0,2,437,294,0
20480,164,7175,7,5,5,0,0,2,7,1,2,1,2,3,3,2,4,0,2,0,0,2,437,294,0
20481,32,948,465,148,393,5,8,60,470,4,31,20,31,35,51,161,261,2,523,29,0,2,18,16,0
20482,32,948,16,12,9,0,0,6,16,1,2,1,2,3,3,2,4,0,2,0,0,2,18,16,0
20483,132,5719,1782,648,1425,9,47,279,1791,8,171,97,189,179,286,1292,2140,4,9462,525,0,2,253,113,0
20484,20,541,256,139,192,9,7,47,265,4,23,12,24,27,36,112,171,2,357,19,0,2,16,10,0
20485,6,329,180,34,164,0,0,16,180,1,12,6,12,13,18,43,66,0,33,1,0,2,21,0,0
20486,23,607,102,59,69,5,3,24,107,6,22,15,28,28,43,113,206,3,789,43,0,2,21,14,0
20487,109,4106,1450,624,1228,12,26,181,1462,14,306,186,354,320,540,2580,4493,8,36391,2021,1,2,204,68,0
20488,155,4372,1660,832,1314,41,38,274,1701,20,312,209,395,332,604,2671,5058,12,64042,3557,1,2,115,42,0
20489,120,4833,1513,682,1277,25,13,200,1538,11,199,116,219,210,335,1557,2584,6,15641,868,0,2,91,38,0
20490,73,3850,1296,573,1062,40,33,157,1336,8,201,118,231,209,349,1561,2689,4,12365,686,0,2,144,39,0
20491,14,341,207,111,150,11,0,50,218,5,26,19,36,31,55,133,272,3,943,52,0,0,101,0,0
20492,79,4191,1457,730,1242,11,6,188,1468,10,292,166,329,302,495,2424,4078,5,22973,1276,1,2,135,64,0
20493,39,2355,652,304,544,16,6,88,668,6,89,51,101,95,152,591,998,3,3399,188,0,2,79,51,0
20494,66,3053,1455,414,1257,16,76,112,1471,5,41,23,46,46,69,231,381,2,1069,59,0,2,132,21,0
20495,2,75,7,6,5,0,0,2,7,1,1,1,2,2,3,0,3,1,3,0,0,2,1,0,0
20496,8,273,74,35,59,1,0,14,75,3,14,7,14,17,21,58,85,1,128,7,0,2,10,2,0
20497,90,4427,1523,757,1297,19,12,193,1542,12,193,117,230,205,347,1508,2664,7,19053,1058,0,2,106,8,0
20498,75,3288,1020,354,843,12,15,144,1032,8,134,77,144,142,221,970,1580,4,6792,377,0,2,174,53,0
20499,37,1624,447,308,343,6,5,95,453,7,96,59,111,103,170,651,1136,4,4600,255,0,2,11,15,0
20500,1,106,53,23,39,0,0,13,53,2,8,4,8,10,12,26,39,1,39,2,0,0,18,0,0
20501,21,661,424,94,331,4,0,89,428,1,5,5,5,6,10,11,25,0,12,0,0,2,51,40,0
20502,40,2367,334,251,279,10,4,40,344,5,127,74,143,132,217,899,1528,2,4303,239,0,2,27,23,0
20503,12,492,184,100,137,2,15,30,186,6,38,20,39,44,59,214,322,3,991,55,0,2,7,7,0
20504,35,1623,1293,570,1093,25,15,163,1318,10,195,123,241,205,364,1516,2795,6,17273,959,0,2,73,24,0
20505,36,1978,384,251,317,7,8,52,391,11,70,44,84,81,128,467,811,6,5355,297,0,2,38,35,0
20506,15,638,722,423,573,19,0,135,741,12,172,101,199,184,300,1320,2257,6,15668,870,0,2,15,3,0
20507,36,1591,386,256,301,16,9,68,402,4,59,35,69,63,104,355,621,2,1453,80,0,2,109,50,0
20508,16,1209,215,129,180,6,0,29,221,8,65,43,72,73,115,415,711,4,3153,175,0,2,12,11,0
20509,75,2972,1043,504,840,53,9,147,1096,9,180,112,198,189,310,1377,2344,4,11604,644,0,2,111,58,0
20510,14,529,295,56,236,0,4,54,295,2,9,5,10,11,15,30,51,1,57,3,0,2,30,16,0
20511,26,1029,373,158,315,8,0,51,381,5,76,44,79,81,123,486,779,2,2026,112,0,2,38,29,0
20512,71,3006,1178,367,1042,6,15,115,1184,9,94,51,95,103,146,644,976,4,4439,246,0,2,57,22,0
20513,76,3899,1943,715,1694,26,18,214,1969,12,185,120,237,197,357,1436,2721,7,20915,1161,0,2,105,46,0
20514,14,825,442,244,305,14,16,103,456,11,68,45,75,79,120,452,756,6,4588,254,0,2,8,2,0
20515,48,1795,1098,241,925,5,10,155,1103,7,46,25,49,53,74,273,423,3,1580,87,0,2,94,75,0
20516,17,604,601,196,481,2,23,85,603,8,63,36,72,71,108,400,664,4,3036,168,0,0,225,0,0
20517,230,5248,4293,999,3693,19,54,507,4312,9,155,88,170,164,258,1156,1898,4,9368,520,0,2,10,9,0
20518,230,5248,1482,859,1002,125,135,219,1607,16,219,134,251,235,385,1766,3032,9,27804,1544,1,2,10,9,0
20519,50,588,647,139,84,35,284,233,682,0,0,0,0,0,0,0,0,0,0,0,0,2,1,1,0
20520,163,7149,139,89,101,2,0,35,141,7,54,34,62,61,96,330,569,4,2287,127,0,2,30,38,0
20521,163,7149,7,5,5,0,0,2,7,1,2,1,2,3,3,2,4,0,2,0,0,2,30,38,0
20522,11,235,19,8,11,5,0,4,24,2,5,3,6,7,9,13,25,1,30,1,0,2,0,3,0
20523,11,235,102,59,69,5,3,24,107,6,22,15,28,28,43,113,206,3,789,43,0,2,0,3,0
20524,11,235,106,40,36,3,49,17,109,8,17,13,23,25,36,93,167,5,904,50,0,2,0,3,0
20525,214,4592,182,127,129,0,0,53,182,5,39,21,42,44,63,217,343,2,926,51,0,2,1,3,0
20526,214,4592,1165,710,800,67,119,181,1232,18,243,153,282,261,435,2000,3492,10,36473,2026,1,2,1,3,0
20527,101,2069,773,419,590,28,0,166,801,10,204,113,217,214,330,1598,2554,5,13587,754,0,2,2,3,0
20528,101,2069,421,273,302,44,34,57,465,17,81,59,107,98,166,583,1098,11,12329,684,0,2,2,3,0
20529,26,524,2,2,2,0,0,0,2,0,0,0,0,0,0,0,0,0,0,0,0,2,4,6,0
20530,26,524,99,48,90,1,3,5,100,0,0,0,0,0,0,0,0,0,0,0,0,2,4,6,0
20531,26,524,8,5,5,2,0,1,10,0,0,0,0,0,0,0,0,0,0,0,0,2,4,6,0
20532,26,524,1217,716,841,84,126,174,1301,14,185,118,215,199,333,1446,2542,8,20687,1149,0,2,4,6,0
20533,26,524,160,89,115,0,13,31,160,7,15,11,17,22,28,78,124,3,495,27,0,2,4,6,0
20534,26,524,10,10,9,9,0,0,19,0,0,0,0,0,0,0,0,0,0,0,0,2,4,6,0
20535,26,524,173,84,99,8,29,36,181,5,12,7,13,17,20,54,81,2,221,12,0,2,4,6,0
20536,26,524,3,1,1,3,0,0,6,0,0,0,0,0,0,0,0,0,0,0,0,2,4,6,0
20537,166,5068,1660,832,1314,41,38,274,1701,20,312,209,395,332,604,2671,5058,12,64042,3557,1,2,12,16,0
20538,166,5068,1057,646,719,113,100,145,1170,18,215,134,248,233,382,1740,3004,10,31186,1732,1,2,12,16,0
20539,17,345,95,58,50,9,16,20,104,12,33,24,45,45,69,209,378,8,3100,172,0,2,3,3,0
20540,86,1804,477,336,357,30,23,73,507,16,194,134,250,210,384,1538,2962,10,30538,1696,0,2,4,3,0
20541,135,2748,1513,682,1277,25,13,200,1538,11,199,116,219,210,335,1557,2584,6,15641,868,0,2,101,54,0
20542,135,2748,819,519,539,24,98,155,843,15,96,57,106,111,163,690,1107,8,9171,509,0,2,101,54,0
20543,52,1082,207,111,150,11,0,50,218,5,26,19,36,31,55,133,272,3,943,52,0,2,68,72,0
20544,52,1082,410,198,237,31,55,97,441,11,63,38,72,74,110,414,683,6,4293,238,0,2,68,72,0
20545,346,6927,1457,730,1242,11,6,188,1468,10,292,166,329,302,495,2424,4078,5,22973,1276,1,2,18,36,0
20546,346,6927,74,35,59,1,0,14,75,3,14,7,14,17,21,58,85,1,128,7,0,2,18,36,0
20547,346,6927,245,125,200,5,7,34,250,7,30,17,34,37,51,166,265,3,1053,58,0,2,18,36,0
20548,21,662,339,213,244,17,9,65,356,10,42,26,48,52,74,259,421,5,2410,133,0,2,3,3,0
20549,64,1726,1455,414,1257,16,76,112,1471,5,41,23,46,46,69,231,381,2,1069,59,0,2,8,1,0
20550,64,1726,669,365,481,22,61,110,691,15,103,63,122,118,185,747,1273,8,11311,628,0,2,8,1,0
20551,231,5269,4293,999,3693,19,54,507,4312,9,155,88,170,164,258,1156,1898,4,9368,520,0,2,20,15,0
20552,231,5269,1482,859,1002,125,135,219,1607,16,219,134,251,235,385,1766,3032,9,27804,1544,1,2,20,15,0
20553,27,954,74,35,59,1,0,14,75,3,14,7,14,17,21,58,85,1,128,7,0,2,1,1,0
20554,27,954,245,125,200,5,7,34,250,7,30,17,34,37,51,166,265,3,1053,58,0,2,1,1,0
20555,50,586,647,139,84,35,284,233,682,0,0,0,0,0,0,0,0,0,0,0,0,2,1,1,0
20556,45,1297,773,422,505,30,103,129,803,14,77,46,83,91,129,535,839,7,6334,351,0,0,337,0,0
20557,185,4238,77,34,69,0,0,8,77,3,24,16,29,27,45,114,213,1,387,21,0,2,15,29,0
20558,185,4238,712,438,573,51,9,84,763,14,102,71,128,116,199,733,1364,8,11988,666,0,2,15,29,0
20559,99,2020,1020,354,843,12,15,144,1032,8,134,77,144,142,221,970,1580,4,6792,377,0,2,55,26,0
20560,46,957,447,308,343,6,5,95,453,7,96,59,111,103,170,651,1136,4,4600,255,0,2,4,5,0
20561,46,957,322,174,179,16,74,51,338,10,41,26,46,51,72,252,408,5,2291,127,0,2,4,5,0
20562,23,382,424,94,331,4,0,89,428,1,5,5,5,6,10,11,25,0,12,0,0,2,1,2,0
20563,23,382,38,23,23,6,0,8,44,3,11,7,11,14,18,42,68,1,102,5,0,2,1,2,0
20564,20,509,205,80,86,16,53,53,221,7,18,10,19,25,29,94,134,3,497,27,0,2,9,2,0
20565,17,518,184,100,137,2,15,30,186,6,38,20,39,44,59,214,322,3,991,55,0,2,5,5,0
20566,17,518,103,65,74,8,5,16,111,7,17,9,17,24,26,89,119,3,417,23,0,2,5,5,0
20567,210,5003,722,423,573,19,0,135,741,12,172,101,199,184,300,1320,2257,6,15668,870,0,2,19,40,0
20568,210,5003,1508,847,911,44,250,301,1552,14,148,88,169,162,257,1120,1886,7,15077,837,0,2,19,40,0
20569,257,6066,72,33,56,0,4,12,72,1,1,1,1,2,2,0,2,0,1,0,0,2,35,39,0
20570,257,6066,1454,835,1044,76,110,219,1530,17,275,158,296,292,454,2297,3718,9,34017,1889,1,2,35,39,0
20571,73,1425,757,253,292,73,244,162,830,13,61,38,67,74,105,409,651,7,4654,258,0,2,4,11,0
20572,46,954,386,256,301,16,9,68,402,4,59,35,69,63,104,355,621,2,1453,80,0,2,36,5,0
20573,46,954,264,131,164,11,41,46,275,6,38,22,40,44,62,214,338,3,1068,59,0,2,36,5,0
20574,112,2472,1043,504,840,53,9,147,1096,9,180,112,198,189,310,1377,2344,4,11604,644,0,2,1,1,0
20575,112,2472,383,288,292,26,6,62,409,11,65,38,67,76,105,429,656,5,3719,206,0,2,1,1,0
20576,20,408,294,64,250,0,0,43,294,1,20,10,20,21,30,86,131,0,65,3,0,2,2,2,0
20577,20,408,78,46,62,3,0,14,81,3,8,4,8,11,12,28,41,1,62,3,0,2,2,2,0
20578,108,2066,1178,367,1042,6,15,115,1184,9,94,51,95,103,146,644,976,4,4439,246,0,2,75,50,0
20579,108,2066,177,108,140,8,0,27,185,6,30,16,32,36,48,162,248,3,794,44,0,2,75,50,0
20580,195,4029,1943,715,1694,26,18,214,1969,12,185,120,237,197,357,1436,2721,7,20915,1161,0,2,65,51,0
20581,195,4029,1168,838,957,57,25,144,1225,19,348,224,416,367,640,3018,5452,11,61921,3440,1,2,65,51,0
20582,62,1222,1098,241,925,5,10,155,1103,7,46,25,49,53,74,273,423,3,1580,87,0,2,1,3,0
20583,62,1222,282,202,222,14,2,44,296,8,42,24,43,50,67,250,378,4,1548,86,0,2,1,3,0
20584,21,436,601,196,481,2,23,85,603,8,63,36,72,71,108,400,664,4,3036,168,0,2,2,2,0
20585,21,436,156,79,106,5,16,28,161,5,14,8,15,19,23,64,97,2,261,14,0,2,2,2,0
20586,7,299,72,33,56,0,4,12,72,1,1,1,1,2,2,0,2,0,1,0,0,2,1,1,0
20587,12,422,42,7,35,4,0,5,46,1,2,1,2,3,3,2,4,0,2,0,0,2,23,10,0
20588,12,422,11,6,10,0,0,1,11,2,4,2,4,6,6,10,15,1,15,0,0,2,23,10,0
20589,81,3472,1289,550,1043,56,32,155,1345,10,167,93,185,177,278,1266,2075,5,11498,638,0,2,1,1,0
20590,147,6933,1392,870,1177,35,17,170,1427,14,494,280,531,508,811,4473,7289,7,54850,3047,2,2,2,9,0
20591,87,2905,773,419,590,28,0,166,801,10,204,113,217,214,330,1598,2554,5,13587,754,0,2,0,2,0
20592,7,353,139,89,101,2,0,35,141,7,54,34,62,61,96,330,569,4,2287,127,0,0,70,0,0
20593,21,1023,1157,318,931,29,22,177,1186,6,104,63,125,110,188,712,1274,3,4596,255,0,0,398,0,0
20594,52,3380,520,294,400,33,13,81,553,10,261,204,367,271,571,2128,4614,7,32445,1802,1,2,0,6,0
20595,97,4424,1338,495,1086,10,64,173,1348,11,122,82,157,133,239,883,1686,7,11934,663,0,2,10,15,0
20596,162,7122,139,89,101,2,0,35,141,7,54,34,62,61,96,330,569,4,2287,127,0,2,1,5,0
20597,162,7122,7,5,5,0,0,2,7,1,2,1,2,3,3,2,4,0,2,0,0,2,1,5,0
20598,132,5724,1782,648,1425,9,47,279,1791,8,171,97,189,179,286,1292,2140,4,9462,525,0,2,1,1,0
20599,155,4372,1660,832,1314,41,38,274,1701,20,312,209,395,332,604,2671,5058,12,64042,3557,1,2,1,1,0
20600,124,4990,1513,682,1277,25,13,200,1538,11,199,116,219,210,335,1557,2584,6,15641,868,0,2,72,32,0
20601,73,3834,1296,573,1062,40,33,157,1336,8,201,118,231,209,349,1561,2689,4,12365,686,0,2,7,8,0
20602,80,4250,1457,730,1242,11,6,188,1468,10,292,166,329,302,495,2424,4078,5,22973,1276,1,2,9,1,0
20603,68,3131,1455,414,1257,16,76,112,1471,5,41,23,46,46,69,231,381,2,1069,59,0,2,28,0,0
20604,38,2303,334,251,279,10,4,40,344,5,127,74,143,132,217,899,1528,2,4303,239,0,2,1,7,0
20605,33,1914,384,251,317,7,8,52,391,11,70,44,84,81,128,467,811,6,5355,297,0,2,8,20,0
20606,16,677,722,423,573,19,0,135,741,12,172,101,199,184,300,1320,2257,6,15668,870,0,2,11,0,0
20607,39,1774,386,256,301,16,9,68,402,4,59,35,69,63,104,355,621,2,1453,80,0,2,24,0,0
20608,75,2972,1043,504,840,53,9,147,1096,9,180,112,198,189,310,1377,2344,4,11604,644,0,2,7,5,0
20609,74,3124,1178,367,1042,6,15,115,1184,9,94,51,95,103,146,644,976,4,4439,246,0,2,64,3,0
20610,76,3893,1943,715,1694,26,18,214,1969,12,185,120,237,197,357,1436,2721,7,20915,1161,0,2,1,2,0
20611,48,1750,1098,241,925,5,10,155,1103,7,46,25,49,53,74,273,423,3,1580,87,0,2,4,7,0
20612,18,646,601,196,481,2,23,85,603,8,63,36,72,71,108,400,664,4,3036,168,0,2,21,1,0
20613,231,5270,4293,999,3693,19,54,507,4312,9,155,88,170,164,258,1156,1898,4,9368,520,0,2,1,1,0
20614,231,5270,1482,859,1002,125,135,219,1607,16,219,134,251,235,385,1766,3032,9,27804,1544,1,2,1,1,0
20615,231,5276,4293,999,3693,19,54,507,4312,9,155,88,170,164,258,1156,1898,4,9368,520,0,2,1,0,0
20616,231,5276,1482,859,1002,125,135,219,1607,16,219,134,251,235,385,1766,3032,9,27804,1544,1,2,1,0,0
20617,231,5276,4293,999,3693,19,54,507,4312,9,155,88,170,164,258,1156,1898,4,9368,520,0,2,8,10,1
20618,231,5276,1482,859,1002,125,135,219,1607,16,219,134,251,235,385,1766,3032,9,27804,1544,1,2,8,10,1
20619,11,410,42,7,35,4,0,5,46,1,2,1,2,3,3,2,4,0,2,0,0,2,1,1,0
20620,11,410,11,6,10,0,0,1,11,2,4,2,4,6,6,10,15,1,15,0,0,2,1,1,0
20621,231,5276,4293,999,3693,19,54,507,4312,9,155,88,170,164,258,1156,1898,4,9368,520,0,2,22,18,0
20622,231,5276,1482,859,1002,125,135,219,1607,16,219,134,251,235,385,1766,3032,9,27804,1544,1,2,22,18,0
20623,50,586,647,139,84,35,284,233,682,0,0,0,0,0,0,0,0,0,0,0,0,2,1,1,0
20624,185,4238,77,34,69,0,0,8,77,3,24,16,29,27,45,114,213,1,387,21,0,2,8,0,0
20625,185,4238,712,438,573,51,9,84,763,14,102,71,128,116,199,733,1364,8,11988,666,0,2,8,0,0
20626,112,2472,1043,504,840,53,9,147,1096,9,180,112,198,189,310,1377,2344,4,11604,644,0,2,0,5,0
20627,112,2472,383,288,292,26,6,62,409,11,65,38,67,76,105,429,656,5,3719,206,0,2,0,5,0
20628,81,3472,1289,550,1043,56,32,155,1345,10,167,93,185,177,278,1266,2075,5,11498,638,0,2,3,1,0
20629,162,7122,139,89,101,2,0,35,141,7,54,34,62,61,96,330,569,4,2287,127,0,2,40,0,0
20630,162,7122,7,5,5,0,0,2,7,1,2,1,2,3,3,2,4,0,2,0,0,2,40,0,0
20631,11,410,42,7,35,4,0,5,46,1,2,1,2,3,3,2,4,0,2,0,0,2,1,1,0
20632,11,410,11,6,10,0,0,1,11,2,4,2,4,6,6,10,15,1,15,0,0,2,1,1,0
20633,12,422,42,7,35,4,0,5,46,1,2,1,2,3,3,2,4,0,2,0,0,2,1,1,0
20634,12,422,11,6,10,0,0,1,11,2,4,2,4,6,6,10,15,1,15,0,0,2,1,1,0
20635,138,2871,1513,682,1277,25,13,200,1538,11,199,116,219,210,335,1557,2584,6,15641,868,0,2,56,20,1
20636,138,2871,819,519,539,24,98,155,843,15,96,57,106,111,163,690,1107,8,9171,509,0,2,56,20,1
20637,126,5054,1513,682,1277,25,13,200,1538,11,199,116,219,210,335,1557,2584,6,15641,868,0,2,26,2,1
20638,11,410,42,7,35,4,0,5,46,1,2,1,2,3,3,2,4,0,2,0,0,2,1,1,0
20639,11,410,11,6,10,0,0,1,11,2,4,2,4,6,6,10,15,1,15,0,0,2,1,1,0
20640,12,426,42,7,35,4,0,5,46,1,2,1,2,3,3,2,4,0,2,0,0,2,1,0,0
20641,12,426,11,6,10,0,0,1,11,2,4,2,4,6,6,10,15,1,15,0,0,2,1,0,0
20642,12,422,42,7,35,4,0,5,46,1,2,1,2,3,3,2,4,0,2,0,0,2,1,1,0
20643,12,422,11,6,10,0,0,1,11,2,4,2,4,6,6,10,15,1,15,0,0,2,1,1,0
20644,12,426,42,7,35,4,0,5,46,1,2,1,2,3,3,2,4,0,2,0,0,2,1,0,0
20645,12,426,11,6,10,0,0,1,11,2,4,2,4,6,6,10,15,1,15,0,0,2,1,0,0
20646,11,410,42,7,35,4,0,5,46,1,2,1,2,3,3,2,4,0,2,0,0,2,1,1,0
20647,11,410,11,6,10,0,0,1,11,2,4,2,4,6,6,10,15,1,15,0,0,2,1,1,0
20648,12,426,42,7,35,4,0,5,46,1,2,1,2,3,3,2,4,0,2,0,0,2,1,1,0
20649,12,426,11,6,10,0,0,1,11,2,4,2,4,6,6,10,15,1,15,0,0,2,1,1,0
20650,258,6089,72,33,56,0,4,12,72,1,1,1,1,2,2,0,2,0,1,0,0,2,9,3,0
20651,258,6089,1454,835,1044,76,110,219,1530,17,275,158,296,292,454,2297,3718,9,34017,1889,1,2,9,3,0
20652,8,329,75,38,59,1,3,12,76,2,4,2,4,6,6,10,15,1,15,0,0,2,17,0,0
20653,12,426,42,7,35,4,0,5,46,1,2,1,2,3,3,2,4,0,2,0,0,2,1,1,0
20654,12,426,11,6,10,0,0,1,11,2,4,2,4,6,6,10,15,1,15,0,0,2,1,1,0
20655,258,6089,72,33,56,0,4,12,72,1,1,1,1,2,2,0,2,0,1,0,0,2,9,3,0
20656,258,6089,1454,835,1044,76,110,219,1530,17,275,158,296,292,454,2297,3718,9,34017,1889,1,2,9,3,0
20657,8,329,75,38,59,1,3,12,76,2,4,2,4,6,6,10,15,1,15,0,0,2,17,0,0
20658,138,2871,1513,682,1277,25,13,200,1538,11,199,116,219,210,335,1557,2584,6,15641,868,0,2,56,20,0
20659,138,2871,819,519,539,24,98,155,843,15,96,57,106,111,163,690,1107,8,9171,509,0,2,56,20,0
20660,126,5054,1513,682,1277,25,13,200,1538,11,199,116,219,210,335,1557,2584,6,15641,868,0,2,26,2,0
20661,141,2959,1513,682,1277,25,13,200,1538,11,199,116,219,210,335,1557,2584,6,15641,868,0,2,28,5,1
20662,141,2959,819,519,539,24,98,155,843,15,96,57,106,111,163,690,1107,8,9171,509,0,2,28,5,1
20663,128,5156,1513,682,1277,25,13,200,1538,11,199,116,219,210,335,1557,2584,6,15641,868,0,2,33,1,1
20664,141,2959,1513,682,1277,25,13,200,1538,11,199,116,219,210,335,1557,2584,6,15641,868,0,2,28,5,0
20665,141,2959,819,519,539,24,98,155,843,15,96,57,106,111,163,690,1107,8,9171,509,0,2,28,5,0
20666,128,5156,1513,682,1277,25,13,200,1538,11,199,116,219,210,335,1557,2584,6,15641,868,0,2,33,1,0
20667,12,426,42,7,35,4,0,5,46,1,2,1,2,3,3,2,4,0,2,0,0,2,1,1,0
20668,12,426,11,6,10,0,0,1,11,2,4,2,4,6,6,10,15,1,15,0,0,2,1,1,0
20669,204,4267,1943,715,1694,26,18,214,1969,12,185,120,237,197,357,1436,2721,7,20915,1161,0,2,49,7,1
20670,204,4267,1168,838,957,57,25,144,1225,19,348,224,416,367,640,3018,5452,11,61921,3440,1,2,49,7,1
20671,81,3472,1289,550,1043,56,32,155,1345,10,167,93,185,177,278,1266,2075,5,11498,638,0,2,5,5,1
20672,162,7134,139,89,101,2,0,35,141,7,54,34,62,61,96,330,569,4,2287,127,0,2,8,0,1
20673,162,7134,7,5,5,0,0,2,7,1,2,1,2,3,3,2,4,0,2,0,0,2,8,0,1
20674,132,5730,1782,648,1425,9,47,279,1791,8,171,97,189,179,286,1292,2140,4,9462,525,0,2,9,5,1
20675,109,4106,1450,624,1228,12,26,181,1462,14,306,186,354,320,540,2580,4493,8,36391,2021,1,2,2,2,1
20676,128,5156,1513,682,1277,25,13,200,1538,11,199,116,219,210,335,1557,2584,6,15641,868,0,2,1,1,1
20677,76,3893,1943,715,1694,26,18,214,1969,12,185,120,237,197,357,1436,2721,7,20915,1161,0,2,6,6,1
20678,214,5107,722,423,573,19,0,135,741,12,172,101,199,184,300,1320,2257,6,15668,870,0,2,46,5,1
20679,214,5107,1508,847,911,44,250,301,1552,14,148,88,169,162,257,1120,1886,7,15077,837,0,2,46,5,1
20680,203,4282,1943,715,1694,26,18,214,1969,12,185,120,237,197,357,1436,2721,7,20915,1161,0,2,2,2,0
20681,203,4282,1168,838,957,57,25,144,1225,19,348,224,416,367,640,3018,5452,11,61921,3440,1,2,2,2,0
20682,204,4297,1943,715,1694,26,18,214,1969,12,185,120,237,197,357,1436,2721,7,20915,1161,0,2,5,2,0
20683,204,4297,1168,838,957,57,25,144,1225,19,348,224,416,367,640,3018,5452,11,61921,3440,1,2,5,2,0
20684,81,4076,1943,715,1694,26,18,214,1969,12,185,120,237,197,357,1436,2721,7,20915,1161,0,2,55,0,0
20685,168,5128,1660,832,1314,41,38,274,1701,20,312,209,395,332,604,2671,5058,12,64042,3557,1,2,1,1,0
20686,168,5128,1057,646,719,113,100,145,1170,18,215,134,248,233,382,1740,3004,10,31186,1732,1,2,1,1,0
20687,110,4156,1450,624,1228,12,26,181,1462,14,306,186,354,320,540,2580,4493,8,36391,2021,1,2,18,0,0
20688,204,4299,1943,715,1694,26,18,214,1969,12,185,120,237,197,357,1436,2721,7,20915,1161,0,2,1,1,0
20689,204,4299,1168,838,957,57,25,144,1225,19,348,224,416,367,640,3018,5452,11,61921,3440,1,2,1,1,0
20690,81,4076,1943,715,1694,26,18,214,1969,12,185,120,237,197,357,1436,2721,7,20915,1161,0,2,1,1,0
20691,168,5128,1660,832,1314,41,38,274,1701,20,312,209,395,332,604,2671,5058,12,64042,3557,1,2,1,1,0
20692,168,5128,1057,646,719,113,100,145,1170,18,215,134,248,233,382,1740,3004,10,31186,1732,1,2,1,1,0
20693,110,4156,1450,624,1228,12,26,181,1462,14,306,186,354,320,540,2580,4493,8,36391,2021,1,2,18,0,0
20694,97,1855,1020,354,843,12,15,144,1032,8,134,77,144,142,221,970,1580,4,6792,377,0,2,4,2,0
20695,76,3351,1020,354,843,12,15,144,1032,8,134,77,144,142,221,970,1580,4,6792,377,0,2,17,0,0
20696,97,1855,1020,354,843,12,15,144,1032,8,134,77,144,142,221,970,1580,4,6792,377,0,2,4,2,0
20697,76,3351,1020,354,843,12,15,144,1032,8,134,77,144,142,221,970,1580,4,6792,377,0,2,17,0,0
20698,214,5107,722,423,573,19,0,135,741,12,172,101,199,184,300,1320,2257,6,15668,870,0,2,2,2,1
20699,214,5107,1508,847,911,44,250,301,1552,14,148,88,169,162,257,1120,1886,7,15077,837,0,2,2,2,1
20700,81,4076,1943,715,1694,26,18,214,1969,12,185,120,237,197,357,1436,2721,7,20915,1161,0,2,4,4,0
20701,214,5107,722,423,573,19,0,135,741,12,172,101,199,184,300,1320,2257,6,15668,870,0,2,46,5,0
20702,214,5107,1508,847,911,44,250,301,1552,14,148,88,169,162,257,1120,1886,7,15077,837,0,2,46,5,0
20703,204,4299,1943,715,1694,26,18,214,1969,12,185,120,237,197,357,1436,2721,7,20915,1161,0,2,54,9,0
20704,204,4299,1168,838,957,57,25,144,1225,19,348,224,416,367,640,3018,5452,11,61921,3440,1,2,54,9,0
20705,12,426,42,7,35,4,0,5,46,1,2,1,2,3,3,2,4,0,2,0,0,2,1,1,0
20706,12,426,11,6,10,0,0,1,11,2,4,2,4,6,6,10,15,1,15,0,0,2,1,1,0
20707,81,3472,1289,550,1043,56,32,155,1345,10,167,93,185,177,278,1266,2075,5,11498,638,0,2,5,5,0
20708,162,7134,139,89,101,2,0,35,141,7,54,34,62,61,96,330,569,4,2287,127,0,2,8,0,0
20709,162,7134,7,5,5,0,0,2,7,1,2,1,2,3,3,2,4,0,2,0,0,2,8,0,0
20710,132,5730,1782,648,1425,9,47,279,1791,8,171,97,189,179,286,1292,2140,4,9462,525,0,2,9,5,0
20711,109,4106,1450,624,1228,12,26,181,1462,14,306,186,354,320,540,2580,4493,8,36391,2021,1,2,2,2,0
20712,128,5156,1513,682,1277,25,13,200,1538,11,199,116,219,210,335,1557,2584,6,15641,868,0,2,1,1,0
20713,81,4076,1943,715,1694,26,18,214,1969,12,185,120,237,197,357,1436,2721,7,20915,1161,0,2,62,7,0
20714,167,5074,1660,832,1314,41,38,274,1701,20,312,209,395,332,604,2671,5058,12,64042,3557,1,2,1,1,0
20715,167,5074,1057,646,719,113,100,145,1170,18,215,134,248,233,382,1740,3004,10,31186,1732,1,2,1,1,0
20716,100,2040,1020,354,843,12,15,144,1032,8,134,77,144,142,221,970,1580,4,6792,377,0,2,4,2,0
20717,110,4156,1450,624,1228,12,26,181,1462,14,306,186,354,320,540,2580,4493,8,36391,2021,1,2,18,0,0
20718,76,3351,1020,354,843,12,15,144,1032,8,134,77,144,142,221,970,1580,4,6792,377,0,2,17,0,0
20719,346,6927,1457,730,1242,11,6,188,1468,10,292,166,329,302,495,2424,4078,5,22973,1276,1,2,1,1,0
20720,346,6927,74,35,59,1,0,14,75,3,14,7,14,17,21,58,85,1,128,7,0,2,1,1,0
20721,346,6927,245,125,200,5,7,34,250,7,30,17,34,37,51,166,265,3,1053,58,0,2,1,1,0
20722,21,662,339,213,244,17,9,65,356,10,42,26,48,52,74,259,421,5,2410,133,0,2,1,1,0
20723,27,954,74,35,59,1,0,14,75,3,14,7,14,17,21,58,85,1,128,7,0,2,1,1,0
20724,27,954,245,125,200,5,7,34,250,7,30,17,34,37,51,166,265,3,1053,58,0,2,1,1,0
20725,17,518,184,100,137,2,15,30,186,6,38,20,39,44,59,214,322,3,991,55,0,2,3,3,0
20726,17,518,103,65,74,8,5,16,111,7,17,9,17,24,26,89,119,3,417,23,0,2,3,3,0
20727,108,2066,1178,367,1042,6,15,115,1184,9,94,51,95,103,146,644,976,4,4439,246,0,2,2,2,0
20728,108,2066,177,108,140,8,0,27,185,6,30,16,32,36,48,162,248,3,794,44,0,2,2,2,0
20729,202,4260,1943,715,1694,26,18,214,1969,12,185,120,237,197,357,1436,2721,7,20915,1161,0,2,44,55,0
20730,202,4260,1168,838,957,57,25,144,1225,19,348,224,416,367,640,3018,5452,11,61921,3440,1,2,44,55,0
20731,76,3351,1020,354,843,12,15,144,1032,8,134,77,144,142,221,970,1580,4,6792,377,0,2,1,1,0
20732,81,4076,1943,715,1694,26,18,214,1969,12,185,120,237,197,357,1436,2721,7,20915,1161,0,2,1,1,0
20733,347,6940,1457,730,1242,11,6,188,1468,10,292,166,329,302,495,2424,4078,5,22973,1276,1,2,4,0,0
20734,347,6940,74,35,59,1,0,14,75,3,14,7,14,17,21,58,85,1,128,7,0,2,4,0,0
20735,347,6940,245,125,200,5,7,34,250,7,30,17,34,37,51,166,265,3,1053,58,0,2,4,0,0
20736,9,367,75,38,59,1,3,12,76,2,4,2,4,6,6,10,15,1,15,0,0,2,13,0,0
20737,12,426,42,7,35,4,0,5,46,1,2,1,2,3,3,2,4,0,2,0,0,2,1,1,0
20738,12,426,11,6,10,0,0,1,11,2,4,2,4,6,6,10,15,1,15,0,0,2,1,1,0
20739,168,5128,1660,832,1314,41,38,274,1701,20,312,209,395,332,604,2671,5058,12,64042,3557,1,2,6,6,0
20740,168,5128,1057,646,719,113,100,145,1170,18,215,134,248,233,382,1740,3004,10,31186,1732,1,2,6,6,0
20741,351,7048,1457,730,1242,11,6,188,1468,10,292,166,329,302,495,2424,4078,5,22973,1276,1,2,2,2,0
20742,351,7048,74,35,59,1,0,14,75,3,14,7,14,17,21,58,85,1,128,7,0,2,2,2,0
20743,351,7048,245,125,200,5,7,34,250,7,30,17,34,37,51,166,265,3,1053,58,0,2,2,2,0
20744,212,5103,722,423,573,19,0,135,741,12,172,101,199,184,300,1320,2257,6,15668,870,0,2,1,1,0
20745,212,5103,1508,847,911,44,250,301,1552,14,148,88,169,162,257,1120,1886,7,15077,837,0,2,1,1,0
20746,110,4156,1450,624,1228,12,26,181,1462,14,306,186,354,320,540,2580,4493,8,36391,2021,1,2,1,1,0
20747,168,5128,1660,832,1314,41,38,274,1701,20,312,209,395,332,604,2671,5058,12,64042,3557,1,2,6,6,0
20748,168,5128,1057,646,719,113,100,145,1170,18,215,134,248,233,382,1740,3004,10,31186,1732,1,2,6,6,0
20749,351,7048,1457,730,1242,11,6,188,1468,10,292,166,329,302,495,2424,4078,5,22973,1276,1,2,2,2,0
20750,351,7048,74,35,59,1,0,14,75,3,14,7,14,17,21,58,85,1,128,7,0,2,2,2,0
20751,351,7048,245,125,200,5,7,34,250,7,30,17,34,37,51,166,265,3,1053,58,0,2,2,2,0
20752,212,5103,722,423,573,19,0,135,741,12,172,101,199,184,300,1320,2257,6,15668,870,0,2,1,1,0
20753,212,5103,1508,847,911,44,250,301,1552,14,148,88,169,162,257,1120,1886,7,15077,837,0,2,1,1,0
20754,110,4156,1450,624,1228,12,26,181,1462,14,306,186,354,320,540,2580,4493,8,36391,2021,1,2,1,1,0
20755,167,5074,1660,832,1314,41,38,274,1701,20,312,209,395,332,604,2671,5058,12,64042,3557,1,2,1,1,0
20756,167,5074,1057,646,719,113,100,145,1170,18,215,134,248,233,382,1740,3004,10,31186,1732,1,2,1,1,0
20757,347,6940,1457,730,1242,11,6,188,1468,10,292,166,329,302,495,2424,4078,5,22973,1276,1,2,5,1,0
20758,347,6940,74,35,59,1,0,14,75,3,14,7,14,17,21,58,85,1,128,7,0,2,5,1,0
20759,347,6940,245,125,200,5,7,34,250,7,30,17,34,37,51,166,265,3,1053,58,0,2,5,1,0
20760,21,662,339,213,244,17,9,65,356,10,42,26,48,52,74,259,421,5,2410,133,0,2,1,1,0
20761,27,954,74,35,59,1,0,14,75,3,14,7,14,17,21,58,85,1,128,7,0,2,1,1,0
20762,27,954,245,125,200,5,7,34,250,7,30,17,34,37,51,166,265,3,1053,58,0,2,1,1,0
20763,100,2040,1020,354,843,12,15,144,1032,8,134,77,144,142,221,970,1580,4,6792,377,0,2,4,2,0
20764,17,518,184,100,137,2,15,30,186,6,38,20,39,44,59,214,322,3,991,55,0,2,3,3,0
20765,17,518,103,65,74,8,5,16,111,7,17,9,17,24,26,89,119,3,417,23,0,2,3,3,0
20766,108,2066,1178,367,1042,6,15,115,1184,9,94,51,95,103,146,644,976,4,4439,246,0,2,2,2,0
20767,108,2066,177,108,140,8,0,27,185,6,30,16,32,36,48,162,248,3,794,44,0,2,2,2,0
20768,202,4260,1943,715,1694,26,18,214,1969,12,185,120,237,197,357,1436,2721,7,20915,1161,0,2,44,55,0
20769,202,4260,1168,838,957,57,25,144,1225,19,348,224,416,367,640,3018,5452,11,61921,3440,1,2,44,55,0
20770,12,426,42,7,35,4,0,5,46,1,2,1,2,3,3,2,4,0,2,0,0,2,1,1,0
20771,12,426,11,6,10,0,0,1,11,2,4,2,4,6,6,10,15,1,15,0,0,2,1,1,0
20772,9,367,75,38,59,1,3,12,76,2,4,2,4,6,6,10,15,1,15,0,0,2,13,0,0
20773,110,4156,1450,624,1228,12,26,181,1462,14,306,186,354,320,540,2580,4493,8,36391,2021,1,2,18,0,0
20774,76,3351,1020,354,843,12,15,144,1032,8,134,77,144,142,221,970,1580,4,6792,377,0,2,18,1,0
20775,81,4076,1943,715,1694,26,18,214,1969,12,185,120,237,197,357,1436,2721,7,20915,1161,0,2,1,1,0
20776,11,235,19,8,11,5,0,4,24,2,5,3,6,7,9,13,25,1,30,1,0,2,0,3,0
20777,11,235,102,59,69,5,3,24,107,6,22,15,28,28,43,113,206,3,789,43,0,2,0,3,0
20778,11,235,106,40,36,3,49,17,109,8,17,13,23,25,36,93,167,5,904,50,0,2,0,3,0
20779,214,4592,182,127,129,0,0,53,182,5,39,21,42,44,63,217,343,2,926,51,0,2,1,3,0
20780,214,4592,1165,710,800,67,119,181,1232,18,243,153,282,261,435,2000,3492,10,36473,2026,1,2,1,3,0
20781,101,2069,773,419,590,28,0,166,801,10,204,113,217,214,330,1598,2554,5,13587,754,0,2,2,3,0
20782,101,2069,421,273,302,44,34,57,465,17,81,59,107,98,166,583,1098,11,12329,684,0,2,2,3,0
20783,26,524,2,2,2,0,0,0,2,0,0,0,0,0,0,0,0,0,0,0,0,2,4,6,0
20784,26,524,99,48,90,1,3,5,100,0,0,0,0,0,0,0,0,0,0,0,0,2,4,6,0
20785,26,524,8,5,5,2,0,1,10,0,0,0,0,0,0,0,0,0,0,0,0,2,4,6,0
20786,26,524,1217,716,841,84,126,174,1301,14,185,118,215,199,333,1446,2542,8,20687,1149,0,2,4,6,0
20787,26,524,160,89,115,0,13,31,160,7,15,11,17,22,28,78,124,3,495,27,0,2,4,6,0
20788,26,524,10,10,9,9,0,0,19,0,0,0,0,0,0,0,0,0,0,0,0,2,4,6,0
20789,26,524,173,84,99,8,29,36,181,5,12,7,13,17,20,54,81,2,221,12,0,2,4,6,0
20790,26,524,3,1,1,3,0,0,6,0,0,0,0,0,0,0,0,0,0,0,0,2,4,6,0
20791,167,5074,1660,832,1314,41,38,274,1701,20,312,209,395,332,604,2671,5058,12,64042,3557,1,2,12,16,0
20792,167,5074,1057,646,719,113,100,145,1170,18,215,134,248,233,382,1740,3004,10,31186,1732,1,2,12,16,0
20793,17,345,95,58,50,9,16,20,104,12,33,24,45,45,69,209,378,8,3100,172,0,2,3,3,0
20794,86,1804,477,336,357,30,23,73,507,16,194,134,250,210,384,1538,2962,10,30538,1696,0,2,4,3,0
20795,141,2959,1513,682,1277,25,13,200,1538,11,199,116,219,210,335,1557,2584,6,15641,868,0,2,183,77,0
20796,141,2959,819,519,539,24,98,155,843,15,96,57,106,111,163,690,1107,8,9171,509,0,2,183,77,0
20797,52,1082,207,111,150,11,0,50,218,5,26,19,36,31,55,133,272,3,943,52,0,2,68,72,0
20798,52,1082,410,198,237,31,55,97,441,11,63,38,72,74,110,414,683,6,4293,238,0,2,68,72,0
20799,347,6940,1457,730,1242,11,6,188,1468,10,292,166,329,302,495,2424,4078,5,22973,1276,1,2,21,35,0
20800,347,6940,74,35,59,1,0,14,75,3,14,7,14,17,21,58,85,1,128,7,0,2,21,35,0
20801,347,6940,245,125,200,5,7,34,250,7,30,17,34,37,51,166,265,3,1053,58,0,2,21,35,0
20802,21,662,339,213,244,17,9,65,356,10,42,26,48,52,74,259,421,5,2410,133,0,2,2,2,0
20803,64,1726,1455,414,1257,16,76,112,1471,5,41,23,46,46,69,231,381,2,1069,59,0,2,8,1,0
20804,64,1726,669,365,481,22,61,110,691,15,103,63,122,118,185,747,1273,8,11311,628,0,2,8,1,0
20805,231,5276,4293,999,3693,19,54,507,4312,9,155,88,170,164,258,1156,1898,4,9368,520,0,2,37,30,0
20806,231,5276,1482,859,1002,125,135,219,1607,16,219,134,251,235,385,1766,3032,9,27804,1544,1,2,37,30,0
20807,50,586,647,139,84,35,284,233,682,0,0,0,0,0,0,0,0,0,0,0,0,2,2,2,0
20808,45,1297,773,422,505,30,103,129,803,14,77,46,83,91,129,535,839,7,6334,351,0,0,337,0,0
20809,185,4238,77,34,69,0,0,8,77,3,24,16,29,27,45,114,213,1,387,21,0,2,15,29,0
20810,185,4238,712,438,573,51,9,84,763,14,102,71,128,116,199,733,1364,8,11988,666,0,2,15,29,0
20811,100,2040,1020,354,843,12,15,144,1032,8,134,77,144,142,221,970,1580,4,6792,377,0,2,55,26,0
20812,46,957,447,308,343,6,5,95,453,7,96,59,111,103,170,651,1136,4,4600,255,0,2,4,5,0
20813,46,957,322,174,179,16,74,51,338,10,41,26,46,51,72,252,408,5,2291,127,0,2,4,5,0
20814,23,382,424,94,331,4,0,89,428,1,5,5,5,6,10,11,25,0,12,0,0,2,1,2,0
20815,23,382,38,23,23,6,0,8,44,3,11,7,11,14,18,42,68,1,102,5,0,2,1,2,0
20816,20,509,205,80,86,16,53,53,221,7,18,10,19,25,29,94,134,3,497,27,0,2,9,2,0
20817,17,518,184,100,137,2,15,30,186,6,38,20,39,44,59,214,322,3,991,55,0,2,2,2,0
20818,17,518,103,65,74,8,5,16,111,7,17,9,17,24,26,89,119,3,417,23,0,2,2,2,0
20819,214,5107,722,423,573,19,0,135,741,12,172,101,199,184,300,1320,2257,6,15668,870,0,2,65,45,0
20820,214,5107,1508,847,911,44,250,301,1552,14,148,88,169,162,257,1120,1886,7,15077,837,0,2,65,45,0
20821,258,6089,72,33,56,0,4,12,72,1,1,1,1,2,2,0,2,0,1,0,0,2,44,42,0
20822,258,6089,1454,835,1044,76,110,219,1530,17,275,158,296,292,454,2297,3718,9,34017,1889,1,2,44,42,0
20823,73,1425,757,253,292,73,244,162,830,13,61,38,67,74,105,409,651,7,4654,258,0,2,4,11,0
20824,46,954,386,256,301,16,9,68,402,4,59,35,69,63,104,355,621,2,1453,80,0,2,36,5,0
20825,46,954,264,131,164,11,41,46,275,6,38,22,40,44,62,214,338,3,1068,59,0,2,36,5,0
20826,112,2472,1043,504,840,53,9,147,1096,9,180,112,198,189,310,1377,2344,4,11604,644,0,2,1,1,0
20827,112,2472,383,288,292,26,6,62,409,11,65,38,67,76,105,429,656,5,3719,206,0,2,1,1,0
20828,20,408,294,64,250,0,0,43,294,1,20,10,20,21,30,86,131,0,65,3,0,2,2,2,0
20829,20,408,78,46,62,3,0,14,81,3,8,4,8,11,12,28,41,1,62,3,0,2,2,2,0
20830,108,2066,1178,367,1042,6,15,115,1184,9,94,51,95,103,146,644,976,4,4439,246,0,2,73,48,0
20831,108,2066,177,108,140,8,0,27,185,6,30,16,32,36,48,162,248,3,794,44,0,2,73,48,0
20832,202,4260,1943,715,1694,26,18,214,1969,12,185,120,237,197,357,1436,2721,7,20915,1161,0,2,70,22,0
20833,202,4260,1168,838,957,57,25,144,1225,19,348,224,416,367,640,3018,5452,11,61921,3440,1,2,70,22,0
20834,62,1222,1098,241,925,5,10,155,1103,7,46,25,49,53,74,273,423,3,1580,87,0,2,1,3,0
20835,62,1222,282,202,222,14,2,44,296,8,42,24,43,50,67,250,378,4,1548,86,0,2,1,3,0
20836,21,436,601,196,481,2,23,85,603,8,63,36,72,71,108,400,664,4,3036,168,0,2,2,2,0
20837,21,436,156,79,106,5,16,28,161,5,14,8,15,19,23,64,97,2,261,14,0,2,2,2,0
20838,7,299,72,33,56,0,4,12,72,1,1,1,1,2,2,0,2,0,1,0,0,2,1,1,0
20839,12,426,42,7,35,4,0,5,46,1,2,1,2,3,3,2,4,0,2,0,0,2,24,10,0
20840,12,426,11,6,10,0,0,1,11,2,4,2,4,6,6,10,15,1,15,0,0,2,24,10,0
20841,81,3472,1289,550,1043,56,32,155,1345,10,167,93,185,177,278,1266,2075,5,11498,638,0,2,6,6,0
20842,147,6933,1392,870,1177,35,17,170,1427,14,494,280,531,508,811,4473,7289,7,54850,3047,2,2,2,9,0
20843,87,2905,773,419,590,28,0,166,801,10,204,113,217,214,330,1598,2554,5,13587,754,0,2,0,2,0
20844,9,367,75,38,59,1,3,12,76,2,4,2,4,6,6,10,15,1,15,0,0,2,30,0,0
20845,7,353,139,89,101,2,0,35,141,7,54,34,62,61,96,330,569,4,2287,127,0,0,70,0,0
20846,21,1023,1157,318,931,29,22,177,1186,6,104,63,125,110,188,712,1274,3,4596,255,0,0,398,0,0
20847,52,3380,520,294,400,33,13,81,553,10,261,204,367,271,571,2128,4614,7,32445,1802,1,2,0,6,0
20848,97,4424,1338,495,1086,10,64,173,1348,11,122,82,157,133,239,883,1686,7,11934,663,0,2,10,15,0
20849,162,7134,139,89,101,2,0,35,141,7,54,34,62,61,96,330,569,4,2287,127,0,2,49,5,0
20850,162,7134,7,5,5,0,0,2,7,1,2,1,2,3,3,2,4,0,2,0,0,2,49,5,0
20851,132,5730,1782,648,1425,9,47,279,1791,8,171,97,189,179,286,1292,2140,4,9462,525,0,2,10,6,0
20852,110,4156,1450,624,1228,12,26,181,1462,14,306,186,354,320,540,2580,4493,8,36391,2021,1,2,2,2,0
20853,155,4372,1660,832,1314,41,38,274,1701,20,312,209,395,332,604,2671,5058,12,64042,3557,1,2,1,1,0
20854,128,5156,1513,682,1277,25,13,200,1538,11,199,116,219,210,335,1557,2584,6,15641,868,0,2,132,36,0
20855,73,3834,1296,573,1062,40,33,157,1336,8,201,118,231,209,349,1561,2689,4,12365,686,0,2,7,8,0
20856,80,4250,1457,730,1242,11,6,188,1468,10,292,166,329,302,495,2424,4078,5,22973,1276,1,2,9,1,0
20857,68,3131,1455,414,1257,16,76,112,1471,5,41,23,46,46,69,231,381,2,1069,59,0,2,28,0,0
20858,76,3351,1020,354,843,12,15,144,1032,8,134,77,144,142,221,970,1580,4,6792,377,0,2,1,1,0
20859,38,2303,334,251,279,10,4,40,344,5,127,74,143,132,217,899,1528,2,4303,239,0,2,1,7,0
20860,33,1914,384,251,317,7,8,52,391,11,70,44,84,81,128,467,811,6,5355,297,0,2,8,20,0
20861,16,677,722,423,573,19,0,135,741,12,172,101,199,184,300,1320,2257,6,15668,870,0,2,11,0,0
20862,39,1774,386,256,301,16,9,68,402,4,59,35,69,63,104,355,621,2,1453,80,0,2,24,0,0
20863,75,2972,1043,504,840,53,9,147,1096,9,180,112,198,189,310,1377,2344,4,11604,644,0,2,7,5,0
20864,74,3124,1178,367,1042,6,15,115,1184,9,94,51,95,103,146,644,976,4,4439,246,0,2,64,3,0
20865,81,4076,1943,715,1694,26,18,214,1969,12,185,120,237,197,357,1436,2721,7,20915,1161,0,2,64,10,0
20866,48,1750,1098,241,925,5,10,155,1103,7,46,25,49,53,74,273,423,3,1580,87,0,2,4,7,0
20867,18,646,601,196,481,2,23,85,603,8,63,36,72,71,108,400,664,4,3036,168,0,2,21,1,0
20868,22,453,601,196,481,2,23,85,603,8,63,36,72,71,108,400,664,4,3036,168,0,2,3,1,1
20869,22,453,156,79,106,5,16,28,161,5,14,8,15,19,23,64,97,2,261,14,0,2,3,1,1
20870,19,679,601,196,481,2,23,85,603,8,63,36,72,71,108,400,664,4,3036,168,0,2,13,0,1
20871,22,453,601,196,481,2,23,85,603,8,63,36,72,71,108,400,664,4,3036,168,0,2,3,1,0
20872,22,453,156,79,106,5,16,28,161,5,14,8,15,19,23,64,97,2,261,14,0,2,3,1,0
20873,19,679,601,196,481,2,23,85,603,8,63,36,72,71,108,400,664,4,3036,168,0,2,13,0,0
20874,348,6947,1457,730,1242,11,6,188,1468,10,292,166,329,302,495,2424,4078,5,22973,1276,1,2,1,1,0
20875,348,6947,74,35,59,1,0,14,75,3,14,7,14,17,21,58,85,1,128,7,0,2,1,1,0
20876,348,6947,245,125,200,5,7,34,250,7,30,17,34,37,51,166,265,3,1053,58,0,2,1,1,0
20877,80,4253,1457,730,1242,11,6,188,1468,10,292,166,329,302,495,2424,4078,5,22973,1276,1,2,6,2,0
20878,80,4253,1457,730,1242,11,6,188,1468,10,292,166,329,302,495,2424,4078,5,22973,1276,1,2,0,3,0
20879,111,2463,1043,504,840,53,9,147,1096,9,180,112,198,189,310,1377,2344,4,11604,644,0,2,2,4,1
20880,111,2463,383,288,292,26,6,62,409,11,65,38,67,76,105,429,656,5,3719,206,0,2,2,4,1
20881,81,3472,1289,550,1043,56,32,155,1345,10,167,93,185,177,278,1266,2075,5,11498,638,0,2,3,3,1
20882,82,4311,1457,730,1242,11,6,188,1468,10,292,166,329,302,495,2424,4078,5,22973,1276,1,2,12,4,0
20883,203,4272,1943,715,1694,26,18,214,1969,12,185,120,237,197,357,1436,2721,7,20915,1161,0,2,5,2,0
20884,203,4272,1168,838,957,57,25,144,1225,19,348,224,416,367,640,3018,5452,11,61921,3440,1,2,5,2,0
20885,82,4120,1943,715,1694,26,18,214,1969,12,185,120,237,197,357,1436,2721,7,20915,1161,0,2,18,0,0
20886,111,2463,1043,504,840,53,9,147,1096,9,180,112,198,189,310,1377,2344,4,11604,644,0,2,2,4,0
20887,111,2463,383,288,292,26,6,62,409,11,65,38,67,76,105,429,656,5,3719,206,0,2,2,4,0
20888,81,3472,1289,550,1043,56,32,155,1345,10,167,93,185,177,278,1266,2075,5,11498,638,0,2,3,3,0
20889,348,6947,1457,730,1242,11,6,188,1468,10,292,166,329,302,495,2424,4078,5,22973,1276,1,2,1,1,0
20890,348,6947,74,35,59,1,0,14,75,3,14,7,14,17,21,58,85,1,128,7,0,2,1,1,0
20891,348,6947,245,125,200,5,7,34,250,7,30,17,34,37,51,166,265,3,1053,58,0,2,1,1,0
20892,82,4311,1457,730,1242,11,6,188,1468,10,292,166,329,302,495,2424,4078,5,22973,1276,1,2,14,5,0
20893,259,6096,72,33,56,0,4,12,72,1,1,1,1,2,2,0,2,0,1,0,0,2,1,1,0
20894,259,6096,1454,835,1044,76,110,219,1530,17,275,158,296,292,454,2297,3718,9,34017,1889,1,2,1,1,0
20895,231,5287,4293,999,3693,19,54,507,4312,9,155,88,170,164,258,1156,1898,4,9368,520,0,2,1,1,0
20896,231,5287,1482,859,1002,125,135,219,1607,16,219,134,251,235,385,1766,3032,9,27804,1544,1,2,1,1,0
20897,135,5789,1782,648,1425,9,47,279,1791,8,171,97,189,179,286,1292,2140,4,9462,525,0,2,14,0,0
20898,135,5789,1782,648,1425,9,47,279,1791,8,171,97,189,179,286,1292,2140,4,9462,525,0,2,7,2,0
20899,231,5287,4293,999,3693,19,54,507,4312,9,155,88,170,164,258,1156,1898,4,9368,520,0,2,1,1,0
20900,231,5287,1482,859,1002,125,135,219,1607,16,219,134,251,235,385,1766,3032,9,27804,1544,1,2,1,1,0
20901,259,6096,72,33,56,0,4,12,72,1,1,1,1,2,2,0,2,0,1,0,0,2,1,1,0
20902,259,6096,1454,835,1044,76,110,219,1530,17,275,158,296,292,454,2297,3718,9,34017,1889,1,2,1,1,0
20903,135,5789,1782,648,1425,9,47,279,1791,8,171,97,189,179,286,1292,2140,4,9462,525,0,2,19,0,0
20904,202,4267,1943,715,1694,26,18,214,1969,12,185,120,237,197,357,1436,2721,7,20915,1161,0,2,2,0,0
20905,202,4267,1168,838,957,57,25,144,1225,19,348,224,416,367,640,3018,5452,11,61921,3440,1,2,2,0,0
20906,11,406,75,38,59,1,3,12,76,2,4,2,4,6,6,10,15,1,15,0,0,2,13,0,0
20907,203,4272,1943,715,1694,26,18,214,1969,12,185,120,237,197,357,1436,2721,7,20915,1161,0,2,5,2,0
20908,203,4272,1168,838,957,57,25,144,1225,19,348,224,416,367,640,3018,5452,11,61921,3440,1,2,5,2,0
20909,82,4120,1943,715,1694,26,18,214,1969,12,185,120,237,197,357,1436,2721,7,20915,1161,0,2,18,0,0
20910,203,4279,1943,715,1694,26,18,214,1969,12,185,120,237,197,357,1436,2721,7,20915,1161,0,2,2,0,0
20911,203,4279,1168,838,957,57,25,144,1225,19,348,224,416,367,640,3018,5452,11,61921,3440,1,2,2,0,0
20912,11,406,75,38,59,1,3,12,76,2,4,2,4,6,6,10,15,1,15,0,0,2,13,0,0
20913,348,6963,1457,730,1242,11,6,188,1468,10,292,166,329,302,495,2424,4078,5,22973,1276,1,2,4,3,0
20914,348,6963,74,35,59,1,0,14,75,3,14,7,14,17,21,58,85,1,128,7,0,2,4,3,0
20915,348,6963,245,125,200,5,7,34,250,7,30,17,34,37,51,166,265,3,1053,58,0,2,4,3,0
20916,11,428,75,38,59,1,3,12,76,2,4,2,4,6,6,10,15,1,15,0,0,2,5,4,0
20917,348,6963,1457,730,1242,11,6,188,1468,10,292,166,329,302,495,2424,4078,5,22973,1276,1,2,4,3,0
20918,348,6963,74,35,59,1,0,14,75,3,14,7,14,17,21,58,85,1,128,7,0,2,4,3,0
20919,348,6963,245,125,200,5,7,34,250,7,30,17,34,37,51,166,265,3,1053,58,0,2,4,3,0
20920,11,428,75,38,59,1,3,12,76,2,4,2,4,6,6,10,15,1,15,0,0,2,5,4,0
20921,348,6963,1457,730,1242,11,6,188,1468,10,292,166,329,302,495,2424,4078,5,22973,1276,1,2,4,3,0
20922,348,6963,74,35,59,1,0,14,75,3,14,7,14,17,21,58,85,1,128,7,0,2,4,3,0
20923,348,6963,245,125,200,5,7,34,250,7,30,17,34,37,51,166,265,3,1053,58,0,2,4,3,0
20924,231,5287,4293,999,3693,19,54,507,4312,9,155,88,170,164,258,1156,1898,4,9368,520,0,2,1,1,0
20925,231,5287,1482,859,1002,125,135,219,1607,16,219,134,251,235,385,1766,3032,9,27804,1544,1,2,1,1,0
20926,203,4279,1943,715,1694,26,18,214,1969,12,185,120,237,197,357,1436,2721,7,20915,1161,0,2,7,2,0
20927,203,4279,1168,838,957,57,25,144,1225,19,348,224,416,367,640,3018,5452,11,61921,3440,1,2,7,2,0
20928,11,428,75,38,59,1,3,12,76,2,4,2,4,6,6,10,15,1,15,0,0,2,18,4,0
20929,82,4120,1943,715,1694,26,18,214,1969,12,185,120,237,197,357,1436,2721,7,20915,1161,0,2,18,0,0
20930,191,4342,77,34,69,0,0,8,77,3,24,16,29,27,45,114,213,1,387,21,0,2,19,0,1
20931,191,4342,712,438,573,51,9,84,763,14,102,71,128,116,199,733,1364,8,11988,666,0,2,19,0,1
20932,87,3758,1289,550,1043,56,32,155,1345,10,167,93,185,177,278,1266,2075,5,11498,638,0,2,65,0,1
20933,41,1265,773,422,505,30,103,129,803,14,77,46,83,91,129,535,839,7,6334,351,0,2,14,24,0
20934,214,5107,722,423,573,19,0,135,741,12,172,101,199,184,300,1320,2257,6,15668,870,0,2,159,160,1
20935,214,5107,1508,847,911,44,250,301,1552,14,148,88,169,162,257,1120,1886,7,15077,837,0,2,159,160,1
20936,214,5107,722,423,573,19,0,135,741,12,172,101,199,184,300,1320,2257,6,15668,870,0,2,0,7,0
20937,214,5107,1508,847,911,44,250,301,1552,14,148,88,169,162,257,1120,1886,7,15077,837,0,2,0,7,0
20938,214,5106,722,423,573,19,0,135,741,12,172,101,199,184,300,1320,2257,6,15668,870,0,2,2,2,0
20939,214,5106,1508,847,911,44,250,301,1552,14,148,88,169,162,257,1120,1886,7,15077,837,0,2,2,2,0
20940,81,3468,1289,550,1043,56,32,155,1345,10,167,93,185,177,278,1266,2075,5,11498,638,0,2,2,2,0
20941,39,2351,652,304,544,16,6,88,668,6,89,51,101,95,152,591,998,3,3399,188,0,2,1,1,0
20942,35,1623,1293,570,1093,25,15,163,1318,10,195,123,241,205,364,1516,2795,6,17273,959,0,2,1,1,0
20943,81,3468,1289,550,1043,56,32,155,1345,10,167,93,185,177,278,1266,2075,5,11498,638,0,2,2,2,0
20944,81,3468,1289,550,1043,56,32,155,1345,10,167,93,185,177,278,1266,2075,5,11498,638,0,2,5,5,0
20945,16,677,722,423,573,19,0,135,741,12,172,101,199,184,300,1320,2257,6,15668,870,0,2,1,1,1
20946,39,2342,652,304,544,16,6,88,668,6,89,51,101,95,152,591,998,3,3399,188,0,2,1,5,0
20947,100,2053,773,419,590,28,0,166,801,10,204,113,217,214,330,1598,2554,5,13587,754,0,2,5,9,0
20948,100,2053,421,273,302,44,34,57,465,17,81,59,107,98,166,583,1098,11,12329,684,0,2,5,9,0
20949,167,5072,1660,832,1314,41,38,274,1701,20,312,209,395,332,604,2671,5058,12,64042,3557,1,2,2,3,0
20950,167,5072,1057,646,719,113,100,145,1170,18,215,134,248,233,382,1740,3004,10,31186,1732,1,2,2,3,0
20951,87,2883,773,419,590,28,0,166,801,10,204,113,217,214,330,1598,2554,5,13587,754,0,2,2,5,0
20952,86,1796,477,336,357,30,23,73,507,16,194,134,250,210,384,1538,2962,10,30538,1696,0,2,1,5,1
20953,86,1788,477,336,357,30,23,73,507,16,194,134,250,210,384,1538,2962,10,30538,1696,0,2,1,1,0
20954,100,2053,773,419,590,28,0,166,801,10,204,113,217,214,330,1598,2554,5,13587,754,0,2,5,9,0
20955,100,2053,421,273,302,44,34,57,465,17,81,59,107,98,166,583,1098,11,12329,684,0,2,5,9,0
20956,167,5072,1660,832,1314,41,38,274,1701,20,312,209,395,332,604,2671,5058,12,64042,3557,1,2,2,3,0
20957,167,5072,1057,646,719,113,100,145,1170,18,215,134,248,233,382,1740,3004,10,31186,1732,1,2,2,3,0
20958,86,1788,477,336,357,30,23,73,507,16,194,134,250,210,384,1538,2962,10,30538,1696,0,2,2,6,0
20959,87,2883,773,419,590,28,0,166,801,10,204,113,217,214,330,1598,2554,5,13587,754,0,2,2,5,0
20960,214,5106,722,423,573,19,0,135,741,12,172,101,199,184,300,1320,2257,6,15668,870,0,2,161,169,0
20961,214,5106,1508,847,911,44,250,301,1552,14,148,88,169,162,257,1120,1886,7,15077,837,0,2,161,169,0
20962,81,3468,1289,550,1043,56,32,155,1345,10,167,93,185,177,278,1266,2075,5,11498,638,0,2,9,9,0
20963,39,2342,652,304,544,16,6,88,668,6,89,51,101,95,152,591,998,3,3399,188,0,2,2,6,0
20964,35,1623,1293,570,1093,25,15,163,1318,10,195,123,241,205,364,1516,2795,6,17273,959,0,2,1,1,0
20965,16,677,722,423,573,19,0,135,741,12,172,101,199,184,300,1320,2257,6,15668,870,0,2,1,1,0
20966,100,2053,773,419,590,28,0,166,801,10,204,113,217,214,330,1598,2554,5,13587,754,0,2,5,9,0
20967,100,2053,421,273,302,44,34,57,465,17,81,59,107,98,166,583,1098,11,12329,684,0,2,5,9,0
20968,167,5072,1660,832,1314,41,38,274,1701,20,312,209,395,332,604,2671,5058,12,64042,3557,1,2,2,3,0
20969,167,5072,1057,646,719,113,100,145,1170,18,215,134,248,233,382,1740,3004,10,31186,1732,1,2,2,3,0
20970,86,1788,477,336,357,30,23,73,507,16,194,134,250,210,384,1538,2962,10,30538,1696,0,2,2,6,0
20971,214,5106,722,423,573,19,0,135,741,12,172,101,199,184,300,1320,2257,6,15668,870,0,2,161,169,0
20972,214,5106,1508,847,911,44,250,301,1552,14,148,88,169,162,257,1120,1886,7,15077,837,0,2,161,169,0
20973,81,3468,1289,550,1043,56,32,155,1345,10,167,93,185,177,278,1266,2075,5,11498,638,0,2,9,9,0
20974,87,2883,773,419,590,28,0,166,801,10,204,113,217,214,330,1598,2554,5,13587,754,0,2,2,5,0
20975,39,2342,652,304,544,16,6,88,668,6,89,51,101,95,152,591,998,3,3399,188,0,2,2,6,0
20976,35,1623,1293,570,1093,25,15,163,1318,10,195,123,241,205,364,1516,2795,6,17273,959,0,2,1,1,0
20977,16,677,722,423,573,19,0,135,741,12,172,101,199,184,300,1320,2257,6,15668,870,0,2,1,1,0
20978,87,3752,1289,550,1043,56,32,155,1345,10,167,93,185,177,278,1266,2075,5,11498,638,0,2,3,3,0
20979,193,4386,77,34,69,0,0,8,77,3,24,16,29,27,45,114,213,1,387,21,0,2,43,20,0
20980,193,4386,712,438,573,51,9,84,763,14,102,71,128,116,199,733,1364,8,11988,666,0,2,43,20,0
20981,193,4386,77,34,69,0,0,8,77,3,24,16,29,27,45,114,213,1,387,21,0,2,40,38,0
20982,193,4386,712,438,573,51,9,84,763,14,102,71,128,116,199,733,1364,8,11988,666,0,2,40,38,0
20983,50,586,647,139,84,35,284,233,682,0,0,0,0,0,0,0,0,0,0,0,0,2,95,30,1
20984,167,5087,1660,832,1314,41,38,274,1701,20,312,209,395,332,604,2671,5058,12,64042,3557,1,2,8,6,1
20985,167,5087,1057,646,719,113,100,145,1170,18,215,134,248,233,382,1740,3004,10,31186,1732,1,2,8,6,1
20986,214,5106,722,423,573,19,0,135,741,12,172,101,199,184,300,1320,2257,6,15668,870,0,2,1,1,1
20987,214,5106,1508,847,911,44,250,301,1552,14,148,88,169,162,257,1120,1886,7,15077,837,0,2,1,1,1
20988,156,4422,1660,832,1314,41,38,274,1701,20,312,209,395,332,604,2671,5058,12,64042,3557,1,2,10,0,1
20989,167,5085,1660,832,1314,41,38,274,1701,20,312,209,395,332,604,2671,5058,12,64042,3557,1,2,3,2,0
20990,167,5085,1057,646,719,113,100,145,1170,18,215,134,248,233,382,1740,3004,10,31186,1732,1,2,3,2,0
20991,41,1265,773,422,505,30,103,129,803,14,77,46,83,91,129,535,839,7,6334,351,0,2,14,24,0
20992,167,5085,1660,832,1314,41,38,274,1701,20,312,209,395,332,604,2671,5058,12,64042,3557,1,2,9,6,0
20993,167,5085,1057,646,719,113,100,145,1170,18,215,134,248,233,382,1740,3004,10,31186,1732,1,2,9,6,0
20994,214,5106,722,423,573,19,0,135,741,12,172,101,199,184,300,1320,2257,6,15668,870,0,2,1,1,0
20995,214,5106,1508,847,911,44,250,301,1552,14,148,88,169,162,257,1120,1886,7,15077,837,0,2,1,1,0
20996,156,4422,1660,832,1314,41,38,274,1701,20,312,209,395,332,604,2671,5058,12,64042,3557,1,2,10,0,0
20997,50,586,647,139,84,35,284,233,682,0,0,0,0,0,0,0,0,0,0,0,0,2,95,30,0
20998,193,4386,77,34,69,0,0,8,77,3,24,16,29,27,45,114,213,1,387,21,0,2,47,3,0
20999,193,4386,712,438,573,51,9,84,763,14,102,71,128,116,199,733,1364,8,11988,666,0,2,47,3,0
21000,87,3748,1289,550,1043,56,32,155,1345,10,167,93,185,177,278,1266,2075,5,11498,638,0,2,65,0,0
21001,45,1258,773,422,505,30,103,129,803,14,77,46,83,91,129,535,839,7,6334,351,0,2,8,9,0
21002,231,5261,4293,999,3693,19,54,507,4312,9,155,88,170,164,258,1156,1898,4,9368,520,0,2,10,7,0
21003,231,5261,1482,859,1002,125,135,219,1607,16,219,134,251,235,385,1766,3032,9,27804,1544,1,2,10,7,0
21004,88,3778,1289,550,1043,56,32,155,1345,10,167,93,185,177,278,1266,2075,5,11498,638,0,2,43,0,0
21005,45,1258,773,422,505,30,103,129,803,14,77,46,83,91,129,535,839,7,6334,351,0,2,8,9,0
21006,231,5261,4293,999,3693,19,54,507,4312,9,155,88,170,164,258,1156,1898,4,9368,520,0,2,10,7,0
21007,231,5261,1482,859,1002,125,135,219,1607,16,219,134,251,235,385,1766,3032,9,27804,1544,1,2,10,7,0
21008,88,3778,1289,550,1043,56,32,155,1345,10,167,93,185,177,278,1266,2075,5,11498,638,0,2,43,0,0
21009,89,3806,1289,550,1043,56,32,155,1345,10,167,93,185,177,278,1266,2075,5,11498,638,0,2,7,0,0
21010,204,4292,1943,715,1694,26,18,214,1969,12,185,120,237,197,357,1436,2721,7,20915,1161,0,2,2,1,0
21011,204,4292,1168,838,957,57,25,144,1225,19,348,224,416,367,640,3018,5452,11,61921,3440,1,2,2,1,0
21012,83,4156,1943,715,1694,26,18,214,1969,12,185,120,237,197,357,1436,2721,7,20915,1161,0,2,8,0,0
21013,167,5085,1660,832,1314,41,38,274,1701,20,312,209,395,332,604,2671,5058,12,64042,3557,1,2,9,6,0
21014,167,5085,1057,646,719,113,100,145,1170,18,215,134,248,233,382,1740,3004,10,31186,1732,1,2,9,6,0
21015,231,5261,4293,999,3693,19,54,507,4312,9,155,88,170,164,258,1156,1898,4,9368,520,0,2,10,7,0
21016,231,5261,1482,859,1002,125,135,219,1607,16,219,134,251,235,385,1766,3032,9,27804,1544,1,2,10,7,0
21017,50,586,647,139,84,35,284,233,682,0,0,0,0,0,0,0,0,0,0,0,0,2,95,30,0
21018,45,1258,773,422,505,30,103,129,803,14,77,46,83,91,129,535,839,7,6334,351,0,2,16,27,0
21019,193,4386,77,34,69,0,0,8,77,3,24,16,29,27,45,114,213,1,387,21,0,2,47,3,0
21020,193,4386,712,438,573,51,9,84,763,14,102,71,128,116,199,733,1364,8,11988,666,0,2,47,3,0
21021,214,5106,722,423,573,19,0,135,741,12,172,101,199,184,300,1320,2257,6,15668,870,0,2,1,1,0
21022,214,5106,1508,847,911,44,250,301,1552,14,148,88,169,162,257,1120,1886,7,15077,837,0,2,1,1,0
21023,204,4292,1943,715,1694,26,18,214,1969,12,185,120,237,197,357,1436,2721,7,20915,1161,0,2,2,1,0
21024,204,4292,1168,838,957,57,25,144,1225,19,348,224,416,367,640,3018,5452,11,61921,3440,1,2,2,1,0
21025,88,3778,1289,550,1043,56,32,155,1345,10,167,93,185,177,278,1266,2075,5,11498,638,0,2,108,0,0
21026,156,4422,1660,832,1314,41,38,274,1701,20,312,209,395,332,604,2671,5058,12,64042,3557,1,2,10,0,0
21027,83,4156,1943,715,1694,26,18,214,1969,12,185,120,237,197,357,1436,2721,7,20915,1161,0,2,8,0,0
21028,90,3836,1289,550,1043,56,32,155,1345,10,167,93,185,177,278,1266,2075,5,11498,638,0,2,7,0,0
21029,51,1398,773,422,505,30,103,129,803,14,77,46,83,91,129,535,839,7,6334,351,0,2,35,7,0
21030,221,5235,722,423,573,19,0,135,741,12,172,101,199,184,300,1320,2257,6,15668,870,0,2,46,21,1
21031,221,5235,1508,847,911,44,250,301,1552,14,148,88,169,162,257,1120,1886,7,15077,837,0,2,46,21,1
21032,222,5253,722,423,573,19,0,135,741,12,172,101,199,184,300,1320,2257,6,15668,870,0,2,52,39,1
21033,222,5253,1508,847,911,44,250,301,1552,14,148,88,169,162,257,1120,1886,7,15077,837,0,2,52,39,1
21034,88,3790,1289,550,1043,56,32,155,1345,10,167,93,185,177,278,1266,2075,5,11498,638,0,2,3,3,1
21035,11,423,75,38,59,1,3,12,76,2,4,2,4,6,6,10,15,1,15,0,0,2,0,1,1
21036,45,2193,722,423,573,19,0,135,741,12,172,101,199,184,300,1320,2257,6,15668,870,0,2,238,9,1
21037,52,1417,773,422,505,30,103,129,803,14,77,46,83,91,129,535,839,7,6334,351,0,2,15,9,0
21038,51,1398,773,422,505,30,103,129,803,14,77,46,83,91,129,535,839,7,6334,351,0,2,9,15,0
21039,45,1258,773,422,505,30,103,129,803,14,77,46,83,91,129,535,839,7,6334,351,0,2,7,35,0
21040,45,1258,773,422,505,30,103,129,803,14,77,46,83,91,129,535,839,7,6334,351,0,2,7,41,0
21041,231,5265,4293,999,3693,19,54,507,4312,9,155,88,170,164,258,1156,1898,4,9368,520,0,2,2,1,1
21042,231,5265,1482,859,1002,125,135,219,1607,16,219,134,251,235,385,1766,3032,9,27804,1544,1,2,2,1,1
21043,50,586,647,139,84,35,284,233,682,0,0,0,0,0,0,0,0,0,0,0,0,2,1,1,1
21044,117,2801,77,34,69,0,0,8,77,3,24,16,29,27,45,114,213,1,387,21,0,2,8,362,1
21045,117,2801,712,438,573,51,9,84,763,14,102,71,128,116,199,733,1364,8,11988,666,0,2,8,362,1
21046,80,1686,53,23,39,0,0,13,53,2,8,4,8,10,12,26,39,1,39,2,0,2,361,0,1
21047,80,1686,515,298,307,33,80,99,548,12,63,44,77,75,121,419,753,7,5527,307,0,2,361,0,1
21048,259,6096,72,33,56,0,4,12,72,1,1,1,1,2,2,0,2,0,1,0,0,2,4,4,1
21049,259,6096,1454,835,1044,76,110,219,1530,17,275,158,296,292,454,2297,3718,9,34017,1889,1,2,4,4,1
21050,97,4426,1338,495,1086,10,64,173,1348,11,122,82,157,133,239,883,1686,7,11934,663,0,2,2,5,1
21051,16,1209,215,129,180,6,0,29,221,8,65,43,72,73,115,415,711,4,3153,175,0,2,1,1,1
21052,79,1686,53,23,39,0,0,13,53,2,8,4,8,10,12,26,39,1,39,2,0,2,5,3,0
21053,79,1686,515,298,307,33,80,99,548,12,63,44,77,75,121,419,753,7,5527,307,0,2,5,3,0
21054,215,5118,722,423,573,19,0,135,741,12,172,101,199,184,300,1320,2257,6,15668,870,0,2,7,0,0
21055,215,5118,1508,847,911,44,250,301,1552,14,148,88,169,162,257,1120,1886,7,15077,837,0,2,7,0,0
21056,222,5253,722,423,573,19,0,135,741,12,172,101,199,184,300,1320,2257,6,15668,870,0,2,97,59,0
21057,222,5253,1508,847,911,44,250,301,1552,14,148,88,169,162,257,1120,1886,7,15077,837,0,2,97,59,0
21058,88,3790,1289,550,1043,56,32,155,1345,10,167,93,185,177,278,1266,2075,5,11498,638,0,2,3,3,0
21059,11,423,75,38,59,1,3,12,76,2,4,2,4,6,6,10,15,1,15,0,0,2,0,1,0
21060,45,2193,722,423,573,19,0,135,741,12,172,101,199,184,300,1320,2257,6,15668,870,0,2,238,9,0
21061,231,5265,4293,999,3693,19,54,507,4312,9,155,88,170,164,258,1156,1898,4,9368,520,0,2,2,1,0
21062,231,5265,1482,859,1002,125,135,219,1607,16,219,134,251,235,385,1766,3032,9,27804,1544,1,2,2,1,0
21063,50,586,647,139,84,35,284,233,682,0,0,0,0,0,0,0,0,0,0,0,0,2,1,1,0
21064,117,2801,77,34,69,0,0,8,77,3,24,16,29,27,45,114,213,1,387,21,0,2,8,362,0
21065,117,2801,712,438,573,51,9,84,763,14,102,71,128,116,199,733,1364,8,11988,666,0,2,8,362,0
21066,79,1686,53,23,39,0,0,13,53,2,8,4,8,10,12,26,39,1,39,2,0,2,363,0,0
21067,79,1686,515,298,307,33,80,99,548,12,63,44,77,75,121,419,753,7,5527,307,0,2,363,0,0
21068,259,6096,72,33,56,0,4,12,72,1,1,1,1,2,2,0,2,0,1,0,0,2,4,4,0
21069,259,6096,1454,835,1044,76,110,219,1530,17,275,158,296,292,454,2297,3718,9,34017,1889,1,2,4,4,0
21070,97,4426,1338,495,1086,10,64,173,1348,11,122,82,157,133,239,883,1686,7,11934,663,0,2,2,5,0
21071,16,1209,215,129,180,6,0,29,221,8,65,43,72,73,115,415,711,4,3153,175,0,2,1,1,0
21072,215,5118,722,423,573,19,0,135,741,12,172,101,199,184,300,1320,2257,6,15668,870,0,2,7,0,0
21073,215,5118,1508,847,911,44,250,301,1552,14,148,88,169,162,257,1120,1886,7,15077,837,0,2,7,0,0
21074,147,6933,1392,870,1177,35,17,170,1427,14,494,280,531,508,811,4473,7289,7,54850,3047,2,2,1,1,0
21075,75,2972,1043,504,840,53,9,147,1096,9,180,112,198,189,310,1377,2344,4,11604,644,0,2,2,2,0
21076,74,3124,1178,367,1042,6,15,115,1184,9,94,51,95,103,146,644,976,4,4439,246,0,2,1,1,0
21077,147,6933,1392,870,1177,35,17,170,1427,14,494,280,531,508,811,4473,7289,7,54850,3047,2,2,1,1,0
21078,75,2972,1043,504,840,53,9,147,1096,9,180,112,198,189,310,1377,2344,4,11604,644,0,2,2,2,0
21079,74,3124,1178,367,1042,6,15,115,1184,9,94,51,95,103,146,644,976,4,4439,246,0,2,1,1,0
21080,108,2071,1178,367,1042,6,15,115,1184,9,94,51,95,103,146,644,976,4,4439,246,0,2,1,1,0
21081,108,2071,177,108,140,8,0,27,185,6,30,16,32,36,48,162,248,3,794,44,0,2,1,1,0
21082,50,586,647,139,84,35,284,233,682,0,0,0,0,0,0,0,0,0,0,0,0,2,13,2,0
21083,108,2071,1178,367,1042,6,15,115,1184,9,94,51,95,103,146,644,976,4,4439,246,0,2,1,1,0
21084,108,2071,177,108,140,8,0,27,185,6,30,16,32,36,48,162,248,3,794,44,0,2,1,1,0
21085,258,6107,72,33,56,0,4,12,72,1,1,1,1,2,2,0,2,0,1,0,0,2,14,7,0
21086,258,6107,1454,835,1044,76,110,219,1530,17,275,158,296,292,454,2297,3718,9,34017,1889,1,2,14,7,0
21087,15,466,42,7,35,4,0,5,46,1,2,1,2,3,3,2,4,0,2,0,0,2,21,6,0
21088,15,466,11,6,10,0,0,1,11,2,4,2,4,6,6,10,15,1,15,0,0,2,21,6,0
21089,15,466,42,7,35,4,0,5,46,1,2,1,2,3,3,2,4,0,2,0,0,2,21,6,0
21090,15,466,11,6,10,0,0,1,11,2,4,2,4,6,6,10,15,1,15,0,0,2,21,6,0
21091,258,6107,72,33,56,0,4,12,72,1,1,1,1,2,2,0,2,0,1,0,0,2,14,7,0
21092,258,6107,1454,835,1044,76,110,219,1530,17,275,158,296,292,454,2297,3718,9,34017,1889,1,2,14,7,0
21093,223,5265,722,423,573,19,0,135,741,12,172,101,199,184,300,1320,2257,6,15668,870,0,2,7,0,0
21094,223,5265,1508,847,911,44,250,301,1552,14,148,88,169,162,257,1120,1886,7,15077,837,0,2,7,0,0
21095,259,6114,72,33,56,0,4,12,72,1,1,1,1,2,2,0,2,0,1,0,0,2,14,7,0
21096,259,6114,1454,835,1044,76,110,219,1530,17,275,158,296,292,454,2297,3718,9,34017,1889,1,2,14,7,0
21097,108,2071,1178,367,1042,6,15,115,1184,9,94,51,95,103,146,644,976,4,4439,246,0,2,1,1,0
21098,108,2071,177,108,140,8,0,27,185,6,30,16,32,36,48,162,248,3,794,44,0,2,1,1,0
21099,15,466,42,7,35,4,0,5,46,1,2,1,2,3,3,2,4,0,2,0,0,2,21,6,0
21100,15,466,11,6,10,0,0,1,11,2,4,2,4,6,6,10,15,1,15,0,0,2,21,6,0
21101,90,3848,1289,550,1043,56,32,155,1345,10,167,93,185,177,278,1266,2075,5,11498,638,0,2,7,0,0
21102,147,6933,1392,870,1177,35,17,170,1427,14,494,280,531,508,811,4473,7289,7,54850,3047,2,2,1,1,0
21103,75,2972,1043,504,840,53,9,147,1096,9,180,112,198,189,310,1377,2344,4,11604,644,0,2,2,2,0
21104,74,3124,1178,367,1042,6,15,115,1184,9,94,51,95,103,146,644,976,4,4439,246,0,2,1,1,0
21105,214,4584,182,127,129,0,0,53,182,5,39,21,42,44,63,217,343,2,926,51,0,2,6,4,1
21106,214,4584,1165,710,800,67,119,181,1232,18,243,153,282,261,435,2000,3492,10,36473,2026,1,2,6,4,1
21107,100,2037,773,419,590,28,0,166,801,10,204,113,217,214,330,1598,2554,5,13587,754,0,2,4,4,1
21108,100,2037,421,273,302,44,34,57,465,17,81,59,107,98,166,583,1098,11,12329,684,0,2,4,4,1
21109,60,1084,282,196,195,3,0,86,285,8,130,71,141,138,212,936,1507,4,6538,363,0,2,2,2,1
21110,17,384,85,59,61,8,0,16,93,5,18,10,18,23,28,86,126,2,316,17,0,2,0,1,1
21111,90,3814,1289,550,1043,56,32,155,1345,10,167,93,185,177,278,1266,2075,5,11498,638,0,2,7,6,1
21112,147,6905,1392,870,1177,35,17,170,1427,14,494,280,531,508,811,4473,7289,7,54850,3047,2,2,10,8,1
21113,87,2871,773,419,590,28,0,166,801,10,204,113,217,214,330,1598,2554,5,13587,754,0,2,4,4,1
21114,97,4414,1338,495,1086,10,64,173,1348,11,122,82,157,133,239,883,1686,7,11934,663,0,2,2,3,1
21115,132,5730,1782,648,1425,9,47,279,1791,8,171,97,189,179,286,1292,2140,4,9462,525,0,2,2,2,1
21116,23,577,102,59,69,5,3,24,107,6,22,15,28,28,43,113,206,3,789,43,0,2,10,9,1
21117,156,4416,1660,832,1314,41,38,274,1701,20,312,209,395,332,604,2671,5058,12,64042,3557,1,2,3,2,1
21118,73,3804,1296,573,1062,40,33,157,1336,8,201,118,231,209,349,1561,2689,4,12365,686,0,2,10,9,1
21119,82,4295,1457,730,1242,11,6,188,1468,10,292,166,329,302,495,2424,4078,5,22973,1276,1,2,5,5,1
21120,39,2324,652,304,544,16,6,88,668,6,89,51,101,95,152,591,998,3,3399,188,0,2,3,3,1
21121,38,2301,334,251,279,10,4,40,344,5,127,74,143,132,217,899,1528,2,4303,239,0,2,2,1,1
21122,33,1886,384,251,317,7,8,52,391,11,70,44,84,81,128,467,811,6,5355,297,0,2,11,9,1
21123,39,1724,386,256,301,16,9,68,402,4,59,35,69,63,104,355,621,2,1453,80,0,2,14,15,1
21124,75,2952,1043,504,840,53,9,147,1096,9,180,112,198,189,310,1377,2344,4,11604,644,0,2,10,8,1
21125,82,4108,1943,715,1694,26,18,214,1969,12,185,120,237,197,357,1436,2721,7,20915,1161,0,2,3,3,1
21126,51,595,647,139,84,35,284,233,682,0,0,0,0,0,0,0,0,0,0,0,0,2,20,2,1
21127,111,2482,1043,504,840,53,9,147,1096,9,180,112,198,189,310,1377,2344,4,11604,644,0,2,3,0,1
21128,111,2482,383,288,292,26,6,62,409,11,65,38,67,76,105,429,656,5,3719,206,0,2,3,0,1
21129,78,3035,1043,504,840,53,9,147,1096,9,180,112,198,189,310,1377,2344,4,11604,644,0,2,12,0,1
21130,214,4584,182,127,129,0,0,53,182,5,39,21,42,44,63,217,343,2,926,51,0,2,6,4,0
21131,214,4584,1165,710,800,67,119,181,1232,18,243,153,282,261,435,2000,3492,10,36473,2026,1,2,6,4,0
21132,100,2037,773,419,590,28,0,166,801,10,204,113,217,214,330,1598,2554,5,13587,754,0,2,4,4,0
21133,100,2037,421,273,302,44,34,57,465,17,81,59,107,98,166,583,1098,11,12329,684,0,2,4,4,0
21134,60,1084,282,196,195,3,0,86,285,8,130,71,141,138,212,936,1507,4,6538,363,0,2,2,2,0
21135,17,384,85,59,61,8,0,16,93,5,18,10,18,23,28,86,126,2,316,17,0,2,0,1,0
21136,90,3814,1289,550,1043,56,32,155,1345,10,167,93,185,177,278,1266,2075,5,11498,638,0,2,7,6,0
21137,147,6905,1392,870,1177,35,17,170,1427,14,494,280,531,508,811,4473,7289,7,54850,3047,2,2,10,8,0
21138,87,2871,773,419,590,28,0,166,801,10,204,113,217,214,330,1598,2554,5,13587,754,0,2,4,4,0
21139,97,4414,1338,495,1086,10,64,173,1348,11,122,82,157,133,239,883,1686,7,11934,663,0,2,2,3,0
21140,132,5730,1782,648,1425,9,47,279,1791,8,171,97,189,179,286,1292,2140,4,9462,525,0,2,2,2,0
21141,23,577,102,59,69,5,3,24,107,6,22,15,28,28,43,113,206,3,789,43,0,2,10,9,0
21142,156,4416,1660,832,1314,41,38,274,1701,20,312,209,395,332,604,2671,5058,12,64042,3557,1,2,3,2,0
21143,73,3804,1296,573,1062,40,33,157,1336,8,201,118,231,209,349,1561,2689,4,12365,686,0,2,10,9,0
21144,82,4295,1457,730,1242,11,6,188,1468,10,292,166,329,302,495,2424,4078,5,22973,1276,1,2,5,5,0
21145,39,2324,652,304,544,16,6,88,668,6,89,51,101,95,152,591,998,3,3399,188,0,2,3,3,0
21146,38,2301,334,251,279,10,4,40,344,5,127,74,143,132,217,899,1528,2,4303,239,0,2,2,1,0
21147,33,1886,384,251,317,7,8,52,391,11,70,44,84,81,128,467,811,6,5355,297,0,2,11,9,0
21148,39,1724,386,256,301,16,9,68,402,4,59,35,69,63,104,355,621,2,1453,80,0,2,14,15,0
21149,75,2952,1043,504,840,53,9,147,1096,9,180,112,198,189,310,1377,2344,4,11604,644,0,2,10,8,0
21150,82,4108,1943,715,1694,26,18,214,1969,12,185,120,237,197,357,1436,2721,7,20915,1161,0,2,3,3,0
21151,51,595,647,139,84,35,284,233,682,0,0,0,0,0,0,0,0,0,0,0,0,2,20,2,0
21152,111,2482,1043,504,840,53,9,147,1096,9,180,112,198,189,310,1377,2344,4,11604,644,0,2,3,0,0
21153,111,2482,383,288,292,26,6,62,409,11,65,38,67,76,105,429,656,5,3719,206,0,2,3,0,0
21154,78,3035,1043,504,840,53,9,147,1096,9,180,112,198,189,310,1377,2344,4,11604,644,0,2,12,0,0
21155,50,586,647,139,84,35,284,233,682,0,0,0,0,0,0,0,0,0,0,0,0,2,13,2,0
21156,227,5227,4293,999,3693,19,54,507,4312,9,155,88,170,164,258,1156,1898,4,9368,520,0,2,42,48,1
21157,227,5227,1482,859,1002,125,135,219,1607,16,219,134,251,235,385,1766,3032,9,27804,1544,1,2,42,48,1
21158,230,5249,4293,999,3693,19,54,507,4312,9,155,88,170,164,258,1156,1898,4,9368,520,0,2,12,17,1
21159,230,5249,1482,859,1002,125,135,219,1607,16,219,134,251,235,385,1766,3032,9,27804,1544,1,2,12,17,1
21160,206,4323,1943,715,1694,26,18,214,1969,12,185,120,237,197,357,1436,2721,7,20915,1161,0,2,18,21,1
21161,206,4323,1168,838,957,57,25,144,1225,19,348,224,416,367,640,3018,5452,11,61921,3440,1,2,18,21,1
21162,90,4382,1943,715,1694,26,18,214,1969,12,185,120,237,197,357,1436,2721,7,20915,1161,0,2,81,6,1
21163,207,4339,1943,715,1694,26,18,214,1969,12,185,120,237,197,357,1436,2721,7,20915,1161,0,2,11,2,0
21164,207,4339,1168,838,957,57,25,144,1225,19,348,224,416,367,640,3018,5452,11,61921,3440,1,2,11,2,0
21165,207,4339,1943,715,1694,26,18,214,1969,12,185,120,237,197,357,1436,2721,7,20915,1161,0,2,27,21,0
21166,207,4339,1168,838,957,57,25,144,1225,19,348,224,416,367,640,3018,5452,11,61921,3440,1,2,27,21,0
21167,90,4382,1943,715,1694,26,18,214,1969,12,185,120,237,197,357,1436,2721,7,20915,1161,0,2,81,6,0
21168,34,1617,1293,570,1093,25,15,163,1318,10,195,123,241,205,364,1516,2795,6,17273,959,0,2,1,2,0
21169,103,2142,1020,354,843,12,15,144,1032,8,134,77,144,142,221,970,1580,4,6792,377,0,2,13,1,1
21170,77,3417,1020,354,843,12,15,144,1032,8,134,77,144,142,221,970,1580,4,6792,377,0,2,15,0,1
21171,104,2098,1020,354,843,12,15,144,1032,8,134,77,144,142,221,970,1580,4,6792,377,0,2,5,7,1
21172,104,2104,1020,354,843,12,15,144,1032,8,134,77,144,142,221,970,1580,4,6792,377,0,2,4,2,0
21173,77,3416,1020,354,843,12,15,144,1032,8,134,77,144,142,221,970,1580,4,6792,377,0,2,3,3,0
21174,348,6977,1457,730,1242,11,6,188,1468,10,292,166,329,302,495,2424,4078,5,22973,1276,1,2,2,1,0
21175,348,6977,74,35,59,1,0,14,75,3,14,7,14,17,21,58,85,1,128,7,0,2,2,1,0
21176,348,6977,245,125,200,5,7,34,250,7,30,17,34,37,51,166,265,3,1053,58,0,2,2,1,0
21177,348,6977,1457,730,1242,11,6,188,1468,10,292,166,329,302,495,2424,4078,5,22973,1276,1,2,2,1,0
21178,348,6977,74,35,59,1,0,14,75,3,14,7,14,17,21,58,85,1,128,7,0,2,2,1,0
21179,348,6977,245,125,200,5,7,34,250,7,30,17,34,37,51,166,265,3,1053,58,0,2,2,1,0
21180,104,2104,1020,354,843,12,15,144,1032,8,134,77,144,142,221,970,1580,4,6792,377,0,2,13,1,0
21181,77,3416,1020,354,843,12,15,144,1032,8,134,77,144,142,221,970,1580,4,6792,377,0,2,15,0,0
21182,120,2925,77,34,69,0,0,8,77,3,24,16,29,27,45,114,213,1,387,21,0,2,19,0,1
21183,120,2925,712,438,573,51,9,84,763,14,102,71,128,116,199,733,1364,8,11988,666,0,2,19,0,1
21184,28,1220,373,158,315,8,0,51,381,5,76,44,79,81,123,486,779,2,2026,112,0,2,32,0,1
21185,28,1210,373,158,315,8,0,51,381,5,76,44,79,81,123,486,779,2,2026,112,0,2,0,1,0
21186,48,1310,773,422,505,30,103,129,803,14,77,46,83,91,129,535,839,7,6334,351,0,2,12,0,0
21187,12,489,139,89,101,2,0,35,141,7,54,34,62,61,96,330,569,4,2287,127,0,2,21,0,0
21188,48,1310,773,422,505,30,103,129,803,14,77,46,83,91,129,535,839,7,6334,351,0,2,12,0,0
21189,12,489,139,89,101,2,0,35,141,7,54,34,62,61,96,330,569,4,2287,127,0,2,21,0,0
21190,50,1354,773,422,505,30,103,129,803,14,77,46,83,91,129,535,839,7,6334,351,0,2,28,18,1
21191,24,1115,1157,318,931,29,22,177,1186,6,104,63,125,110,188,712,1274,3,4596,255,0,2,29,0,1
21192,50,1361,773,422,505,30,103,129,803,14,77,46,83,91,129,535,839,7,6334,351,0,2,15,17,1
21193,23,1137,1157,318,931,29,22,177,1186,6,104,63,125,110,188,712,1274,3,4596,255,0,2,20,15,1
21194,51,1412,773,422,505,30,103,129,803,14,77,46,83,91,129,535,839,7,6334,351,0,2,28,12,0
21195,13,565,139,89,101,2,0,35,141,7,54,34,62,61,96,330,569,4,2287,127,0,2,28,0,0
21196,53,1452,773,422,505,30,103,129,803,14,77,46,83,91,129,535,839,7,6334,351,0,2,26,19,1
21197,23,1145,1157,318,931,29,22,177,1186,6,104,63,125,110,188,712,1274,3,4596,255,0,2,18,14,1
21198,53,1452,773,422,505,30,103,129,803,14,77,46,83,91,129,535,839,7,6334,351,0,2,1,0,0
21199,23,1101,1157,318,931,29,22,177,1186,6,104,63,125,110,188,712,1274,3,4596,255,0,2,5,19,0
21200,57,1539,773,422,505,30,103,129,803,14,77,46,83,91,129,535,839,7,6334,351,0,2,23,1,0
21201,23,1108,1157,318,931,29,22,177,1186,6,104,63,125,110,188,712,1274,3,4596,255,0,2,6,1,0
21202,57,1539,773,422,505,30,103,129,803,14,77,46,83,91,129,535,839,7,6334,351,0,2,11,24,0
21203,17,1072,1157,318,931,29,22,177,1186,6,104,63,125,110,188,712,1274,3,4596,255,0,2,3,18,0
21204,63,1639,773,422,505,30,103,129,803,14,77,46,83,91,129,535,839,7,6334,351,0,2,32,8,1
21205,24,1310,1157,318,931,29,22,177,1186,6,104,63,125,110,188,712,1274,3,4596,255,0,2,85,0,1
21206,23,1297,1157,318,931,29,22,177,1186,6,104,63,125,110,188,712,1274,3,4596,255,0,2,2,9,0
21207,13,571,139,89,101,2,0,35,141,7,54,34,62,61,96,330,569,4,2287,127,0,2,1,0,0
21208,63,1639,773,422,505,30,103,129,803,14,77,46,83,91,129,535,839,7,6334,351,0,2,3,1,0
21209,352,7047,1457,730,1242,11,6,188,1468,10,292,166,329,302,495,2424,4078,5,22973,1276,1,2,11,2,1
21210,352,7047,74,35,59,1,0,14,75,3,14,7,14,17,21,58,85,1,128,7,0,2,11,2,1
21211,352,7047,245,125,200,5,7,34,250,7,30,17,34,37,51,166,265,3,1053,58,0,2,11,2,1
21212,117,2821,77,34,69,0,0,8,77,3,24,16,29,27,45,114,213,1,387,21,0,2,1,14,1
21213,117,2821,712,438,573,51,9,84,763,14,102,71,128,116,199,733,1364,8,11988,666,0,2,1,14,1
21214,27,1108,373,158,315,8,0,51,381,5,76,44,79,81,123,486,779,2,2026,112,0,2,0,18,1
21215,50,586,647,139,84,35,284,233,682,0,0,0,0,0,0,0,0,0,0,0,0,2,9,1,0
21216,50,586,647,139,84,35,284,233,682,0,0,0,0,0,0,0,0,0,0,0,0,2,20,1,0
21217,50,586,647,139,84,35,284,233,682,0,0,0,0,0,0,0,0,0,0,0,0,2,20,1,0
21218,50,586,647,139,84,35,284,233,682,0,0,0,0,0,0,0,0,0,0,0,0,2,9,1,0
21219,67,1738,773,422,505,30,103,129,803,14,77,46,83,91,129,535,839,7,6334,351,0,2,17,7,0
21220,25,1443,1157,318,931,29,22,177,1186,6,104,63,125,110,188,712,1274,3,4596,255,0,2,62,8,0
21221,87,2475,1523,757,1297,19,12,193,1542,12,193,117,230,205,347,1508,2664,7,19053,1058,0,2,26,0,1
21222,87,2475,701,378,504,33,58,109,734,13,110,68,126,123,194,794,1346,7,10027,557,0,2,26,0,1
21223,91,4494,1523,757,1297,19,12,193,1542,12,193,117,230,205,347,1508,2664,7,19053,1058,0,2,21,0,1
21224,69,1729,773,422,505,30,103,129,803,14,77,46,83,91,129,535,839,7,6334,351,0,2,12,9,0
21225,25,1433,1157,318,931,29,22,177,1186,6,104,63,125,110,188,712,1274,3,4596,255,0,2,1,4,0
21226,25,1432,1157,318,931,29,22,177,1186,6,104,63,125,110,188,712,1274,3,4596,255,0,2,2,2,0
21227,68,1718,773,422,505,30,103,129,803,14,77,46,83,91,129,535,839,7,6334,351,0,2,1,2,0
21228,25,1432,1157,318,931,29,22,177,1186,6,104,63,125,110,188,712,1274,3,4596,255,0,2,2,2,0
21229,68,1718,773,422,505,30,103,129,803,14,77,46,83,91,129,535,839,7,6334,351,0,2,1,1,0
21230,34,1617,1293,570,1093,25,15,163,1318,10,195,123,241,205,364,1516,2795,6,17273,959,0,2,1,2,0
21231,349,6987,1457,730,1242,11,6,188,1468,10,292,166,329,302,495,2424,4078,5,22973,1276,1,2,4,1,0
21232,349,6987,74,35,59,1,0,14,75,3,14,7,14,17,21,58,85,1,128,7,0,2,4,1,0
21233,349,6987,245,125,200,5,7,34,250,7,30,17,34,37,51,166,265,3,1053,58,0,2,4,1,0
21234,84,4398,1457,730,1242,11,6,188,1468,10,292,166,329,302,495,2424,4078,5,22973,1276,1,2,37,0,0
21235,83,4348,1457,730,1242,11,6,188,1468,10,292,166,329,302,495,2424,4078,5,22973,1276,1,2,8,36,0
21236,83,4374,1457,730,1242,11,6,188,1468,10,292,166,329,302,495,2424,4078,5,22973,1276,1,2,9,4,0
21237,347,6972,1457,730,1242,11,6,188,1468,10,292,166,329,302,495,2424,4078,5,22973,1276,1,2,8,12,1
21238,347,6972,74,35,59,1,0,14,75,3,14,7,14,17,21,58,85,1,128,7,0,2,8,12,1
21239,347,6972,245,125,200,5,7,34,250,7,30,17,34,37,51,166,265,3,1053,58,0,2,8,12,1
21240,27,950,74,35,59,1,0,14,75,3,14,7,14,17,21,58,85,1,128,7,0,2,2,2,1
21241,27,950,245,125,200,5,7,34,250,7,30,17,34,37,51,166,265,3,1053,58,0,2,2,2,1
21242,84,4416,1457,730,1242,11,6,188,1468,10,292,166,329,302,495,2424,4078,5,22973,1276,1,2,36,16,1
21243,11,238,19,8,11,5,0,4,24,2,5,3,6,7,9,13,25,1,30,1,0,2,1,1,1
21244,11,238,102,59,69,5,3,24,107,6,22,15,28,28,43,113,206,3,789,43,0,2,1,1,1
21245,11,238,106,40,36,3,49,17,109,8,17,13,23,25,36,93,167,5,904,50,0,2,1,1,1
21246,26,527,2,2,2,0,0,0,2,0,0,0,0,0,0,0,0,0,0,0,0,2,1,1,1
21247,26,527,99,48,90,1,3,5,100,0,0,0,0,0,0,0,0,0,0,0,0,2,1,1,1
21248,26,527,8,5,5,2,0,1,10,0,0,0,0,0,0,0,0,0,0,0,0,2,1,1,1
21249,26,527,1217,716,841,84,126,174,1301,14,185,118,215,199,333,1446,2542,8,20687,1149,0,2,1,1,1
21250,26,527,160,89,115,0,13,31,160,7,15,11,17,22,28,78,124,3,495,27,0,2,1,1,1
21251,26,527,10,10,9,9,0,0,19,0,0,0,0,0,0,0,0,0,0,0,0,2,1,1,1
21252,26,527,173,84,99,8,29,36,181,5,12,7,13,17,20,54,81,2,221,12,0,2,1,1,1
21253,26,527,3,1,1,3,0,0,6,0,0,0,0,0,0,0,0,0,0,0,0,2,1,1,1
21254,59,1355,996,429,845,24,10,117,1020,7,76,50,88,83,138,494,879,4,3565,198,0,2,1,1,1
21255,59,1355,456,277,329,12,42,72,468,13,85,50,97,98,147,592,972,7,7212,400,0,2,1,1,1
21256,141,2977,1513,682,1277,25,13,200,1538,11,199,116,219,210,335,1557,2584,6,15641,868,0,2,6,6,1
21257,141,2977,819,519,539,24,98,155,843,15,96,57,106,111,163,690,1107,8,9171,509,0,2,6,6,1
21258,348,6992,1457,730,1242,11,6,188,1468,10,292,166,329,302,495,2424,4078,5,22973,1276,1,2,5,5,1
21259,348,6992,74,35,59,1,0,14,75,3,14,7,14,17,21,58,85,1,128,7,0,2,5,5,1
21260,348,6992,245,125,200,5,7,34,250,7,30,17,34,37,51,166,265,3,1053,58,0,2,5,5,1
21261,21,668,339,213,244,17,9,65,356,10,42,26,48,52,74,259,421,5,2410,133,0,2,2,2,1
21262,231,5277,4293,999,3693,19,54,507,4312,9,155,88,170,164,258,1156,1898,4,9368,520,0,2,4,4,1
21263,231,5277,1482,859,1002,125,135,219,1607,16,219,134,251,235,385,1766,3032,9,27804,1544,1,2,4,4,1
21264,117,2804,77,34,69,0,0,8,77,3,24,16,29,27,45,114,213,1,387,21,0,2,1,1,1
21265,117,2804,712,438,573,51,9,84,763,14,102,71,128,116,199,733,1364,8,11988,666,0,2,1,1,1
21266,104,2107,1020,354,843,12,15,144,1032,8,134,77,144,142,221,970,1580,4,6792,377,0,2,1,1,1
21267,46,963,447,308,343,6,5,95,453,7,96,59,111,103,170,651,1136,4,4600,255,0,2,2,2,1
21268,46,963,322,174,179,16,74,51,338,10,41,26,46,51,72,252,408,5,2291,127,0,2,2,2,1
21269,223,5307,722,423,573,19,0,135,741,12,172,101,199,184,300,1320,2257,6,15668,870,0,2,14,14,1
21270,223,5307,1508,847,911,44,250,301,1552,14,148,88,169,162,257,1120,1886,7,15077,837,0,2,14,14,1
21271,111,2485,1043,504,840,53,9,147,1096,9,180,112,198,189,310,1377,2344,4,11604,644,0,2,1,1,1
21272,111,2485,383,288,292,26,6,62,409,11,65,38,67,76,105,429,656,5,3719,206,0,2,1,1,1
21273,207,4345,1943,715,1694,26,18,214,1969,12,185,120,237,197,357,1436,2721,7,20915,1161,0,2,2,2,1
21274,207,4345,1168,838,957,57,25,144,1225,19,348,224,416,367,640,3018,5452,11,61921,3440,1,2,2,2,1
21275,16,480,442,244,305,14,16,103,456,11,68,45,75,79,120,452,756,6,4588,254,0,2,1,1,1
21276,16,480,182,102,99,11,40,35,193,3,11,6,11,14,17,42,64,1,97,5,0,2,1,1,1
21277,90,3848,1289,550,1043,56,32,155,1345,10,167,93,185,177,278,1266,2075,5,11498,638,0,2,1,1,1
21278,97,4426,1338,495,1086,10,64,173,1348,11,122,82,157,133,239,883,1686,7,11934,663,0,2,2,2,1
21279,162,7134,139,89,101,2,0,35,141,7,54,34,62,61,96,330,569,4,2287,127,0,2,1,1,1
21280,162,7134,7,5,5,0,0,2,7,1,2,1,2,3,3,2,4,0,2,0,0,2,1,1,1
21281,135,5792,1782,648,1425,9,47,279,1791,8,171,97,189,179,286,1292,2140,4,9462,525,0,2,1,1,1
21282,128,5159,1513,682,1277,25,13,200,1538,11,199,116,219,210,335,1557,2584,6,15641,868,0,2,1,1,1
21283,45,2208,722,423,573,19,0,135,741,12,172,101,199,184,300,1320,2257,6,15668,870,0,2,5,5,1
21284,90,4388,1943,715,1694,26,18,214,1969,12,185,120,237,197,357,1436,2721,7,20915,1161,0,2,2,2,1
21285,69,1731,773,422,505,30,103,129,803,14,77,46,83,91,129,535,839,7,6334,351,0,2,15,4,0
21286,13,563,139,89,101,2,0,35,141,7,54,34,62,61,96,330,569,4,2287,127,0,2,4,4,0
21287,347,6972,1457,730,1242,11,6,188,1468,10,292,166,329,302,495,2424,4078,5,22973,1276,1,2,8,9,0
21288,347,6972,74,35,59,1,0,14,75,3,14,7,14,17,21,58,85,1,128,7,0,2,8,9,0
21289,347,6972,245,125,200,5,7,34,250,7,30,17,34,37,51,166,265,3,1053,58,0,2,8,9,0
21290,27,950,74,35,59,1,0,14,75,3,14,7,14,17,21,58,85,1,128,7,0,2,2,2,0
21291,27,950,245,125,200,5,7,34,250,7,30,17,34,37,51,166,265,3,1053,58,0,2,2,2,0
21292,84,4416,1457,730,1242,11,6,188,1468,10,292,166,329,302,495,2424,4078,5,22973,1276,1,2,39,5,0
21293,11,238,19,8,11,5,0,4,24,2,5,3,6,7,9,13,25,1,30,1,0,2,1,1,0
21294,11,238,102,59,69,5,3,24,107,6,22,15,28,28,43,113,206,3,789,43,0,2,1,1,0
21295,11,238,106,40,36,3,49,17,109,8,17,13,23,25,36,93,167,5,904,50,0,2,1,1,0
21296,26,527,2,2,2,0,0,0,2,0,0,0,0,0,0,0,0,0,0,0,0,2,1,1,0
21297,26,527,99,48,90,1,3,5,100,0,0,0,0,0,0,0,0,0,0,0,0,2,1,1,0
21298,26,527,8,5,5,2,0,1,10,0,0,0,0,0,0,0,0,0,0,0,0,2,1,1,0
21299,26,527,1217,716,841,84,126,174,1301,14,185,118,215,199,333,1446,2542,8,20687,1149,0,2,1,1,0
21300,26,527,160,89,115,0,13,31,160,7,15,11,17,22,28,78,124,3,495,27,0,2,1,1,0
21301,26,527,10,10,9,9,0,0,19,0,0,0,0,0,0,0,0,0,0,0,0,2,1,1,0
21302,26,527,173,84,99,8,29,36,181,5,12,7,13,17,20,54,81,2,221,12,0,2,1,1,0
21303,26,527,3,1,1,3,0,0,6,0,0,0,0,0,0,0,0,0,0,0,0,2,1,1,0
21304,59,1355,996,429,845,24,10,117,1020,7,76,50,88,83,138,494,879,4,3565,198,0,2,1,1,0
21305,59,1355,456,277,329,12,42,72,468,13,85,50,97,98,147,592,972,7,7212,400,0,2,1,1,0
21306,141,2977,1513,682,1277,25,13,200,1538,11,199,116,219,210,335,1557,2584,6,15641,868,0,2,6,6,0
21307,141,2977,819,519,539,24,98,155,843,15,96,57,106,111,163,690,1107,8,9171,509,0,2,6,6,0
21308,347,6987,1457,730,1242,11,6,188,1468,10,292,166,329,302,495,2424,4078,5,22973,1276,1,2,5,5,0
21309,347,6987,74,35,59,1,0,14,75,3,14,7,14,17,21,58,85,1,128,7,0,2,5,5,0
21310,347,6987,245,125,200,5,7,34,250,7,30,17,34,37,51,166,265,3,1053,58,0,2,5,5,0
21311,21,668,339,213,244,17,9,65,356,10,42,26,48,52,74,259,421,5,2410,133,0,2,2,2,0
21312,231,5277,4293,999,3693,19,54,507,4312,9,155,88,170,164,258,1156,1898,4,9368,520,0,2,4,4,0
21313,231,5277,1482,859,1002,125,135,219,1607,16,219,134,251,235,385,1766,3032,9,27804,1544,1,2,4,4,0
21314,117,2804,77,34,69,0,0,8,77,3,24,16,29,27,45,114,213,1,387,21,0,2,1,1,0
21315,117,2804,712,438,573,51,9,84,763,14,102,71,128,116,199,733,1364,8,11988,666,0,2,1,1,0
21316,104,2107,1020,354,843,12,15,144,1032,8,134,77,144,142,221,970,1580,4,6792,377,0,2,1,1,0
21317,46,963,447,308,343,6,5,95,453,7,96,59,111,103,170,651,1136,4,4600,255,0,2,2,2,0
21318,46,963,322,174,179,16,74,51,338,10,41,26,46,51,72,252,408,5,2291,127,0,2,2,2,0
21319,223,5307,722,423,573,19,0,135,741,12,172,101,199,184,300,1320,2257,6,15668,870,0,2,14,14,0
21320,223,5307,1508,847,911,44,250,301,1552,14,148,88,169,162,257,1120,1886,7,15077,837,0,2,14,14,0
21321,111,2485,1043,504,840,53,9,147,1096,9,180,112,198,189,310,1377,2344,4,11604,644,0,2,1,1,0
21322,111,2485,383,288,292,26,6,62,409,11,65,38,67,76,105,429,656,5,3719,206,0,2,1,1,0
21323,207,4345,1943,715,1694,26,18,214,1969,12,185,120,237,197,357,1436,2721,7,20915,1161,0,2,2,2,0
21324,207,4345,1168,838,957,57,25,144,1225,19,348,224,416,367,640,3018,5452,11,61921,3440,1,2,2,2,0
21325,16,480,442,244,305,14,16,103,456,11,68,45,75,79,120,452,756,6,4588,254,0,2,1,1,0
21326,16,480,182,102,99,11,40,35,193,3,11,6,11,14,17,42,64,1,97,5,0,2,1,1,0
21327,90,3848,1289,550,1043,56,32,155,1345,10,167,93,185,177,278,1266,2075,5,11498,638,0,2,1,1,0
21328,97,4426,1338,495,1086,10,64,173,1348,11,122,82,157,133,239,883,1686,7,11934,663,0,2,2,2,0
21329,162,7134,139,89,101,2,0,35,141,7,54,34,62,61,96,330,569,4,2287,127,0,2,1,1,0
21330,162,7134,7,5,5,0,0,2,7,1,2,1,2,3,3,2,4,0,2,0,0,2,1,1,0
21331,135,5792,1782,648,1425,9,47,279,1791,8,171,97,189,179,286,1292,2140,4,9462,525,0,2,1,1,0
21332,128,5159,1513,682,1277,25,13,200,1538,11,199,116,219,210,335,1557,2584,6,15641,868,0,2,1,1,0
21333,45,2208,722,423,573,19,0,135,741,12,172,101,199,184,300,1320,2257,6,15668,870,0,2,5,5,0
21334,90,4388,1943,715,1694,26,18,214,1969,12,185,120,237,197,357,1436,2721,7,20915,1161,0,2,2,2,0
21335,28,1141,373,158,315,8,0,51,381,5,76,44,79,81,123,486,779,2,2026,112,0,2,16,4,1
21336,352,7034,1457,730,1242,11,6,188,1468,10,292,166,329,302,495,2424,4078,5,22973,1276,1,2,0,1,0
21337,352,7034,74,35,59,1,0,14,75,3,14,7,14,17,21,58,85,1,128,7,0,2,0,1,0
21338,352,7034,245,125,200,5,7,34,250,7,30,17,34,37,51,166,265,3,1053,58,0,2,0,1,0
21339,59,1355,996,429,845,24,10,117,1020,7,76,50,88,83,138,494,879,4,3565,198,0,2,3,2,0
21340,59,1355,456,277,329,12,42,72,468,13,85,50,97,98,147,592,972,7,7212,400,0,2,3,2,0
21341,22,666,339,213,244,17,9,65,356,10,42,26,48,52,74,259,421,5,2410,133,0,2,11,7,0
21342,105,2128,1020,354,843,12,15,144,1032,8,134,77,144,142,221,970,1580,4,6792,377,0,2,10,5,1
21343,259,6118,72,33,56,0,4,12,72,1,1,1,1,2,2,0,2,0,1,0,0,2,1,1,1
21344,259,6118,1454,835,1044,76,110,219,1530,17,275,158,296,292,454,2297,3718,9,34017,1889,1,2,1,1,1
21345,108,2217,1020,354,843,12,15,144,1032,8,134,77,144,142,221,970,1580,4,6792,377,0,2,19,2,0
21346,82,3538,1020,354,843,12,15,144,1032,8,134,77,144,142,221,970,1580,4,6792,377,0,2,23,0,0
21347,138,5836,1782,648,1425,9,47,279,1791,8,171,97,189,179,286,1292,2140,4,9462,525,0,2,15,3,1
21348,82,3550,1020,354,843,12,15,144,1032,8,134,77,144,142,221,970,1580,4,6792,377,0,2,1,1,0
21349,69,1731,773,422,505,30,103,129,803,14,77,46,83,91,129,535,839,7,6334,351,0,2,154,64,0
21350,13,563,139,89,101,2,0,35,141,7,54,34,62,61,96,330,569,4,2287,127,0,2,33,4,0
21351,25,1432,1157,318,931,29,22,177,1186,6,104,63,125,110,188,712,1274,3,4596,255,0,2,193,50,0
21352,108,2217,1020,354,843,12,15,144,1032,8,134,77,144,142,221,970,1580,4,6792,377,0,2,2,2,0
21353,108,2217,1020,354,843,12,15,144,1032,8,134,77,144,142,221,970,1580,4,6792,377,0,2,1,1,0
21354,82,3556,1020,354,843,12,15,144,1032,8,134,77,144,142,221,970,1580,4,6792,377,0,2,3,3,0
21355,108,2218,1020,354,843,12,15,144,1032,8,134,77,144,142,221,970,1580,4,6792,377,0,2,7,6,0
21356,82,3566,1020,354,843,12,15,144,1032,8,134,77,144,142,221,970,1580,4,6792,377,0,2,6,2,0
21357,59,1355,996,429,845,24,10,117,1020,7,76,50,88,83,138,494,879,4,3565,198,0,2,3,2,0
21358,59,1355,456,277,329,12,42,72,468,13,85,50,97,98,147,592,972,7,7212,400,0,2,3,2,0
21359,108,2218,1020,354,843,12,15,144,1032,8,134,77,144,142,221,970,1580,4,6792,377,0,2,28,5,0
21360,259,6118,72,33,56,0,4,12,72,1,1,1,1,2,2,0,2,0,1,0,0,2,1,1,0
21361,259,6118,1454,835,1044,76,110,219,1530,17,275,158,296,292,454,2297,3718,9,34017,1889,1,2,1,1,0
21362,138,5836,1782,648,1425,9,47,279,1791,8,171,97,189,179,286,1292,2140,4,9462,525,0,2,15,3,0
21363,82,3566,1020,354,843,12,15,144,1032,8,134,77,144,142,221,970,1580,4,6792,377,0,2,28,1,0
21364,214,4584,182,127,129,0,0,53,182,5,39,21,42,44,63,217,343,2,926,51,0,2,6,4,0
21365,214,4584,1165,710,800,67,119,181,1232,18,243,153,282,261,435,2000,3492,10,36473,2026,1,2,6,4,0
21366,100,2037,773,419,590,28,0,166,801,10,204,113,217,214,330,1598,2554,5,13587,754,0,2,4,4,0
21367,100,2037,421,273,302,44,34,57,465,17,81,59,107,98,166,583,1098,11,12329,684,0,2,4,4,0
21368,51,595,647,139,84,35,284,233,682,0,0,0,0,0,0,0,0,0,0,0,0,2,42,4,0
21369,60,1084,282,196,195,3,0,86,285,8,130,71,141,138,212,936,1507,4,6538,363,0,2,2,2,0
21370,17,384,85,59,61,8,0,16,93,5,18,10,18,23,28,86,126,2,316,17,0,2,0,1,0
21371,90,3826,1289,550,1043,56,32,155,1345,10,167,93,185,177,278,1266,2075,5,11498,638,0,2,7,6,0
21372,147,6905,1392,870,1177,35,17,170,1427,14,494,280,531,508,811,4473,7289,7,54850,3047,2,2,10,8,0
21373,87,2871,773,419,590,28,0,166,801,10,204,113,217,214,330,1598,2554,5,13587,754,0,2,4,4,0
21374,97,4416,1338,495,1086,10,64,173,1348,11,122,82,157,133,239,883,1686,7,11934,663,0,2,2,3,0
21375,138,5836,1782,648,1425,9,47,279,1791,8,171,97,189,179,286,1292,2140,4,9462,525,0,2,2,2,0
21376,23,577,102,59,69,5,3,24,107,6,22,15,28,28,43,113,206,3,789,43,0,2,10,9,0
21377,156,4416,1660,832,1314,41,38,274,1701,20,312,209,395,332,604,2671,5058,12,64042,3557,1,2,3,2,0
21378,73,3804,1296,573,1062,40,33,157,1336,8,201,118,231,209,349,1561,2689,4,12365,686,0,2,10,9,0
21379,84,4400,1457,730,1242,11,6,188,1468,10,292,166,329,302,495,2424,4078,5,22973,1276,1,2,5,5,0
21380,39,2324,652,304,544,16,6,88,668,6,89,51,101,95,152,591,998,3,3399,188,0,2,3,3,0
21381,38,2301,334,251,279,10,4,40,344,5,127,74,143,132,217,899,1528,2,4303,239,0,2,2,1,0
21382,34,1617,1293,570,1093,25,15,163,1318,10,195,123,241,205,364,1516,2795,6,17273,959,0,2,1,2,0
21383,33,1886,384,251,317,7,8,52,391,11,70,44,84,81,128,467,811,6,5355,297,0,2,11,9,0
21384,39,1724,386,256,301,16,9,68,402,4,59,35,69,63,104,355,621,2,1453,80,0,2,14,15,0
21385,78,3015,1043,504,840,53,9,147,1096,9,180,112,198,189,310,1377,2344,4,11604,644,0,2,10,8,0
21386,90,4376,1943,715,1694,26,18,214,1969,12,185,120,237,197,357,1436,2721,7,20915,1161,0,2,3,3,0
21387,230,5261,4293,999,3693,19,54,507,4312,9,155,88,170,164,258,1156,1898,4,9368,520,0,2,36,47,0
21388,230,5261,1482,859,1002,125,135,219,1607,16,219,134,251,235,385,1766,3032,9,27804,1544,1,2,36,47,0
21389,59,1355,996,429,845,24,10,117,1020,7,76,50,88,83,138,494,879,4,3565,198,0,2,5,5,0
21390,59,1355,456,277,329,12,42,72,468,13,85,50,97,98,147,592,972,7,7212,400,0,2,5,5,0
21391,59,1355,996,429,845,24,10,117,1020,7,76,50,88,83,138,494,879,4,3565,198,0,2,5,5,0
21392,59,1355,456,277,329,12,42,72,468,13,85,50,97,98,147,592,972,7,7212,400,0,2,5,5,0
21393,87,2475,1523,757,1297,19,12,193,1542,12,193,117,230,205,347,1508,2664,7,19053,1058,0,2,26,0,0
21394,87,2475,701,378,504,33,58,109,734,13,110,68,126,123,194,794,1346,7,10027,557,0,2,26,0,0
21395,91,4494,1523,757,1297,19,12,193,1542,12,193,117,230,205,347,1508,2664,7,19053,1058,0,2,21,0,0
21396,78,2063,773,422,505,30,103,129,803,14,77,46,83,91,129,535,839,7,6334,351,0,2,59,1,0
21397,1,135,149,67,118,4,0,27,153,1,17,14,28,18,42,69,175,0,144,8,0,0,29,0,0
21398,78,2063,773,422,505,30,103,129,803,14,77,46,83,91,129,535,839,7,6334,351,0,2,59,1,0
21399,1,135,149,67,118,4,0,27,153,1,17,14,28,18,42,69,175,0,144,8,0,0,29,0,0
21400,60,1088,282,196,195,3,0,86,285,8,130,71,141,138,212,936,1507,4,6538,363,0,2,2,0,0
21401,60,1088,282,196,195,3,0,86,285,8,130,71,141,138,212,936,1507,4,6538,363,0,2,2,0,0
21402,100,2042,1020,354,843,12,15,144,1032,8,134,77,144,142,221,970,1580,4,6792,377,0,2,1,1,0
21403,258,6111,72,33,56,0,4,12,72,1,1,1,1,2,2,0,2,0,1,0,0,2,2,2,0
21404,258,6111,1454,835,1044,76,110,219,1530,17,275,158,296,292,454,2297,3718,9,34017,1889,1,2,2,2,0
21405,11,238,19,8,11,5,0,4,24,2,5,3,6,7,9,13,25,1,30,1,0,2,1,1,0
21406,11,238,102,59,69,5,3,24,107,6,22,15,28,28,43,113,206,3,789,43,0,2,1,1,0
21407,11,238,106,40,36,3,49,17,109,8,17,13,23,25,36,93,167,5,904,50,0,2,1,1,0
21408,26,527,2,2,2,0,0,0,2,0,0,0,0,0,0,0,0,0,0,0,0,2,1,1,0
21409,26,527,99,48,90,1,3,5,100,0,0,0,0,0,0,0,0,0,0,0,0,2,1,1,0
21410,26,527,8,5,5,2,0,1,10,0,0,0,0,0,0,0,0,0,0,0,0,2,1,1,0
21411,26,527,1217,716,841,84,126,174,1301,14,185,118,215,199,333,1446,2542,8,20687,1149,0,2,1,1,0
21412,26,527,160,89,115,0,13,31,160,7,15,11,17,22,28,78,124,3,495,27,0,2,1,1,0
21413,26,527,10,10,9,9,0,0,19,0,0,0,0,0,0,0,0,0,0,0,0,2,1,1,0
21414,26,527,173,84,99,8,29,36,181,5,12,7,13,17,20,54,81,2,221,12,0,2,1,1,0
21415,26,527,3,1,1,3,0,0,6,0,0,0,0,0,0,0,0,0,0,0,0,2,1,1,0
21416,59,1355,996,429,845,24,10,117,1020,7,76,50,88,83,138,494,879,4,3565,198,0,2,8,7,0
21417,59,1355,456,277,329,12,42,72,468,13,85,50,97,98,147,592,972,7,7212,400,0,2,8,7,0
21418,141,2977,1513,682,1277,25,13,200,1538,11,199,116,219,210,335,1557,2584,6,15641,868,0,2,6,6,0
21419,141,2977,819,519,539,24,98,155,843,15,96,57,106,111,163,690,1107,8,9171,509,0,2,6,6,0
21420,347,6987,1457,730,1242,11,6,188,1468,10,292,166,329,302,495,2424,4078,5,22973,1276,1,2,15,15,0
21421,347,6987,74,35,59,1,0,14,75,3,14,7,14,17,21,58,85,1,128,7,0,2,15,15,0
21422,347,6987,245,125,200,5,7,34,250,7,30,17,34,37,51,166,265,3,1053,58,0,2,15,15,0
21423,21,668,339,213,244,17,9,65,356,10,42,26,48,52,74,259,421,5,2410,133,0,2,2,2,0
21424,230,5261,4293,999,3693,19,54,507,4312,9,155,88,170,164,258,1156,1898,4,9368,520,0,2,42,52,0
21425,230,5261,1482,859,1002,125,135,219,1607,16,219,134,251,235,385,1766,3032,9,27804,1544,1,2,42,52,0
21426,27,950,74,35,59,1,0,14,75,3,14,7,14,17,21,58,85,1,128,7,0,2,2,2,0
21427,27,950,245,125,200,5,7,34,250,7,30,17,34,37,51,166,265,3,1053,58,0,2,2,2,0
21428,51,595,647,139,84,35,284,233,682,0,0,0,0,0,0,0,0,0,0,0,0,2,21,3,0
21429,87,2475,1523,757,1297,19,12,193,1542,12,193,117,230,205,347,1508,2664,7,19053,1058,0,2,26,0,0
21430,87,2475,701,378,504,33,58,109,734,13,110,68,126,123,194,794,1346,7,10027,557,0,2,26,0,0
21431,78,2063,773,422,505,30,103,129,803,14,77,46,83,91,129,535,839,7,6334,351,0,2,220,60,0
21432,117,2804,77,34,69,0,0,8,77,3,24,16,29,27,45,114,213,1,387,21,0,2,9,363,0
21433,117,2804,712,438,573,51,9,84,763,14,102,71,128,116,199,733,1364,8,11988,666,0,2,9,363,0
21434,108,2218,1020,354,843,12,15,144,1032,8,134,77,144,142,221,970,1580,4,6792,377,0,2,41,6,0
21435,46,963,447,308,343,6,5,95,453,7,96,59,111,103,170,651,1136,4,4600,255,0,2,2,2,0
21436,46,963,322,174,179,16,74,51,338,10,41,26,46,51,72,252,408,5,2291,127,0,2,2,2,0
21437,79,1686,53,23,39,0,0,13,53,2,8,4,8,10,12,26,39,1,39,2,0,2,363,0,0
21438,79,1686,515,298,307,33,80,99,548,12,63,44,77,75,121,419,753,7,5527,307,0,2,363,0,0
21439,223,5307,722,423,573,19,0,135,741,12,172,101,199,184,300,1320,2257,6,15668,870,0,2,106,68,0
21440,223,5307,1508,847,911,44,250,301,1552,14,148,88,169,162,257,1120,1886,7,15077,837,0,2,106,68,0
21441,259,6118,72,33,56,0,4,12,72,1,1,1,1,2,2,0,2,0,1,0,0,2,6,5,0
21442,259,6118,1454,835,1044,76,110,219,1530,17,275,158,296,292,454,2297,3718,9,34017,1889,1,2,6,5,0
21443,111,2485,1043,504,840,53,9,147,1096,9,180,112,198,189,310,1377,2344,4,11604,644,0,2,4,1,0
21444,111,2485,383,288,292,26,6,62,409,11,65,38,67,76,105,429,656,5,3719,206,0,2,4,1,0
21445,207,4345,1943,715,1694,26,18,214,1969,12,185,120,237,197,357,1436,2721,7,20915,1161,0,2,29,22,0
21446,207,4345,1168,838,957,57,25,144,1225,19,348,224,416,367,640,3018,5452,11,61921,3440,1,2,29,22,0
21447,16,480,442,244,305,14,16,103,456,11,68,45,75,79,120,452,756,6,4588,254,0,2,1,1,0
21448,16,480,182,102,99,11,40,35,193,3,11,6,11,14,17,42,64,1,97,5,0,2,1,1,0
21449,60,1088,282,196,195,3,0,86,285,8,130,71,141,138,212,936,1507,4,6538,363,0,2,2,0,0
21450,90,3826,1289,550,1043,56,32,155,1345,10,167,93,185,177,278,1266,2075,5,11498,638,0,2,4,4,0
21451,11,423,75,38,59,1,3,12,76,2,4,2,4,6,6,10,15,1,15,0,0,2,0,1,0
21452,13,563,139,89,101,2,0,35,141,7,54,34,62,61,96,330,569,4,2287,127,0,2,50,0,0
21453,1,135,149,67,118,4,0,27,153,1,17,14,28,18,42,69,175,0,144,8,0,0,29,0,0
21454,25,1432,1157,318,931,29,22,177,1186,6,104,63,125,110,188,712,1274,3,4596,255,0,2,193,50,0
21455,97,4416,1338,495,1086,10,64,173,1348,11,122,82,157,133,239,883,1686,7,11934,663,0,2,4,7,0
21456,162,7134,139,89,101,2,0,35,141,7,54,34,62,61,96,330,569,4,2287,127,0,2,1,1,0
21457,162,7134,7,5,5,0,0,2,7,1,2,1,2,3,3,2,4,0,2,0,0,2,1,1,0
21458,138,5836,1782,648,1425,9,47,279,1791,8,171,97,189,179,286,1292,2140,4,9462,525,0,2,34,3,0
21459,32,2401,996,429,845,24,10,117,1020,7,76,50,88,83,138,494,879,4,3565,198,0,3,9,9,0
21460,128,5159,1513,682,1277,25,13,200,1538,11,199,116,219,210,335,1557,2584,6,15641,868,0,2,1,1,0
21461,84,4400,1457,730,1242,11,6,188,1468,10,292,166,329,302,495,2424,4078,5,22973,1276,1,2,39,5,0
21462,91,4494,1523,757,1297,19,12,193,1542,12,193,117,230,205,347,1508,2664,7,19053,1058,0,2,21,0,0
21463,82,3566,1020,354,843,12,15,144,1032,8,134,77,144,142,221,970,1580,4,6792,377,0,2,43,1,0
21464,45,2208,722,423,573,19,0,135,741,12,172,101,199,184,300,1320,2257,6,15668,870,0,2,238,9,0
21465,16,1209,215,129,180,6,0,29,221,8,65,43,72,73,115,415,711,4,3153,175,0,2,1,1,0
21466,78,3015,1043,504,840,53,9,147,1096,9,180,112,198,189,310,1377,2344,4,11604,644,0,2,12,0,0
21467,90,4376,1943,715,1694,26,18,214,1969,12,185,120,237,197,357,1436,2721,7,20915,1161,0,2,89,6,0
21468,39,1724,386,256,301,16,9,68,402,4,59,35,69,63,104,355,621,2,1453,80,0,2,2,2,0
21469,108,2218,1020,354,843,12,15,144,1032,8,134,77,144,142,221,970,1580,4,6792,377,0,2,1,1,0
21470,259,6118,72,33,56,0,4,12,72,1,1,1,1,2,2,0,2,0,1,0,0,2,2,1,0
21471,259,6118,1454,835,1044,76,110,219,1530,17,275,158,296,292,454,2297,3718,9,34017,1889,1,2,2,1,0
21472,209,4372,1943,715,1694,26,18,214,1969,12,185,120,237,197,357,1436,2721,7,20915,1161,0,2,5,0,1
21473,209,4372,1168,838,957,57,25,144,1225,19,348,224,416,367,640,3018,5452,11,61921,3440,1,2,5,0,1
21474,91,4435,1943,715,1694,26,18,214,1969,12,185,120,237,197,357,1436,2721,7,20915,1161,0,2,13,0,1
21475,351,7022,1457,730,1242,11,6,188,1468,10,292,166,329,302,495,2424,4078,5,22973,1276,1,2,0,2,0
21476,351,7022,74,35,59,1,0,14,75,3,14,7,14,17,21,58,85,1,128,7,0,2,0,2,0
21477,351,7022,245,125,200,5,7,34,250,7,30,17,34,37,51,166,265,3,1053,58,0,2,0,2,0
21478,30,1214,373,158,315,8,0,51,381,5,76,44,79,81,123,486,779,2,2026,112,0,2,14,7,0
21479,11,238,19,8,11,5,0,4,24,2,5,3,6,7,9,13,25,1,30,1,0,2,1,1,0
21480,11,238,102,59,69,5,3,24,107,6,22,15,28,28,43,113,206,3,789,43,0,2,1,1,0
21481,11,238,106,40,36,3,49,17,109,8,17,13,23,25,36,93,167,5,904,50,0,2,1,1,0
21482,214,4584,182,127,129,0,0,53,182,5,39,21,42,44,63,217,343,2,926,51,0,2,6,4,0
21483,214,4584,1165,710,800,67,119,181,1232,18,243,153,282,261,435,2000,3492,10,36473,2026,1,2,6,4,0
21484,100,2037,773,419,590,28,0,166,801,10,204,113,217,214,330,1598,2554,5,13587,754,0,2,4,4,0
21485,100,2037,421,273,302,44,34,57,465,17,81,59,107,98,166,583,1098,11,12329,684,0,2,4,4,0
21486,26,527,2,2,2,0,0,0,2,0,0,0,0,0,0,0,0,0,0,0,0,2,1,1,0
21487,26,527,99,48,90,1,3,5,100,0,0,0,0,0,0,0,0,0,0,0,0,2,1,1,0
21488,26,527,8,5,5,2,0,1,10,0,0,0,0,0,0,0,0,0,0,0,0,2,1,1,0
21489,26,527,1217,716,841,84,126,174,1301,14,185,118,215,199,333,1446,2542,8,20687,1149,0,2,1,1,0
21490,26,527,160,89,115,0,13,31,160,7,15,11,17,22,28,78,124,3,495,27,0,2,1,1,0
21491,26,527,10,10,9,9,0,0,19,0,0,0,0,0,0,0,0,0,0,0,0,2,1,1,0
21492,26,527,173,84,99,8,29,36,181,5,12,7,13,17,20,54,81,2,221,12,0,2,1,1,0
21493,26,527,3,1,1,3,0,0,6,0,0,0,0,0,0,0,0,0,0,0,0,2,1,1,0
21494,59,1355,996,429,845,24,10,117,1020,7,76,50,88,83,138,494,879,4,3565,198,0,2,8,7,0
21495,59,1355,456,277,329,12,42,72,468,13,85,50,97,98,147,592,972,7,7212,400,0,2,8,7,0
21496,141,2977,1513,682,1277,25,13,200,1538,11,199,116,219,210,335,1557,2584,6,15641,868,0,2,6,6,0
21497,141,2977,819,519,539,24,98,155,843,15,96,57,106,111,163,690,1107,8,9171,509,0,2,6,6,0
21498,350,7046,1457,730,1242,11,6,188,1468,10,292,166,329,302,495,2424,4078,5,22973,1276,1,2,15,15,0
21499,350,7046,74,35,59,1,0,14,75,3,14,7,14,17,21,58,85,1,128,7,0,2,15,15,0
21500,350,7046,245,125,200,5,7,34,250,7,30,17,34,37,51,166,265,3,1053,58,0,2,15,15,0
21501,21,668,339,213,244,17,9,65,356,10,42,26,48,52,74,259,421,5,2410,133,0,2,2,2,0
21502,230,5261,4293,999,3693,19,54,507,4312,9,155,88,170,164,258,1156,1898,4,9368,520,0,2,40,51,0
21503,230,5261,1482,859,1002,125,135,219,1607,16,219,134,251,235,385,1766,3032,9,27804,1544,1,2,40,51,0
21504,27,950,74,35,59,1,0,14,75,3,14,7,14,17,21,58,85,1,128,7,0,2,2,2,0
21505,27,950,245,125,200,5,7,34,250,7,30,17,34,37,51,166,265,3,1053,58,0,2,2,2,0
21506,51,595,647,139,84,35,284,233,682,0,0,0,0,0,0,0,0,0,0,0,0,2,42,4,0
21507,87,2475,1523,757,1297,19,12,193,1542,12,193,117,230,205,347,1508,2664,7,19053,1058,0,2,26,0,0
21508,87,2475,701,378,504,33,58,109,734,13,110,68,126,123,194,794,1346,7,10027,557,0,2,26,0,0
21509,78,2063,773,422,505,30,103,129,803,14,77,46,83,91,129,535,839,7,6334,351,0,2,220,60,0
21510,117,2824,77,34,69,0,0,8,77,3,24,16,29,27,45,114,213,1,387,21,0,2,1,1,0
21511,117,2824,712,438,573,51,9,84,763,14,102,71,128,116,199,733,1364,8,11988,666,0,2,1,1,0
21512,108,2218,1020,354,843,12,15,144,1032,8,134,77,144,142,221,970,1580,4,6792,377,0,2,42,7,0
21513,46,963,447,308,343,6,5,95,453,7,96,59,111,103,170,651,1136,4,4600,255,0,2,2,2,0
21514,46,963,322,174,179,16,74,51,338,10,41,26,46,51,72,252,408,5,2291,127,0,2,2,2,0
21515,223,5307,722,423,573,19,0,135,741,12,172,101,199,184,300,1320,2257,6,15668,870,0,2,14,14,0
21516,223,5307,1508,847,911,44,250,301,1552,14,148,88,169,162,257,1120,1886,7,15077,837,0,2,14,14,0
21517,259,6118,72,33,56,0,4,12,72,1,1,1,1,2,2,0,2,0,1,0,0,2,1,1,0
21518,259,6118,1454,835,1044,76,110,219,1530,17,275,158,296,292,454,2297,3718,9,34017,1889,1,2,1,1,0
21519,111,2485,1043,504,840,53,9,147,1096,9,180,112,198,189,310,1377,2344,4,11604,644,0,2,1,1,0
21520,111,2485,383,288,292,26,6,62,409,11,65,38,67,76,105,429,656,5,3719,206,0,2,1,1,0
21521,207,4345,1943,715,1694,26,18,214,1969,12,185,120,237,197,357,1436,2721,7,20915,1161,0,2,2,2,0
21522,207,4345,1168,838,957,57,25,144,1225,19,348,224,416,367,640,3018,5452,11,61921,3440,1,2,2,2,0
21523,16,480,442,244,305,14,16,103,456,11,68,45,75,79,120,452,756,6,4588,254,0,2,1,1,0
21524,16,480,182,102,99,11,40,35,193,3,11,6,11,14,17,42,64,1,97,5,0,2,1,1,0
21525,60,1088,282,196,195,3,0,86,285,8,130,71,141,138,212,936,1507,4,6538,363,0,2,4,2,0
21526,17,384,85,59,61,8,0,16,93,5,18,10,18,23,28,86,126,2,316,17,0,2,0,1,0
21527,90,3826,1289,550,1043,56,32,155,1345,10,167,93,185,177,278,1266,2075,5,11498,638,0,2,8,7,0
21528,147,6905,1392,870,1177,35,17,170,1427,14,494,280,531,508,811,4473,7289,7,54850,3047,2,2,10,8,0
21529,87,2871,773,419,590,28,0,166,801,10,204,113,217,214,330,1598,2554,5,13587,754,0,2,4,4,0
21530,13,563,139,89,101,2,0,35,141,7,54,34,62,61,96,330,569,4,2287,127,0,2,50,0,0
21531,1,135,149,67,118,4,0,27,153,1,17,14,28,18,42,69,175,0,144,8,0,0,29,0,0
21532,25,1432,1157,318,931,29,22,177,1186,6,104,63,125,110,188,712,1274,3,4596,255,0,2,193,50,0
21533,97,4416,1338,495,1086,10,64,173,1348,11,122,82,157,133,239,883,1686,7,11934,663,0,2,4,5,0
21534,162,7134,139,89,101,2,0,35,141,7,54,34,62,61,96,330,569,4,2287,127,0,2,1,1,0
21535,162,7134,7,5,5,0,0,2,7,1,2,1,2,3,3,2,4,0,2,0,0,2,1,1,0
21536,138,5836,1782,648,1425,9,47,279,1791,8,171,97,189,179,286,1292,2140,4,9462,525,0,2,18,6,0
21537,23,577,102,59,69,5,3,24,107,6,22,15,28,28,43,113,206,3,789,43,0,2,10,9,0
21538,156,4416,1660,832,1314,41,38,274,1701,20,312,209,395,332,604,2671,5058,12,64042,3557,1,2,3,2,0
21539,32,2401,996,429,845,24,10,117,1020,7,76,50,88,83,138,494,879,4,3565,198,0,3,15,15,0
21540,128,5159,1513,682,1277,25,13,200,1538,11,199,116,219,210,335,1557,2584,6,15641,868,0,2,1,1,0
21541,73,3804,1296,573,1062,40,33,157,1336,8,201,118,231,209,349,1561,2689,4,12365,686,0,2,10,9,0
21542,84,4400,1457,730,1242,11,6,188,1468,10,292,166,329,302,495,2424,4078,5,22973,1276,1,2,44,10,0
21543,39,2324,652,304,544,16,6,88,668,6,89,51,101,95,152,591,998,3,3399,188,0,2,3,3,0
21544,91,4494,1523,757,1297,19,12,193,1542,12,193,117,230,205,347,1508,2664,7,19053,1058,0,2,21,0,0
21545,82,3566,1020,354,843,12,15,144,1032,8,134,77,144,142,221,970,1580,4,6792,377,0,2,43,1,0
21546,38,2301,334,251,279,10,4,40,344,5,127,74,143,132,217,899,1528,2,4303,239,0,2,2,1,0
21547,34,1617,1293,570,1093,25,15,163,1318,10,195,123,241,205,364,1516,2795,6,17273,959,0,2,1,2,0
21548,33,1886,384,251,317,7,8,52,391,11,70,44,84,81,128,467,811,6,5355,297,0,2,11,9,0
21549,45,2208,722,423,573,19,0,135,741,12,172,101,199,184,300,1320,2257,6,15668,870,0,2,5,5,0
21550,39,1724,386,256,301,16,9,68,402,4,59,35,69,63,104,355,621,2,1453,80,0,2,14,15,0
21551,78,3015,1043,504,840,53,9,147,1096,9,180,112,198,189,310,1377,2344,4,11604,644,0,2,10,8,0
21552,90,4376,1943,715,1694,26,18,214,1969,12,185,120,237,197,357,1436,2721,7,20915,1161,0,2,5,5,0
21553,30,1193,373,158,315,8,0,51,381,5,76,44,79,81,123,486,779,2,2026,112,0,2,5,3,0
21554,350,7046,1457,730,1242,11,6,188,1468,10,292,166,329,302,495,2424,4078,5,22973,1276,1,2,3,3,0
21555,350,7046,74,35,59,1,0,14,75,3,14,7,14,17,21,58,85,1,128,7,0,2,3,3,0
21556,350,7046,245,125,200,5,7,34,250,7,30,17,34,37,51,166,265,3,1053,58,0,2,3,3,0
21557,28,1170,373,158,315,8,0,51,381,5,76,44,79,81,123,486,779,2,2026,112,0,2,6,10,0
21558,234,5320,4293,999,3693,19,54,507,4312,9,155,88,170,164,258,1156,1898,4,9368,520,0,2,15,7,0
21559,234,5320,1482,859,1002,125,135,219,1607,16,219,134,251,235,385,1766,3032,9,27804,1544,1,2,15,7,0
21560,163,7176,139,89,101,2,0,35,141,7,54,34,62,61,96,330,569,4,2287,127,0,2,41,0,0
21561,163,7176,7,5,5,0,0,2,7,1,2,1,2,3,3,2,4,0,2,0,0,2,41,0,0
21562,39,1724,386,256,301,16,9,68,402,4,59,35,69,63,104,355,621,2,1453,80,0,2,2,2,0
21563,15,466,42,7,35,4,0,5,46,1,2,1,2,3,3,2,4,0,2,0,0,2,1,1,0
21564,15,466,11,6,10,0,0,1,11,2,4,2,4,6,6,10,15,1,15,0,0,2,1,1,0
21565,97,2643,1523,757,1297,19,12,193,1542,12,193,117,230,205,347,1508,2664,7,19053,1058,0,2,48,5,0
21566,97,2643,701,378,504,33,58,109,734,13,110,68,126,123,194,794,1346,7,10027,557,0,2,48,5,0
21567,113,2514,1043,504,840,53,9,147,1096,9,180,112,198,189,310,1377,2344,4,11604,644,0,2,8,0,0
21568,113,2514,383,288,292,26,6,62,409,11,65,38,67,76,105,429,656,5,3719,206,0,2,8,0,0
21569,94,4604,1523,757,1297,19,12,193,1542,12,193,117,230,205,347,1508,2664,7,19053,1058,0,2,20,3,0
21570,34,1626,1293,570,1093,25,15,163,1318,10,195,123,241,205,364,1516,2795,6,17273,959,0,2,4,0,0
21571,34,1634,1293,570,1093,25,15,163,1318,10,195,123,241,205,364,1516,2795,6,17273,959,0,2,1,1,1
21572,21,662,339,213,244,17,9,65,356,10,42,26,48,52,74,259,421,5,2410,133,0,2,7,11,0
21573,34,1634,1293,570,1093,25,15,163,1318,10,195,123,241,205,364,1516,2795,6,17273,959,0,2,4,0,0
21574,21,668,339,213,244,17,9,65,356,10,42,26,48,52,74,259,421,5,2410,133,0,2,3,3,0
21575,15,466,42,7,35,4,0,5,46,1,2,1,2,3,3,2,4,0,2,0,0,2,1,1,0
21576,15,466,11,6,10,0,0,1,11,2,4,2,4,6,6,10,15,1,15,0,0,2,1,1,0
21577,79,2067,773,422,505,30,103,129,803,14,77,46,83,91,129,535,839,7,6334,351,0,2,1,1,0
21578,26,1513,1157,318,931,29,22,177,1186,6,104,63,125,110,188,712,1274,3,4596,255,0,2,54,0,0
21579,113,2514,1043,504,840,53,9,147,1096,9,180,112,198,189,310,1377,2344,4,11604,644,0,2,1,1,0
21580,113,2514,383,288,292,26,6,62,409,11,65,38,67,76,105,429,656,5,3719,206,0,2,1,1,0
21581,80,2120,773,422,505,30,103,129,803,14,77,46,83,91,129,535,839,7,6334,351,0,2,14,1,0
21582,25,1456,1157,318,931,29,22,177,1186,6,104,63,125,110,188,712,1274,3,4596,255,0,2,22,1,0
21583,210,4402,1943,715,1694,26,18,214,1969,12,185,120,237,197,357,1436,2721,7,20915,1161,0,2,7,4,1
21584,210,4402,1168,838,957,57,25,144,1225,19,348,224,416,367,640,3018,5452,11,61921,3440,1,2,7,4,1
21585,91,4486,1943,715,1694,26,18,214,1969,12,185,120,237,197,357,1436,2721,7,20915,1161,0,2,11,3,1
21586,97,2643,1523,757,1297,19,12,193,1542,12,193,117,230,205,347,1508,2664,7,19053,1058,0,2,48,5,0
21587,97,2643,701,378,504,33,58,109,734,13,110,68,126,123,194,794,1346,7,10027,557,0,2,48,5,0
21588,113,2514,1043,504,840,53,9,147,1096,9,180,112,198,189,310,1377,2344,4,11604,644,0,2,8,0,0
21589,113,2514,383,288,292,26,6,62,409,11,65,38,67,76,105,429,656,5,3719,206,0,2,8,0,0
21590,94,4604,1523,757,1297,19,12,193,1542,12,193,117,230,205,347,1508,2664,7,19053,1058,0,2,20,3,0
21591,80,2120,773,422,505,30,103,129,803,14,77,46,83,91,129,535,839,7,6334,351,0,2,14,1,0
21592,25,1456,1157,318,931,29,22,177,1186,6,104,63,125,110,188,712,1274,3,4596,255,0,2,22,1,0
21593,234,5320,4293,999,3693,19,54,507,4312,9,155,88,170,164,258,1156,1898,4,9368,520,0,2,15,7,0
21594,234,5320,1482,859,1002,125,135,219,1607,16,219,134,251,235,385,1766,3032,9,27804,1544,1,2,15,7,0
21595,163,7176,139,89,101,2,0,35,141,7,54,34,62,61,96,330,569,4,2287,127,0,2,41,0,0
21596,163,7176,7,5,5,0,0,2,7,1,2,1,2,3,3,2,4,0,2,0,0,2,41,0,0
21597,350,7046,1457,730,1242,11,6,188,1468,10,292,166,329,302,495,2424,4078,5,22973,1276,1,2,8,2,0
21598,350,7046,74,35,59,1,0,14,75,3,14,7,14,17,21,58,85,1,128,7,0,2,8,2,0
21599,350,7046,245,125,200,5,7,34,250,7,30,17,34,37,51,166,265,3,1053,58,0,2,8,2,0
21600,117,2824,77,34,69,0,0,8,77,3,24,16,29,27,45,114,213,1,387,21,0,2,6,0,0
21601,117,2824,712,438,573,51,9,84,763,14,102,71,128,116,199,733,1364,8,11988,666,0,2,6,0,0
21602,28,1170,373,158,315,8,0,51,381,5,76,44,79,81,123,486,779,2,2026,112,0,2,30,0,0
21603,83,2161,773,422,505,30,103,129,803,14,77,46,83,91,129,535,839,7,6334,351,0,2,9,2,1
21604,27,1578,1157,318,931,29,22,177,1186,6,104,63,125,110,188,712,1274,3,4596,255,0,2,42,0,1
21605,82,2143,773,422,505,30,103,129,803,14,77,46,83,91,129,535,839,7,6334,351,0,2,8,8,0
21606,210,4422,1943,715,1694,26,18,214,1969,12,185,120,237,197,357,1436,2721,7,20915,1161,0,2,7,4,0
21607,210,4422,1168,838,957,57,25,144,1225,19,348,224,416,367,640,3018,5452,11,61921,3440,1,2,7,4,0
21608,91,4548,1943,715,1694,26,18,214,1969,12,185,120,237,197,357,1436,2721,7,20915,1161,0,2,8,0,0
21609,82,2143,773,422,505,30,103,129,803,14,77,46,83,91,129,535,839,7,6334,351,0,2,1,1,0
21610,82,2143,773,422,505,30,103,129,803,14,77,46,83,91,129,535,839,7,6334,351,0,2,9,2,0
21611,27,1578,1157,318,931,29,22,177,1186,6,104,63,125,110,188,712,1274,3,4596,255,0,2,42,0,0
21612,84,2178,773,422,505,30,103,129,803,14,77,46,83,91,129,535,839,7,6334,351,0,2,8,1,0
21613,28,1711,1157,318,931,29,22,177,1186,6,104,63,125,110,188,712,1274,3,4596,255,0,2,59,0,0
21614,210,4412,1943,715,1694,26,18,214,1969,12,185,120,237,197,357,1436,2721,7,20915,1161,0,2,0,1,0
21615,210,4412,1168,838,957,57,25,144,1225,19,348,224,416,367,640,3018,5452,11,61921,3440,1,2,0,1,0
21616,210,4418,1943,715,1694,26,18,214,1969,12,185,120,237,197,357,1436,2721,7,20915,1161,0,2,10,0,0
21617,210,4418,1168,838,957,57,25,144,1225,19,348,224,416,367,640,3018,5452,11,61921,3440,1,2,10,0,0
21618,91,4542,1943,715,1694,26,18,214,1969,12,185,120,237,197,357,1436,2721,7,20915,1161,0,2,29,0,0
21619,73,1425,757,253,292,73,244,162,830,13,61,38,67,74,105,409,651,7,4654,258,0,2,4,0,0
21620,73,1425,757,253,292,73,244,162,830,13,61,38,67,74,105,409,651,7,4654,258,0,2,4,0,0
21621,54,1096,207,111,150,11,0,50,218,5,26,19,36,31,55,133,272,3,943,52,0,2,4,3,1
21622,54,1096,410,198,237,31,55,97,441,11,63,38,72,74,110,414,683,6,4293,238,0,2,4,3,1
21623,33,991,465,148,393,5,8,60,470,4,31,20,31,35,51,161,261,2,523,29,0,2,22,0,1
21624,33,991,16,12,9,0,0,6,16,1,2,1,2,3,3,2,4,0,2,0,0,2,22,0,1
21625,23,722,339,213,244,17,9,65,356,10,42,26,48,52,74,259,421,5,2410,133,0,2,11,0,1
21626,36,1762,1293,570,1093,25,15,163,1318,10,195,123,241,205,364,1516,2795,6,17273,959,0,2,35,4,1
21627,66,1783,1455,414,1257,16,76,112,1471,5,41,23,46,46,69,231,381,2,1069,59,0,2,12,0,0
21628,66,1783,669,365,481,22,61,110,691,15,103,63,122,118,185,747,1273,8,11311,628,0,2,12,0,0
21629,21,668,339,213,244,17,9,65,356,10,42,26,48,52,74,259,421,5,2410,133,0,2,3,3,0
21630,234,5320,4293,999,3693,19,54,507,4312,9,155,88,170,164,258,1156,1898,4,9368,520,0,2,15,7,0
21631,234,5320,1482,859,1002,125,135,219,1607,16,219,134,251,235,385,1766,3032,9,27804,1544,1,2,15,7,0
21632,108,2218,1020,354,843,12,15,144,1032,8,134,77,144,142,221,970,1580,4,6792,377,0,2,1,1,0
21633,259,6118,72,33,56,0,4,12,72,1,1,1,1,2,2,0,2,0,1,0,0,2,2,1,0
21634,259,6118,1454,835,1044,76,110,219,1530,17,275,158,296,292,454,2297,3718,9,34017,1889,1,2,2,1,0
21635,73,1425,757,253,292,73,244,162,830,13,61,38,67,74,105,409,651,7,4654,258,0,2,4,0,0
21636,15,466,42,7,35,4,0,5,46,1,2,1,2,3,3,2,4,0,2,0,0,2,1,1,0
21637,15,466,11,6,10,0,0,1,11,2,4,2,4,6,6,10,15,1,15,0,0,2,1,1,0
21638,163,7176,139,89,101,2,0,35,141,7,54,34,62,61,96,330,569,4,2287,127,0,2,41,0,0
21639,163,7176,7,5,5,0,0,2,7,1,2,1,2,3,3,2,4,0,2,0,0,2,41,0,0
21640,34,1634,1293,570,1093,25,15,163,1318,10,195,123,241,205,364,1516,2795,6,17273,959,0,2,4,0,0
21641,39,1724,386,256,301,16,9,68,402,4,59,35,69,63,104,355,621,2,1453,80,0,2,2,2,0
21642,34,1617,1293,570,1093,25,15,163,1318,10,195,123,241,205,364,1516,2795,6,17273,959,0,2,0,4,0
21643,72,1639,996,429,845,24,10,117,1020,7,76,50,88,83,138,494,879,4,3565,198,0,2,42,0,1
21644,72,1639,456,277,329,12,42,72,468,13,85,50,97,98,147,592,972,7,7212,400,0,2,42,0,1
21645,34,2781,996,429,845,24,10,117,1020,7,76,50,88,83,138,494,879,4,3565,198,0,2,117,4,1
21646,209,4409,1943,715,1694,26,18,214,1969,12,185,120,237,197,357,1436,2721,7,20915,1161,0,2,4,6,0
21647,209,4409,1168,838,957,57,25,144,1225,19,348,224,416,367,640,3018,5452,11,61921,3440,1,2,4,6,0
21648,32,2401,996,429,845,24,10,117,1020,7,76,50,88,83,138,494,879,4,3565,198,0,2,1,1,0
21649,92,4598,1943,715,1694,26,18,214,1969,12,185,120,237,197,357,1436,2721,7,20915,1161,0,2,26,1,0
21650,67,1795,1455,414,1257,16,76,112,1471,5,41,23,46,46,69,231,381,2,1069,59,0,2,3,0,0
21651,67,1795,669,365,481,22,61,110,691,15,103,63,122,118,185,747,1273,8,11311,628,0,2,3,0,0
21652,73,1417,757,253,292,73,244,162,830,13,61,38,67,74,105,409,651,7,4654,258,0,2,0,1,0
21653,74,1419,757,253,292,73,244,162,830,13,61,38,67,74,105,409,651,7,4654,258,0,2,1,1,0
21654,21,572,256,139,192,9,7,47,265,4,23,12,24,27,36,112,171,2,357,19,0,2,10,0,0
21655,67,1795,1455,414,1257,16,76,112,1471,5,41,23,46,46,69,231,381,2,1069,59,0,2,2,2,0
21656,67,1795,669,365,481,22,61,110,691,15,103,63,122,118,185,747,1273,8,11311,628,0,2,2,2,0
21657,230,5261,4293,999,3693,19,54,507,4312,9,155,88,170,164,258,1156,1898,4,9368,520,0,2,2,2,1
21658,230,5261,1482,859,1002,125,135,219,1607,16,219,134,251,235,385,1766,3032,9,27804,1544,1,2,2,2,1
21659,15,466,42,7,35,4,0,5,46,1,2,1,2,3,3,2,4,0,2,0,0,2,1,1,1
21660,15,466,11,6,10,0,0,1,11,2,4,2,4,6,6,10,15,1,15,0,0,2,1,1,1
21661,54,1096,207,111,150,11,0,50,218,5,26,19,36,31,55,133,272,3,943,52,0,2,4,3,0
21662,54,1096,410,198,237,31,55,97,441,11,63,38,72,74,110,414,683,6,4293,238,0,2,4,3,0
21663,33,991,465,148,393,5,8,60,470,4,31,20,31,35,51,161,261,2,523,29,0,2,22,0,0
21664,33,991,16,12,9,0,0,6,16,1,2,1,2,3,3,2,4,0,2,0,0,2,22,0,0
21665,23,722,339,213,244,17,9,65,356,10,42,26,48,52,74,259,421,5,2410,133,0,2,11,0,0
21666,36,1779,1293,570,1093,25,15,163,1318,10,195,123,241,205,364,1516,2795,6,17273,959,0,2,35,4,0
21667,123,2925,77,34,69,0,0,8,77,3,24,16,29,27,45,114,213,1,387,21,0,2,20,0,0
21668,123,2925,712,438,573,51,9,84,763,14,102,71,128,116,199,733,1364,8,11988,666,0,2,20,0,0
21669,30,1233,373,158,315,8,0,51,381,5,76,44,79,81,123,486,779,2,2026,112,0,2,14,0,0
21670,123,2925,77,34,69,0,0,8,77,3,24,16,29,27,45,114,213,1,387,21,0,2,20,0,0
21671,123,2925,712,438,573,51,9,84,763,14,102,71,128,116,199,733,1364,8,11988,666,0,2,20,0,0
21672,30,1233,373,158,315,8,0,51,381,5,76,44,79,81,123,486,779,2,2026,112,0,2,14,0,0
21673,84,2178,773,422,505,30,103,129,803,14,77,46,83,91,129,535,839,7,6334,351,0,2,8,1,0
21674,28,1711,1157,318,931,29,22,177,1186,6,104,63,125,110,188,712,1274,3,4596,255,0,2,59,0,0
21675,79,2067,773,422,505,30,103,129,803,14,77,46,83,91,129,535,839,7,6334,351,0,2,1,1,0
21676,26,1513,1157,318,931,29,22,177,1186,6,104,63,125,110,188,712,1274,3,4596,255,0,2,54,0,0
21677,209,4409,1943,715,1694,26,18,214,1969,12,185,120,237,197,357,1436,2721,7,20915,1161,0,2,4,6,0
21678,209,4409,1168,838,957,57,25,144,1225,19,348,224,416,367,640,3018,5452,11,61921,3440,1,2,4,6,0
21679,32,2401,996,429,845,24,10,117,1020,7,76,50,88,83,138,494,879,4,3565,198,0,2,1,1,0
21680,92,4598,1943,715,1694,26,18,214,1969,12,185,120,237,197,357,1436,2721,7,20915,1161,0,2,26,1,0
21681,29,1792,1157,318,931,29,22,177,1186,6,104,63,125,110,188,712,1274,3,4596,255,0,2,54,0,0
21682,54,1096,207,111,150,11,0,50,218,5,26,19,36,31,55,133,272,3,943,52,0,2,4,3,0
21683,54,1096,410,198,237,31,55,97,441,11,63,38,72,74,110,414,683,6,4293,238,0,2,4,3,0
21684,23,722,339,213,244,17,9,65,356,10,42,26,48,52,74,259,421,5,2410,133,0,2,14,3,0
21685,234,5320,4293,999,3693,19,54,507,4312,9,155,88,170,164,258,1156,1898,4,9368,520,0,2,15,7,0
21686,234,5320,1482,859,1002,125,135,219,1607,16,219,134,251,235,385,1766,3032,9,27804,1544,1,2,15,7,0
21687,85,2182,773,422,505,30,103,129,803,14,77,46,83,91,129,535,839,7,6334,351,0,2,1,1,0
21688,108,2218,1020,354,843,12,15,144,1032,8,134,77,144,142,221,970,1580,4,6792,377,0,2,1,1,0
21689,259,6118,72,33,56,0,4,12,72,1,1,1,1,2,2,0,2,0,1,0,0,2,2,1,0
21690,259,6118,1454,835,1044,76,110,219,1530,17,275,158,296,292,454,2297,3718,9,34017,1889,1,2,2,1,0
21691,73,1425,757,253,292,73,244,162,830,13,61,38,67,74,105,409,651,7,4654,258,0,2,4,0,0
21692,15,466,42,7,35,4,0,5,46,1,2,1,2,3,3,2,4,0,2,0,0,2,1,1,0
21693,15,466,11,6,10,0,0,1,11,2,4,2,4,6,6,10,15,1,15,0,0,2,1,1,0
21694,163,7176,139,89,101,2,0,35,141,7,54,34,62,61,96,330,569,4,2287,127,0,2,41,0,0
21695,163,7176,7,5,5,0,0,2,7,1,2,1,2,3,3,2,4,0,2,0,0,2,41,0,0
21696,33,991,465,148,393,5,8,60,470,4,31,20,31,35,51,161,261,2,523,29,0,2,22,0,0
21697,33,991,16,12,9,0,0,6,16,1,2,1,2,3,3,2,4,0,2,0,0,2,22,0,0
21698,36,1779,1293,570,1093,25,15,163,1318,10,195,123,241,205,364,1516,2795,6,17273,959,0,2,39,4,0
21699,39,1724,386,256,301,16,9,68,402,4,59,35,69,63,104,355,621,2,1453,80,0,2,2,2,0
21700,54,1096,207,111,150,11,0,50,218,5,26,19,36,31,55,133,272,3,943,52,0,2,4,3,0
21701,54,1096,410,198,237,31,55,97,441,11,63,38,72,74,110,414,683,6,4293,238,0,2,4,3,0
21702,23,722,339,213,244,17,9,65,356,10,42,26,48,52,74,259,421,5,2410,133,0,2,14,3,0
21703,234,5320,4293,999,3693,19,54,507,4312,9,155,88,170,164,258,1156,1898,4,9368,520,0,2,15,7,0
21704,234,5320,1482,859,1002,125,135,219,1607,16,219,134,251,235,385,1766,3032,9,27804,1544,1,2,15,7,0
21705,85,2182,773,422,505,30,103,129,803,14,77,46,83,91,129,535,839,7,6334,351,0,2,1,1,0
21706,108,2218,1020,354,843,12,15,144,1032,8,134,77,144,142,221,970,1580,4,6792,377,0,2,1,1,0
21707,259,6118,72,33,56,0,4,12,72,1,1,1,1,2,2,0,2,0,1,0,0,2,2,1,0
21708,259,6118,1454,835,1044,76,110,219,1530,17,275,158,296,292,454,2297,3718,9,34017,1889,1,2,2,1,0
21709,73,1425,757,253,292,73,244,162,830,13,61,38,67,74,105,409,651,7,4654,258,0,2,4,0,0
21710,15,466,42,7,35,4,0,5,46,1,2,1,2,3,3,2,4,0,2,0,0,2,1,1,0
21711,15,466,11,6,10,0,0,1,11,2,4,2,4,6,6,10,15,1,15,0,0,2,1,1,0
21712,29,1792,1157,318,931,29,22,177,1186,6,104,63,125,110,188,712,1274,3,4596,255,0,2,54,0,0
21713,163,7176,139,89,101,2,0,35,141,7,54,34,62,61,96,330,569,4,2287,127,0,2,41,0,0
21714,163,7176,7,5,5,0,0,2,7,1,2,1,2,3,3,2,4,0,2,0,0,2,41,0,0
21715,33,991,465,148,393,5,8,60,470,4,31,20,31,35,51,161,261,2,523,29,0,2,22,0,0
21716,33,991,16,12,9,0,0,6,16,1,2,1,2,3,3,2,4,0,2,0,0,2,22,0,0
21717,36,1779,1293,570,1093,25,15,163,1318,10,195,123,241,205,364,1516,2795,6,17273,959,0,2,39,4,0
21718,39,1724,386,256,301,16,9,68,402,4,59,35,69,63,104,355,621,2,1453,80,0,2,2,2,0
21719,67,1795,1455,414,1257,16,76,112,1471,5,41,23,46,46,69,231,381,2,1069,59,0,2,1,1,0
21720,67,1795,669,365,481,22,61,110,691,15,103,63,122,118,185,747,1273,8,11311,628,0,2,1,1,0
21721,67,1795,1455,414,1257,16,76,112,1471,5,41,23,46,46,69,231,381,2,1069,59,0,2,1,1,0
21722,67,1795,669,365,481,22,61,110,691,15,103,63,122,118,185,747,1273,8,11311,628,0,2,1,1,0
21723,24,749,339,213,244,17,9,65,356,10,42,26,48,52,74,259,421,5,2410,133,0,2,5,0,1
21724,37,1850,1293,570,1093,25,15,163,1318,10,195,123,241,205,364,1516,2795,6,17273,959,0,2,16,0,1
21725,67,1795,1455,414,1257,16,76,112,1471,5,41,23,46,46,69,231,381,2,1069,59,0,2,15,0,0
21726,67,1795,669,365,481,22,61,110,691,15,103,63,122,118,185,747,1273,8,11311,628,0,2,15,0,0
21727,36,1762,1293,570,1093,25,15,163,1318,10,195,123,241,205,364,1516,2795,6,17273,959,0,2,0,4,0
21728,234,5320,4293,999,3693,19,54,507,4312,9,155,88,170,164,258,1156,1898,4,9368,520,0,2,2,2,0
21729,234,5320,1482,859,1002,125,135,219,1607,16,219,134,251,235,385,1766,3032,9,27804,1544,1,2,2,2,0
21730,15,466,42,7,35,4,0,5,46,1,2,1,2,3,3,2,4,0,2,0,0,2,1,1,0
21731,15,466,11,6,10,0,0,1,11,2,4,2,4,6,6,10,15,1,15,0,0,2,1,1,0
21732,74,1419,757,253,292,73,244,162,830,13,61,38,67,74,105,409,651,7,4654,258,0,2,1,2,0
21733,21,572,256,139,192,9,7,47,265,4,23,12,24,27,36,112,171,2,357,19,0,2,10,0,0
21734,25,753,339,213,244,17,9,65,356,10,42,26,48,52,74,259,421,5,2410,133,0,2,10,14,1
21735,209,4399,1943,715,1694,26,18,214,1969,12,185,120,237,197,357,1436,2721,7,20915,1161,0,2,7,7,1
21736,209,4399,1168,838,957,57,25,144,1225,19,348,224,416,367,640,3018,5452,11,61921,3440,1,2,7,7,1
21737,38,1882,1293,570,1093,25,15,163,1318,10,195,123,241,205,364,1516,2795,6,17273,959,0,2,7,5,1
21738,92,4613,1943,715,1694,26,18,214,1969,12,185,120,237,197,357,1436,2721,7,20915,1161,0,2,34,18,1
21739,84,2139,773,422,505,30,103,129,803,14,77,46,83,91,129,535,839,7,6334,351,0,2,3,10,1
21740,27,1631,1157,318,931,29,22,177,1186,6,104,63,125,110,188,712,1274,3,4596,255,0,2,0,54,1
21741,85,2182,773,422,505,30,103,129,803,14,77,46,83,91,129,535,839,7,6334,351,0,2,10,3,0
21742,29,1792,1157,318,931,29,22,177,1186,6,104,63,125,110,188,712,1274,3,4596,255,0,2,54,0,0
21743,25,753,339,213,244,17,9,65,356,10,42,26,48,52,74,259,421,5,2410,133,0,2,10,9,0
21744,209,4399,1943,715,1694,26,18,214,1969,12,185,120,237,197,357,1436,2721,7,20915,1161,0,2,7,7,0
21745,209,4399,1168,838,957,57,25,144,1225,19,348,224,416,367,640,3018,5452,11,61921,3440,1,2,7,7,0
21746,38,1882,1293,570,1093,25,15,163,1318,10,195,123,241,205,364,1516,2795,6,17273,959,0,2,18,0,0
21747,92,4613,1943,715,1694,26,18,214,1969,12,185,120,237,197,357,1436,2721,7,20915,1161,0,2,34,18,0
21748,98,2673,1523,757,1297,19,12,193,1542,12,193,117,230,205,347,1508,2664,7,19053,1058,0,2,29,15,1
21749,98,2673,701,378,504,33,58,109,734,13,110,68,126,123,194,794,1346,7,10027,557,0,2,29,15,1
21750,79,1692,53,23,39,0,0,13,53,2,8,4,8,10,12,26,39,1,39,2,0,2,4,0,1
21751,79,1692,515,298,307,33,80,99,548,12,63,44,77,75,121,419,753,7,5527,307,0,2,4,0,1
21752,113,2525,1043,504,840,53,9,147,1096,9,180,112,198,189,310,1377,2344,4,11604,644,0,2,7,1,1
21753,113,2525,383,288,292,26,6,62,409,11,65,38,67,76,105,429,656,5,3719,206,0,2,7,1,1
21754,94,4604,1523,757,1297,19,12,193,1542,12,193,117,230,205,347,1508,2664,7,19053,1058,0,2,8,8,1
21755,67,1795,1455,414,1257,16,76,112,1471,5,41,23,46,46,69,231,381,2,1069,59,0,2,15,0,0
21756,67,1795,669,365,481,22,61,110,691,15,103,63,122,118,185,747,1273,8,11311,628,0,2,15,0,0
21757,74,1419,757,253,292,73,244,162,830,13,61,38,67,74,105,409,651,7,4654,258,0,2,1,2,0
21758,21,572,256,139,192,9,7,47,265,4,23,12,24,27,36,112,171,2,357,19,0,2,10,0,0
21759,38,1865,1293,570,1093,25,15,163,1318,10,195,123,241,205,364,1516,2795,6,17273,959,0,2,0,4,0
21760,91,4587,1943,715,1694,26,18,214,1969,12,185,120,237,197,357,1436,2721,7,20915,1161,0,2,17,12,0
21761,98,2670,1523,757,1297,19,12,193,1542,12,193,117,230,205,347,1508,2664,7,19053,1058,0,2,2,2,0
21762,98,2670,701,378,504,33,58,109,734,13,110,68,126,123,194,794,1346,7,10027,557,0,2,2,2,0
21763,113,2530,1043,504,840,53,9,147,1096,9,180,112,198,189,310,1377,2344,4,11604,644,0,2,2,4,0
21764,113,2530,383,288,292,26,6,62,409,11,65,38,67,76,105,429,656,5,3719,206,0,2,2,4,0
21765,75,1466,757,253,292,73,244,162,830,13,61,38,67,74,105,409,651,7,4654,258,0,2,14,2,1
21766,52,3387,520,294,400,33,13,81,553,10,261,204,367,271,571,2128,4614,7,32445,1802,1,2,1,0,1
21767,91,4587,1943,715,1694,26,18,214,1969,12,185,120,237,197,357,1436,2721,7,20915,1161,0,2,17,12,0
21768,234,5333,4293,999,3693,19,54,507,4312,9,155,88,170,164,258,1156,1898,4,9368,520,0,2,6,5,0
21769,234,5333,1482,859,1002,125,135,219,1607,16,219,134,251,235,385,1766,3032,9,27804,1544,1,2,6,5,0
21770,75,1466,757,253,292,73,244,162,830,13,61,38,67,74,105,409,651,7,4654,258,0,2,14,2,0
21771,52,3387,520,294,400,33,13,81,553,10,261,204,367,271,571,2128,4614,7,32445,1802,1,2,1,0,0
21772,98,2670,1523,757,1297,19,12,193,1542,12,193,117,230,205,347,1508,2664,7,19053,1058,0,2,29,15,0
21773,98,2670,701,378,504,33,58,109,734,13,110,68,126,123,194,794,1346,7,10027,557,0,2,29,15,0
21774,79,1692,53,23,39,0,0,13,53,2,8,4,8,10,12,26,39,1,39,2,0,2,4,0,0
21775,79,1692,515,298,307,33,80,99,548,12,63,44,77,75,121,419,753,7,5527,307,0,2,4,0,0
21776,113,2530,1043,504,840,53,9,147,1096,9,180,112,198,189,310,1377,2344,4,11604,644,0,2,6,2,0
21777,113,2530,383,288,292,26,6,62,409,11,65,38,67,76,105,429,656,5,3719,206,0,2,6,2,0
21778,94,4604,1523,757,1297,19,12,193,1542,12,193,117,230,205,347,1508,2664,7,19053,1058,0,2,8,8,0
21779,164,7205,139,89,101,2,0,35,141,7,54,34,62,61,96,330,569,4,2287,127,0,2,35,0,1
21780,164,7205,7,5,5,0,0,2,7,1,2,1,2,3,3,2,4,0,2,0,0,2,35,0,1
21781,234,5348,4293,999,3693,19,54,507,4312,9,155,88,170,164,258,1156,1898,4,9368,520,0,2,6,2,0
21782,234,5348,1482,859,1002,125,135,219,1607,16,219,134,251,235,385,1766,3032,9,27804,1544,1,2,6,2,0
21783,108,2220,2,2,2,0,0,0,2,0,0,0,0,0,0,0,0,0,0,0,0,3,2,2,0
21784,108,2220,99,48,90,1,3,5,100,0,0,0,0,0,0,0,0,0,0,0,0,3,2,2,0
21785,108,2220,8,5,5,2,0,1,10,0,0,0,0,0,0,0,0,0,0,0,0,3,2,2,0
21786,108,2220,1217,716,841,84,126,174,1301,14,185,118,215,199,333,1446,2542,8,20687,1149,0,3,2,2,0
21787,108,2220,160,89,115,0,13,31,160,7,15,11,17,22,28,78,124,3,495,27,0,3,2,2,0
21788,108,2220,10,10,9,9,0,0,19,0,0,0,0,0,0,0,0,0,0,0,0,3,2,2,0
21789,108,2220,173,84,99,8,29,36,181,5,12,7,13,17,20,54,81,2,221,12,0,3,2,2,0
21790,108,2220,3,1,1,3,0,0,6,0,0,0,0,0,0,0,0,0,0,0,0,3,2,2,0
21791,33,701,125,97,103,3,0,19,128,9,25,17,27,34,44,144,223,4,1087,60,0,0,126,0,1
21792,75,1390,1178,367,1042,6,15,115,1184,9,94,51,95,103,146,644,976,4,4439,246,0,2,2,123,1
21793,75,1390,177,108,140,8,0,27,185,6,30,16,32,36,48,162,248,3,794,44,0,2,2,123,1
21794,71,1417,1178,367,1042,6,15,115,1184,9,94,51,95,103,146,644,976,4,4439,246,0,2,21,12,0
21795,71,1417,177,108,140,8,0,27,185,6,30,16,32,36,48,162,248,3,794,44,0,2,21,12,0
21796,15,468,42,7,35,4,0,5,46,1,2,1,2,3,3,2,4,0,2,0,0,2,1,1,0
21797,15,468,11,6,10,0,0,1,11,2,4,2,4,6,6,10,15,1,15,0,0,2,1,1,0
21798,85,1879,2,2,2,0,0,0,2,0,0,0,0,0,0,0,0,0,0,0,0,2,1,84,1
21799,85,1879,99,48,90,1,3,5,100,0,0,0,0,0,0,0,0,0,0,0,0,2,1,84,1
21800,85,1879,8,5,5,2,0,1,10,0,0,0,0,0,0,0,0,0,0,0,0,2,1,84,1
21801,85,1879,1217,716,841,84,126,174,1301,14,185,118,215,199,333,1446,2542,8,20687,1149,0,2,1,84,1
21802,85,1879,160,89,115,0,13,31,160,7,15,11,17,22,28,78,124,3,495,27,0,2,1,84,1
21803,85,1879,10,10,9,9,0,0,19,0,0,0,0,0,0,0,0,0,0,0,0,2,1,84,1
21804,85,1879,173,84,99,8,29,36,181,5,12,7,13,17,20,54,81,2,221,12,0,2,1,84,1
21805,85,1879,3,1,1,3,0,0,6,0,0,0,0,0,0,0,0,0,0,0,0,2,1,84,1
21806,23,363,102,57,55,5,16,25,107,5,17,10,18,22,28,81,124,2,330,18,0,0,93,0,1
21807,24,380,102,57,55,5,16,25,107,5,17,10,18,22,28,81,124,2,330,18,0,2,22,18,1
21808,22,528,2,2,2,0,0,0,2,0,0,0,0,0,0,0,0,0,0,0,0,2,5,330,1
21809,22,528,99,48,90,1,3,5,100,0,0,0,0,0,0,0,0,0,0,0,0,2,5,330,1
21810,22,528,8,5,5,2,0,1,10,0,0,0,0,0,0,0,0,0,0,0,0,2,5,330,1
21811,22,528,1217,716,841,84,126,174,1301,14,185,118,215,199,333,1446,2542,8,20687,1149,0,2,5,330,1
21812,22,528,160,89,115,0,13,31,160,7,15,11,17,22,28,78,124,3,495,27,0,2,5,330,1
21813,22,528,10,10,9,9,0,0,19,0,0,0,0,0,0,0,0,0,0,0,0,2,5,330,1
21814,22,528,173,84,99,8,29,36,181,5,12,7,13,17,20,54,81,2,221,12,0,2,5,330,1
21815,22,528,3,1,1,3,0,0,6,0,0,0,0,0,0,0,0,0,0,0,0,2,5,330,1
21816,63,1378,402,202,227,24,74,80,426,12,52,33,61,64,94,339,564,7,3969,220,0,0,330,0,1
21817,259,6120,72,33,56,0,4,12,72,1,1,1,1,2,2,0,2,0,1,0,0,2,1,1,1
21818,259,6120,1454,835,1044,76,110,219,1530,17,275,158,296,292,454,2297,3718,9,34017,1889,1,2,1,1,1
21819,24,588,2,2,2,0,0,0,2,0,0,0,0,0,0,0,0,0,0,0,0,2,26,12,0
21820,24,588,99,48,90,1,3,5,100,0,0,0,0,0,0,0,0,0,0,0,0,2,26,12,0
21821,24,588,8,5,5,2,0,1,10,0,0,0,0,0,0,0,0,0,0,0,0,2,26,12,0
21822,24,588,1217,716,841,84,126,174,1301,14,185,118,215,199,333,1446,2542,8,20687,1149,0,2,26,12,0
21823,24,588,160,89,115,0,13,31,160,7,15,11,17,22,28,78,124,3,495,27,0,2,26,12,0
21824,24,588,10,10,9,9,0,0,19,0,0,0,0,0,0,0,0,0,0,0,0,2,26,12,0
21825,24,588,173,84,99,8,29,36,181,5,12,7,13,17,20,54,81,2,221,12,0,2,26,12,0
21826,24,588,3,1,1,3,0,0,6,0,0,0,0,0,0,0,0,0,0,0,0,2,26,12,0
21827,24,599,2,2,2,0,0,0,2,0,0,0,0,0,0,0,0,0,0,0,0,2,6,2,0
21828,24,599,99,48,90,1,3,5,100,0,0,0,0,0,0,0,0,0,0,0,0,2,6,2,0
21829,24,599,8,5,5,2,0,1,10,0,0,0,0,0,0,0,0,0,0,0,0,2,6,2,0
21830,24,599,1217,716,841,84,126,174,1301,14,185,118,215,199,333,1446,2542,8,20687,1149,0,2,6,2,0
21831,24,599,160,89,115,0,13,31,160,7,15,11,17,22,28,78,124,3,495,27,0,2,6,2,0
21832,24,599,10,10,9,9,0,0,19,0,0,0,0,0,0,0,0,0,0,0,0,2,6,2,0
21833,24,599,173,84,99,8,29,36,181,5,12,7,13,17,20,54,81,2,221,12,0,2,6,2,0
21834,24,599,3,1,1,3,0,0,6,0,0,0,0,0,0,0,0,0,0,0,0,2,6,2,0
21835,259,6120,72,33,56,0,4,12,72,1,1,1,1,2,2,0,2,0,1,0,0,2,1,1,0
21836,259,6120,1454,835,1044,76,110,219,1530,17,275,158,296,292,454,2297,3718,9,34017,1889,1,2,1,1,0
21837,39,1946,1293,570,1093,25,15,163,1318,10,195,123,241,205,364,1516,2795,6,17273,959,0,2,18,0,1
21838,33,701,125,97,103,3,0,19,128,9,25,17,27,34,44,144,223,4,1087,60,0,2,0,1,0
21839,234,5348,4293,999,3693,19,54,507,4312,9,155,88,170,164,258,1156,1898,4,9368,520,0,2,9,4,0
21840,234,5348,1482,859,1002,125,135,219,1607,16,219,134,251,235,385,1766,3032,9,27804,1544,1,2,9,4,0
21841,164,7205,139,89,101,2,0,35,141,7,54,34,62,61,96,330,569,4,2287,127,0,2,35,0,0
21842,164,7205,7,5,5,0,0,2,7,1,2,1,2,3,3,2,4,0,2,0,0,2,35,0,0
21843,39,1946,1293,570,1093,25,15,163,1318,10,195,123,241,205,364,1516,2795,6,17273,959,0,2,18,0,0
21844,82,2133,1455,414,1257,16,76,112,1471,5,41,23,46,46,69,231,381,2,1069,59,0,2,141,45,0
21845,82,2133,669,365,481,22,61,110,691,15,103,63,122,118,185,747,1273,8,11311,628,0,2,141,45,0
21846,69,3191,1455,414,1257,16,76,112,1471,5,41,23,46,46,69,231,381,2,1069,59,0,2,19,0,0
21847,98,2670,1523,757,1297,19,12,193,1542,12,193,117,230,205,347,1508,2664,7,19053,1058,0,2,29,15,0
21848,98,2670,701,378,504,33,58,109,734,13,110,68,126,123,194,794,1346,7,10027,557,0,2,29,15,0
21849,79,1692,53,23,39,0,0,13,53,2,8,4,8,10,12,26,39,1,39,2,0,2,4,0,0
21850,79,1692,515,298,307,33,80,99,548,12,63,44,77,75,121,419,753,7,5527,307,0,2,4,0,0
21851,113,2530,1043,504,840,53,9,147,1096,9,180,112,198,189,310,1377,2344,4,11604,644,0,2,6,2,0
21852,113,2530,383,288,292,26,6,62,409,11,65,38,67,76,105,429,656,5,3719,206,0,2,6,2,0
21853,94,4604,1523,757,1297,19,12,193,1542,12,193,117,230,205,347,1508,2664,7,19053,1058,0,2,8,8,0
21854,39,1946,1293,570,1093,25,15,163,1318,10,195,123,241,205,364,1516,2795,6,17273,959,0,2,18,0,0
21855,70,1621,996,429,845,24,10,117,1020,7,76,50,88,83,138,494,879,4,3565,198,0,2,19,18,1
21856,70,1621,456,277,329,12,42,72,468,13,85,50,97,98,147,592,972,7,7212,400,0,2,19,18,1
21857,34,2709,996,429,845,24,10,117,1020,7,76,50,88,83,138,494,879,4,3565,198,0,2,30,34,1
21858,54,1096,207,111,150,11,0,50,218,5,26,19,36,31,55,133,272,3,943,52,0,2,4,3,0
21859,54,1096,410,198,237,31,55,97,441,11,63,38,72,74,110,414,683,6,4293,238,0,2,4,3,0
21860,25,753,339,213,244,17,9,65,356,10,42,26,48,52,74,259,421,5,2410,133,0,2,15,3,0
21861,67,1795,1455,414,1257,16,76,112,1471,5,41,23,46,46,69,231,381,2,1069,59,0,2,15,0,0
21862,67,1795,669,365,481,22,61,110,691,15,103,63,122,118,185,747,1273,8,11311,628,0,2,15,0,0
21863,234,5320,4293,999,3693,19,54,507,4312,9,155,88,170,164,258,1156,1898,4,9368,520,0,2,17,9,0
21864,234,5320,1482,859,1002,125,135,219,1607,16,219,134,251,235,385,1766,3032,9,27804,1544,1,2,17,9,0
21865,98,2670,1523,757,1297,19,12,193,1542,12,193,117,230,205,347,1508,2664,7,19053,1058,0,2,29,15,0
21866,98,2670,701,378,504,33,58,109,734,13,110,68,126,123,194,794,1346,7,10027,557,0,2,29,15,0
21867,85,2182,773,422,505,30,103,129,803,14,77,46,83,91,129,535,839,7,6334,351,0,2,9,2,0
21868,123,2925,77,34,69,0,0,8,77,3,24,16,29,27,45,114,213,1,387,21,0,2,20,0,0
21869,123,2925,712,438,573,51,9,84,763,14,102,71,128,116,199,733,1364,8,11988,666,0,2,20,0,0
21870,108,2218,1020,354,843,12,15,144,1032,8,134,77,144,142,221,970,1580,4,6792,377,0,2,1,1,0
21871,79,1692,53,23,39,0,0,13,53,2,8,4,8,10,12,26,39,1,39,2,0,2,4,0,0
21872,79,1692,515,298,307,33,80,99,548,12,63,44,77,75,121,419,753,7,5527,307,0,2,4,0,0
21873,259,6118,72,33,56,0,4,12,72,1,1,1,1,2,2,0,2,0,1,0,0,2,2,1,0
21874,259,6118,1454,835,1044,76,110,219,1530,17,275,158,296,292,454,2297,3718,9,34017,1889,1,2,2,1,0
21875,74,1419,757,253,292,73,244,162,830,13,61,38,67,74,105,409,651,7,4654,258,0,2,5,2,0
21876,113,2530,1043,504,840,53,9,147,1096,9,180,112,198,189,310,1377,2344,4,11604,644,0,2,6,2,0
21877,113,2530,383,288,292,26,6,62,409,11,65,38,67,76,105,429,656,5,3719,206,0,2,6,2,0
21878,209,4399,1943,715,1694,26,18,214,1969,12,185,120,237,197,357,1436,2721,7,20915,1161,0,2,11,13,0
21879,209,4399,1168,838,957,57,25,144,1225,19,348,224,416,367,640,3018,5452,11,61921,3440,1,2,11,13,0
21880,15,466,42,7,35,4,0,5,46,1,2,1,2,3,3,2,4,0,2,0,0,2,2,2,0
21881,15,466,11,6,10,0,0,1,11,2,4,2,4,6,6,10,15,1,15,0,0,2,2,2,0
21882,29,1792,1157,318,931,29,22,177,1186,6,104,63,125,110,188,712,1274,3,4596,255,0,2,113,0,0
21883,163,7176,139,89,101,2,0,35,141,7,54,34,62,61,96,330,569,4,2287,127,0,2,41,0,0
21884,163,7176,7,5,5,0,0,2,7,1,2,1,2,3,3,2,4,0,2,0,0,2,41,0,0
21885,33,991,465,148,393,5,8,60,470,4,31,20,31,35,51,161,261,2,523,29,0,2,22,0,0
21886,33,991,16,12,9,0,0,6,16,1,2,1,2,3,3,2,4,0,2,0,0,2,22,0,0
21887,21,572,256,139,192,9,7,47,265,4,23,12,24,27,36,112,171,2,357,19,0,2,10,0,0
21888,34,2709,996,429,845,24,10,117,1020,7,76,50,88,83,138,494,879,4,3565,198,0,2,1,1,0
21889,94,4604,1523,757,1297,19,12,193,1542,12,193,117,230,205,347,1508,2664,7,19053,1058,0,2,8,8,0
21890,39,1946,1293,570,1093,25,15,163,1318,10,195,123,241,205,364,1516,2795,6,17273,959,0,2,71,4,0
21891,39,1724,386,256,301,16,9,68,402,4,59,35,69,63,104,355,621,2,1453,80,0,2,2,2,0
21892,30,1233,373,158,315,8,0,51,381,5,76,44,79,81,123,486,779,2,2026,112,0,2,14,0,0
21893,91,4587,1943,715,1694,26,18,214,1969,12,185,120,237,197,357,1436,2721,7,20915,1161,0,2,77,31,0
21894,82,2133,1455,414,1257,16,76,112,1471,5,41,23,46,46,69,231,381,2,1069,59,0,2,0,22,0
21895,82,2133,669,365,481,22,61,110,691,15,103,63,122,118,185,747,1273,8,11311,628,0,2,0,22,0
21896,69,3182,1455,414,1257,16,76,112,1471,5,41,23,46,46,69,231,381,2,1069,59,0,2,7,5,0
21897,83,2145,1455,414,1257,16,76,112,1471,5,41,23,46,46,69,231,381,2,1069,59,0,2,25,16,0
21898,83,2145,669,365,481,22,61,110,691,15,103,63,122,118,185,747,1273,8,11311,628,0,2,25,16,0
21899,69,3184,1455,414,1257,16,76,112,1471,5,41,23,46,46,69,231,381,2,1069,59,0,2,1,1,0
21900,24,599,2,2,2,0,0,0,2,0,0,0,0,0,0,0,0,0,0,0,0,0,141,0,0
21901,24,599,99,48,90,1,3,5,100,0,0,0,0,0,0,0,0,0,0,0,0,0,141,0,0
21902,24,599,8,5,5,2,0,1,10,0,0,0,0,0,0,0,0,0,0,0,0,0,141,0,0
21903,24,599,1217,716,841,84,126,174,1301,14,185,118,215,199,333,1446,2542,8,20687,1149,0,0,141,0,0
21904,24,599,160,89,115,0,13,31,160,7,15,11,17,22,28,78,124,3,495,27,0,0,141,0,0
21905,24,599,10,10,9,9,0,0,19,0,0,0,0,0,0,0,0,0,0,0,0,0,141,0,0
21906,24,599,173,84,99,8,29,36,181,5,12,7,13,17,20,54,81,2,221,12,0,0,141,0,0
21907,24,599,3,1,1,3,0,0,6,0,0,0,0,0,0,0,0,0,0,0,0,0,141,0,0
21908,33,701,125,97,103,3,0,19,128,9,25,17,27,34,44,144,223,4,1087,60,0,0,125,0,0
21909,24,380,102,57,55,5,16,25,107,5,17,10,18,22,28,81,124,2,330,18,0,0,97,0,0
21910,63,1378,402,202,227,24,74,80,426,12,52,33,61,64,94,339,564,7,3969,220,0,3,83,284,0
21911,259,6120,72,33,56,0,4,12,72,1,1,1,1,2,2,0,2,0,1,0,0,2,1,1,0
21912,259,6120,1454,835,1044,76,110,219,1530,17,275,158,296,292,454,2297,3718,9,34017,1889,1,2,1,1,0
21913,71,1417,1178,367,1042,6,15,115,1184,9,94,51,95,103,146,644,976,4,4439,246,0,2,23,135,0
21914,71,1417,177,108,140,8,0,27,185,6,30,16,32,36,48,162,248,3,794,44,0,2,23,135,0
21915,15,468,42,7,35,4,0,5,46,1,2,1,2,3,3,2,4,0,2,0,0,2,1,1,0
21916,15,468,11,6,10,0,0,1,11,2,4,2,4,6,6,10,15,1,15,0,0,2,1,1,0
21917,33,707,125,97,103,3,0,19,128,9,25,17,27,34,44,144,223,4,1087,60,0,2,2,1,0
21918,75,3157,1178,367,1042,6,15,115,1184,9,94,51,95,103,146,644,976,4,4439,246,0,2,10,0,0
21919,208,4359,1943,715,1694,26,18,214,1969,12,185,120,237,197,357,1436,2721,7,20915,1161,0,2,2,0,0
21920,208,4359,1168,838,957,57,25,144,1225,19,348,224,416,367,640,3018,5452,11,61921,3440,1,2,2,0,0
21921,90,4387,1943,715,1694,26,18,214,1969,12,185,120,237,197,357,1436,2721,7,20915,1161,0,2,1,0,0
21922,90,4395,1943,715,1694,26,18,214,1969,12,185,120,237,197,357,1436,2721,7,20915,1161,0,2,2,0,0
21923,51,597,647,139,84,35,284,233,682,0,0,0,0,0,0,0,0,0,0,0,0,2,10,2,1
21924,71,1415,1178,367,1042,6,15,115,1184,9,94,51,95,103,146,644,976,4,4439,246,0,2,10,8,1
21925,71,1415,177,108,140,8,0,27,185,6,30,16,32,36,48,162,248,3,794,44,0,2,10,8,1
21926,210,4421,1943,715,1694,26,18,214,1969,12,185,120,237,197,357,1436,2721,7,20915,1161,0,2,9,4,1
21927,210,4421,1168,838,957,57,25,144,1225,19,348,224,416,367,640,3018,5452,11,61921,3440,1,2,9,4,1
21928,75,3160,1178,367,1042,6,15,115,1184,9,94,51,95,103,146,644,976,4,4439,246,0,2,15,0,1
21929,76,3201,1178,367,1042,6,15,115,1184,9,94,51,95,103,146,644,976,4,4439,246,0,2,15,0,0
21930,76,3201,1178,367,1042,6,15,115,1184,9,94,51,95,103,146,644,976,4,4439,246,0,2,1,1,0
21931,72,1450,757,253,292,73,244,162,830,13,61,38,67,74,105,409,651,7,4654,258,0,2,6,9,1
21932,15,468,42,7,35,4,0,5,46,1,2,1,2,3,3,2,4,0,2,0,0,2,1,0,1
21933,15,468,11,6,10,0,0,1,11,2,4,2,4,6,6,10,15,1,15,0,0,2,1,0,1
21934,51,595,647,139,84,35,284,233,682,0,0,0,0,0,0,0,0,0,0,0,0,2,1,2,0
21935,210,4415,1943,715,1694,26,18,214,1969,12,185,120,237,197,357,1436,2721,7,20915,1161,0,2,0,1,0
21936,210,4415,1168,838,957,57,25,144,1225,19,348,224,416,367,640,3018,5452,11,61921,3440,1,2,0,1,0
21937,208,4359,1943,715,1694,26,18,214,1969,12,185,120,237,197,357,1436,2721,7,20915,1161,0,2,2,0,0
21938,208,4359,1168,838,957,57,25,144,1225,19,348,224,416,367,640,3018,5452,11,61921,3440,1,2,2,0,0
21939,90,4395,1943,715,1694,26,18,214,1969,12,185,120,237,197,357,1436,2721,7,20915,1161,0,2,3,0,0
21940,83,2145,1455,414,1257,16,76,112,1471,5,41,23,46,46,69,231,381,2,1069,59,0,2,128,45,0
21941,83,2145,669,365,481,22,61,110,691,15,103,63,122,118,185,747,1273,8,11311,628,0,2,128,45,0
21942,69,3184,1455,414,1257,16,76,112,1471,5,41,23,46,46,69,231,381,2,1069,59,0,2,21,0,0
21943,33,707,125,97,103,3,0,19,128,9,25,17,27,34,44,144,223,4,1087,60,0,2,2,1,0
21944,76,3201,1178,367,1042,6,15,115,1184,9,94,51,95,103,146,644,976,4,4439,246,0,2,25,0,0
21945,352,7039,1457,730,1242,11,6,188,1468,10,292,166,329,302,495,2424,4078,5,22973,1276,1,2,11,4,0
21946,352,7039,74,35,59,1,0,14,75,3,14,7,14,17,21,58,85,1,128,7,0,2,11,4,0
21947,352,7039,245,125,200,5,7,34,250,7,30,17,34,37,51,166,265,3,1053,58,0,2,11,4,0
21948,84,4429,1457,730,1242,11,6,188,1468,10,292,166,329,302,495,2424,4078,5,22973,1276,1,2,7,0,0
21949,352,7048,1457,730,1242,11,6,188,1468,10,292,166,329,302,495,2424,4078,5,22973,1276,1,2,3,2,0
21950,352,7048,74,35,59,1,0,14,75,3,14,7,14,17,21,58,85,1,128,7,0,2,3,2,0
21951,352,7048,245,125,200,5,7,34,250,7,30,17,34,37,51,166,265,3,1053,58,0,2,3,2,0
21952,349,7017,1457,730,1242,11,6,188,1468,10,292,166,329,302,495,2424,4078,5,22973,1276,1,2,0,4,0
21953,349,7017,74,35,59,1,0,14,75,3,14,7,14,17,21,58,85,1,128,7,0,2,0,4,0
21954,349,7017,245,125,200,5,7,34,250,7,30,17,34,37,51,166,265,3,1053,58,0,2,0,4,0
21955,51,595,647,139,84,35,284,233,682,0,0,0,0,0,0,0,0,0,0,0,0,2,8,1,0
21956,71,1415,1178,367,1042,6,15,115,1184,9,94,51,95,103,146,644,976,4,4439,246,0,2,10,8,0
21957,71,1415,177,108,140,8,0,27,185,6,30,16,32,36,48,162,248,3,794,44,0,2,10,8,0
21958,210,4415,1943,715,1694,26,18,214,1969,12,185,120,237,197,357,1436,2721,7,20915,1161,0,2,8,4,0
21959,210,4415,1168,838,957,57,25,144,1225,19,348,224,416,367,640,3018,5452,11,61921,3440,1,2,8,4,0
21960,77,3237,1178,367,1042,6,15,115,1184,9,94,51,95,103,146,644,976,4,4439,246,0,2,15,0,0
21961,349,7017,1457,730,1242,11,6,188,1468,10,292,166,329,302,495,2424,4078,5,22973,1276,1,2,8,4,0
21962,349,7017,74,35,59,1,0,14,75,3,14,7,14,17,21,58,85,1,128,7,0,2,8,4,0
21963,349,7017,245,125,200,5,7,34,250,7,30,17,34,37,51,166,265,3,1053,58,0,2,8,4,0
21964,84,4429,1457,730,1242,11,6,188,1468,10,292,166,329,302,495,2424,4078,5,22973,1276,1,2,7,0,0
21965,352,7076,1457,730,1242,11,6,188,1468,10,292,166,329,302,495,2424,4078,5,22973,1276,1,2,8,4,0
21966,352,7076,74,35,59,1,0,14,75,3,14,7,14,17,21,58,85,1,128,7,0,2,8,4,0
21967,352,7076,245,125,200,5,7,34,250,7,30,17,34,37,51,166,265,3,1053,58,0,2,8,4,0
21968,234,5348,4293,999,3693,19,54,507,4312,9,155,88,170,164,258,1156,1898,4,9368,520,0,2,9,4,0
21969,234,5348,1482,859,1002,125,135,219,1607,16,219,134,251,235,385,1766,3032,9,27804,1544,1,2,9,4,0
21970,75,1466,757,253,292,73,244,162,830,13,61,38,67,74,105,409,651,7,4654,258,0,2,14,2,0
21971,211,4429,1943,715,1694,26,18,214,1969,12,185,120,237,197,357,1436,2721,7,20915,1161,0,2,2,0,0
21972,211,4429,1168,838,957,57,25,144,1225,19,348,224,416,367,640,3018,5452,11,61921,3440,1,2,2,0,0
21973,52,3387,520,294,400,33,13,81,553,10,261,204,367,271,571,2128,4614,7,32445,1802,1,2,1,0,0
21974,164,7205,139,89,101,2,0,35,141,7,54,34,62,61,96,330,569,4,2287,127,0,2,35,0,0
21975,164,7205,7,5,5,0,0,2,7,1,2,1,2,3,3,2,4,0,2,0,0,2,35,0,0
21976,84,4429,1457,730,1242,11,6,188,1468,10,292,166,329,302,495,2424,4078,5,22973,1276,1,2,7,0,0
21977,91,4606,1943,715,1694,26,18,214,1969,12,185,120,237,197,357,1436,2721,7,20915,1161,0,2,3,0,0
21978,77,3237,1178,367,1042,6,15,115,1184,9,94,51,95,103,146,644,976,4,4439,246,0,2,1,1,0
21979,77,3237,1178,367,1042,6,15,115,1184,9,94,51,95,103,146,644,976,4,4439,246,0,2,1,1,0
21980,352,7076,1457,730,1242,11,6,188,1468,10,292,166,329,302,495,2424,4078,5,22973,1276,1,2,8,4,0
21981,352,7076,74,35,59,1,0,14,75,3,14,7,14,17,21,58,85,1,128,7,0,2,8,4,0
21982,352,7076,245,125,200,5,7,34,250,7,30,17,34,37,51,166,265,3,1053,58,0,2,8,4,0
21983,234,5348,4293,999,3693,19,54,507,4312,9,155,88,170,164,258,1156,1898,4,9368,520,0,2,9,4,0
21984,234,5348,1482,859,1002,125,135,219,1607,16,219,134,251,235,385,1766,3032,9,27804,1544,1,2,9,4,0
21985,75,1466,757,253,292,73,244,162,830,13,61,38,67,74,105,409,651,7,4654,258,0,2,14,2,0
21986,211,4429,1943,715,1694,26,18,214,1969,12,185,120,237,197,357,1436,2721,7,20915,1161,0,2,2,0,0
21987,211,4429,1168,838,957,57,25,144,1225,19,348,224,416,367,640,3018,5452,11,61921,3440,1,2,2,0,0
21988,52,3387,520,294,400,33,13,81,553,10,261,204,367,271,571,2128,4614,7,32445,1802,1,2,1,0,0
21989,164,7205,139,89,101,2,0,35,141,7,54,34,62,61,96,330,569,4,2287,127,0,2,35,0,0
21990,164,7205,7,5,5,0,0,2,7,1,2,1,2,3,3,2,4,0,2,0,0,2,35,0,0
21991,84,4429,1457,730,1242,11,6,188,1468,10,292,166,329,302,495,2424,4078,5,22973,1276,1,2,7,0,0
21992,91,4606,1943,715,1694,26,18,214,1969,12,185,120,237,197,357,1436,2721,7,20915,1161,0,2,3,0,0
21993,72,1450,757,253,292,73,244,162,830,13,61,38,67,74,105,409,651,7,4654,258,0,2,6,9,0
21994,15,468,42,7,35,4,0,5,46,1,2,1,2,3,3,2,4,0,2,0,0,2,1,0,0
21995,15,468,11,6,10,0,0,1,11,2,4,2,4,6,6,10,15,1,15,0,0,2,1,0,0
21996,355,7107,1457,730,1242,11,6,188,1468,10,292,166,329,302,495,2424,4078,5,22973,1276,1,2,4,0,0
21997,355,7107,74,35,59,1,0,14,75,3,14,7,14,17,21,58,85,1,128,7,0,2,4,0,0
21998,355,7107,245,125,200,5,7,34,250,7,30,17,34,37,51,166,265,3,1053,58,0,2,4,0,0
21999,12,459,75,38,59,1,3,12,76,2,4,2,4,6,6,10,15,1,15,0,0,2,9,0,0
22000,355,7114,1457,730,1242,11,6,188,1468,10,292,166,329,302,495,2424,4078,5,22973,1276,1,2,4,4,0
22001,355,7114,74,35,59,1,0,14,75,3,14,7,14,17,21,58,85,1,128,7,0,2,4,4,0
22002,355,7114,245,125,200,5,7,34,250,7,30,17,34,37,51,166,265,3,1053,58,0,2,4,4,0
22003,355,7114,1457,730,1242,11,6,188,1468,10,292,166,329,302,495,2424,4078,5,22973,1276,1,2,6,2,0
22004,355,7114,74,35,59,1,0,14,75,3,14,7,14,17,21,58,85,1,128,7,0,2,6,2,0
22005,355,7114,245,125,200,5,7,34,250,7,30,17,34,37,51,166,265,3,1053,58,0,2,6,2,0
22006,12,459,75,38,59,1,3,12,76,2,4,2,4,6,6,10,15,1,15,0,0,2,9,0,0
22007,70,1621,996,429,845,24,10,117,1020,7,76,50,88,83,138,494,879,4,3565,198,0,2,43,0,0
22008,70,1621,456,277,329,12,42,72,468,13,85,50,97,98,147,592,972,7,7212,400,0,2,43,0,0
22009,34,2709,996,429,845,24,10,117,1020,7,76,50,88,83,138,494,879,4,3565,198,0,2,113,4,0
22010,79,2068,773,422,505,30,103,129,803,14,77,46,83,91,129,535,839,7,6334,351,0,2,1,0,0
22011,117,2804,77,34,69,0,0,8,77,3,24,16,29,27,45,114,213,1,387,21,0,2,1,1,0
22012,117,2804,712,438,573,51,9,84,763,14,102,71,128,116,199,733,1364,8,11988,666,0,2,1,1,0
22013,79,2068,773,422,505,30,103,129,803,14,77,46,83,91,129,535,839,7,6334,351,0,2,1,0,0
22014,117,2804,77,34,69,0,0,8,77,3,24,16,29,27,45,114,213,1,387,21,0,2,1,1,0
22015,117,2804,712,438,573,51,9,84,763,14,102,71,128,116,199,733,1364,8,11988,666,0,2,1,1,0
22016,75,1466,757,253,292,73,244,162,830,13,61,38,67,74,105,409,651,7,4654,258,0,2,9,6,0
22017,15,466,42,7,35,4,0,5,46,1,2,1,2,3,3,2,4,0,2,0,0,2,0,1,0
22018,15,466,11,6,10,0,0,1,11,2,4,2,4,6,6,10,15,1,15,0,0,2,0,1,0
22019,85,2183,773,422,505,30,103,129,803,14,77,46,83,91,129,535,839,7,6334,351,0,2,1,0,0
22020,123,2925,77,34,69,0,0,8,77,3,24,16,29,27,45,114,213,1,387,21,0,2,1,1,0
22021,123,2925,712,438,573,51,9,84,763,14,102,71,128,116,199,733,1364,8,11988,666,0,2,1,1,0
22022,72,1450,757,253,292,73,244,162,830,13,61,38,67,74,105,409,651,7,4654,258,0,2,6,9,0
22023,15,470,42,7,35,4,0,5,46,1,2,1,2,3,3,2,4,0,2,0,0,2,1,0,0
22024,15,470,11,6,10,0,0,1,11,2,4,2,4,6,6,10,15,1,15,0,0,2,1,0,0
22025,75,1466,757,253,292,73,244,162,830,13,61,38,67,74,105,409,651,7,4654,258,0,2,9,6,0
22026,15,466,42,7,35,4,0,5,46,1,2,1,2,3,3,2,4,0,2,0,0,2,0,1,0
22027,15,466,11,6,10,0,0,1,11,2,4,2,4,6,6,10,15,1,15,0,0,2,0,1,0
22028,85,2183,773,422,505,30,103,129,803,14,77,46,83,91,129,535,839,7,6334,351,0,2,1,0,0
22029,123,2925,77,34,69,0,0,8,77,3,24,16,29,27,45,114,213,1,387,21,0,2,1,1,0
22030,123,2925,712,438,573,51,9,84,763,14,102,71,128,116,199,733,1364,8,11988,666,0,2,1,1,0
22031,72,1450,757,253,292,73,244,162,830,13,61,38,67,74,105,409,651,7,4654,258,0,2,6,9,0
22032,15,470,42,7,35,4,0,5,46,1,2,1,2,3,3,2,4,0,2,0,0,2,1,0,0
22033,15,470,11,6,10,0,0,1,11,2,4,2,4,6,6,10,15,1,15,0,0,2,1,0,0
22034,353,7096,1457,730,1242,11,6,188,1468,10,292,166,329,302,495,2424,4078,5,22973,1276,1,2,3,4,0
22035,353,7096,74,35,59,1,0,14,75,3,14,7,14,17,21,58,85,1,128,7,0,2,3,4,0
22036,353,7096,245,125,200,5,7,34,250,7,30,17,34,37,51,166,265,3,1053,58,0,2,3,4,0
22037,355,7107,1457,730,1242,11,6,188,1468,10,292,166,329,302,495,2424,4078,5,22973,1276,1,2,25,19,0
22038,355,7107,74,35,59,1,0,14,75,3,14,7,14,17,21,58,85,1,128,7,0,2,25,19,0
22039,355,7107,245,125,200,5,7,34,250,7,30,17,34,37,51,166,265,3,1053,58,0,2,25,19,0
22040,355,7107,1457,730,1242,11,6,188,1468,10,292,166,329,302,495,2424,4078,5,22973,1276,1,2,28,23,0
22041,355,7107,74,35,59,1,0,14,75,3,14,7,14,17,21,58,85,1,128,7,0,2,28,23,0
22042,355,7107,245,125,200,5,7,34,250,7,30,17,34,37,51,166,265,3,1053,58,0,2,28,23,0
22043,1,301,382,65,130,157,2,92,539,4,10,5,10,14,15,41,57,2,114,6,0,2,6,5,0
22044,141,2980,1513,682,1277,25,13,200,1538,11,199,116,219,210,335,1557,2584,6,15641,868,0,2,14,4,1
22045,141,2980,819,519,539,24,98,155,843,15,96,57,106,111,163,690,1107,8,9171,509,0,2,14,4,1
22046,234,5348,4293,999,3693,19,54,507,4312,9,155,88,170,164,258,1156,1898,4,9368,520,0,2,1,1,1
22047,234,5348,1482,859,1002,125,135,219,1607,16,219,134,251,235,385,1766,3032,9,27804,1544,1,2,1,1,1
22048,67,1795,1455,414,1257,16,76,112,1471,5,41,23,46,46,69,231,381,2,1069,59,0,2,1,1,0
22049,67,1795,669,365,481,22,61,110,691,15,103,63,122,118,185,747,1273,8,11311,628,0,2,1,1,0
22050,234,5348,4293,999,3693,19,54,507,4312,9,155,88,170,164,258,1156,1898,4,9368,520,0,2,9,1,1
22051,234,5348,1482,859,1002,125,135,219,1607,16,219,134,251,235,385,1766,3032,9,27804,1544,1,2,9,1,1
22052,87,2475,1523,757,1297,19,12,193,1542,12,193,117,230,205,347,1508,2664,7,19053,1058,0,2,5,0,1
22053,87,2475,701,378,504,33,58,109,734,13,110,68,126,123,194,794,1346,7,10027,557,0,2,5,0,1
22054,75,1466,757,253,292,73,244,162,830,13,61,38,67,74,105,409,651,7,4654,258,0,2,3,2,0
22055,46,954,386,256,301,16,9,68,402,4,59,35,69,63,104,355,621,2,1453,80,0,2,5,8,0
22056,46,954,264,131,164,11,41,46,275,6,38,22,40,44,62,214,338,3,1068,59,0,2,5,8,0
22057,16,480,442,244,305,14,16,103,456,11,68,45,75,79,120,452,756,6,4588,254,0,2,2,0,0
22058,16,480,182,102,99,11,40,35,193,3,11,6,11,14,17,42,64,1,97,5,0,2,2,0,0
22059,108,2219,1020,354,843,12,15,144,1032,8,134,77,144,142,221,970,1580,4,6792,377,0,2,15,0,0
22060,259,6118,72,33,56,0,4,12,72,1,1,1,1,2,2,0,2,0,1,0,0,2,1,1,0
22061,259,6118,1454,835,1044,76,110,219,1530,17,275,158,296,292,454,2297,3718,9,34017,1889,1,2,1,1,0
22062,141,2980,1513,682,1277,25,13,200,1538,11,199,116,219,210,335,1557,2584,6,15641,868,0,2,2,3,1
22063,141,2980,819,519,539,24,98,155,843,15,96,57,106,111,163,690,1107,8,9171,509,0,2,2,3,1
22064,349,7017,1457,730,1242,11,6,188,1468,10,292,166,329,302,495,2424,4078,5,22973,1276,1,2,1,1,0
22065,349,7017,74,35,59,1,0,14,75,3,14,7,14,17,21,58,85,1,128,7,0,2,1,1,0
22066,349,7017,245,125,200,5,7,34,250,7,30,17,34,37,51,166,265,3,1053,58,0,2,1,1,0
22067,211,4427,1943,715,1694,26,18,214,1969,12,185,120,237,197,357,1436,2721,7,20915,1161,0,2,2,2,0
22068,211,4427,1168,838,957,57,25,144,1225,19,348,224,416,367,640,3018,5452,11,61921,3440,1,2,2,2,0
22069,79,1689,53,23,39,0,0,13,53,2,8,4,8,10,12,26,39,1,39,2,0,2,0,1,0
22070,79,1689,515,298,307,33,80,99,548,12,63,44,77,75,121,419,753,7,5527,307,0,2,0,1,0
22071,74,1565,402,202,227,24,74,80,426,12,52,33,61,64,94,339,564,7,3969,220,0,2,37,1,1
22072,68,1508,53,23,39,0,0,13,53,2,8,4,8,10,12,26,39,1,39,2,0,2,1,38,1
22073,68,1508,515,298,307,33,80,99,548,12,63,44,77,75,121,419,753,7,5527,307,0,2,1,38,1
22074,122,2921,77,34,69,0,0,8,77,3,24,16,29,27,45,114,213,1,387,21,0,2,1,4,1
22075,122,2921,712,438,573,51,9,84,763,14,102,71,128,116,199,733,1364,8,11988,666,0,2,1,4,1
22076,69,1540,53,23,39,0,0,13,53,2,8,4,8,10,12,26,39,1,39,2,0,2,29,25,1
22077,69,1540,515,298,307,33,80,99,548,12,63,44,77,75,121,419,753,7,5527,307,0,2,29,25,1
22078,16,1213,215,129,180,6,0,29,221,8,65,43,72,73,115,415,711,4,3153,175,0,2,1,1,1
22079,98,2008,773,419,590,28,0,166,801,10,204,113,217,214,330,1598,2554,5,13587,754,0,2,5,11,0
22080,98,2008,421,273,302,44,34,57,465,17,81,59,107,98,166,583,1098,11,12329,684,0,2,5,11,0
22081,213,4606,182,127,129,0,0,53,182,5,39,21,42,44,63,217,343,2,926,51,0,2,9,7,0
22082,213,4606,1165,710,800,67,119,181,1232,18,243,153,282,261,435,2000,3492,10,36473,2026,1,2,9,7,0
22083,74,1569,402,202,227,24,74,80,426,12,52,33,61,64,94,339,564,7,3969,220,0,2,14,13,0
22084,86,1823,773,419,590,28,0,166,801,10,204,113,217,214,330,1598,2554,5,13587,754,0,2,2,40,0
22085,86,1823,421,273,302,44,34,57,465,17,81,59,107,98,166,583,1098,11,12329,684,0,2,2,40,0
22086,85,1818,773,419,590,28,0,166,801,10,204,113,217,214,330,1598,2554,5,13587,754,0,2,0,2,0
22087,85,1818,421,273,302,44,34,57,465,17,81,59,107,98,166,583,1098,11,12329,684,0,2,0,2,0
22088,84,1807,773,419,590,28,0,166,801,10,204,113,217,214,330,1598,2554,5,13587,754,0,2,5,5,0
22089,84,1807,421,273,302,44,34,57,465,17,81,59,107,98,166,583,1098,11,12329,684,0,2,5,5,0
22090,84,1807,773,419,590,28,0,166,801,10,204,113,217,214,330,1598,2554,5,13587,754,0,2,1,2,0
22091,84,1807,421,273,302,44,34,57,465,17,81,59,107,98,166,583,1098,11,12329,684,0,2,1,2,0
22092,84,1807,773,419,590,28,0,166,801,10,204,113,217,214,330,1598,2554,5,13587,754,0,2,1,0,0
22093,84,1807,421,273,302,44,34,57,465,17,81,59,107,98,166,583,1098,11,12329,684,0,2,1,0,0
22094,357,7141,1457,730,1242,11,6,188,1468,10,292,166,329,302,495,2424,4078,5,22973,1276,1,2,6,0,0
22095,357,7141,74,35,59,1,0,14,75,3,14,7,14,17,21,58,85,1,128,7,0,2,6,0,0
22096,357,7141,245,125,200,5,7,34,250,7,30,17,34,37,51,166,265,3,1053,58,0,2,6,0,0
22097,15,742,75,38,59,1,3,12,76,2,4,2,4,6,6,10,15,1,15,0,0,2,67,0,0
22098,71,1698,996,429,845,24,10,117,1020,7,76,50,88,83,138,494,879,4,3565,198,0,2,29,18,1
22099,71,1698,456,277,329,12,42,72,468,13,85,50,97,98,147,592,972,7,7212,400,0,2,29,18,1
22100,36,2884,996,429,845,24,10,117,1020,7,76,50,88,83,138,494,879,4,3565,198,0,2,30,0,1
22101,46,963,447,308,343,6,5,95,453,7,96,59,111,103,170,651,1136,4,4600,255,0,2,1,1,0
22102,46,963,322,174,179,16,74,51,338,10,41,26,46,51,72,252,408,5,2291,127,0,2,1,1,0
22103,46,963,447,308,343,6,5,95,453,7,96,59,111,103,170,651,1136,4,4600,255,0,2,1,1,0
22104,46,963,322,174,179,16,74,51,338,10,41,26,46,51,72,252,408,5,2291,127,0,2,1,1,0
22105,122,2921,77,34,69,0,0,8,77,3,24,16,29,27,45,114,213,1,387,21,0,2,1,4,0
22106,122,2921,712,438,573,51,9,84,763,14,102,71,128,116,199,733,1364,8,11988,666,0,2,1,4,0
22107,74,1569,402,202,227,24,74,80,426,12,52,33,61,64,94,339,564,7,3969,220,0,2,45,8,0
22108,69,1540,53,23,39,0,0,13,53,2,8,4,8,10,12,26,39,1,39,2,0,2,29,63,0
22109,69,1540,515,298,307,33,80,99,548,12,63,44,77,75,121,419,753,7,5527,307,0,2,29,63,0
22110,211,4427,1943,715,1694,26,18,214,1969,12,185,120,237,197,357,1436,2721,7,20915,1161,0,2,2,2,0
22111,211,4427,1168,838,957,57,25,144,1225,19,348,224,416,367,640,3018,5452,11,61921,3440,1,2,2,2,0
22112,16,1213,215,129,180,6,0,29,221,8,65,43,72,73,115,415,711,4,3153,175,0,2,1,1,0
22113,13,572,139,89,101,2,0,35,141,7,54,34,62,61,96,330,569,4,2287,127,0,2,2,0,0
22114,80,2091,773,422,505,30,103,129,803,14,77,46,83,91,129,535,839,7,6334,351,0,2,11,2,0
22115,213,4606,182,127,129,0,0,53,182,5,39,21,42,44,63,217,343,2,926,51,0,2,9,7,0
22116,213,4606,1165,710,800,67,119,181,1232,18,243,153,282,261,435,2000,3492,10,36473,2026,1,2,9,7,0
22117,84,1807,773,419,590,28,0,166,801,10,204,113,217,214,330,1598,2554,5,13587,754,0,2,13,59,0
22118,84,1807,421,273,302,44,34,57,465,17,81,59,107,98,166,583,1098,11,12329,684,0,2,13,59,0
22119,213,4560,1943,715,1694,26,18,214,1969,12,185,120,237,197,357,1436,2721,7,20915,1161,0,2,37,5,0
22120,213,4560,1168,838,957,57,25,144,1225,19,348,224,416,367,640,3018,5452,11,61921,3440,1,2,37,5,0
22121,80,2091,773,422,505,30,103,129,803,14,77,46,83,91,129,535,839,7,6334,351,0,2,11,2,0
22122,13,572,139,89,101,2,0,35,141,7,54,34,62,61,96,330,569,4,2287,127,0,2,2,0,0
22123,352,7059,1457,730,1242,11,6,188,1468,10,292,166,329,302,495,2424,4078,5,22973,1276,1,2,6,18,0
22124,352,7059,74,35,59,1,0,14,75,3,14,7,14,17,21,58,85,1,128,7,0,2,6,18,0
22125,352,7059,245,125,200,5,7,34,250,7,30,17,34,37,51,166,265,3,1053,58,0,2,6,18,0
22126,213,4560,1943,715,1694,26,18,214,1969,12,185,120,237,197,357,1436,2721,7,20915,1161,0,2,37,5,0
22127,213,4560,1168,838,957,57,25,144,1225,19,348,224,416,367,640,3018,5452,11,61921,3440,1,2,37,5,0
22128,144,3005,1513,682,1277,25,13,200,1538,11,199,116,219,210,335,1557,2584,6,15641,868,0,2,13,2,1
22129,144,3005,819,519,539,24,98,155,843,15,96,57,106,111,163,690,1107,8,9171,509,0,2,13,2,1
22130,129,5195,1513,682,1277,25,13,200,1538,11,199,116,219,210,335,1557,2584,6,15641,868,0,2,24,0,1
22131,352,7059,1457,730,1242,11,6,188,1468,10,292,166,329,302,495,2424,4078,5,22973,1276,1,2,6,18,0
22132,352,7059,74,35,59,1,0,14,75,3,14,7,14,17,21,58,85,1,128,7,0,2,6,18,0
22133,352,7059,245,125,200,5,7,34,250,7,30,17,34,37,51,166,265,3,1053,58,0,2,6,18,0
22134,144,3005,1513,682,1277,25,13,200,1538,11,199,116,219,210,335,1557,2584,6,15641,868,0,2,13,2,0
22135,144,3005,819,519,539,24,98,155,843,15,96,57,106,111,163,690,1107,8,9171,509,0,2,13,2,0
22136,129,5195,1513,682,1277,25,13,200,1538,11,199,116,219,210,335,1557,2584,6,15641,868,0,2,24,0,0
22137,76,1523,757,253,292,73,244,162,830,13,61,38,67,74,105,409,651,7,4654,258,0,2,21,4,1
22138,53,3494,520,294,400,33,13,81,553,10,261,204,367,271,571,2128,4614,7,32445,1802,1,2,11,0,1
22139,80,1573,757,253,292,73,244,162,830,13,61,38,67,74,105,409,651,7,4654,258,0,2,10,5,1
22140,54,3601,520,294,400,33,13,81,553,10,261,204,367,271,571,2128,4614,7,32445,1802,1,2,11,0,1
22141,80,1590,757,253,292,73,244,162,830,13,61,38,67,74,105,409,651,7,4654,258,0,2,5,11,0
22142,144,3008,1513,682,1277,25,13,200,1538,11,199,116,219,210,335,1557,2584,6,15641,868,0,2,13,4,0
22143,144,3008,819,519,539,24,98,155,843,15,96,57,106,111,163,690,1107,8,9171,509,0,2,13,4,0
22144,349,7017,1457,730,1242,11,6,188,1468,10,292,166,329,302,495,2424,4078,5,22973,1276,1,2,1,1,0
22145,349,7017,74,35,59,1,0,14,75,3,14,7,14,17,21,58,85,1,128,7,0,2,1,1,0
22146,349,7017,245,125,200,5,7,34,250,7,30,17,34,37,51,166,265,3,1053,58,0,2,1,1,0
22147,67,1795,1455,414,1257,16,76,112,1471,5,41,23,46,46,69,231,381,2,1069,59,0,2,1,1,0
22148,67,1795,669,365,481,22,61,110,691,15,103,63,122,118,185,747,1273,8,11311,628,0,2,1,1,0
22149,234,5348,4293,999,3693,19,54,507,4312,9,155,88,170,164,258,1156,1898,4,9368,520,0,2,10,2,0
22150,234,5348,1482,859,1002,125,135,219,1607,16,219,134,251,235,385,1766,3032,9,27804,1544,1,2,10,2,0
22151,87,2475,1523,757,1297,19,12,193,1542,12,193,117,230,205,347,1508,2664,7,19053,1058,0,2,5,0,0
22152,87,2475,701,378,504,33,58,109,734,13,110,68,126,123,194,794,1346,7,10027,557,0,2,5,0,0
22153,108,2219,1020,354,843,12,15,144,1032,8,134,77,144,142,221,970,1580,4,6792,377,0,2,15,0,0
22154,259,6118,72,33,56,0,4,12,72,1,1,1,1,2,2,0,2,0,1,0,0,2,1,1,0
22155,259,6118,1454,835,1044,76,110,219,1530,17,275,158,296,292,454,2297,3718,9,34017,1889,1,2,1,1,0
22156,75,1466,757,253,292,73,244,162,830,13,61,38,67,74,105,409,651,7,4654,258,0,2,3,2,0
22157,46,954,386,256,301,16,9,68,402,4,59,35,69,63,104,355,621,2,1453,80,0,2,5,8,0
22158,46,954,264,131,164,11,41,46,275,6,38,22,40,44,62,214,338,3,1068,59,0,2,5,8,0
22159,16,480,442,244,305,14,16,103,456,11,68,45,75,79,120,452,756,6,4588,254,0,2,2,0,0
22160,16,480,182,102,99,11,40,35,193,3,11,6,11,14,17,42,64,1,97,5,0,2,2,0,0
22161,1,301,382,65,130,157,2,92,539,4,10,5,10,14,15,41,57,2,114,6,0,2,6,5,0
22162,80,1599,757,253,292,73,244,162,830,13,61,38,67,74,105,409,651,7,4654,258,0,2,8,4,0
22163,129,5207,1513,682,1277,25,13,200,1538,11,199,116,219,210,335,1557,2584,6,15641,868,0,2,4,2,0
22164,145,3016,1513,682,1277,25,13,200,1538,11,199,116,219,210,335,1557,2584,6,15641,868,0,2,4,1,0
22165,145,3016,819,519,539,24,98,155,843,15,96,57,106,111,163,690,1107,8,9171,509,0,2,4,1,0
22166,145,3018,1513,682,1277,25,13,200,1538,11,199,116,219,210,335,1557,2584,6,15641,868,0,2,1,1,0
22167,145,3018,819,519,539,24,98,155,843,15,96,57,106,111,163,690,1107,8,9171,509,0,2,1,1,0
22168,80,2091,773,422,505,30,103,129,803,14,77,46,83,91,129,535,839,7,6334,351,0,2,1,2,0
22169,80,2091,773,422,505,30,103,129,803,14,77,46,83,91,129,535,839,7,6334,351,0,2,1,2,0
22170,77,1551,757,253,292,73,244,162,830,13,61,38,67,74,105,409,651,7,4654,258,0,2,8,12,1
22171,145,3018,1513,682,1277,25,13,200,1538,11,199,116,219,210,335,1557,2584,6,15641,868,0,2,5,2,0
22172,145,3018,819,519,539,24,98,155,843,15,96,57,106,111,163,690,1107,8,9171,509,0,2,5,2,0
22173,129,5207,1513,682,1277,25,13,200,1538,11,199,116,219,210,335,1557,2584,6,15641,868,0,2,4,2,0
22174,145,3018,1513,682,1277,25,13,200,1538,11,199,116,219,210,335,1557,2584,6,15641,868,0,2,31,8,0
22175,145,3018,819,519,539,24,98,155,843,15,96,57,106,111,163,690,1107,8,9171,509,0,2,31,8,0
22176,352,7059,1457,730,1242,11,6,188,1468,10,292,166,329,302,495,2424,4078,5,22973,1276,1,2,1,1,0
22177,352,7059,74,35,59,1,0,14,75,3,14,7,14,17,21,58,85,1,128,7,0,2,1,1,0
22178,352,7059,245,125,200,5,7,34,250,7,30,17,34,37,51,166,265,3,1053,58,0,2,1,1,0
22179,83,2145,1455,414,1257,16,76,112,1471,5,41,23,46,46,69,231,381,2,1069,59,0,2,1,1,0
22180,83,2145,669,365,481,22,61,110,691,15,103,63,122,118,185,747,1273,8,11311,628,0,2,1,1,0
22181,234,5348,4293,999,3693,19,54,507,4312,9,155,88,170,164,258,1156,1898,4,9368,520,0,2,10,2,0
22182,234,5348,1482,859,1002,125,135,219,1607,16,219,134,251,235,385,1766,3032,9,27804,1544,1,2,10,2,0
22183,98,2670,1523,757,1297,19,12,193,1542,12,193,117,230,205,347,1508,2664,7,19053,1058,0,2,7,1,0
22184,98,2670,701,378,504,33,58,109,734,13,110,68,126,123,194,794,1346,7,10027,557,0,2,7,1,0
22185,86,2206,773,422,505,30,103,129,803,14,77,46,83,91,129,535,839,7,6334,351,0,2,10,2,0
22186,24,600,2,2,2,0,0,0,2,0,0,0,0,0,0,0,0,0,0,0,0,2,15,0,0
22187,24,600,99,48,90,1,3,5,100,0,0,0,0,0,0,0,0,0,0,0,0,2,15,0,0
22188,24,600,8,5,5,2,0,1,10,0,0,0,0,0,0,0,0,0,0,0,0,2,15,0,0
22189,24,600,1217,716,841,84,126,174,1301,14,185,118,215,199,333,1446,2542,8,20687,1149,0,2,15,0,0
22190,24,600,160,89,115,0,13,31,160,7,15,11,17,22,28,78,124,3,495,27,0,2,15,0,0
22191,24,600,10,10,9,9,0,0,19,0,0,0,0,0,0,0,0,0,0,0,0,2,15,0,0
22192,24,600,173,84,99,8,29,36,181,5,12,7,13,17,20,54,81,2,221,12,0,2,15,0,0
22193,24,600,3,1,1,3,0,0,6,0,0,0,0,0,0,0,0,0,0,0,0,2,15,0,0
22194,46,963,447,308,343,6,5,95,453,7,96,59,111,103,170,651,1136,4,4600,255,0,2,1,1,0
22195,46,963,322,174,179,16,74,51,338,10,41,26,46,51,72,252,408,5,2291,127,0,2,1,1,0
22196,259,6120,72,33,56,0,4,12,72,1,1,1,1,2,2,0,2,0,1,0,0,2,1,1,0
22197,259,6120,1454,835,1044,76,110,219,1530,17,275,158,296,292,454,2297,3718,9,34017,1889,1,2,1,1,0
22198,72,1450,757,253,292,73,244,162,830,13,61,38,67,74,105,409,651,7,4654,258,0,2,3,2,0
22199,46,954,386,256,301,16,9,68,402,4,59,35,69,63,104,355,621,2,1453,80,0,2,5,8,0
22200,46,954,264,131,164,11,41,46,275,6,38,22,40,44,62,214,338,3,1068,59,0,2,5,8,0
22201,16,480,442,244,305,14,16,103,456,11,68,45,75,79,120,452,756,6,4588,254,0,2,2,0,0
22202,16,480,182,102,99,11,40,35,193,3,11,6,11,14,17,42,64,1,97,5,0,2,2,0,0
22203,1,301,382,65,130,157,2,92,539,4,10,5,10,14,15,41,57,2,114,6,0,2,6,5,0
22204,13,572,139,89,101,2,0,35,141,7,54,34,62,61,96,330,569,4,2287,127,0,2,2,0,0
22205,129,5207,1513,682,1277,25,13,200,1538,11,199,116,219,210,335,1557,2584,6,15641,868,0,2,28,2,0
22206,77,1551,757,253,292,73,244,162,830,13,61,38,67,74,105,409,651,7,4654,258,0,2,34,18,0
22207,54,3601,520,294,400,33,13,81,553,10,261,204,367,271,571,2128,4614,7,32445,1802,1,2,22,0,0
22208,145,3018,1513,682,1277,25,13,200,1538,11,199,116,219,210,335,1557,2584,6,15641,868,0,2,31,8,0
22209,145,3018,819,519,539,24,98,155,843,15,96,57,106,111,163,690,1107,8,9171,509,0,2,31,8,0
22210,352,7059,1457,730,1242,11,6,188,1468,10,292,166,329,302,495,2424,4078,5,22973,1276,1,2,1,1,0
22211,352,7059,74,35,59,1,0,14,75,3,14,7,14,17,21,58,85,1,128,7,0,2,1,1,0
22212,352,7059,245,125,200,5,7,34,250,7,30,17,34,37,51,166,265,3,1053,58,0,2,1,1,0
22213,83,2145,1455,414,1257,16,76,112,1471,5,41,23,46,46,69,231,381,2,1069,59,0,2,1,1,0
22214,83,2145,669,365,481,22,61,110,691,15,103,63,122,118,185,747,1273,8,11311,628,0,2,1,1,0
22215,234,5348,4293,999,3693,19,54,507,4312,9,155,88,170,164,258,1156,1898,4,9368,520,0,2,10,2,0
22216,234,5348,1482,859,1002,125,135,219,1607,16,219,134,251,235,385,1766,3032,9,27804,1544,1,2,10,2,0
22217,98,2670,1523,757,1297,19,12,193,1542,12,193,117,230,205,347,1508,2664,7,19053,1058,0,2,7,1,0
22218,98,2670,701,378,504,33,58,109,734,13,110,68,126,123,194,794,1346,7,10027,557,0,2,7,1,0
22219,86,2206,773,422,505,30,103,129,803,14,77,46,83,91,129,535,839,7,6334,351,0,2,10,2,0
22220,24,600,2,2,2,0,0,0,2,0,0,0,0,0,0,0,0,0,0,0,0,2,15,0,0
22221,24,600,99,48,90,1,3,5,100,0,0,0,0,0,0,0,0,0,0,0,0,2,15,0,0
22222,24,600,8,5,5,2,0,1,10,0,0,0,0,0,0,0,0,0,0,0,0,2,15,0,0
22223,24,600,1217,716,841,84,126,174,1301,14,185,118,215,199,333,1446,2542,8,20687,1149,0,2,15,0,0
22224,24,600,160,89,115,0,13,31,160,7,15,11,17,22,28,78,124,3,495,27,0,2,15,0,0
22225,24,600,10,10,9,9,0,0,19,0,0,0,0,0,0,0,0,0,0,0,0,2,15,0,0
22226,24,600,173,84,99,8,29,36,181,5,12,7,13,17,20,54,81,2,221,12,0,2,15,0,0
22227,24,600,3,1,1,3,0,0,6,0,0,0,0,0,0,0,0,0,0,0,0,2,15,0,0
22228,46,963,447,308,343,6,5,95,453,7,96,59,111,103,170,651,1136,4,4600,255,0,2,1,1,0
22229,46,963,322,174,179,16,74,51,338,10,41,26,46,51,72,252,408,5,2291,127,0,2,1,1,0
22230,259,6120,72,33,56,0,4,12,72,1,1,1,1,2,2,0,2,0,1,0,0,2,1,1,0
22231,259,6120,1454,835,1044,76,110,219,1530,17,275,158,296,292,454,2297,3718,9,34017,1889,1,2,1,1,0
22232,77,1551,757,253,292,73,244,162,830,13,61,38,67,74,105,409,651,7,4654,258,0,2,3,2,0
22233,46,954,386,256,301,16,9,68,402,4,59,35,69,63,104,355,621,2,1453,80,0,2,5,8,0
22234,46,954,264,131,164,11,41,46,275,6,38,22,40,44,62,214,338,3,1068,59,0,2,5,8,0
22235,16,480,442,244,305,14,16,103,456,11,68,45,75,79,120,452,756,6,4588,254,0,2,2,0,0
22236,16,480,182,102,99,11,40,35,193,3,11,6,11,14,17,42,64,1,97,5,0,2,2,0,0
22237,1,301,382,65,130,157,2,92,539,4,10,5,10,14,15,41,57,2,114,6,0,2,6,5,0
22238,13,572,139,89,101,2,0,35,141,7,54,34,62,61,96,330,569,4,2287,127,0,2,2,0,0
22239,129,5207,1513,682,1277,25,13,200,1538,11,199,116,219,210,335,1557,2584,6,15641,868,0,2,28,2,0
22240,71,1698,996,429,845,24,10,117,1020,7,76,50,88,83,138,494,879,4,3565,198,0,2,29,18,0
22241,71,1698,456,277,329,12,42,72,468,13,85,50,97,98,147,592,972,7,7212,400,0,2,29,18,0
22242,36,2884,996,429,845,24,10,117,1020,7,76,50,88,83,138,494,879,4,3565,198,0,2,30,0,0
22243,164,7206,139,89,101,2,0,35,141,7,54,34,62,61,96,330,569,4,2287,127,0,2,13,13,1
22244,164,7206,7,5,5,0,0,2,7,1,2,1,2,3,3,2,4,0,2,0,0,2,13,13,1
22245,236,5368,4293,999,3693,19,54,507,4312,9,155,88,170,164,258,1156,1898,4,9368,520,0,2,10,3,1
22246,236,5368,1482,859,1002,125,135,219,1607,16,219,134,251,235,385,1766,3032,9,27804,1544,1,2,10,3,1
22247,91,3852,1289,550,1043,56,32,155,1345,10,167,93,185,177,278,1266,2075,5,11498,638,0,2,24,0,1
22248,170,7554,139,89,101,2,0,35,141,7,54,34,62,61,96,330,569,4,2287,127,0,2,198,13,1
22249,170,7554,7,5,5,0,0,2,7,1,2,1,2,3,3,2,4,0,2,0,0,2,198,13,1
22250,354,7093,1457,730,1242,11,6,188,1468,10,292,166,329,302,495,2424,4078,5,22973,1276,1,2,6,0,0
22251,354,7093,74,35,59,1,0,14,75,3,14,7,14,17,21,58,85,1,128,7,0,2,6,0,0
22252,354,7093,245,125,200,5,7,34,250,7,30,17,34,37,51,166,265,3,1053,58,0,2,6,0,0
22253,15,742,75,38,59,1,3,12,76,2,4,2,4,6,6,10,15,1,15,0,0,2,67,0,0
22254,236,5368,4293,999,3693,19,54,507,4312,9,155,88,170,164,258,1156,1898,4,9368,520,0,2,10,3,0
22255,236,5368,1482,859,1002,125,135,219,1607,16,219,134,251,235,385,1766,3032,9,27804,1544,1,2,10,3,0
22256,91,3852,1289,550,1043,56,32,155,1345,10,167,93,185,177,278,1266,2075,5,11498,638,0,2,24,0,0
22257,170,7554,139,89,101,2,0,35,141,7,54,34,62,61,96,330,569,4,2287,127,0,2,199,14,0
22258,170,7554,7,5,5,0,0,2,7,1,2,1,2,3,3,2,4,0,2,0,0,2,199,14,0
22259,209,4527,1943,715,1694,26,18,214,1969,12,185,120,237,197,357,1436,2721,7,20915,1161,0,2,2,10,0
22260,209,4527,1168,838,957,57,25,144,1225,19,348,224,416,367,640,3018,5452,11,61921,3440,1,2,2,10,0
22261,23,737,339,213,244,17,9,65,356,10,42,26,48,52,74,259,421,5,2410,133,0,2,6,0,0
22262,46,1902,1293,570,1093,25,15,163,1318,10,195,123,241,205,364,1516,2795,6,17273,959,0,2,25,0,0
22263,209,4527,1943,715,1694,26,18,214,1969,12,185,120,237,197,357,1436,2721,7,20915,1161,0,2,2,10,0
22264,209,4527,1168,838,957,57,25,144,1225,19,348,224,416,367,640,3018,5452,11,61921,3440,1,2,2,10,0
22265,213,4606,182,127,129,0,0,53,182,5,39,21,42,44,63,217,343,2,926,51,0,2,9,7,0
22266,213,4606,1165,710,800,67,119,181,1232,18,243,153,282,261,435,2000,3492,10,36473,2026,1,2,9,7,0
22267,84,1807,773,419,590,28,0,166,801,10,204,113,217,214,330,1598,2554,5,13587,754,0,2,13,59,0
22268,84,1807,421,273,302,44,34,57,465,17,81,59,107,98,166,583,1098,11,12329,684,0,2,13,59,0
22269,71,1698,996,429,845,24,10,117,1020,7,76,50,88,83,138,494,879,4,3565,198,0,2,72,18,0
22270,71,1698,456,277,329,12,42,72,468,13,85,50,97,98,147,592,972,7,7212,400,0,2,72,18,0
22271,354,7093,1457,730,1242,11,6,188,1468,10,292,166,329,302,495,2424,4078,5,22973,1276,1,2,54,45,0
22272,354,7093,74,35,59,1,0,14,75,3,14,7,14,17,21,58,85,1,128,7,0,2,54,45,0
22273,354,7093,245,125,200,5,7,34,250,7,30,17,34,37,51,166,265,3,1053,58,0,2,54,45,0
22274,25,753,339,213,244,17,9,65,356,10,42,26,48,52,74,259,421,5,2410,133,0,2,10,9,0
22275,83,2145,1455,414,1257,16,76,112,1471,5,41,23,46,46,69,231,381,2,1069,59,0,2,128,45,0
22276,83,2145,669,365,481,22,61,110,691,15,103,63,122,118,185,747,1273,8,11311,628,0,2,128,45,0
22277,236,5368,4293,999,3693,19,54,507,4312,9,155,88,170,164,258,1156,1898,4,9368,520,0,2,12,5,0
22278,236,5368,1482,859,1002,125,135,219,1607,16,219,134,251,235,385,1766,3032,9,27804,1544,1,2,12,5,0
22279,51,595,647,139,84,35,284,233,682,0,0,0,0,0,0,0,0,0,0,0,0,2,8,1,0
22280,98,2670,1523,757,1297,19,12,193,1542,12,193,117,230,205,347,1508,2664,7,19053,1058,0,2,78,20,0
22281,98,2670,701,378,504,33,58,109,734,13,110,68,126,123,194,794,1346,7,10027,557,0,2,78,20,0
22282,86,2206,773,422,505,30,103,129,803,14,77,46,83,91,129,535,839,7,6334,351,0,2,30,3,0
22283,122,2921,77,34,69,0,0,8,77,3,24,16,29,27,45,114,213,1,387,21,0,2,27,4,0
22284,122,2921,712,438,573,51,9,84,763,14,102,71,128,116,199,733,1364,8,11988,666,0,2,27,4,0
22285,24,600,2,2,2,0,0,0,2,0,0,0,0,0,0,0,0,0,0,0,0,0,156,0,0
22286,24,600,99,48,90,1,3,5,100,0,0,0,0,0,0,0,0,0,0,0,0,0,156,0,0
22287,24,600,8,5,5,2,0,1,10,0,0,0,0,0,0,0,0,0,0,0,0,0,156,0,0
22288,24,600,1217,716,841,84,126,174,1301,14,185,118,215,199,333,1446,2542,8,20687,1149,0,0,156,0,0
22289,24,600,160,89,115,0,13,31,160,7,15,11,17,22,28,78,124,3,495,27,0,0,156,0,0
22290,24,600,10,10,9,9,0,0,19,0,0,0,0,0,0,0,0,0,0,0,0,0,156,0,0
22291,24,600,173,84,99,8,29,36,181,5,12,7,13,17,20,54,81,2,221,12,0,0,156,0,0
22292,24,600,3,1,1,3,0,0,6,0,0,0,0,0,0,0,0,0,0,0,0,0,156,0,0
22293,33,707,125,97,103,3,0,19,128,9,25,17,27,34,44,144,223,4,1087,60,0,0,126,0,0
22294,24,380,102,57,55,5,16,25,107,5,17,10,18,22,28,81,124,2,330,18,0,0,97,0,0
22295,74,1569,402,202,227,24,74,80,426,12,52,33,61,64,94,339,564,7,3969,220,0,3,123,302,0
22296,69,1540,53,23,39,0,0,13,53,2,8,4,8,10,12,26,39,1,39,2,0,2,33,63,0
22297,69,1540,515,298,307,33,80,99,548,12,63,44,77,75,121,419,753,7,5527,307,0,2,33,63,0
22298,259,6120,72,33,56,0,4,12,72,1,1,1,1,2,2,0,2,0,1,0,0,2,1,1,0
22299,259,6120,1454,835,1044,76,110,219,1530,17,275,158,296,292,454,2297,3718,9,34017,1889,1,2,1,1,0
22300,77,1551,757,253,292,73,244,162,830,13,61,38,67,74,105,409,651,7,4654,258,0,2,40,27,0
22301,113,2530,1043,504,840,53,9,147,1096,9,180,112,198,189,310,1377,2344,4,11604,644,0,2,14,2,0
22302,113,2530,383,288,292,26,6,62,409,11,65,38,67,76,105,429,656,5,3719,206,0,2,14,2,0
22303,71,1415,1178,367,1042,6,15,115,1184,9,94,51,95,103,146,644,976,4,4439,246,0,2,33,143,0
22304,71,1415,177,108,140,8,0,27,185,6,30,16,32,36,48,162,248,3,794,44,0,2,33,143,0
22305,209,4527,1943,715,1694,26,18,214,1969,12,185,120,237,197,357,1436,2721,7,20915,1161,0,2,61,25,0
22306,209,4527,1168,838,957,57,25,144,1225,19,348,224,416,367,640,3018,5452,11,61921,3440,1,2,61,25,0
22307,15,470,42,7,35,4,0,5,46,1,2,1,2,3,3,2,4,0,2,0,0,2,3,2,0
22308,15,470,11,6,10,0,0,1,11,2,4,2,4,6,6,10,15,1,15,0,0,2,3,2,0
22309,91,3852,1289,550,1043,56,32,155,1345,10,167,93,185,177,278,1266,2075,5,11498,638,0,2,24,0,0
22310,15,742,75,38,59,1,3,12,76,2,4,2,4,6,6,10,15,1,15,0,0,2,76,0,0
22311,29,1792,1157,318,931,29,22,177,1186,6,104,63,125,110,188,712,1274,3,4596,255,0,2,123,1,0
22312,54,3601,520,294,400,33,13,81,553,10,261,204,367,271,571,2128,4614,7,32445,1802,1,2,22,0,0
22313,170,7554,139,89,101,2,0,35,141,7,54,34,62,61,96,330,569,4,2287,127,0,2,199,14,0
22314,170,7554,7,5,5,0,0,2,7,1,2,1,2,3,3,2,4,0,2,0,0,2,199,14,0
22315,36,2884,996,429,845,24,10,117,1020,7,76,50,88,83,138,494,879,4,3565,198,0,2,144,5,0
22316,69,3184,1455,414,1257,16,76,112,1471,5,41,23,46,46,69,231,381,2,1069,59,0,2,21,0,0
22317,94,4604,1523,757,1297,19,12,193,1542,12,193,117,230,205,347,1508,2664,7,19053,1058,0,2,28,11,0
22318,39,1946,1293,570,1093,25,15,163,1318,10,195,123,241,205,364,1516,2795,6,17273,959,0,2,36,0,0
22319,16,1213,215,129,180,6,0,29,221,8,65,43,72,73,115,415,711,4,3153,175,0,2,1,1,0
22320,30,1233,373,158,315,8,0,51,381,5,76,44,79,81,123,486,779,2,2026,112,0,2,44,0,0
22321,77,3237,1178,367,1042,6,15,115,1184,9,94,51,95,103,146,644,976,4,4439,246,0,2,40,0,0
22322,91,4606,1943,715,1694,26,18,214,1969,12,185,120,237,197,357,1436,2721,7,20915,1161,0,2,88,13,0
22323,48,2177,1293,570,1093,25,15,163,1318,10,195,123,241,205,364,1516,2795,6,17273,959,0,2,75,6,1
22324,25,773,339,213,244,17,9,65,356,10,42,26,48,52,74,259,421,5,2410,133,0,2,8,0,0
22325,26,776,339,213,244,17,9,65,356,10,42,26,48,52,74,259,421,5,2410,133,0,2,2,1,0
22326,55,2398,1293,570,1093,25,15,163,1318,10,195,123,241,205,364,1516,2795,6,17273,959,0,2,53,0,0
22327,54,2391,1293,570,1093,25,15,163,1318,10,195,123,241,205,364,1516,2795,6,17273,959,0,2,8,14,1
22328,54,2391,1293,570,1093,25,15,163,1318,10,195,123,241,205,364,1516,2795,6,17273,959,0,2,1,1,0
22329,85,2188,773,422,505,30,103,129,803,14,77,46,83,91,129,535,839,7,6334,351,0,2,1,1,0
22330,31,1981,1157,318,931,29,22,177,1186,6,104,63,125,110,188,712,1274,3,4596,255,0,2,61,1,0
22331,26,776,339,213,244,17,9,65,356,10,42,26,48,52,74,259,421,5,2410,133,0,2,1,1,0
22332,54,2368,1293,570,1093,25,15,163,1318,10,195,123,241,205,364,1516,2795,6,17273,959,0,2,22,21,0
22333,86,2211,773,422,505,30,103,129,803,14,77,46,83,91,129,535,839,7,6334,351,0,2,1,1,0
22334,31,1981,1157,318,931,29,22,177,1186,6,104,63,125,110,188,712,1274,3,4596,255,0,2,61,1,0
22335,55,2425,1293,570,1093,25,15,163,1318,10,195,123,241,205,364,1516,2795,6,17273,959,0,2,24,0,0
22336,78,1583,757,253,292,73,244,162,830,13,61,38,67,74,105,409,651,7,4654,258,0,2,4,0,0
22337,22,606,256,139,192,9,7,47,265,4,23,12,24,27,36,112,171,2,357,19,0,2,5,0,0
22338,39,1724,386,256,301,16,9,68,402,4,59,35,69,63,104,355,621,2,1453,80,0,2,1,1,0
22339,78,1574,757,253,292,73,244,162,830,13,61,38,67,74,105,409,651,7,4654,258,0,2,1,1,0
22340,78,1574,757,253,292,73,244,162,830,13,61,38,67,74,105,409,651,7,4654,258,0,2,4,0,0
22341,22,606,256,139,192,9,7,47,265,4,23,12,24,27,36,112,171,2,357,19,0,2,5,0,0
22342,39,1724,386,256,301,16,9,68,402,4,59,35,69,63,104,355,621,2,1453,80,0,2,1,1,0
22343,55,2461,1293,570,1093,25,15,163,1318,10,195,123,241,205,364,1516,2795,6,17273,959,0,2,13,4,0
22344,24,600,2,2,2,0,0,0,2,0,0,0,0,0,0,0,0,0,0,0,0,2,2,1,0
22345,24,600,99,48,90,1,3,5,100,0,0,0,0,0,0,0,0,0,0,0,0,2,2,1,0
22346,24,600,8,5,5,2,0,1,10,0,0,0,0,0,0,0,0,0,0,0,0,2,2,1,0
22347,24,600,1217,716,841,84,126,174,1301,14,185,118,215,199,333,1446,2542,8,20687,1149,0,2,2,1,0
22348,24,600,160,89,115,0,13,31,160,7,15,11,17,22,28,78,124,3,495,27,0,2,2,1,0
22349,24,600,10,10,9,9,0,0,19,0,0,0,0,0,0,0,0,0,0,0,0,2,2,1,0
22350,24,600,173,84,99,8,29,36,181,5,12,7,13,17,20,54,81,2,221,12,0,2,2,1,0
22351,24,600,3,1,1,3,0,0,6,0,0,0,0,0,0,0,0,0,0,0,0,2,2,1,0
22352,56,2400,1293,570,1093,25,15,163,1318,10,195,123,241,205,364,1516,2795,6,17273,959,0,2,29,49,0
22353,24,600,2,2,2,0,0,0,2,0,0,0,0,0,0,0,0,0,0,0,0,2,2,1,0
22354,24,600,99,48,90,1,3,5,100,0,0,0,0,0,0,0,0,0,0,0,0,2,2,1,0
22355,24,600,8,5,5,2,0,1,10,0,0,0,0,0,0,0,0,0,0,0,0,2,2,1,0
22356,24,600,1217,716,841,84,126,174,1301,14,185,118,215,199,333,1446,2542,8,20687,1149,0,2,2,1,0
22357,24,600,160,89,115,0,13,31,160,7,15,11,17,22,28,78,124,3,495,27,0,2,2,1,0
22358,24,600,10,10,9,9,0,0,19,0,0,0,0,0,0,0,0,0,0,0,0,2,2,1,0
22359,24,600,173,84,99,8,29,36,181,5,12,7,13,17,20,54,81,2,221,12,0,2,2,1,0
22360,24,600,3,1,1,3,0,0,6,0,0,0,0,0,0,0,0,0,0,0,0,2,2,1,0
22361,80,1688,402,202,227,24,74,80,426,12,52,33,61,64,94,339,564,7,3969,220,0,2,25,0,1
22362,68,1556,53,23,39,0,0,13,53,2,8,4,8,10,12,26,39,1,39,2,0,2,9,6,1
22363,68,1556,515,298,307,33,80,99,548,12,63,44,77,75,121,419,753,7,5527,307,0,2,9,6,1
22364,260,6185,72,33,56,0,4,12,72,1,1,1,1,2,2,0,2,0,1,0,0,2,9,1,1
22365,260,6185,1454,835,1044,76,110,219,1530,17,275,158,296,292,454,2297,3718,9,34017,1889,1,2,9,1,1
22366,235,5354,4293,999,3693,19,54,507,4312,9,155,88,170,164,258,1156,1898,4,9368,520,0,2,1,4,0
22367,235,5354,1482,859,1002,125,135,219,1607,16,219,134,251,235,385,1766,3032,9,27804,1544,1,2,1,4,0
22368,30,655,125,97,103,3,0,19,128,9,25,17,27,34,44,144,223,4,1087,60,0,2,1,10,0
22369,82,3555,1020,354,843,12,15,144,1032,8,134,77,144,142,221,970,1580,4,6792,377,0,2,0,1,0
22370,82,3557,1020,354,843,12,15,144,1032,8,134,77,144,142,221,970,1580,4,6792,377,0,2,2,2,0
22371,30,657,125,97,103,3,0,19,128,9,25,17,27,34,44,144,223,4,1087,60,0,2,2,1,0
22372,237,5377,4293,999,3693,19,54,507,4312,9,155,88,170,164,258,1156,1898,4,9368,520,0,2,5,2,1
22373,237,5377,1482,859,1002,125,135,219,1607,16,219,134,251,235,385,1766,3032,9,27804,1544,1,2,5,2,1
22374,80,1706,402,202,227,24,74,80,426,12,52,33,61,64,94,339,564,7,3969,220,0,2,6,6,1
22375,261,6242,72,33,56,0,4,12,72,1,1,1,1,2,2,0,2,0,1,0,0,2,30,11,1
22376,261,6242,1454,835,1044,76,110,219,1530,17,275,158,296,292,454,2297,3718,9,34017,1889,1,2,30,11,1
22377,70,1373,1178,367,1042,6,15,115,1184,9,94,51,95,103,146,644,976,4,4439,246,0,2,6,10,1
22378,70,1373,177,108,140,8,0,27,185,6,30,16,32,36,48,162,248,3,794,44,0,2,6,10,1
22379,170,7555,139,89,101,2,0,35,141,7,54,34,62,61,96,330,569,4,2287,127,0,2,3,1,1
22380,170,7555,7,5,5,0,0,2,7,1,2,1,2,3,3,2,4,0,2,0,0,2,3,1,1
22381,138,5857,1782,648,1425,9,47,279,1791,8,171,97,189,179,286,1292,2140,4,9462,525,0,2,7,1,1
22382,82,3581,1020,354,843,12,15,144,1032,8,134,77,144,142,221,970,1580,4,6792,377,0,2,9,0,1
22383,262,6251,72,33,56,0,4,12,72,1,1,1,1,2,2,0,2,0,1,0,0,2,1,1,0
22384,262,6251,1454,835,1044,76,110,219,1530,17,275,158,296,292,454,2297,3718,9,34017,1889,1,2,1,1,0
22385,138,5861,1782,648,1425,9,47,279,1791,8,171,97,189,179,286,1292,2140,4,9462,525,0,2,6,6,0
22386,262,6251,72,33,56,0,4,12,72,1,1,1,1,2,2,0,2,0,1,0,0,2,2,1,1
22387,262,6251,1454,835,1044,76,110,219,1530,17,275,158,296,292,454,2297,3718,9,34017,1889,1,2,2,1,1
22388,78,1663,402,202,227,24,74,80,426,12,52,33,61,64,94,339,564,7,3969,220,0,2,3,9,0
22389,70,1570,53,23,39,0,0,13,53,2,8,4,8,10,12,26,39,1,39,2,0,2,4,2,0
22390,70,1570,515,298,307,33,80,99,548,12,63,44,77,75,121,419,753,7,5527,307,0,2,4,2,0
22391,78,1664,402,202,227,24,74,80,426,12,52,33,61,64,94,339,564,7,3969,220,0,2,8,0,1
22392,70,1570,53,23,39,0,0,13,53,2,8,4,8,10,12,26,39,1,39,2,0,2,4,1,1
22393,70,1570,515,298,307,33,80,99,548,12,63,44,77,75,121,419,753,7,5527,307,0,2,4,1,1
22394,78,1701,402,202,227,24,74,80,426,12,52,33,61,64,94,339,564,7,3969,220,0,2,14,7,1
22395,71,1575,53,23,39,0,0,13,53,2,8,4,8,10,12,26,39,1,39,2,0,2,4,3,1
22396,71,1575,515,298,307,33,80,99,548,12,63,44,77,75,121,419,753,7,5527,307,0,2,4,3,1
22397,22,452,601,196,481,2,23,85,603,8,63,36,72,71,108,400,664,4,3036,168,0,2,1,2,1
22398,22,452,156,79,106,5,16,28,161,5,14,8,15,19,23,64,97,2,261,14,0,2,1,2,1
22399,82,3585,1020,354,843,12,15,144,1032,8,134,77,144,142,221,970,1580,4,6792,377,0,2,2,1,1
22400,71,1575,53,23,39,0,0,13,53,2,8,4,8,10,12,26,39,1,39,2,0,2,1,0,0
22401,71,1575,515,298,307,33,80,99,548,12,63,44,77,75,121,419,753,7,5527,307,0,2,1,0,0
22402,236,5371,4293,999,3693,19,54,507,4312,9,155,88,170,164,258,1156,1898,4,9368,520,0,2,1,2,1
22403,236,5371,1482,859,1002,125,135,219,1607,16,219,134,251,235,385,1766,3032,9,27804,1544,1,2,1,2,1
22404,262,6251,72,33,56,0,4,12,72,1,1,1,1,2,2,0,2,0,1,0,0,2,4,0,0
22405,262,6251,1454,835,1044,76,110,219,1530,17,275,158,296,292,454,2297,3718,9,34017,1889,1,2,4,0,0
22406,79,1714,402,202,227,24,74,80,426,12,52,33,61,64,94,339,564,7,3969,220,0,2,3,0,0
22407,73,1606,53,23,39,0,0,13,53,2,8,4,8,10,12,26,39,1,39,2,0,2,14,1,0
22408,73,1606,515,298,307,33,80,99,548,12,63,44,77,75,121,419,753,7,5527,307,0,2,14,1,0
22409,77,1666,53,23,39,0,0,13,53,2,8,4,8,10,12,26,39,1,39,2,0,2,19,3,0
22410,77,1666,515,298,307,33,80,99,548,12,63,44,77,75,121,419,753,7,5527,307,0,2,19,3,0
22411,237,5376,4293,999,3693,19,54,507,4312,9,155,88,170,164,258,1156,1898,4,9368,520,0,2,1,1,1
22412,237,5376,1482,859,1002,125,135,219,1607,16,219,134,251,235,385,1766,3032,9,27804,1544,1,2,1,1,1
22413,32,665,125,97,103,3,0,19,128,9,25,17,27,34,44,144,223,4,1087,60,0,2,1,1,1
22414,75,1595,53,23,39,0,0,13,53,2,8,4,8,10,12,26,39,1,39,2,0,2,8,25,1
22415,75,1595,515,298,307,33,80,99,548,12,63,44,77,75,121,419,753,7,5527,307,0,2,8,25,1
22416,263,6257,72,33,56,0,4,12,72,1,1,1,1,2,2,0,2,0,1,0,0,2,6,5,1
22417,263,6257,1454,835,1044,76,110,219,1530,17,275,158,296,292,454,2297,3718,9,34017,1889,1,2,6,5,1
22418,71,1380,1178,367,1042,6,15,115,1184,9,94,51,95,103,146,644,976,4,4439,246,0,2,3,1,1
22419,71,1380,177,108,140,8,0,27,185,6,30,16,32,36,48,162,248,3,794,44,0,2,3,1,1
22420,23,458,601,196,481,2,23,85,603,8,63,36,72,71,108,400,664,4,3036,168,0,2,4,3,1
22421,23,458,156,79,106,5,16,28,161,5,14,8,15,19,23,64,97,2,261,14,0,2,4,3,1
22422,84,3593,1020,354,843,12,15,144,1032,8,134,77,144,142,221,970,1580,4,6792,377,0,2,1,1,1
22423,86,1809,477,336,357,30,23,73,507,16,194,134,250,210,384,1538,2962,10,30538,1696,0,2,5,1,1
22424,74,1594,402,202,227,24,74,80,426,12,52,33,61,64,94,339,564,7,3969,220,0,2,6,1,1
22425,86,1790,477,336,357,30,23,73,507,16,194,134,250,210,384,1538,2962,10,30538,1696,0,2,1,5,0
22426,54,1125,207,111,150,11,0,50,218,5,26,19,36,31,55,133,272,3,943,52,0,2,8,0,0
22427,54,1125,410,198,237,31,55,97,441,11,63,38,72,74,110,414,683,6,4293,238,0,2,8,0,0
22428,74,1567,402,202,227,24,74,80,426,12,52,33,61,64,94,339,564,7,3969,220,0,2,4,9,0
22429,51,595,647,139,84,35,284,233,682,0,0,0,0,0,0,0,0,0,0,0,0,2,3,2,0
22430,54,1125,207,111,150,11,0,50,218,5,26,19,36,31,55,133,272,3,943,52,0,2,2,2,0
22431,54,1125,410,198,237,31,55,97,441,11,63,38,72,74,110,414,683,6,4293,238,0,2,2,2,0
22432,263,6260,72,33,56,0,4,12,72,1,1,1,1,2,2,0,2,0,1,0,0,2,2,0,0
22433,263,6260,1454,835,1044,76,110,219,1530,17,275,158,296,292,454,2297,3718,9,34017,1889,1,2,2,0,0
22434,98,2655,1523,757,1297,19,12,193,1542,12,193,117,230,205,347,1508,2664,7,19053,1058,0,2,0,5,0
22435,98,2655,701,378,504,33,58,109,734,13,110,68,126,123,194,794,1346,7,10027,557,0,2,0,5,0
22436,86,1790,477,336,357,30,23,73,507,16,194,134,250,210,384,1538,2962,10,30538,1696,0,2,1,1,0
22437,54,1125,207,111,150,11,0,50,218,5,26,19,36,31,55,133,272,3,943,52,0,2,8,0,0
22438,54,1125,410,198,237,31,55,97,441,11,63,38,72,74,110,414,683,6,4293,238,0,2,8,0,0
22439,74,1567,402,202,227,24,74,80,426,12,52,33,61,64,94,339,564,7,3969,220,0,2,4,4,0
22440,55,2371,1293,570,1093,25,15,163,1318,10,195,123,241,205,364,1516,2795,6,17273,959,0,2,0,7,0
22441,51,595,647,139,84,35,284,233,682,0,0,0,0,0,0,0,0,0,0,0,0,2,3,2,0
22442,94,4602,1523,757,1297,19,12,193,1542,12,193,117,230,205,347,1508,2664,7,19053,1058,0,2,0,1,0
22443,55,2369,1293,570,1093,25,15,163,1318,10,195,123,241,205,364,1516,2795,6,17273,959,0,2,1,1,0
22444,15,470,42,7,35,4,0,5,46,1,2,1,2,3,3,2,4,0,2,0,0,2,1,1,1
22445,15,470,11,6,10,0,0,1,11,2,4,2,4,6,6,10,15,1,15,0,0,2,1,1,1
22446,15,470,42,7,35,4,0,5,46,1,2,1,2,3,3,2,4,0,2,0,0,2,1,1,0
22447,15,470,11,6,10,0,0,1,11,2,4,2,4,6,6,10,15,1,15,0,0,2,1,1,0
22448,113,2553,1043,504,840,53,9,147,1096,9,180,112,198,189,310,1377,2344,4,11604,644,0,2,2,1,1
22449,113,2553,383,288,292,26,6,62,409,11,65,38,67,76,105,429,656,5,3719,206,0,2,2,1,1
22450,79,3054,1043,504,840,53,9,147,1096,9,180,112,198,189,310,1377,2344,4,11604,644,0,2,14,5,1
22451,94,4591,1523,757,1297,19,12,193,1542,12,193,117,230,205,347,1508,2664,7,19053,1058,0,2,1,4,0
22452,79,1724,402,202,227,24,74,80,426,12,52,33,61,64,94,339,564,7,3969,220,0,2,13,3,0
22453,98,2655,1523,757,1297,19,12,193,1542,12,193,117,230,205,347,1508,2664,7,19053,1058,0,2,0,5,0
22454,98,2655,701,378,504,33,58,109,734,13,110,68,126,123,194,794,1346,7,10027,557,0,2,0,5,0
22455,94,4591,1523,757,1297,19,12,193,1542,12,193,117,230,205,347,1508,2664,7,19053,1058,0,2,1,5,0
22456,79,1583,757,253,292,73,244,162,830,13,61,38,67,74,105,409,651,7,4654,258,0,2,5,4,1
22457,25,685,256,139,192,9,7,47,265,4,23,12,24,27,36,112,171,2,357,19,0,2,18,0,1
22458,80,1589,757,253,292,73,244,162,830,13,61,38,67,74,105,409,651,7,4654,258,0,2,1,1,0
22459,78,1591,757,253,292,73,244,162,830,13,61,38,67,74,105,409,651,7,4654,258,0,2,6,5,0
22460,78,1591,757,253,292,73,244,162,830,13,61,38,67,74,105,409,651,7,4654,258,0,2,1,1,0
22461,78,1591,757,253,292,73,244,162,830,13,61,38,67,74,105,409,651,7,4654,258,0,2,3,1,0
22462,25,685,256,139,192,9,7,47,265,4,23,12,24,27,36,112,171,2,357,19,0,2,18,0,0
22463,237,5376,4293,999,3693,19,54,507,4312,9,155,88,170,164,258,1156,1898,4,9368,520,0,2,6,7,0
22464,237,5376,1482,859,1002,125,135,219,1607,16,219,134,251,235,385,1766,3032,9,27804,1544,1,2,6,7,0
22465,32,665,125,97,103,3,0,19,128,9,25,17,27,34,44,144,223,4,1087,60,0,2,3,11,0
22466,79,1724,402,202,227,24,74,80,426,12,52,33,61,64,94,339,564,7,3969,220,0,2,63,16,0
22467,75,1595,53,23,39,0,0,13,53,2,8,4,8,10,12,26,39,1,39,2,0,2,29,7,0
22468,75,1595,515,298,307,33,80,99,548,12,63,44,77,75,121,419,753,7,5527,307,0,2,29,7,0
22469,263,6260,72,33,56,0,4,12,72,1,1,1,1,2,2,0,2,0,1,0,0,2,47,12,0
22470,263,6260,1454,835,1044,76,110,219,1530,17,275,158,296,292,454,2297,3718,9,34017,1889,1,2,47,12,0
22471,71,1380,1178,367,1042,6,15,115,1184,9,94,51,95,103,146,644,976,4,4439,246,0,2,8,10,0
22472,71,1380,177,108,140,8,0,27,185,6,30,16,32,36,48,162,248,3,794,44,0,2,8,10,0
22473,23,458,601,196,481,2,23,85,603,8,63,36,72,71,108,400,664,4,3036,168,0,2,4,4,0
22474,23,458,156,79,106,5,16,28,161,5,14,8,15,19,23,64,97,2,261,14,0,2,4,4,0
22475,170,7555,139,89,101,2,0,35,141,7,54,34,62,61,96,330,569,4,2287,127,0,2,3,1,0
22476,170,7555,7,5,5,0,0,2,7,1,2,1,2,3,3,2,4,0,2,0,0,2,3,1,0
22477,138,5861,1782,648,1425,9,47,279,1791,8,171,97,189,179,286,1292,2140,4,9462,525,0,2,8,2,0
22478,84,3593,1020,354,843,12,15,144,1032,8,134,77,144,142,221,970,1580,4,6792,377,0,2,13,4,0
22479,28,807,339,213,244,17,9,65,356,10,42,26,48,52,74,259,421,5,2410,133,0,2,15,0,0
22480,58,2553,1293,570,1093,25,15,163,1318,10,195,123,241,205,364,1516,2795,6,17273,959,0,2,148,0,0
22481,92,3882,1289,550,1043,56,32,155,1345,10,167,93,185,177,278,1266,2075,5,11498,638,0,2,30,0,0
22482,48,991,447,308,343,6,5,95,453,7,96,59,111,103,170,651,1136,4,4600,255,0,2,10,0,0
22483,48,991,322,174,179,16,74,51,338,10,41,26,46,51,72,252,408,5,2291,127,0,2,10,0,0
22484,38,1651,447,308,343,6,5,95,453,7,96,59,111,103,170,651,1136,4,4600,255,0,2,13,0,0
22485,86,1790,477,336,357,30,23,73,507,16,194,134,250,210,384,1538,2962,10,30538,1696,0,2,1,1,0
22486,54,1125,207,111,150,11,0,50,218,5,26,19,36,31,55,133,272,3,943,52,0,2,8,0,0
22487,54,1125,410,198,237,31,55,97,441,11,63,38,72,74,110,414,683,6,4293,238,0,2,8,0,0
22488,51,595,647,139,84,35,284,233,682,0,0,0,0,0,0,0,0,0,0,0,0,2,3,2,0
22489,98,2655,1523,757,1297,19,12,193,1542,12,193,117,230,205,347,1508,2664,7,19053,1058,0,2,0,5,0
22490,98,2655,701,378,504,33,58,109,734,13,110,68,126,123,194,794,1346,7,10027,557,0,2,0,5,0
22491,24,600,2,2,2,0,0,0,2,0,0,0,0,0,0,0,0,0,0,0,0,2,2,1,0
22492,24,600,99,48,90,1,3,5,100,0,0,0,0,0,0,0,0,0,0,0,0,2,2,1,0
22493,24,600,8,5,5,2,0,1,10,0,0,0,0,0,0,0,0,0,0,0,0,2,2,1,0
22494,24,600,1217,716,841,84,126,174,1301,14,185,118,215,199,333,1446,2542,8,20687,1149,0,2,2,1,0
22495,24,600,160,89,115,0,13,31,160,7,15,11,17,22,28,78,124,3,495,27,0,2,2,1,0
22496,24,600,10,10,9,9,0,0,19,0,0,0,0,0,0,0,0,0,0,0,0,2,2,1,0
22497,24,600,173,84,99,8,29,36,181,5,12,7,13,17,20,54,81,2,221,12,0,2,2,1,0
22498,24,600,3,1,1,3,0,0,6,0,0,0,0,0,0,0,0,0,0,0,0,2,2,1,0
22499,79,1722,402,202,227,24,74,80,426,12,52,33,61,64,94,339,564,7,3969,220,0,2,3,3,0
22500,78,1591,757,253,292,73,244,162,830,13,61,38,67,74,105,409,651,7,4654,258,0,2,7,1,0
22501,15,470,42,7,35,4,0,5,46,1,2,1,2,3,3,2,4,0,2,0,0,2,1,1,0
22502,15,470,11,6,10,0,0,1,11,2,4,2,4,6,6,10,15,1,15,0,0,2,1,1,0
22503,25,685,256,139,192,9,7,47,265,4,23,12,24,27,36,112,171,2,357,19,0,2,23,0,0
22504,94,4591,1523,757,1297,19,12,193,1542,12,193,117,230,205,347,1508,2664,7,19053,1058,0,2,1,5,0
22505,39,1724,386,256,301,16,9,68,402,4,59,35,69,63,104,355,621,2,1453,80,0,2,1,1,0
22506,238,5409,4293,999,3693,19,54,507,4312,9,155,88,170,164,258,1156,1898,4,9368,520,0,2,7,3,1
22507,238,5409,1482,859,1002,125,135,219,1607,16,219,134,251,235,385,1766,3032,9,27804,1544,1,2,7,3,1
22508,131,3042,77,34,69,0,0,8,77,3,24,16,29,27,45,114,213,1,387,21,0,2,22,9,1
22509,131,3042,712,438,573,51,9,84,763,14,102,71,128,116,199,733,1364,8,11988,666,0,2,22,9,1
22510,279,6562,72,33,56,0,4,12,72,1,1,1,1,2,2,0,2,0,1,0,0,2,46,1,1
22511,279,6562,1454,835,1044,76,110,219,1530,17,275,158,296,292,454,2297,3718,9,34017,1889,1,2,46,1,1
22512,171,7658,139,89,101,2,0,35,141,7,54,34,62,61,96,330,569,4,2287,127,0,2,33,0,1
22513,171,7658,7,5,5,0,0,2,7,1,2,1,2,3,3,2,4,0,2,0,0,2,33,0,1
22514,73,3804,1296,573,1062,40,33,157,1336,8,201,118,231,209,349,1561,2689,4,12365,686,0,2,1,1,1
22515,30,1233,373,158,315,8,0,51,381,5,76,44,79,81,123,486,779,2,2026,112,0,2,1,1,1
22516,279,6562,72,33,56,0,4,12,72,1,1,1,1,2,2,0,2,0,1,0,0,2,1,0,0
22517,279,6562,1454,835,1044,76,110,219,1530,17,275,158,296,292,454,2297,3718,9,34017,1889,1,2,1,0,0
22518,15,483,42,7,35,4,0,5,46,1,2,1,2,3,3,2,4,0,2,0,0,2,4,0,0
22519,15,483,11,6,10,0,0,1,11,2,4,2,4,6,6,10,15,1,15,0,0,2,4,0,0
22520,86,1790,477,336,357,30,23,73,507,16,194,134,250,210,384,1538,2962,10,30538,1696,0,2,1,1,0
22521,54,1125,207,111,150,11,0,50,218,5,26,19,36,31,55,133,272,3,943,52,0,2,8,0,0
22522,54,1125,410,198,237,31,55,97,441,11,63,38,72,74,110,414,683,6,4293,238,0,2,8,0,0
22523,51,595,647,139,84,35,284,233,682,0,0,0,0,0,0,0,0,0,0,0,0,2,3,2,0
22524,98,2655,1523,757,1297,19,12,193,1542,12,193,117,230,205,347,1508,2664,7,19053,1058,0,2,0,5,0
22525,98,2655,701,378,504,33,58,109,734,13,110,68,126,123,194,794,1346,7,10027,557,0,2,0,5,0
22526,24,600,2,2,2,0,0,0,2,0,0,0,0,0,0,0,0,0,0,0,0,2,2,1,0
22527,24,600,99,48,90,1,3,5,100,0,0,0,0,0,0,0,0,0,0,0,0,2,2,1,0
22528,24,600,8,5,5,2,0,1,10,0,0,0,0,0,0,0,0,0,0,0,0,2,2,1,0
22529,24,600,1217,716,841,84,126,174,1301,14,185,118,215,199,333,1446,2542,8,20687,1149,0,2,2,1,0
22530,24,600,160,89,115,0,13,31,160,7,15,11,17,22,28,78,124,3,495,27,0,2,2,1,0
22531,24,600,10,10,9,9,0,0,19,0,0,0,0,0,0,0,0,0,0,0,0,2,2,1,0
22532,24,600,173,84,99,8,29,36,181,5,12,7,13,17,20,54,81,2,221,12,0,2,2,1,0
22533,24,600,3,1,1,3,0,0,6,0,0,0,0,0,0,0,0,0,0,0,0,2,2,1,0
22534,79,1722,402,202,227,24,74,80,426,12,52,33,61,64,94,339,564,7,3969,220,0,2,3,3,0
22535,78,1591,757,253,292,73,244,162,830,13,61,38,67,74,105,409,651,7,4654,258,0,2,7,1,0
22536,15,470,42,7,35,4,0,5,46,1,2,1,2,3,3,2,4,0,2,0,0,2,1,1,0
22537,15,470,11,6,10,0,0,1,11,2,4,2,4,6,6,10,15,1,15,0,0,2,1,1,0
22538,25,685,256,139,192,9,7,47,265,4,23,12,24,27,36,112,171,2,357,19,0,2,23,0,0
22539,94,4591,1523,757,1297,19,12,193,1542,12,193,117,230,205,347,1508,2664,7,19053,1058,0,2,1,5,0
22540,39,1724,386,256,301,16,9,68,402,4,59,35,69,63,104,355,621,2,1453,80,0,2,1,1,0
22541,15,483,42,7,35,4,0,5,46,1,2,1,2,3,3,2,4,0,2,0,0,2,4,0,0
22542,15,483,11,6,10,0,0,1,11,2,4,2,4,6,6,10,15,1,15,0,0,2,4,0,0
22543,113,2553,1043,504,840,53,9,147,1096,9,180,112,198,189,310,1377,2344,4,11604,644,0,2,2,1,0
22544,113,2553,383,288,292,26,6,62,409,11,65,38,67,76,105,429,656,5,3719,206,0,2,2,1,0
22545,92,3882,1289,550,1043,56,32,155,1345,10,167,93,185,177,278,1266,2075,5,11498,638,0,2,30,0,0
22546,79,3054,1043,504,840,53,9,147,1096,9,180,112,198,189,310,1377,2344,4,11604,644,0,2,14,5,0
22547,164,5028,1660,832,1314,41,38,274,1701,20,312,209,395,332,604,2671,5058,12,64042,3557,1,2,14,27,1
22548,164,5028,1057,646,719,113,100,145,1170,18,215,134,248,233,382,1740,3004,10,31186,1732,1,2,14,27,1
22549,15,472,42,7,35,4,0,5,46,1,2,1,2,3,3,2,4,0,2,0,0,2,1,0,1
22550,15,472,11,6,10,0,0,1,11,2,4,2,4,6,6,10,15,1,15,0,0,2,1,0,1
22551,155,4419,1660,832,1314,41,38,274,1701,20,312,209,395,332,604,2671,5058,12,64042,3557,1,2,6,6,1
22552,164,5028,1660,832,1314,41,38,274,1701,20,312,209,395,332,604,2671,5058,12,64042,3557,1,2,14,27,0
22553,164,5028,1057,646,719,113,100,145,1170,18,215,134,248,233,382,1740,3004,10,31186,1732,1,2,14,27,0
22554,15,472,42,7,35,4,0,5,46,1,2,1,2,3,3,2,4,0,2,0,0,2,1,0,0
22555,15,472,11,6,10,0,0,1,11,2,4,2,4,6,6,10,15,1,15,0,0,2,1,0,0
22556,155,4419,1660,832,1314,41,38,274,1701,20,312,209,395,332,604,2671,5058,12,64042,3557,1,2,6,6,0
22557,48,992,447,308,343,6,5,95,453,7,96,59,111,103,170,651,1136,4,4600,255,0,2,15,0,0
22558,48,992,322,174,179,16,74,51,338,10,41,26,46,51,72,252,408,5,2291,127,0,2,15,0,0
22559,38,1676,447,308,343,6,5,95,453,7,96,59,111,103,170,651,1136,4,4600,255,0,2,8,9,0
22560,27,951,74,35,59,1,0,14,75,3,14,7,14,17,21,58,85,1,128,7,0,2,2,1,1
22561,27,951,245,125,200,5,7,34,250,7,30,17,34,37,51,166,265,3,1053,58,0,2,2,1,1
22562,259,6121,72,33,56,0,4,12,72,1,1,1,1,2,2,0,2,0,1,0,0,2,2,1,1
22563,259,6121,1454,835,1044,76,110,219,1530,17,275,158,296,292,454,2297,3718,9,34017,1889,1,2,2,1,1
22564,58,1174,207,111,150,11,0,50,218,5,26,19,36,31,55,133,272,3,943,52,0,2,8,0,0
22565,58,1174,410,198,237,31,55,97,441,11,63,38,72,74,110,414,683,6,4293,238,0,2,8,0,0
22566,259,6152,72,33,56,0,4,12,72,1,1,1,1,2,2,0,2,0,1,0,0,2,11,7,0
22567,259,6152,1454,835,1044,76,110,219,1530,17,275,158,296,292,454,2297,3718,9,34017,1889,1,2,11,7,0
22568,139,5869,1782,648,1425,9,47,279,1791,8,171,97,189,179,286,1292,2140,4,9462,525,0,2,13,0,0
22569,27,951,74,35,59,1,0,14,75,3,14,7,14,17,21,58,85,1,128,7,0,2,2,1,0
22570,27,951,245,125,200,5,7,34,250,7,30,17,34,37,51,166,265,3,1053,58,0,2,2,1,0
22571,259,6121,72,33,56,0,4,12,72,1,1,1,1,2,2,0,2,0,1,0,0,2,2,1,0
22572,259,6121,1454,835,1044,76,110,219,1530,17,275,158,296,292,454,2297,3718,9,34017,1889,1,2,2,1,0
22573,132,3068,77,34,69,0,0,8,77,3,24,16,29,27,45,114,213,1,387,21,0,2,5,2,0
22574,132,3068,712,438,573,51,9,84,763,14,102,71,128,116,199,733,1364,8,11988,666,0,2,5,2,0
22575,97,4416,1338,495,1086,10,64,173,1348,11,122,82,157,133,239,883,1686,7,11934,663,0,2,1,1,0
22576,73,3806,1296,573,1062,40,33,157,1336,8,201,118,231,209,349,1561,2689,4,12365,686,0,2,1,1,0
22577,86,2206,773,422,505,30,103,129,803,14,77,46,83,91,129,535,839,7,6334,351,0,2,3,3,0
22578,27,951,74,35,59,1,0,14,75,3,14,7,14,17,21,58,85,1,128,7,0,2,2,1,0
22579,27,951,245,125,200,5,7,34,250,7,30,17,34,37,51,166,265,3,1053,58,0,2,2,1,0
22580,259,6121,72,33,56,0,4,12,72,1,1,1,1,2,2,0,2,0,1,0,0,2,2,1,0
22581,259,6121,1454,835,1044,76,110,219,1530,17,275,158,296,292,454,2297,3718,9,34017,1889,1,2,2,1,0
22582,113,2553,1043,504,840,53,9,147,1096,9,180,112,198,189,310,1377,2344,4,11604,644,0,2,2,1,0
22583,113,2553,383,288,292,26,6,62,409,11,65,38,67,76,105,429,656,5,3719,206,0,2,2,1,0
22584,15,483,42,7,35,4,0,5,46,1,2,1,2,3,3,2,4,0,2,0,0,2,4,0,0
22585,15,483,11,6,10,0,0,1,11,2,4,2,4,6,6,10,15,1,15,0,0,2,4,0,0
22586,92,3882,1289,550,1043,56,32,155,1345,10,167,93,185,177,278,1266,2075,5,11498,638,0,2,30,0,0
22587,79,3054,1043,504,840,53,9,147,1096,9,180,112,198,189,310,1377,2344,4,11604,644,0,2,14,5,0
22588,164,5028,1660,832,1314,41,38,274,1701,20,312,209,395,332,604,2671,5058,12,64042,3557,1,2,14,27,0
22589,164,5028,1057,646,719,113,100,145,1170,18,215,134,248,233,382,1740,3004,10,31186,1732,1,2,14,27,0
22590,86,1790,477,336,357,30,23,73,507,16,194,134,250,210,384,1538,2962,10,30538,1696,0,2,1,1,0
22591,54,1125,207,111,150,11,0,50,218,5,26,19,36,31,55,133,272,3,943,52,0,2,8,0,0
22592,54,1125,410,198,237,31,55,97,441,11,63,38,72,74,110,414,683,6,4293,238,0,2,8,0,0
22593,51,595,647,139,84,35,284,233,682,0,0,0,0,0,0,0,0,0,0,0,0,2,3,2,0
22594,98,2655,1523,757,1297,19,12,193,1542,12,193,117,230,205,347,1508,2664,7,19053,1058,0,2,0,5,0
22595,98,2655,701,378,504,33,58,109,734,13,110,68,126,123,194,794,1346,7,10027,557,0,2,0,5,0
22596,24,600,2,2,2,0,0,0,2,0,0,0,0,0,0,0,0,0,0,0,0,2,2,1,0
22597,24,600,99,48,90,1,3,5,100,0,0,0,0,0,0,0,0,0,0,0,0,2,2,1,0
22598,24,600,8,5,5,2,0,1,10,0,0,0,0,0,0,0,0,0,0,0,0,2,2,1,0
22599,24,600,1217,716,841,84,126,174,1301,14,185,118,215,199,333,1446,2542,8,20687,1149,0,2,2,1,0
22600,24,600,160,89,115,0,13,31,160,7,15,11,17,22,28,78,124,3,495,27,0,2,2,1,0
22601,24,600,10,10,9,9,0,0,19,0,0,0,0,0,0,0,0,0,0,0,0,2,2,1,0
22602,24,600,173,84,99,8,29,36,181,5,12,7,13,17,20,54,81,2,221,12,0,2,2,1,0
22603,24,600,3,1,1,3,0,0,6,0,0,0,0,0,0,0,0,0,0,0,0,2,2,1,0
22604,79,1722,402,202,227,24,74,80,426,12,52,33,61,64,94,339,564,7,3969,220,0,2,3,3,0
22605,78,1591,757,253,292,73,244,162,830,13,61,38,67,74,105,409,651,7,4654,258,0,2,7,1,0
22606,15,472,42,7,35,4,0,5,46,1,2,1,2,3,3,2,4,0,2,0,0,2,2,1,0
22607,15,472,11,6,10,0,0,1,11,2,4,2,4,6,6,10,15,1,15,0,0,2,2,1,0
22608,25,685,256,139,192,9,7,47,265,4,23,12,24,27,36,112,171,2,357,19,0,2,23,0,0
22609,155,4419,1660,832,1314,41,38,274,1701,20,312,209,395,332,604,2671,5058,12,64042,3557,1,2,6,6,0
22610,94,4591,1523,757,1297,19,12,193,1542,12,193,117,230,205,347,1508,2664,7,19053,1058,0,2,1,5,0
22611,39,1724,386,256,301,16,9,68,402,4,59,35,69,63,104,355,621,2,1453,80,0,2,1,1,0
22612,122,2921,77,34,69,0,0,8,77,3,24,16,29,27,45,114,213,1,387,21,0,2,1,1,0
22613,122,2921,712,438,573,51,9,84,763,14,102,71,128,116,199,733,1364,8,11988,666,0,2,1,1,0
22614,122,2921,77,34,69,0,0,8,77,3,24,16,29,27,45,114,213,1,387,21,0,2,1,1,0
22615,122,2921,712,438,573,51,9,84,763,14,102,71,128,116,199,733,1364,8,11988,666,0,2,1,1,0
22616,48,992,447,308,343,6,5,95,453,7,96,59,111,103,170,651,1136,4,4600,255,0,2,25,0,0
22617,48,992,322,174,179,16,74,51,338,10,41,26,46,51,72,252,408,5,2291,127,0,2,25,0,0
22618,38,1676,447,308,343,6,5,95,453,7,96,59,111,103,170,651,1136,4,4600,255,0,2,12,0,0
22619,86,2206,773,422,505,30,103,129,803,14,77,46,83,91,129,535,839,7,6334,351,0,2,3,3,0
22620,243,5487,4293,999,3693,19,54,507,4312,9,155,88,170,164,258,1156,1898,4,9368,520,0,2,16,1,1
22621,243,5487,1482,859,1002,125,135,219,1607,16,219,134,251,235,385,1766,3032,9,27804,1544,1,2,16,1,1
22622,75,1601,53,23,39,0,0,13,53,2,8,4,8,10,12,26,39,1,39,2,0,2,1,0,1
22623,75,1601,515,298,307,33,80,99,548,12,63,44,77,75,121,419,753,7,5527,307,0,2,1,0,1
22624,288,6751,72,33,56,0,4,12,72,1,1,1,1,2,2,0,2,0,1,0,0,2,34,3,1
22625,288,6751,1454,835,1044,76,110,219,1530,17,275,158,296,292,454,2297,3718,9,34017,1889,1,2,34,3,1
22626,48,992,447,308,343,6,5,95,453,7,96,59,111,103,170,651,1136,4,4600,255,0,2,25,0,0
22627,48,992,322,174,179,16,74,51,338,10,41,26,46,51,72,252,408,5,2291,127,0,2,25,0,0
22628,38,1676,447,308,343,6,5,95,453,7,96,59,111,103,170,651,1136,4,4600,255,0,2,12,0,0
22629,244,5496,4293,999,3693,19,54,507,4312,9,155,88,170,164,258,1156,1898,4,9368,520,0,2,4,3,0
22630,244,5496,1482,859,1002,125,135,219,1607,16,219,134,251,235,385,1766,3032,9,27804,1544,1,2,4,3,0
22631,244,5495,4293,999,3693,19,54,507,4312,9,155,88,170,164,258,1156,1898,4,9368,520,0,2,2,2,0
22632,244,5495,1482,859,1002,125,135,219,1607,16,219,134,251,235,385,1766,3032,9,27804,1544,1,2,2,2,0
22633,140,3230,77,34,69,0,0,8,77,3,24,16,29,27,45,114,213,1,387,21,0,2,46,13,1
22634,140,3230,712,438,573,51,9,84,763,14,102,71,128,116,199,733,1364,8,11988,666,0,2,46,13,1
22635,30,1233,373,158,315,8,0,51,381,5,76,44,79,81,123,486,779,2,2026,112,0,2,1,1,1
22636,76,1603,53,23,39,0,0,13,53,2,8,4,8,10,12,26,39,1,39,2,0,2,1,1,0
22637,76,1603,515,298,307,33,80,99,548,12,63,44,77,75,121,419,753,7,5527,307,0,2,1,1,0
22638,58,1174,207,111,150,11,0,50,218,5,26,19,36,31,55,133,272,3,943,52,0,2,8,0,0
22639,58,1174,410,198,237,31,55,97,441,11,63,38,72,74,110,414,683,6,4293,238,0,2,8,0,0
22640,259,6153,72,33,56,0,4,12,72,1,1,1,1,2,2,0,2,0,1,0,0,2,11,7,0
22641,259,6153,1454,835,1044,76,110,219,1530,17,275,158,296,292,454,2297,3718,9,34017,1889,1,2,11,7,0
22642,139,5869,1782,648,1425,9,47,279,1791,8,171,97,189,179,286,1292,2140,4,9462,525,0,2,13,0,0
22643,150,6861,139,89,101,2,0,35,141,7,54,34,62,61,96,330,569,4,2287,127,0,2,8,0,1
22644,150,6861,7,5,5,0,0,2,7,1,2,1,2,3,3,2,4,0,2,0,0,2,8,0,1
22645,11,238,19,8,11,5,0,4,24,2,5,3,6,7,9,13,25,1,30,1,0,2,9,8,0
22646,11,238,102,59,69,5,3,24,107,6,22,15,28,28,43,113,206,3,789,43,0,2,9,8,0
22647,11,238,106,40,36,3,49,17,109,8,17,13,23,25,36,93,167,5,904,50,0,2,9,8,0
22648,213,4606,182,127,129,0,0,53,182,5,39,21,42,44,63,217,343,2,926,51,0,2,65,50,0
22649,213,4606,1165,710,800,67,119,181,1232,18,243,153,282,261,435,2000,3492,10,36473,2026,1,2,65,50,0
22650,84,1807,773,419,590,28,0,166,801,10,204,113,217,214,330,1598,2554,5,13587,754,0,2,51,100,0
22651,84,1807,421,273,302,44,34,57,465,17,81,59,107,98,166,583,1098,11,12329,684,0,2,51,100,0
22652,26,527,2,2,2,0,0,0,2,0,0,0,0,0,0,0,0,0,0,0,0,2,5,8,0
22653,26,527,99,48,90,1,3,5,100,0,0,0,0,0,0,0,0,0,0,0,0,2,5,8,0
22654,26,527,8,5,5,2,0,1,10,0,0,0,0,0,0,0,0,0,0,0,0,2,5,8,0
22655,26,527,1217,716,841,84,126,174,1301,14,185,118,215,199,333,1446,2542,8,20687,1149,0,2,5,8,0
22656,26,527,160,89,115,0,13,31,160,7,15,11,17,22,28,78,124,3,495,27,0,2,5,8,0
22657,26,527,10,10,9,9,0,0,19,0,0,0,0,0,0,0,0,0,0,0,0,2,5,8,0
22658,26,527,173,84,99,8,29,36,181,5,12,7,13,17,20,54,81,2,221,12,0,2,5,8,0
22659,26,527,3,1,1,3,0,0,6,0,0,0,0,0,0,0,0,0,0,0,0,2,5,8,0
22660,164,5028,1660,832,1314,41,38,274,1701,20,312,209,395,332,604,2671,5058,12,64042,3557,1,2,69,73,0
22661,164,5028,1057,646,719,113,100,145,1170,18,215,134,248,233,382,1740,3004,10,31186,1732,1,2,69,73,0
22662,17,345,95,58,50,9,16,20,104,12,33,24,45,45,69,209,378,8,3100,172,0,2,3,3,0
22663,86,1790,477,336,357,30,23,73,507,16,194,134,250,210,384,1538,2962,10,30538,1696,0,2,25,22,0
22664,71,1698,996,429,845,24,10,117,1020,7,76,50,88,83,138,494,879,4,3565,198,0,2,110,40,0
22665,71,1698,456,277,329,12,42,72,468,13,85,50,97,98,147,592,972,7,7212,400,0,2,110,40,0
22666,145,3018,1513,682,1277,25,13,200,1538,11,199,116,219,210,335,1557,2584,6,15641,868,0,2,257,93,0
22667,145,3018,819,519,539,24,98,155,843,15,96,57,106,111,163,690,1107,8,9171,509,0,2,257,93,0
22668,54,1125,207,111,150,11,0,50,218,5,26,19,36,31,55,133,272,3,943,52,0,2,98,74,0
22669,54,1125,410,198,237,31,55,97,441,11,63,38,72,74,110,414,683,6,4293,238,0,2,98,74,0
22670,354,7093,1457,730,1242,11,6,188,1468,10,292,166,329,302,495,2424,4078,5,22973,1276,1,2,167,150,0
22671,354,7093,74,35,59,1,0,14,75,3,14,7,14,17,21,58,85,1,128,7,0,2,167,150,0
22672,354,7093,245,125,200,5,7,34,250,7,30,17,34,37,51,166,265,3,1053,58,0,2,167,150,0
22673,28,807,339,213,244,17,9,65,356,10,42,26,48,52,74,259,421,5,2410,133,0,2,34,7,0
22674,83,2145,1455,414,1257,16,76,112,1471,5,41,23,46,46,69,231,381,2,1069,59,0,2,170,63,0
22675,83,2145,669,365,481,22,61,110,691,15,103,63,122,118,185,747,1273,8,11311,628,0,2,170,63,0
22676,238,5391,4293,999,3693,19,54,507,4312,9,155,88,170,164,258,1156,1898,4,9368,520,0,2,195,156,0
22677,238,5391,1482,859,1002,125,135,219,1607,16,219,134,251,235,385,1766,3032,9,27804,1544,1,2,195,156,0
22678,6,136,44,22,19,0,19,6,44,2,10,6,12,12,18,35,64,1,77,4,0,2,0,1,0
22679,27,950,74,35,59,1,0,14,75,3,14,7,14,17,21,58,85,1,128,7,0,2,27,22,0
22680,27,950,245,125,200,5,7,34,250,7,30,17,34,37,51,166,265,3,1053,58,0,2,27,22,0
22681,51,595,647,139,84,35,284,233,682,0,0,0,0,0,0,0,0,0,0,0,0,2,237,38,0
22682,98,2655,1523,757,1297,19,12,193,1542,12,193,117,230,205,347,1508,2664,7,19053,1058,0,2,103,18,0
22683,98,2655,701,378,504,33,58,109,734,13,110,68,126,123,194,794,1346,7,10027,557,0,2,103,18,0
22684,86,2211,773,422,505,30,103,129,803,14,77,46,83,91,129,535,839,7,6334,351,0,0,522,0,0
22685,122,2921,77,34,69,0,0,8,77,3,24,16,29,27,45,114,213,1,387,21,0,2,148,399,0
22686,122,2921,712,438,573,51,9,84,763,14,102,71,128,116,199,733,1364,8,11988,666,0,2,148,399,0
22687,24,600,2,2,2,0,0,0,2,0,0,0,0,0,0,0,0,0,0,0,0,0,157,0,0
22688,24,600,99,48,90,1,3,5,100,0,0,0,0,0,0,0,0,0,0,0,0,0,157,0,0
22689,24,600,8,5,5,2,0,1,10,0,0,0,0,0,0,0,0,0,0,0,0,0,157,0,0
22690,24,600,1217,716,841,84,126,174,1301,14,185,118,215,199,333,1446,2542,8,20687,1149,0,0,157,0,0
22691,24,600,160,89,115,0,13,31,160,7,15,11,17,22,28,78,124,3,495,27,0,0,157,0,0
22692,24,600,10,10,9,9,0,0,19,0,0,0,0,0,0,0,0,0,0,0,0,0,157,0,0
22693,24,600,173,84,99,8,29,36,181,5,12,7,13,17,20,54,81,2,221,12,0,0,157,0,0
22694,24,600,3,1,1,3,0,0,6,0,0,0,0,0,0,0,0,0,0,0,0,0,157,0,0
22695,32,665,125,97,103,3,0,19,128,9,25,17,27,34,44,144,223,4,1087,60,0,0,118,0,0
22696,24,380,102,57,55,5,16,25,107,5,17,10,18,22,28,81,124,2,330,18,0,0,97,0,0
22697,79,1722,402,202,227,24,74,80,426,12,52,33,61,64,94,339,564,7,3969,220,0,3,222,256,0
22698,48,992,447,308,343,6,5,95,453,7,96,59,111,103,170,651,1136,4,4600,255,0,2,34,10,0
22699,48,992,322,174,179,16,74,51,338,10,41,26,46,51,72,252,408,5,2291,127,0,2,34,10,0
22700,75,1595,53,23,39,0,0,13,53,2,8,4,8,10,12,26,39,1,39,2,0,0,392,0,0
22701,75,1595,515,298,307,33,80,99,548,12,63,44,77,75,121,419,753,7,5527,307,0,0,392,0,0
22702,23,382,424,94,331,4,0,89,428,1,5,5,5,6,10,11,25,0,12,0,0,2,4,4,0
22703,23,382,38,23,23,6,0,8,44,3,11,7,11,14,18,42,68,1,102,5,0,2,4,4,0
22704,20,509,205,80,86,16,53,53,221,7,18,10,19,25,29,94,134,3,497,27,0,0,147,0,0
22705,17,518,184,100,137,2,15,30,186,6,38,20,39,44,59,214,322,3,991,55,0,2,6,6,0
22706,17,518,103,65,74,8,5,16,111,7,17,9,17,24,26,89,119,3,417,23,0,2,6,6,0
22707,223,5307,722,423,573,19,0,135,741,12,172,101,199,184,300,1320,2257,6,15668,870,0,2,384,311,0
22708,223,5307,1508,847,911,44,250,301,1552,14,148,88,169,162,257,1120,1886,7,15077,837,0,2,384,311,0
22709,263,6260,72,33,56,0,4,12,72,1,1,1,1,2,2,0,2,0,1,0,0,2,233,160,0
22710,263,6260,1454,835,1044,76,110,219,1530,17,275,158,296,292,454,2297,3718,9,34017,1889,1,2,233,160,0
22711,78,1591,757,253,292,73,244,162,830,13,61,38,67,74,105,409,651,7,4654,258,0,2,377,153,0
22712,46,954,386,256,301,16,9,68,402,4,59,35,69,63,104,355,621,2,1453,80,0,2,45,16,0
22713,46,954,264,131,164,11,41,46,275,6,38,22,40,44,62,214,338,3,1068,59,0,2,45,16,0
22714,30,649,215,129,180,6,0,29,221,8,65,43,72,73,115,415,711,4,3153,175,0,2,9,4,0
22715,30,649,97,69,77,3,3,16,100,6,22,13,23,28,36,113,173,3,542,30,0,2,9,4,0
22716,113,2530,1043,504,840,53,9,147,1096,9,180,112,198,189,310,1377,2344,4,11604,644,0,2,88,147,0
22717,113,2530,383,288,292,26,6,62,409,11,65,38,67,76,105,429,656,5,3719,206,0,2,88,147,0
22718,20,408,294,64,250,0,0,43,294,1,20,10,20,21,30,86,131,0,65,3,0,2,2,2,0
22719,20,408,78,46,62,3,0,14,81,3,8,4,8,11,12,28,41,1,62,3,0,2,2,2,0
22720,71,1380,1178,367,1042,6,15,115,1184,9,94,51,95,103,146,644,976,4,4439,246,0,2,91,186,0
22721,71,1380,177,108,140,8,0,27,185,6,30,16,32,36,48,162,248,3,794,44,0,2,91,186,0
22722,209,4527,1943,715,1694,26,18,214,1969,12,185,120,237,197,357,1436,2721,7,20915,1161,0,2,209,88,0
22723,209,4527,1168,838,957,57,25,144,1225,19,348,224,416,367,640,3018,5452,11,61921,3440,1,2,209,88,0
22724,16,480,442,244,305,14,16,103,456,11,68,45,75,79,120,452,756,6,4588,254,0,2,5,3,0
22725,16,480,182,102,99,11,40,35,193,3,11,6,11,14,17,42,64,1,97,5,0,2,5,3,0
22726,62,1222,1098,241,925,5,10,155,1103,7,46,25,49,53,74,273,423,3,1580,87,0,2,10,12,0
22727,62,1222,282,202,222,14,2,44,296,8,42,24,43,50,67,250,378,4,1548,86,0,2,10,12,0
22728,23,458,601,196,481,2,23,85,603,8,63,36,72,71,108,400,664,4,3036,168,0,2,13,5,0
22729,23,458,156,79,106,5,16,28,161,5,14,8,15,19,23,64,97,2,261,14,0,2,13,5,0
22730,1,301,382,65,130,157,2,92,539,4,10,5,10,14,15,41,57,2,114,6,0,2,6,5,0
22731,60,1088,282,196,195,3,0,86,285,8,130,71,141,138,212,936,1507,4,6538,363,0,2,4,2,0
22732,7,299,72,33,56,0,4,12,72,1,1,1,1,2,2,0,2,0,1,0,0,2,1,1,0
22733,17,384,85,59,61,8,0,16,93,5,18,10,18,23,28,86,126,2,316,17,0,2,0,1,0
22734,15,472,42,7,35,4,0,5,46,1,2,1,2,3,3,2,4,0,2,0,0,2,47,15,0
22735,15,472,11,6,10,0,0,1,11,2,4,2,4,6,6,10,15,1,15,0,0,2,47,15,0
22736,91,3852,1289,550,1043,56,32,155,1345,10,167,93,185,177,278,1266,2075,5,11498,638,0,2,191,38,0
22737,36,1085,182,127,129,0,0,53,182,5,39,21,42,44,63,217,343,2,926,51,0,2,40,6,0
22738,147,6905,1392,870,1177,35,17,170,1427,14,494,280,531,508,811,4473,7289,7,54850,3047,2,2,121,72,0
22739,87,2871,773,419,590,28,0,166,801,10,204,113,217,214,330,1598,2554,5,13587,754,0,2,68,49,0
22740,15,742,75,38,59,1,3,12,76,2,4,2,4,6,6,10,15,1,15,0,0,2,128,2,0
22741,2,26,6,4,4,0,0,2,6,1,4,2,4,5,6,8,13,0,6,0,0,2,2,1,0
22742,13,572,139,89,101,2,0,35,141,7,54,34,62,61,96,330,569,4,2287,127,0,0,122,0,0
22743,1,135,149,67,118,4,0,27,153,1,17,14,28,18,42,69,175,0,144,8,0,0,29,0,0
22744,31,1981,1157,318,931,29,22,177,1186,6,104,63,125,110,188,712,1274,3,4596,255,0,0,777,0,0
22745,54,3601,520,294,400,33,13,81,553,10,261,204,367,271,571,2128,4614,7,32445,1802,1,2,212,109,0
22746,97,4416,1338,495,1086,10,64,173,1348,11,122,82,157,133,239,883,1686,7,11934,663,0,2,60,30,0
22747,172,7584,139,89,101,2,0,35,141,7,54,34,62,61,96,330,569,4,2287,127,0,2,656,253,0
22748,172,7584,7,5,5,0,0,2,7,1,2,1,2,3,3,2,4,0,2,0,0,2,656,253,0
22749,33,991,465,148,393,5,8,60,470,4,31,20,31,35,51,161,261,2,523,29,0,2,31,7,0
22750,33,991,16,12,9,0,0,6,16,1,2,1,2,3,3,2,4,0,2,0,0,2,31,7,0
22751,138,5861,1782,648,1425,9,47,279,1791,8,171,97,189,179,286,1292,2140,4,9462,525,0,2,158,78,0
22752,25,685,256,139,192,9,7,47,265,4,23,12,24,27,36,112,171,2,357,19,0,2,33,1,0
22753,6,329,180,34,164,0,0,16,180,1,12,6,12,13,18,43,66,0,33,1,0,2,21,0,0
22754,23,577,102,59,69,5,3,24,107,6,22,15,28,28,43,113,206,3,789,43,0,2,26,18,0
22755,110,4156,1450,624,1228,12,26,181,1462,14,306,186,354,320,540,2580,4493,8,36391,2021,1,2,68,33,0
22756,155,4419,1660,832,1314,41,38,274,1701,20,312,209,395,332,604,2671,5058,12,64042,3557,1,2,78,43,0
22757,36,2884,996,429,845,24,10,117,1020,7,76,50,88,83,138,494,879,4,3565,198,0,0,744,0,0
22758,129,5207,1513,682,1277,25,13,200,1538,11,199,116,219,210,335,1557,2584,6,15641,868,0,2,218,57,0
22759,73,3804,1296,573,1062,40,33,157,1336,8,201,118,231,209,349,1561,2689,4,12365,686,0,2,108,29,0
22760,14,341,207,111,150,11,0,50,218,5,26,19,36,31,55,133,272,3,943,52,0,2,26,1,0
22761,84,4429,1457,730,1242,11,6,188,1468,10,292,166,329,302,495,2424,4078,5,22973,1276,1,2,129,55,0
22762,39,2324,652,304,544,16,6,88,668,6,89,51,101,95,152,591,998,3,3399,188,0,2,67,56,0
22763,69,3184,1455,414,1257,16,76,112,1471,5,41,23,46,46,69,231,381,2,1069,59,0,2,102,13,0
22764,8,273,74,35,59,1,0,14,75,3,14,7,14,17,21,58,85,1,128,7,0,2,8,1,0
22765,94,4591,1523,757,1297,19,12,193,1542,12,193,117,230,205,347,1508,2664,7,19053,1058,0,2,52,16,0
22766,84,3593,1020,354,843,12,15,144,1032,8,134,77,144,142,221,970,1580,4,6792,377,0,2,169,36,0
22767,38,1676,447,308,343,6,5,95,453,7,96,59,111,103,170,651,1136,4,4600,255,0,2,14,1,0
22768,1,106,53,23,39,0,0,13,53,2,8,4,8,10,12,26,39,1,39,2,0,0,18,0,0
22769,21,661,424,94,331,4,0,89,428,1,5,5,5,6,10,11,25,0,12,0,0,2,45,35,0
22770,38,2301,334,251,279,10,4,40,344,5,127,74,143,132,217,899,1528,2,4303,239,0,2,17,19,0
22771,12,492,184,100,137,2,15,30,186,6,38,20,39,44,59,214,322,3,991,55,0,2,3,4,0
22772,58,2553,1293,570,1093,25,15,163,1318,10,195,123,241,205,364,1516,2795,6,17273,959,0,2,227,15,0
22773,33,1886,384,251,317,7,8,52,391,11,70,44,84,81,128,467,811,6,5355,297,0,2,42,50,0
22774,45,2208,722,423,573,19,0,135,741,12,172,101,199,184,300,1320,2257,6,15668,870,0,2,254,10,0
22775,39,1724,386,256,301,16,9,68,402,4,59,35,69,63,104,355,621,2,1453,80,0,2,48,50,0
22776,16,1213,215,129,180,6,0,29,221,8,65,43,72,73,115,415,711,4,3153,175,0,2,12,12,0
22777,78,3015,1043,504,840,53,9,147,1096,9,180,112,198,189,310,1377,2344,4,11604,644,0,2,127,58,0
22778,14,529,295,56,236,0,4,54,295,2,9,5,10,11,15,30,51,1,57,3,0,2,17,5,0
22779,30,1233,373,158,315,8,0,51,381,5,76,44,79,81,123,486,779,2,2026,112,0,2,74,22,0
22780,77,3237,1178,367,1042,6,15,115,1184,9,94,51,95,103,146,644,976,4,4439,246,0,2,126,14,0
22781,91,4606,1943,715,1694,26,18,214,1969,12,185,120,237,197,357,1436,2721,7,20915,1161,0,2,321,48,0
22782,14,825,442,244,305,14,16,103,456,11,68,45,75,79,120,452,756,6,4588,254,0,2,5,0,0
22783,48,1750,1098,241,925,5,10,155,1103,7,46,25,49,53,74,273,423,3,1580,87,0,2,95,80,0
22784,19,679,601,196,481,2,23,85,603,8,63,36,72,71,108,400,664,4,3036,168,0,2,72,4,0
22785,238,5391,4293,999,3693,19,54,507,4312,9,155,88,170,164,258,1156,1898,4,9368,520,0,2,5,0,0
22786,238,5391,1482,859,1002,125,135,219,1607,16,219,134,251,235,385,1766,3032,9,27804,1544,1,2,5,0,0
22787,172,7584,139,89,101,2,0,35,141,7,54,34,62,61,96,330,569,4,2287,127,0,2,8,0,0
22788,172,7584,7,5,5,0,0,2,7,1,2,1,2,3,3,2,4,0,2,0,0,2,8,0,0
22789,172,7751,139,89,101,2,0,35,141,7,54,34,62,61,96,330,569,4,2287,127,0,2,47,5,1
22790,172,7751,7,5,5,0,0,2,7,1,2,1,2,3,3,2,4,0,2,0,0,2,47,5,1
22791,245,5510,4293,999,3693,19,54,507,4312,9,155,88,170,164,258,1156,1898,4,9368,520,0,2,5,0,0
22792,245,5510,1482,859,1002,125,135,219,1607,16,219,134,251,235,385,1766,3032,9,27804,1544,1,2,5,0,0
22793,174,7780,139,89,101,2,0,35,141,7,54,34,62,61,96,330,569,4,2287,127,0,2,8,0,0
22794,174,7780,7,5,5,0,0,2,7,1,2,1,2,3,3,2,4,0,2,0,0,2,8,0,0
22795,58,1174,207,111,150,11,0,50,218,5,26,19,36,31,55,133,272,3,943,52,0,2,8,0,0
22796,58,1174,410,198,237,31,55,97,441,11,63,38,72,74,110,414,683,6,4293,238,0,2,8,0,0
22797,27,951,74,35,59,1,0,14,75,3,14,7,14,17,21,58,85,1,128,7,0,2,2,1,0
22798,27,951,245,125,200,5,7,34,250,7,30,17,34,37,51,166,265,3,1053,58,0,2,2,1,0
22799,86,2211,773,422,505,30,103,129,803,14,77,46,83,91,129,535,839,7,6334,351,0,2,3,3,0
22800,122,2921,77,34,69,0,0,8,77,3,24,16,29,27,45,114,213,1,387,21,0,2,1,1,0
22801,122,2921,712,438,573,51,9,84,763,14,102,71,128,116,199,733,1364,8,11988,666,0,2,1,1,0
22802,263,6293,72,33,56,0,4,12,72,1,1,1,1,2,2,0,2,0,1,0,0,2,13,8,0
22803,263,6293,1454,835,1044,76,110,219,1530,17,275,158,296,292,454,2297,3718,9,34017,1889,1,2,13,8,0
22804,113,2553,1043,504,840,53,9,147,1096,9,180,112,198,189,310,1377,2344,4,11604,644,0,2,2,1,0
22805,113,2553,383,288,292,26,6,62,409,11,65,38,67,76,105,429,656,5,3719,206,0,2,2,1,0
22806,15,485,42,7,35,4,0,5,46,1,2,1,2,3,3,2,4,0,2,0,0,2,4,0,0
22807,15,485,11,6,10,0,0,1,11,2,4,2,4,6,6,10,15,1,15,0,0,2,4,0,0
22808,92,3882,1289,550,1043,56,32,155,1345,10,167,93,185,177,278,1266,2075,5,11498,638,0,2,30,0,0
22809,139,5894,1782,648,1425,9,47,279,1791,8,171,97,189,179,286,1292,2140,4,9462,525,0,2,13,0,0
22810,79,3054,1043,504,840,53,9,147,1096,9,180,112,198,189,310,1377,2344,4,11604,644,0,2,14,5,0
22811,58,1174,207,111,150,11,0,50,218,5,26,19,36,31,55,133,272,3,943,52,0,2,8,0,0
22812,58,1174,410,198,237,31,55,97,441,11,63,38,72,74,110,414,683,6,4293,238,0,2,8,0,0
22813,27,951,74,35,59,1,0,14,75,3,14,7,14,17,21,58,85,1,128,7,0,2,2,1,0
22814,27,951,245,125,200,5,7,34,250,7,30,17,34,37,51,166,265,3,1053,58,0,2,2,1,0
22815,86,2211,773,422,505,30,103,129,803,14,77,46,83,91,129,535,839,7,6334,351,0,2,3,3,0
22816,122,2921,77,34,69,0,0,8,77,3,24,16,29,27,45,114,213,1,387,21,0,2,1,1,0
22817,122,2921,712,438,573,51,9,84,763,14,102,71,128,116,199,733,1364,8,11988,666,0,2,1,1,0
22818,263,6293,72,33,56,0,4,12,72,1,1,1,1,2,2,0,2,0,1,0,0,2,13,8,0
22819,263,6293,1454,835,1044,76,110,219,1530,17,275,158,296,292,454,2297,3718,9,34017,1889,1,2,13,8,0
22820,113,2553,1043,504,840,53,9,147,1096,9,180,112,198,189,310,1377,2344,4,11604,644,0,2,2,1,0
22821,113,2553,383,288,292,26,6,62,409,11,65,38,67,76,105,429,656,5,3719,206,0,2,2,1,0
22822,15,485,42,7,35,4,0,5,46,1,2,1,2,3,3,2,4,0,2,0,0,2,4,0,0
22823,15,485,11,6,10,0,0,1,11,2,4,2,4,6,6,10,15,1,15,0,0,2,4,0,0
22824,92,3882,1289,550,1043,56,32,155,1345,10,167,93,185,177,278,1266,2075,5,11498,638,0,2,30,0,0
22825,139,5894,1782,648,1425,9,47,279,1791,8,171,97,189,179,286,1292,2140,4,9462,525,0,2,13,0,0
22826,79,3054,1043,504,840,53,9,147,1096,9,180,112,198,189,310,1377,2344,4,11604,644,0,2,14,5,0
22827,245,5514,4293,999,3693,19,54,507,4312,9,155,88,170,164,258,1156,1898,4,9368,520,0,2,1,1,0
22828,245,5514,1482,859,1002,125,135,219,1607,16,219,134,251,235,385,1766,3032,9,27804,1544,1,2,1,1,0
22829,58,1174,207,111,150,11,0,50,218,5,26,19,36,31,55,133,272,3,943,52,0,2,8,0,0
22830,58,1174,410,198,237,31,55,97,441,11,63,38,72,74,110,414,683,6,4293,238,0,2,8,0,0
22831,27,951,74,35,59,1,0,14,75,3,14,7,14,17,21,58,85,1,128,7,0,2,2,1,0
22832,27,951,245,125,200,5,7,34,250,7,30,17,34,37,51,166,265,3,1053,58,0,2,2,1,0
22833,86,2211,773,422,505,30,103,129,803,14,77,46,83,91,129,535,839,7,6334,351,0,2,3,3,0
22834,140,3230,77,34,69,0,0,8,77,3,24,16,29,27,45,114,213,1,387,21,0,2,1,1,0
22835,140,3230,712,438,573,51,9,84,763,14,102,71,128,116,199,733,1364,8,11988,666,0,2,1,1,0
22836,288,6784,72,33,56,0,4,12,72,1,1,1,1,2,2,0,2,0,1,0,0,2,13,8,0
22837,288,6784,1454,835,1044,76,110,219,1530,17,275,158,296,292,454,2297,3718,9,34017,1889,1,2,13,8,0
22838,113,2553,1043,504,840,53,9,147,1096,9,180,112,198,189,310,1377,2344,4,11604,644,0,2,2,1,0
22839,113,2553,383,288,292,26,6,62,409,11,65,38,67,76,105,429,656,5,3719,206,0,2,2,1,0
22840,15,485,42,7,35,4,0,5,46,1,2,1,2,3,3,2,4,0,2,0,0,2,4,0,0
22841,15,485,11,6,10,0,0,1,11,2,4,2,4,6,6,10,15,1,15,0,0,2,4,0,0
22842,92,3882,1289,550,1043,56,32,155,1345,10,167,93,185,177,278,1266,2075,5,11498,638,0,2,30,0,0
22843,139,5894,1782,648,1425,9,47,279,1791,8,171,97,189,179,286,1292,2140,4,9462,525,0,2,13,0,0
22844,79,3054,1043,504,840,53,9,147,1096,9,180,112,198,189,310,1377,2344,4,11604,644,0,2,14,5,0
22845,288,6780,72,33,56,0,4,12,72,1,1,1,1,2,2,0,2,0,1,0,0,2,1,1,0
22846,288,6780,1454,835,1044,76,110,219,1530,17,275,158,296,292,454,2297,3718,9,34017,1889,1,2,1,1,0
22847,245,5516,4293,999,3693,19,54,507,4312,9,155,88,170,164,258,1156,1898,4,9368,520,0,2,2,1,0
22848,245,5516,1482,859,1002,125,135,219,1607,16,219,134,251,235,385,1766,3032,9,27804,1544,1,2,2,1,0
22849,76,1597,53,23,39,0,0,13,53,2,8,4,8,10,12,26,39,1,39,2,0,2,0,1,0
22850,76,1597,515,298,307,33,80,99,548,12,63,44,77,75,121,419,753,7,5527,307,0,2,0,1,0
22851,28,807,339,213,244,17,9,65,356,10,42,26,48,52,74,259,421,5,2410,133,0,2,1,1,1
22852,114,2580,1043,504,840,53,9,147,1096,9,180,112,198,189,310,1377,2344,4,11604,644,0,2,8,4,1
22853,114,2580,383,288,292,26,6,62,409,11,65,38,67,76,105,429,656,5,3719,206,0,2,8,4,1
22854,59,2584,1293,570,1093,25,15,163,1318,10,195,123,241,205,364,1516,2795,6,17273,959,0,2,9,0,1
22855,59,2582,1293,570,1093,25,15,163,1318,10,195,123,241,205,364,1516,2795,6,17273,959,0,2,0,1,0
22856,22,351,102,57,55,5,16,25,107,5,17,10,18,22,28,81,124,2,330,18,0,2,3,8,0
22857,84,3593,1020,354,843,12,15,144,1032,8,134,77,144,142,221,970,1580,4,6792,377,0,2,1,1,0
22858,28,807,339,213,244,17,9,65,356,10,42,26,48,52,74,259,421,5,2410,133,0,2,1,1,0
22859,114,2580,1043,504,840,53,9,147,1096,9,180,112,198,189,310,1377,2344,4,11604,644,0,2,8,4,0
22860,114,2580,383,288,292,26,6,62,409,11,65,38,67,76,105,429,656,5,3719,206,0,2,8,4,0
22861,59,2582,1293,570,1093,25,15,163,1318,10,195,123,241,205,364,1516,2795,6,17273,959,0,2,8,0,0
22862,85,3690,1020,354,843,12,15,144,1032,8,134,77,144,142,221,970,1580,4,6792,377,0,2,32,0,0
22863,22,351,102,57,55,5,16,25,107,5,17,10,18,22,28,81,124,2,330,18,0,2,3,8,0
22864,85,3690,1020,354,843,12,15,144,1032,8,134,77,144,142,221,970,1580,4,6792,377,0,2,33,1,0
22865,89,1841,477,336,357,30,23,73,507,16,194,134,250,210,384,1538,2962,10,30538,1696,0,2,18,2,1
22866,111,4196,1450,624,1228,12,26,181,1462,14,306,186,354,320,540,2580,4493,8,36391,2021,1,2,12,0,1
22867,89,1841,477,336,357,30,23,73,507,16,194,134,250,210,384,1538,2962,10,30538,1696,0,2,4,4,0
22868,89,1841,477,336,357,30,23,73,507,16,194,134,250,210,384,1538,2962,10,30538,1696,0,2,18,2,0
22869,111,4196,1450,624,1228,12,26,181,1462,14,306,186,354,320,540,2580,4493,8,36391,2021,1,2,12,0,0
22870,170,7554,139,89,101,2,0,35,141,7,54,34,62,61,96,330,569,4,2287,127,0,2,2,1,1
22871,170,7554,7,5,5,0,0,2,7,1,2,1,2,3,3,2,4,0,2,0,0,2,2,1,1
22872,170,7554,139,89,101,2,0,35,141,7,54,34,62,61,96,330,569,4,2287,127,0,2,2,1,0
22873,170,7554,7,5,5,0,0,2,7,1,2,1,2,3,3,2,4,0,2,0,0,2,2,1,0
22874,237,5388,4293,999,3693,19,54,507,4312,9,155,88,170,164,258,1156,1898,4,9368,520,0,2,1,1,0
22875,237,5388,1482,859,1002,125,135,219,1607,16,219,134,251,235,385,1766,3032,9,27804,1544,1,2,1,1,0
22876,30,659,125,97,103,3,0,19,128,9,25,17,27,34,44,144,223,4,1087,60,0,2,1,1,0
22877,76,1643,53,23,39,0,0,13,53,2,8,4,8,10,12,26,39,1,39,2,0,2,17,5,0
22878,76,1643,515,298,307,33,80,99,548,12,63,44,77,75,121,419,753,7,5527,307,0,2,17,5,0
22879,262,6289,72,33,56,0,4,12,72,1,1,1,1,2,2,0,2,0,1,0,0,2,2,3,0
22880,262,6289,1454,835,1044,76,110,219,1530,17,275,158,296,292,454,2297,3718,9,34017,1889,1,2,2,3,0
22881,70,1375,1178,367,1042,6,15,115,1184,9,94,51,95,103,146,644,976,4,4439,246,0,2,1,3,0
22882,70,1375,177,108,140,8,0,27,185,6,30,16,32,36,48,162,248,3,794,44,0,2,1,3,0
22883,22,454,601,196,481,2,23,85,603,8,63,36,72,71,108,400,664,4,3036,168,0,2,3,4,0
22884,22,454,156,79,106,5,16,28,161,5,14,8,15,19,23,64,97,2,261,14,0,2,3,4,0
22885,87,3808,1020,354,843,12,15,144,1032,8,134,77,144,142,221,970,1580,4,6792,377,0,2,30,3,0
22886,84,1807,773,419,590,28,0,166,801,10,204,113,217,214,330,1598,2554,5,13587,754,0,2,1,1,0
22887,84,1807,421,273,302,44,34,57,465,17,81,59,107,98,166,583,1098,11,12329,684,0,2,1,1,0
22888,145,3018,1513,682,1277,25,13,200,1538,11,199,116,219,210,335,1557,2584,6,15641,868,0,2,1,1,0
22889,145,3018,819,519,539,24,98,155,843,15,96,57,106,111,163,690,1107,8,9171,509,0,2,1,1,0
22890,58,1174,207,111,150,11,0,50,218,5,26,19,36,31,55,133,272,3,943,52,0,2,1,1,0
22891,58,1174,410,198,237,31,55,97,441,11,63,38,72,74,110,414,683,6,4293,238,0,2,1,1,0
22892,83,2145,1455,414,1257,16,76,112,1471,5,41,23,46,46,69,231,381,2,1069,59,0,2,1,1,0
22893,83,2145,669,365,481,22,61,110,691,15,103,63,122,118,185,747,1273,8,11311,628,0,2,1,1,0
22894,236,5368,4293,999,3693,19,54,507,4312,9,155,88,170,164,258,1156,1898,4,9368,520,0,2,2,2,0
22895,236,5368,1482,859,1002,125,135,219,1607,16,219,134,251,235,385,1766,3032,9,27804,1544,1,2,2,2,0
22896,122,2921,77,34,69,0,0,8,77,3,24,16,29,27,45,114,213,1,387,21,0,2,2,2,0
22897,122,2921,712,438,573,51,9,84,763,14,102,71,128,116,199,733,1364,8,11988,666,0,2,2,2,0
22898,74,1567,402,202,227,24,74,80,426,12,52,33,61,64,94,339,564,7,3969,220,0,2,2,2,0
22899,20,509,205,80,86,16,53,53,221,7,18,10,19,25,29,94,134,3,497,27,0,2,1,1,0
22900,259,6153,72,33,56,0,4,12,72,1,1,1,1,2,2,0,2,0,1,0,0,2,1,1,0
22901,259,6153,1454,835,1044,76,110,219,1530,17,275,158,296,292,454,2297,3718,9,34017,1889,1,2,1,1,0
22902,147,6905,1392,870,1177,35,17,170,1427,14,494,280,531,508,811,4473,7289,7,54850,3047,2,2,1,1,0
22903,170,7554,139,89,101,2,0,35,141,7,54,34,62,61,96,330,569,4,2287,127,0,2,1,1,0
22904,170,7554,7,5,5,0,0,2,7,1,2,1,2,3,3,2,4,0,2,0,0,2,1,1,0
22905,111,4196,1450,624,1228,12,26,181,1462,14,306,186,354,320,540,2580,4493,8,36391,2021,1,2,1,1,0
22906,129,5207,1513,682,1277,25,13,200,1538,11,199,116,219,210,335,1557,2584,6,15641,868,0,2,1,1,0
22907,39,2324,652,304,544,16,6,88,668,6,89,51,101,95,152,591,998,3,3399,188,0,2,1,1,0
22908,21,661,424,94,331,4,0,89,428,1,5,5,5,6,10,11,25,0,12,0,0,2,1,1,0
22909,6,136,44,22,19,0,19,6,44,2,10,6,12,12,18,35,64,1,77,4,0,2,1,1,0
22910,223,5307,722,423,573,19,0,135,741,12,172,101,199,184,300,1320,2257,6,15668,870,0,2,2,2,0
22911,223,5307,1508,847,911,44,250,301,1552,14,148,88,169,162,257,1120,1886,7,15077,837,0,2,2,2,0
22912,1,319,382,65,130,157,2,92,539,4,10,5,10,14,15,41,57,2,114,6,0,2,3,1,0
22913,84,1807,773,419,590,28,0,166,801,10,204,113,217,214,330,1598,2554,5,13587,754,0,2,1,1,0
22914,84,1807,421,273,302,44,34,57,465,17,81,59,107,98,166,583,1098,11,12329,684,0,2,1,1,0
22915,145,3018,1513,682,1277,25,13,200,1538,11,199,116,219,210,335,1557,2584,6,15641,868,0,2,1,1,0
22916,145,3018,819,519,539,24,98,155,843,15,96,57,106,111,163,690,1107,8,9171,509,0,2,1,1,0
22917,58,1174,207,111,150,11,0,50,218,5,26,19,36,31,55,133,272,3,943,52,0,2,1,1,0
22918,58,1174,410,198,237,31,55,97,441,11,63,38,72,74,110,414,683,6,4293,238,0,2,1,1,0
22919,83,2145,1455,414,1257,16,76,112,1471,5,41,23,46,46,69,231,381,2,1069,59,0,2,1,1,0
22920,83,2145,669,365,481,22,61,110,691,15,103,63,122,118,185,747,1273,8,11311,628,0,2,1,1,0
22921,236,5368,4293,999,3693,19,54,507,4312,9,155,88,170,164,258,1156,1898,4,9368,520,0,2,2,2,0
22922,236,5368,1482,859,1002,125,135,219,1607,16,219,134,251,235,385,1766,3032,9,27804,1544,1,2,2,2,0
22923,122,2921,77,34,69,0,0,8,77,3,24,16,29,27,45,114,213,1,387,21,0,2,2,2,0
22924,122,2921,712,438,573,51,9,84,763,14,102,71,128,116,199,733,1364,8,11988,666,0,2,2,2,0
22925,74,1567,402,202,227,24,74,80,426,12,52,33,61,64,94,339,564,7,3969,220,0,2,2,2,0
22926,20,509,205,80,86,16,53,53,221,7,18,10,19,25,29,94,134,3,497,27,0,2,1,1,0
22927,259,6153,72,33,56,0,4,12,72,1,1,1,1,2,2,0,2,0,1,0,0,2,1,1,0
22928,259,6153,1454,835,1044,76,110,219,1530,17,275,158,296,292,454,2297,3718,9,34017,1889,1,2,1,1,0
22929,147,6905,1392,870,1177,35,17,170,1427,14,494,280,531,508,811,4473,7289,7,54850,3047,2,2,1,1,0
22930,170,7554,139,89,101,2,0,35,141,7,54,34,62,61,96,330,569,4,2287,127,0,2,1,1,0
22931,170,7554,7,5,5,0,0,2,7,1,2,1,2,3,3,2,4,0,2,0,0,2,1,1,0
22932,111,4196,1450,624,1228,12,26,181,1462,14,306,186,354,320,540,2580,4493,8,36391,2021,1,2,1,1,0
22933,129,5207,1513,682,1277,25,13,200,1538,11,199,116,219,210,335,1557,2584,6,15641,868,0,2,1,1,0
22934,39,2324,652,304,544,16,6,88,668,6,89,51,101,95,152,591,998,3,3399,188,0,2,1,1,0
22935,21,661,424,94,331,4,0,89,428,1,5,5,5,6,10,11,25,0,12,0,0,2,1,1,0
22936,6,136,44,22,19,0,19,6,44,2,10,6,12,12,18,35,64,1,77,4,0,2,1,1,0
22937,223,5307,722,423,573,19,0,135,741,12,172,101,199,184,300,1320,2257,6,15668,870,0,2,2,2,0
22938,223,5307,1508,847,911,44,250,301,1552,14,148,88,169,162,257,1120,1886,7,15077,837,0,2,2,2,0
22939,76,1643,53,23,39,0,0,13,53,2,8,4,8,10,12,26,39,1,39,2,0,2,8,4,0
22940,76,1643,515,298,307,33,80,99,548,12,63,44,77,75,121,419,753,7,5527,307,0,2,8,4,0
22941,139,5880,1782,648,1425,9,47,279,1791,8,171,97,189,179,286,1292,2140,4,9462,525,0,2,1,0,0
22942,1,319,382,65,130,157,2,92,539,4,10,5,10,14,15,41,57,2,114,6,0,2,3,1,0
22943,139,5880,1782,648,1425,9,47,279,1791,8,171,97,189,179,286,1292,2140,4,9462,525,0,2,1,0,0
22944,356,7105,1457,730,1242,11,6,188,1468,10,292,166,329,302,495,2424,4078,5,22973,1276,1,2,6,1,0
22945,356,7105,74,35,59,1,0,14,75,3,14,7,14,17,21,58,85,1,128,7,0,2,6,1,0
22946,356,7105,245,125,200,5,7,34,250,7,30,17,34,37,51,166,265,3,1053,58,0,2,6,1,0
22947,84,1807,773,419,590,28,0,166,801,10,204,113,217,214,330,1598,2554,5,13587,754,0,2,1,1,0
22948,84,1807,421,273,302,44,34,57,465,17,81,59,107,98,166,583,1098,11,12329,684,0,2,1,1,0
22949,89,1841,477,336,357,30,23,73,507,16,194,134,250,210,384,1538,2962,10,30538,1696,0,2,18,2,0
22950,145,3018,1513,682,1277,25,13,200,1538,11,199,116,219,210,335,1557,2584,6,15641,868,0,2,1,1,0
22951,145,3018,819,519,539,24,98,155,843,15,96,57,106,111,163,690,1107,8,9171,509,0,2,1,1,0
22952,58,1174,207,111,150,11,0,50,218,5,26,19,36,31,55,133,272,3,943,52,0,2,1,1,0
22953,58,1174,410,198,237,31,55,97,441,11,63,38,72,74,110,414,683,6,4293,238,0,2,1,1,0
22954,83,2145,1455,414,1257,16,76,112,1471,5,41,23,46,46,69,231,381,2,1069,59,0,2,1,1,0
22955,83,2145,669,365,481,22,61,110,691,15,103,63,122,118,185,747,1273,8,11311,628,0,2,1,1,0
22956,238,5391,4293,999,3693,19,54,507,4312,9,155,88,170,164,258,1156,1898,4,9368,520,0,2,2,2,0
22957,238,5391,1482,859,1002,125,135,219,1607,16,219,134,251,235,385,1766,3032,9,27804,1544,1,2,2,2,0
22958,6,136,44,22,19,0,19,6,44,2,10,6,12,12,18,35,64,1,77,4,0,2,1,1,0
22959,122,2921,77,34,69,0,0,8,77,3,24,16,29,27,45,114,213,1,387,21,0,2,2,2,0
22960,122,2921,712,438,573,51,9,84,763,14,102,71,128,116,199,733,1364,8,11988,666,0,2,2,2,0
22961,79,1722,402,202,227,24,74,80,426,12,52,33,61,64,94,339,564,7,3969,220,0,2,2,2,0
22962,20,509,205,80,86,16,53,53,221,7,18,10,19,25,29,94,134,3,497,27,0,2,1,1,0
22963,223,5307,722,423,573,19,0,135,741,12,172,101,199,184,300,1320,2257,6,15668,870,0,2,2,2,0
22964,223,5307,1508,847,911,44,250,301,1552,14,148,88,169,162,257,1120,1886,7,15077,837,0,2,2,2,0
22965,263,6293,72,33,56,0,4,12,72,1,1,1,1,2,2,0,2,0,1,0,0,2,1,1,0
22966,263,6293,1454,835,1044,76,110,219,1530,17,275,158,296,292,454,2297,3718,9,34017,1889,1,2,1,1,0
22967,1,319,382,65,130,157,2,92,539,4,10,5,10,14,15,41,57,2,114,6,0,2,3,1,0
22968,147,6905,1392,870,1177,35,17,170,1427,14,494,280,531,508,811,4473,7289,7,54850,3047,2,2,1,1,0
22969,172,7584,139,89,101,2,0,35,141,7,54,34,62,61,96,330,569,4,2287,127,0,2,3,2,0
22970,172,7584,7,5,5,0,0,2,7,1,2,1,2,3,3,2,4,0,2,0,0,2,3,2,0
22971,139,5905,1782,648,1425,9,47,279,1791,8,171,97,189,179,286,1292,2140,4,9462,525,0,2,1,0,0
22972,111,4196,1450,624,1228,12,26,181,1462,14,306,186,354,320,540,2580,4493,8,36391,2021,1,2,13,1,0
22973,129,5207,1513,682,1277,25,13,200,1538,11,199,116,219,210,335,1557,2584,6,15641,868,0,2,1,1,0
22974,39,2324,652,304,544,16,6,88,668,6,89,51,101,95,152,591,998,3,3399,188,0,2,1,1,0
22975,21,661,424,94,331,4,0,89,428,1,5,5,5,6,10,11,25,0,12,0,0,2,1,1,0
22976,84,1807,773,419,590,28,0,166,801,10,204,113,217,214,330,1598,2554,5,13587,754,0,2,1,1,0
22977,84,1807,421,273,302,44,34,57,465,17,81,59,107,98,166,583,1098,11,12329,684,0,2,1,1,0
22978,89,1841,477,336,357,30,23,73,507,16,194,134,250,210,384,1538,2962,10,30538,1696,0,2,18,2,0
22979,145,3018,1513,682,1277,25,13,200,1538,11,199,116,219,210,335,1557,2584,6,15641,868,0,2,1,1,0
22980,145,3018,819,519,539,24,98,155,843,15,96,57,106,111,163,690,1107,8,9171,509,0,2,1,1,0
22981,58,1174,207,111,150,11,0,50,218,5,26,19,36,31,55,133,272,3,943,52,0,2,1,1,0
22982,58,1174,410,198,237,31,55,97,441,11,63,38,72,74,110,414,683,6,4293,238,0,2,1,1,0
22983,83,2145,1455,414,1257,16,76,112,1471,5,41,23,46,46,69,231,381,2,1069,59,0,2,1,1,0
22984,83,2145,669,365,481,22,61,110,691,15,103,63,122,118,185,747,1273,8,11311,628,0,2,1,1,0
22985,238,5391,4293,999,3693,19,54,507,4312,9,155,88,170,164,258,1156,1898,4,9368,520,0,2,2,2,0
22986,238,5391,1482,859,1002,125,135,219,1607,16,219,134,251,235,385,1766,3032,9,27804,1544,1,2,2,2,0
22987,6,136,44,22,19,0,19,6,44,2,10,6,12,12,18,35,64,1,77,4,0,2,1,1,0
22988,122,2921,77,34,69,0,0,8,77,3,24,16,29,27,45,114,213,1,387,21,0,2,2,2,0
22989,122,2921,712,438,573,51,9,84,763,14,102,71,128,116,199,733,1364,8,11988,666,0,2,2,2,0
22990,79,1722,402,202,227,24,74,80,426,12,52,33,61,64,94,339,564,7,3969,220,0,2,2,2,0
22991,20,509,205,80,86,16,53,53,221,7,18,10,19,25,29,94,134,3,497,27,0,2,1,1,0
22992,223,5307,722,423,573,19,0,135,741,12,172,101,199,184,300,1320,2257,6,15668,870,0,2,2,2,0
22993,223,5307,1508,847,911,44,250,301,1552,14,148,88,169,162,257,1120,1886,7,15077,837,0,2,2,2,0
22994,263,6293,72,33,56,0,4,12,72,1,1,1,1,2,2,0,2,0,1,0,0,2,1,1,0
22995,263,6293,1454,835,1044,76,110,219,1530,17,275,158,296,292,454,2297,3718,9,34017,1889,1,2,1,1,0
22996,1,319,382,65,130,157,2,92,539,4,10,5,10,14,15,41,57,2,114,6,0,2,3,1,0
22997,147,6905,1392,870,1177,35,17,170,1427,14,494,280,531,508,811,4473,7289,7,54850,3047,2,2,1,1,0
22998,172,7584,139,89,101,2,0,35,141,7,54,34,62,61,96,330,569,4,2287,127,0,2,3,2,0
22999,172,7584,7,5,5,0,0,2,7,1,2,1,2,3,3,2,4,0,2,0,0,2,3,2,0
23000,139,5905,1782,648,1425,9,47,279,1791,8,171,97,189,179,286,1292,2140,4,9462,525,0,2,1,0,0
23001,111,4196,1450,624,1228,12,26,181,1462,14,306,186,354,320,540,2580,4493,8,36391,2021,1,2,13,1,0
23002,129,5207,1513,682,1277,25,13,200,1538,11,199,116,219,210,335,1557,2584,6,15641,868,0,2,1,1,0
23003,39,2324,652,304,544,16,6,88,668,6,89,51,101,95,152,591,998,3,3399,188,0,2,1,1,0
23004,21,661,424,94,331,4,0,89,428,1,5,5,5,6,10,11,25,0,12,0,0,2,1,1,0
23005,237,5388,4293,999,3693,19,54,507,4312,9,155,88,170,164,258,1156,1898,4,9368,520,0,2,1,1,0
23006,237,5388,1482,859,1002,125,135,219,1607,16,219,134,251,235,385,1766,3032,9,27804,1544,1,2,1,1,0
23007,30,659,125,97,103,3,0,19,128,9,25,17,27,34,44,144,223,4,1087,60,0,2,1,1,0
23008,76,1643,53,23,39,0,0,13,53,2,8,4,8,10,12,26,39,1,39,2,0,2,24,8,0
23009,76,1643,515,298,307,33,80,99,548,12,63,44,77,75,121,419,753,7,5527,307,0,2,24,8,0
23010,262,6289,72,33,56,0,4,12,72,1,1,1,1,2,2,0,2,0,1,0,0,2,2,3,0
23011,262,6289,1454,835,1044,76,110,219,1530,17,275,158,296,292,454,2297,3718,9,34017,1889,1,2,2,3,0
23012,70,1375,1178,367,1042,6,15,115,1184,9,94,51,95,103,146,644,976,4,4439,246,0,2,1,3,0
23013,70,1375,177,108,140,8,0,27,185,6,30,16,32,36,48,162,248,3,794,44,0,2,1,3,0
23014,22,454,601,196,481,2,23,85,603,8,63,36,72,71,108,400,664,4,3036,168,0,2,3,4,0
23015,22,454,156,79,106,5,16,28,161,5,14,8,15,19,23,64,97,2,261,14,0,2,3,4,0
23016,87,3808,1020,354,843,12,15,144,1032,8,134,77,144,142,221,970,1580,4,6792,377,0,2,30,3,0
23017,356,7105,1457,730,1242,11,6,188,1468,10,292,166,329,302,495,2424,4078,5,22973,1276,1,2,6,1,0
23018,356,7105,74,35,59,1,0,14,75,3,14,7,14,17,21,58,85,1,128,7,0,2,6,1,0
23019,356,7105,245,125,200,5,7,34,250,7,30,17,34,37,51,166,265,3,1053,58,0,2,6,1,0
23020,58,1178,207,111,150,11,0,50,218,5,26,19,36,31,55,133,272,3,943,52,0,2,2,2,0
23021,58,1178,410,198,237,31,55,97,441,11,63,38,72,74,110,414,683,6,4293,238,0,2,2,2,0
23022,78,1593,757,253,292,73,244,162,830,13,61,38,67,74,105,409,651,7,4654,258,0,2,1,1,0
23023,58,1178,207,111,150,11,0,50,218,5,26,19,36,31,55,133,272,3,943,52,0,2,2,2,0
23024,58,1178,410,198,237,31,55,97,441,11,63,38,72,74,110,414,683,6,4293,238,0,2,2,2,0
23025,78,1593,757,253,292,73,244,162,830,13,61,38,67,74,105,409,651,7,4654,258,0,2,1,1,0
23026,58,1178,207,111,150,11,0,50,218,5,26,19,36,31,55,133,272,3,943,52,0,2,2,2,0
23027,58,1178,410,198,237,31,55,97,441,11,63,38,72,74,110,414,683,6,4293,238,0,2,2,2,0
23028,356,7105,1457,730,1242,11,6,188,1468,10,292,166,329,302,495,2424,4078,5,22973,1276,1,2,6,1,0
23029,356,7105,74,35,59,1,0,14,75,3,14,7,14,17,21,58,85,1,128,7,0,2,6,1,0
23030,356,7105,245,125,200,5,7,34,250,7,30,17,34,37,51,166,265,3,1053,58,0,2,6,1,0
23031,78,1593,757,253,292,73,244,162,830,13,61,38,67,74,105,409,651,7,4654,258,0,2,1,1,0
23032,58,1178,207,111,150,11,0,50,218,5,26,19,36,31,55,133,272,3,943,52,0,2,2,2,0
23033,58,1178,410,198,237,31,55,97,441,11,63,38,72,74,110,414,683,6,4293,238,0,2,2,2,0
23034,356,7105,1457,730,1242,11,6,188,1468,10,292,166,329,302,495,2424,4078,5,22973,1276,1,2,6,1,0
23035,356,7105,74,35,59,1,0,14,75,3,14,7,14,17,21,58,85,1,128,7,0,2,6,1,0
23036,356,7105,245,125,200,5,7,34,250,7,30,17,34,37,51,166,265,3,1053,58,0,2,6,1,0
23037,78,1593,757,253,292,73,244,162,830,13,61,38,67,74,105,409,651,7,4654,258,0,2,1,1,0
23038,213,4606,182,127,129,0,0,53,182,5,39,21,42,44,63,217,343,2,926,51,0,2,1,1,1
23039,213,4606,1165,710,800,67,119,181,1232,18,243,153,282,261,435,2000,3492,10,36473,2026,1,2,1,1,1
23040,164,5028,1660,832,1314,41,38,274,1701,20,312,209,395,332,604,2671,5058,12,64042,3557,1,2,2,2,1
23041,164,5028,1057,646,719,113,100,145,1170,18,215,134,248,233,382,1740,3004,10,31186,1732,1,2,2,2,1
23042,17,345,95,58,50,9,16,20,104,12,33,24,45,45,69,209,378,8,3100,172,0,2,3,3,1
23043,89,1831,477,336,357,30,23,73,507,16,194,134,250,210,384,1538,2962,10,30538,1696,0,2,4,4,1
23044,145,3014,1513,682,1277,25,13,200,1538,11,199,116,219,210,335,1557,2584,6,15641,868,0,2,2,2,1
23045,145,3014,819,519,539,24,98,155,843,15,96,57,106,111,163,690,1107,8,9171,509,0,2,2,2,1
23046,356,7105,1457,730,1242,11,6,188,1468,10,292,166,329,302,495,2424,4078,5,22973,1276,1,2,4,4,1
23047,356,7105,74,35,59,1,0,14,75,3,14,7,14,17,21,58,85,1,128,7,0,2,4,4,1
23048,356,7105,245,125,200,5,7,34,250,7,30,17,34,37,51,166,265,3,1053,58,0,2,4,4,1
23049,237,5388,4293,999,3693,19,54,507,4312,9,155,88,170,164,258,1156,1898,4,9368,520,0,2,7,7,1
23050,237,5388,1482,859,1002,125,135,219,1607,16,219,134,251,235,385,1766,3032,9,27804,1544,1,2,7,7,1
23051,86,2211,773,422,505,30,103,129,803,14,77,46,83,91,129,535,839,7,6334,351,0,2,2,2,1
23052,122,2921,77,34,69,0,0,8,77,3,24,16,29,27,45,114,213,1,387,21,0,2,1,1,1
23053,122,2921,712,438,573,51,9,84,763,14,102,71,128,116,199,733,1364,8,11988,666,0,2,1,1,1
23054,22,350,102,57,55,5,16,25,107,5,17,10,18,22,28,81,124,2,330,18,0,2,1,1,1
23055,79,1722,402,202,227,24,74,80,426,12,52,33,61,64,94,339,564,7,3969,220,0,2,1,1,1
23056,20,509,205,80,86,16,53,53,221,7,18,10,19,25,29,94,134,3,497,27,0,2,1,1,1
23057,223,5301,722,423,573,19,0,135,741,12,172,101,199,184,300,1320,2257,6,15668,870,0,2,1,1,1
23058,223,5301,1508,847,911,44,250,301,1552,14,148,88,169,162,257,1120,1886,7,15077,837,0,2,1,1,1
23059,262,6289,72,33,56,0,4,12,72,1,1,1,1,2,2,0,2,0,1,0,0,2,6,6,1
23060,262,6289,1454,835,1044,76,110,219,1530,17,275,158,296,292,454,2297,3718,9,34017,1889,1,2,6,6,1
23061,78,1590,757,253,292,73,244,162,830,13,61,38,67,74,105,409,651,7,4654,258,0,2,9,9,1
23062,46,954,386,256,301,16,9,68,402,4,59,35,69,63,104,355,621,2,1453,80,0,2,5,5,1
23063,46,954,264,131,164,11,41,46,275,6,38,22,40,44,62,214,338,3,1068,59,0,2,5,5,1
23064,114,2575,1043,504,840,53,9,147,1096,9,180,112,198,189,310,1377,2344,4,11604,644,0,2,3,3,1
23065,114,2575,383,288,292,26,6,62,409,11,65,38,67,76,105,429,656,5,3719,206,0,2,3,3,1
23066,20,408,294,64,250,0,0,43,294,1,20,10,20,21,30,86,131,0,65,3,0,2,2,2,1
23067,20,408,78,46,62,3,0,14,81,3,8,4,8,11,12,28,41,1,62,3,0,2,2,2,1
23068,70,1375,1178,367,1042,6,15,115,1184,9,94,51,95,103,146,644,976,4,4439,246,0,2,2,2,1
23069,70,1375,177,108,140,8,0,27,185,6,30,16,32,36,48,162,248,3,794,44,0,2,2,2,1
23070,60,1082,282,196,195,3,0,86,285,8,130,71,141,138,212,936,1507,4,6538,363,0,2,1,1,1
23071,92,3882,1289,550,1043,56,32,155,1345,10,167,93,185,177,278,1266,2075,5,11498,638,0,2,2,2,1
23072,147,6905,1392,870,1177,35,17,170,1427,14,494,280,531,508,811,4473,7289,7,54850,3047,2,2,2,2,1
23073,15,742,75,38,59,1,3,12,76,2,4,2,4,6,6,10,15,1,15,0,0,2,1,1,1
23074,31,1981,1157,318,931,29,22,177,1186,6,104,63,125,110,188,712,1274,3,4596,255,0,2,4,4,1
23075,54,3601,520,294,400,33,13,81,553,10,261,204,367,271,571,2128,4614,7,32445,1802,1,2,1,1,1
23076,172,7584,139,89,101,2,0,35,141,7,54,34,62,61,96,330,569,4,2287,127,0,2,9,9,1
23077,172,7584,7,5,5,0,0,2,7,1,2,1,2,3,3,2,4,0,2,0,0,2,9,9,1
23078,139,5902,1782,648,1425,9,47,279,1791,8,171,97,189,179,286,1292,2140,4,9462,525,0,2,3,3,1
23079,25,685,256,139,192,9,7,47,265,4,23,12,24,27,36,112,171,2,357,19,0,2,3,3,1
23080,111,4179,1450,624,1228,12,26,181,1462,14,306,186,354,320,540,2580,4493,8,36391,2021,1,2,6,6,1
23081,84,4426,1457,730,1242,11,6,188,1468,10,292,166,329,302,495,2424,4078,5,22973,1276,1,2,1,1,1
23082,69,3180,1455,414,1257,16,76,112,1471,5,41,23,46,46,69,231,381,2,1069,59,0,2,5,5,1
23083,94,4585,1523,757,1297,19,12,193,1542,12,193,117,230,205,347,1508,2664,7,19053,1058,0,2,3,3,1
23084,87,3802,1020,354,843,12,15,144,1032,8,134,77,144,142,221,970,1580,4,6792,377,0,2,3,3,1
23085,38,2298,334,251,279,10,4,40,344,5,127,74,143,132,217,899,1528,2,4303,239,0,2,1,1,1
23086,3,42,14,8,8,0,0,6,14,0,0,0,0,0,0,0,0,0,0,0,0,2,0,1,0
23087,7,114,44,19,17,0,16,11,44,3,14,7,14,17,21,58,85,1,128,7,0,2,0,1,0
23088,6,71,127,75,83,2,11,30,129,4,14,7,14,18,21,61,87,2,175,9,0,2,0,3,0
23089,6,71,652,304,544,16,6,88,668,6,89,51,101,95,152,591,998,3,3399,188,0,2,0,3,0
23090,6,71,2,2,2,0,0,0,2,0,0,0,0,0,0,0,0,0,0,0,0,2,0,3,0
23091,6,71,8,5,5,0,0,3,8,0,0,0,0,0,0,0,0,0,0,0,0,2,0,3,0
23092,6,71,2,2,2,0,0,0,2,0,0,0,0,0,0,0,0,0,0,0,0,2,0,3,0
23093,6,71,14,8,8,0,0,6,14,0,0,0,0,0,0,0,0,0,0,0,0,2,0,3,0
23094,6,71,6,4,4,0,0,2,6,0,0,0,0,0,0,0,0,0,0,0,0,2,0,3,0
23095,6,71,6,4,4,0,0,2,6,1,2,1,2,3,3,2,4,0,2,0,0,2,0,3,0
23096,6,71,6,4,4,0,0,2,6,0,0,0,0,0,0,0,0,0,0,0,0,2,0,3,0
23097,6,71,7,5,5,0,0,2,7,0,0,0,0,0,0,0,0,0,0,0,0,2,0,3,0
23098,6,71,6,4,4,0,0,2,6,0,0,0,0,0,0,0,0,0,0,0,0,2,0,3,0
23099,6,71,10,6,6,0,0,4,10,0,0,0,0,0,0,0,0,0,0,0,0,2,0,3,0
23100,6,71,1,1,1,0,0,0,1,0,0,0,0,0,0,0,0,0,0,0,0,2,0,3,0
23101,6,71,1,1,1,0,0,0,1,0,0,0,0,0,0,0,0,0,0,0,0,2,0,3,0
23102,6,71,14,10,10,0,0,4,14,1,1,1,1,2,2,0,2,0,1,0,0,2,0,3,0
23103,6,71,46,26,30,3,0,12,49,3,6,3,6,9,9,20,28,1,42,2,0,2,0,3,0
23104,17,384,85,59,61,8,0,16,93,5,18,10,18,23,28,86,126,2,316,17,0,2,0,1,0
23105,237,5388,4293,999,3693,19,54,507,4312,9,155,88,170,164,258,1156,1898,4,9368,520,0,2,4,4,0
23106,237,5388,1482,859,1002,125,135,219,1607,16,219,134,251,235,385,1766,3032,9,27804,1544,1,2,4,4,0
23107,46,954,386,256,301,16,9,68,402,4,59,35,69,63,104,355,621,2,1453,80,0,2,6,4,0
23108,46,954,264,131,164,11,41,46,275,6,38,22,40,44,62,214,338,3,1068,59,0,2,6,4,0
23109,87,3802,1020,354,843,12,15,144,1032,8,134,77,144,142,221,970,1580,4,6792,377,0,2,4,2,0
23110,11,238,19,8,11,5,0,4,24,2,5,3,6,7,9,13,25,1,30,1,0,2,10,6,1
23111,11,238,102,59,69,5,3,24,107,6,22,15,28,28,43,113,206,3,789,43,0,2,10,6,1
23112,11,238,106,40,36,3,49,17,109,8,17,13,23,25,36,93,167,5,904,50,0,2,10,6,1
23113,213,4611,182,127,129,0,0,53,182,5,39,21,42,44,63,217,343,2,926,51,0,2,121,61,1
23114,213,4611,1165,710,800,67,119,181,1232,18,243,153,282,261,435,2000,3492,10,36473,2026,1,2,121,61,1
23115,83,1808,773,419,590,28,0,166,801,10,204,113,217,214,330,1598,2554,5,13587,754,0,2,32,18,1
23116,83,1808,421,273,302,44,34,57,465,17,81,59,107,98,166,583,1098,11,12329,684,0,2,32,18,1
23117,26,525,2,2,2,0,0,0,2,0,0,0,0,0,0,0,0,0,0,0,0,2,21,16,1
23118,26,525,99,48,90,1,3,5,100,0,0,0,0,0,0,0,0,0,0,0,0,2,21,16,1
23119,26,525,8,5,5,2,0,1,10,0,0,0,0,0,0,0,0,0,0,0,0,2,21,16,1
23120,26,525,1217,716,841,84,126,174,1301,14,185,118,215,199,333,1446,2542,8,20687,1149,0,2,21,16,1
23121,26,525,160,89,115,0,13,31,160,7,15,11,17,22,28,78,124,3,495,27,0,2,21,16,1
23122,26,525,10,10,9,9,0,0,19,0,0,0,0,0,0,0,0,0,0,0,0,2,21,16,1
23123,26,525,173,84,99,8,29,36,181,5,12,7,13,17,20,54,81,2,221,12,0,2,21,16,1
23124,26,525,3,1,1,3,0,0,6,0,0,0,0,0,0,0,0,0,0,0,0,2,21,16,1
23125,164,5032,1660,832,1314,41,38,274,1701,20,312,209,395,332,604,2671,5058,12,64042,3557,1,2,76,56,1
23126,164,5032,1057,646,719,113,100,145,1170,18,215,134,248,233,382,1740,3004,10,31186,1732,1,2,76,56,1
23127,17,344,95,58,50,9,16,20,104,12,33,24,45,45,69,209,378,8,3100,172,0,2,6,9,1
23128,89,1830,477,336,357,30,23,73,507,16,194,134,250,210,384,1538,2962,10,30538,1696,0,2,79,61,1
23129,71,1702,996,429,845,24,10,117,1020,7,76,50,88,83,138,494,879,4,3565,198,0,2,65,41,1
23130,71,1702,456,277,329,12,42,72,468,13,85,50,97,98,147,592,972,7,7212,400,0,2,65,41,1
23131,145,3016,1513,682,1277,25,13,200,1538,11,199,116,219,210,335,1557,2584,6,15641,868,0,2,58,40,1
23132,145,3016,819,519,539,24,98,155,843,15,96,57,106,111,163,690,1107,8,9171,509,0,2,58,40,1
23133,58,1177,207,111,150,11,0,50,218,5,26,19,36,31,55,133,272,3,943,52,0,2,77,47,1
23134,58,1177,410,198,237,31,55,97,441,11,63,38,72,74,110,414,683,6,4293,238,0,2,77,47,1
23135,356,7117,1457,730,1242,11,6,188,1468,10,292,166,329,302,495,2424,4078,5,22973,1276,1,2,248,177,1
23136,356,7117,74,35,59,1,0,14,75,3,14,7,14,17,21,58,85,1,128,7,0,2,248,177,1
23137,356,7117,245,125,200,5,7,34,250,7,30,17,34,37,51,166,265,3,1053,58,0,2,248,177,1
23138,28,809,339,213,244,17,9,65,356,10,42,26,48,52,74,259,421,5,2410,133,0,2,23,11,1
23139,84,2154,1455,414,1257,16,76,112,1471,5,41,23,46,46,69,231,381,2,1069,59,0,2,138,85,1
23140,84,2154,669,365,481,22,61,110,691,15,103,63,122,118,185,747,1273,8,11311,628,0,2,138,85,1
23141,237,5395,4293,999,3693,19,54,507,4312,9,155,88,170,164,258,1156,1898,4,9368,520,0,2,139,82,1
23142,237,5395,1482,859,1002,125,135,219,1607,16,219,134,251,235,385,1766,3032,9,27804,1544,1,2,139,82,1
23143,6,136,44,22,19,0,19,6,44,2,10,6,12,12,18,35,64,1,77,4,0,2,5,3,1
23144,27,959,74,35,59,1,0,14,75,3,14,7,14,17,21,58,85,1,128,7,0,2,77,50,1
23145,27,959,245,125,200,5,7,34,250,7,30,17,34,37,51,166,265,3,1053,58,0,2,77,50,1
23146,51,595,647,139,84,35,284,233,682,0,0,0,0,0,0,0,0,0,0,0,0,2,11,0,1
23147,98,2661,1523,757,1297,19,12,193,1542,12,193,117,230,205,347,1508,2664,7,19053,1058,0,2,142,110,1
23148,98,2661,701,378,504,33,58,109,734,13,110,68,126,123,194,794,1346,7,10027,557,0,2,142,110,1
23149,86,2225,773,422,505,30,103,129,803,14,77,46,83,91,129,535,839,7,6334,351,0,2,155,102,1
23150,122,2937,77,34,69,0,0,8,77,3,24,16,29,27,45,114,213,1,387,21,0,2,152,75,1
23151,122,2937,712,438,573,51,9,84,763,14,102,71,128,116,199,733,1364,8,11988,666,0,2,152,75,1
23152,24,605,2,2,2,0,0,0,2,0,0,0,0,0,0,0,0,0,0,0,0,2,45,28,1
23153,24,605,99,48,90,1,3,5,100,0,0,0,0,0,0,0,0,0,0,0,0,2,45,28,1
23154,24,605,8,5,5,2,0,1,10,0,0,0,0,0,0,0,0,0,0,0,0,2,45,28,1
23155,24,605,1217,716,841,84,126,174,1301,14,185,118,215,199,333,1446,2542,8,20687,1149,0,2,45,28,1
23156,24,605,160,89,115,0,13,31,160,7,15,11,17,22,28,78,124,3,495,27,0,2,45,28,1
23157,24,605,10,10,9,9,0,0,19,0,0,0,0,0,0,0,0,0,0,0,0,2,45,28,1
23158,24,605,173,84,99,8,29,36,181,5,12,7,13,17,20,54,81,2,221,12,0,2,45,28,1
23159,24,605,3,1,1,3,0,0,6,0,0,0,0,0,0,0,0,0,0,0,0,2,45,28,1
23160,30,658,125,97,103,3,0,19,128,9,25,17,27,34,44,144,223,4,1087,60,0,2,23,20,1
23161,22,350,102,57,55,5,16,25,107,5,17,10,18,22,28,81,124,2,330,18,0,2,7,2,1
23162,79,1721,402,202,227,24,74,80,426,12,52,33,61,64,94,339,564,7,3969,220,0,2,36,33,1
23163,48,992,447,308,343,6,5,95,453,7,96,59,111,103,170,651,1136,4,4600,255,0,2,17,17,1
23164,48,992,322,174,179,16,74,51,338,10,41,26,46,51,72,252,408,5,2291,127,0,2,17,17,1
23165,72,1644,53,23,39,0,0,13,53,2,8,4,8,10,12,26,39,1,39,2,0,2,27,16,1
23166,72,1644,515,298,307,33,80,99,548,12,63,44,77,75,121,419,753,7,5527,307,0,2,27,16,1
23167,23,381,424,94,331,4,0,89,428,1,5,5,5,6,10,11,25,0,12,0,0,2,14,14,1
23168,23,381,38,23,23,6,0,8,44,3,11,7,11,14,18,42,68,1,102,5,0,2,14,14,1
23169,20,511,205,80,86,16,53,53,221,7,18,10,19,25,29,94,134,3,497,27,0,2,23,13,1
23170,17,519,184,100,137,2,15,30,186,6,38,20,39,44,59,214,322,3,991,55,0,2,30,21,1
23171,17,519,103,65,74,8,5,16,111,7,17,9,17,24,26,89,119,3,417,23,0,2,30,21,1
23172,226,5309,722,423,573,19,0,135,741,12,172,101,199,184,300,1320,2257,6,15668,870,0,2,124,76,1
23173,226,5309,1508,847,911,44,250,301,1552,14,148,88,169,162,257,1120,1886,7,15077,837,0,2,124,76,1
23174,285,6295,72,33,56,0,4,12,72,1,1,1,1,2,2,0,2,0,1,0,0,2,275,166,1
23175,285,6295,1454,835,1044,76,110,219,1530,17,275,158,296,292,454,2297,3718,9,34017,1889,1,2,275,166,1
23176,78,1590,757,253,292,73,244,162,830,13,61,38,67,74,105,409,651,7,4654,258,0,2,42,24,1
23177,46,955,386,256,301,16,9,68,402,4,59,35,69,63,104,355,621,2,1453,80,0,2,21,13,1
23178,46,955,264,131,164,11,41,46,275,6,38,22,40,44,62,214,338,3,1068,59,0,2,21,13,1
23179,30,650,215,129,180,6,0,29,221,8,65,43,72,73,115,415,711,4,3153,175,0,2,25,18,1
23180,30,650,97,69,77,3,3,16,100,6,22,13,23,28,36,113,173,3,542,30,0,2,25,18,1
23181,115,2577,1043,504,840,53,9,147,1096,9,180,112,198,189,310,1377,2344,4,11604,644,0,2,88,53,1
23182,115,2577,383,288,292,26,6,62,409,11,65,38,67,76,105,429,656,5,3719,206,0,2,88,53,1
23183,20,411,294,64,250,0,0,43,294,1,20,10,20,21,30,86,131,0,65,3,0,2,30,20,1
23184,20,411,78,46,62,3,0,14,81,3,8,4,8,11,12,28,41,1,62,3,0,2,30,20,1
23185,5,119,110,30,77,3,13,16,113,4,21,15,30,25,45,100,208,2,597,33,0,2,7,3,1
23186,5,119,28,15,21,1,0,6,29,0,0,0,0,0,0,0,0,0,0,0,0,2,7,3,1
23187,70,1380,1178,367,1042,6,15,115,1184,9,94,51,95,103,146,644,976,4,4439,246,0,2,75,65,1
23188,70,1380,177,108,140,8,0,27,185,6,30,16,32,36,48,162,248,3,794,44,0,2,75,65,1
23189,209,4543,1943,715,1694,26,18,214,1969,12,185,120,237,197,357,1436,2721,7,20915,1161,0,2,215,134,1
23190,209,4543,1168,838,957,57,25,144,1225,19,348,224,416,367,640,3018,5452,11,61921,3440,1,2,215,134,1
23191,16,480,442,244,305,14,16,103,456,11,68,45,75,79,120,452,756,6,4588,254,0,2,11,8,1
23192,16,480,182,102,99,11,40,35,193,3,11,6,11,14,17,42,64,1,97,5,0,2,11,8,1
23193,62,1223,1098,241,925,5,10,155,1103,7,46,25,49,53,74,273,423,3,1580,87,0,2,42,27,1
23194,62,1223,282,202,222,14,2,44,296,8,42,24,43,50,67,250,378,4,1548,86,0,2,42,27,1
23195,22,460,601,196,481,2,23,85,603,8,63,36,72,71,108,400,664,4,3036,168,0,2,34,17,1
23196,22,460,156,79,106,5,16,28,161,5,14,8,15,19,23,64,97,2,261,14,0,2,34,17,1
23197,3,42,14,8,8,0,0,6,14,0,0,0,0,0,0,0,0,0,0,0,0,2,5,1,1
23198,2,34,9,6,6,0,0,3,9,0,0,0,0,0,0,0,0,0,0,0,0,2,1,0,1
23199,2,34,13,9,8,0,0,4,13,0,0,0,0,0,0,0,0,0,0,0,0,2,1,0,1
23200,1,324,382,65,130,157,2,92,539,4,10,5,10,14,15,41,57,2,114,6,0,2,117,100,1
23201,60,1081,282,196,195,3,0,86,285,8,130,71,141,138,212,936,1507,4,6538,363,0,2,84,46,1
23202,4,77,127,75,83,2,11,30,129,4,14,7,14,18,21,61,87,2,175,9,0,2,4,2,1
23203,4,77,652,304,544,16,6,88,668,6,89,51,101,95,152,591,998,3,3399,188,0,2,4,2,1
23204,4,77,2,2,2,0,0,0,2,0,0,0,0,0,0,0,0,0,0,0,0,2,4,2,1
23205,4,77,8,5,5,0,0,3,8,0,0,0,0,0,0,0,0,0,0,0,0,2,4,2,1
23206,4,77,2,2,2,0,0,0,2,0,0,0,0,0,0,0,0,0,0,0,0,2,4,2,1
23207,4,77,14,8,8,0,0,6,14,0,0,0,0,0,0,0,0,0,0,0,0,2,4,2,1
23208,4,77,6,4,4,0,0,2,6,0,0,0,0,0,0,0,0,0,0,0,0,2,4,2,1
23209,4,77,6,4,4,0,0,2,6,1,2,1,2,3,3,2,4,0,2,0,0,2,4,2,1
23210,4,77,6,4,4,0,0,2,6,0,0,0,0,0,0,0,0,0,0,0,0,2,4,2,1
23211,4,77,7,5,5,0,0,2,7,0,0,0,0,0,0,0,0,0,0,0,0,2,4,2,1
23212,4,77,6,4,4,0,0,2,6,0,0,0,0,0,0,0,0,0,0,0,0,2,4,2,1
23213,4,77,10,6,6,0,0,4,10,0,0,0,0,0,0,0,0,0,0,0,0,2,4,2,1
23214,4,77,1,1,1,0,0,0,1,0,0,0,0,0,0,0,0,0,0,0,0,2,4,2,1
23215,4,77,1,1,1,0,0,0,1,0,0,0,0,0,0,0,0,0,0,0,0,2,4,2,1
23216,4,77,14,10,10,0,0,4,14,1,1,1,1,2,2,0,2,0,1,0,0,2,4,2,1
23217,4,77,46,26,30,3,0,12,49,3,6,3,6,9,9,20,28,1,42,2,0,2,4,2,1
23218,1,9,5,3,3,0,0,2,5,0,0,0,0,0,0,0,0,0,0,0,0,2,1,0,1
23219,1,88,13,10,10,0,0,3,13,1,2,1,2,3,3,2,4,0,2,0,0,2,5,5,1
23220,7,114,44,19,17,0,16,11,44,3,14,7,14,17,21,58,85,1,128,7,0,2,4,0,1
23221,3,66,127,75,83,2,11,30,129,4,14,7,14,18,21,61,87,2,175,9,0,2,5,1,1
23222,3,66,652,304,544,16,6,88,668,6,89,51,101,95,152,591,998,3,3399,188,0,2,5,1,1
23223,3,66,2,2,2,0,0,0,2,0,0,0,0,0,0,0,0,0,0,0,0,2,5,1,1
23224,3,66,8,5,5,0,0,3,8,0,0,0,0,0,0,0,0,0,0,0,0,2,5,1,1
23225,3,66,2,2,2,0,0,0,2,0,0,0,0,0,0,0,0,0,0,0,0,2,5,1,1
23226,3,66,14,8,8,0,0,6,14,0,0,0,0,0,0,0,0,0,0,0,0,2,5,1,1
23227,3,66,6,4,4,0,0,2,6,0,0,0,0,0,0,0,0,0,0,0,0,2,5,1,1
23228,3,66,6,4,4,0,0,2,6,1,2,1,2,3,3,2,4,0,2,0,0,2,5,1,1
23229,3,66,6,4,4,0,0,2,6,0,0,0,0,0,0,0,0,0,0,0,0,2,5,1,1
23230,3,66,7,5,5,0,0,2,7,0,0,0,0,0,0,0,0,0,0,0,0,2,5,1,1
23231,3,66,6,4,4,0,0,2,6,0,0,0,0,0,0,0,0,0,0,0,0,2,5,1,1
23232,3,66,10,6,6,0,0,4,10,0,0,0,0,0,0,0,0,0,0,0,0,2,5,1,1
23233,3,66,1,1,1,0,0,0,1,0,0,0,0,0,0,0,0,0,0,0,0,2,5,1,1
23234,3,66,1,1,1,0,0,0,1,0,0,0,0,0,0,0,0,0,0,0,0,2,5,1,1
23235,3,66,14,10,10,0,0,4,14,1,1,1,1,2,2,0,2,0,1,0,0,2,5,1,1
23236,3,66,46,26,30,3,0,12,49,3,6,3,6,9,9,20,28,1,42,2,0,2,5,1,1
23237,7,298,72,33,56,0,4,12,72,1,1,1,1,2,2,0,2,0,1,0,0,2,27,10,1
23238,12,229,127,75,83,2,11,30,129,4,14,7,14,18,21,61,87,2,175,9,0,2,15,6,1
23239,12,229,652,304,544,16,6,88,668,6,89,51,101,95,152,591,998,3,3399,188,0,2,15,6,1
23240,12,229,2,2,2,0,0,0,2,0,0,0,0,0,0,0,0,0,0,0,0,2,15,6,1
23241,12,229,8,5,5,0,0,3,8,0,0,0,0,0,0,0,0,0,0,0,0,2,15,6,1
23242,12,229,2,2,2,0,0,0,2,0,0,0,0,0,0,0,0,0,0,0,0,2,15,6,1
23243,12,229,14,8,8,0,0,6,14,0,0,0,0,0,0,0,0,0,0,0,0,2,15,6,1
23244,12,229,6,4,4,0,0,2,6,0,0,0,0,0,0,0,0,0,0,0,0,2,15,6,1
23245,12,229,6,4,4,0,0,2,6,1,2,1,2,3,3,2,4,0,2,0,0,2,15,6,1
23246,12,229,6,4,4,0,0,2,6,0,0,0,0,0,0,0,0,0,0,0,0,2,15,6,1
23247,12,229,7,5,5,0,0,2,7,0,0,0,0,0,0,0,0,0,0,0,0,2,15,6,1
23248,12,229,6,4,4,0,0,2,6,0,0,0,0,0,0,0,0,0,0,0,0,2,15,6,1
23249,12,229,10,6,6,0,0,4,10,0,0,0,0,0,0,0,0,0,0,0,0,2,15,6,1
23250,12,229,1,1,1,0,0,0,1,0,0,0,0,0,0,0,0,0,0,0,0,2,15,6,1
23251,12,229,1,1,1,0,0,0,1,0,0,0,0,0,0,0,0,0,0,0,0,2,15,6,1
23252,12,229,14,10,10,0,0,4,14,1,1,1,1,2,2,0,2,0,1,0,0,2,15,6,1
23253,12,229,46,26,30,3,0,12,49,3,6,3,6,9,9,20,28,1,42,2,0,2,15,6,1
23254,6,71,127,75,83,2,11,30,129,4,14,7,14,18,21,61,87,2,175,9,0,2,3,0,1
23255,6,71,652,304,544,16,6,88,668,6,89,51,101,95,152,591,998,3,3399,188,0,2,3,0,1
23256,6,71,2,2,2,0,0,0,2,0,0,0,0,0,0,0,0,0,0,0,0,2,3,0,1
23257,6,71,8,5,5,0,0,3,8,0,0,0,0,0,0,0,0,0,0,0,0,2,3,0,1
23258,6,71,2,2,2,0,0,0,2,0,0,0,0,0,0,0,0,0,0,0,0,2,3,0,1
23259,6,71,14,8,8,0,0,6,14,0,0,0,0,0,0,0,0,0,0,0,0,2,3,0,1
23260,6,71,6,4,4,0,0,2,6,0,0,0,0,0,0,0,0,0,0,0,0,2,3,0,1
23261,6,71,6,4,4,0,0,2,6,1,2,1,2,3,3,2,4,0,2,0,0,2,3,0,1
23262,6,71,6,4,4,0,0,2,6,0,0,0,0,0,0,0,0,0,0,0,0,2,3,0,1
23263,6,71,7,5,5,0,0,2,7,0,0,0,0,0,0,0,0,0,0,0,0,2,3,0,1
23264,6,71,6,4,4,0,0,2,6,0,0,0,0,0,0,0,0,0,0,0,0,2,3,0,1
23265,6,71,10,6,6,0,0,4,10,0,0,0,0,0,0,0,0,0,0,0,0,2,3,0,1
23266,6,71,1,1,1,0,0,0,1,0,0,0,0,0,0,0,0,0,0,0,0,2,3,0,1
23267,6,71,1,1,1,0,0,0,1,0,0,0,0,0,0,0,0,0,0,0,0,2,3,0,1
23268,6,71,14,10,10,0,0,4,14,1,1,1,1,2,2,0,2,0,1,0,0,2,3,0,1
23269,6,71,46,26,30,3,0,12,49,3,6,3,6,9,9,20,28,1,42,2,0,2,3,0,1
23270,3,26,14,7,7,2,0,5,16,0,0,0,0,0,0,0,0,0,0,0,0,2,3,0,1
23271,7,103,38,23,23,0,0,15,38,0,0,0,0,0,0,0,0,0,0,0,0,2,8,0,1
23272,17,384,85,59,61,8,0,16,93,5,18,10,18,23,28,86,126,2,316,17,0,2,18,15,1
23273,15,484,42,7,35,4,0,5,46,1,2,1,2,3,3,2,4,0,2,0,0,2,49,50,1
23274,15,484,11,6,10,0,0,1,11,2,4,2,4,6,6,10,15,1,15,0,0,2,49,50,1
23275,92,3866,1289,550,1043,56,32,155,1345,10,167,93,185,177,278,1266,2075,5,11498,638,0,2,316,270,1
23276,36,1084,182,127,129,0,0,53,182,5,39,21,42,44,63,217,343,2,926,51,0,2,42,29,1
23277,147,6916,1392,870,1177,35,17,170,1427,14,494,280,531,508,811,4473,7289,7,54850,3047,2,2,280,169,1
23278,88,2881,773,419,590,28,0,166,801,10,204,113,217,214,330,1598,2554,5,13587,754,0,2,164,83,1
23279,15,742,75,38,59,1,3,12,76,2,4,2,4,6,6,10,15,1,15,0,0,2,138,76,1
23280,2,26,6,4,4,0,0,2,6,1,4,2,4,5,6,8,13,0,6,0,0,2,2,3,1
23281,13,570,139,89,101,2,0,35,141,7,54,34,62,61,96,330,569,4,2287,127,0,2,45,48,1
23282,1,138,149,67,118,4,0,27,153,1,17,14,28,18,42,69,175,0,144,8,0,2,15,7,1
23283,31,1983,1157,318,931,29,22,177,1186,6,104,63,125,110,188,712,1274,3,4596,255,0,2,368,271,1
23284,54,3598,520,294,400,33,13,81,553,10,261,204,367,271,571,2128,4614,7,32445,1802,1,2,81,90,1
23285,97,4401,1338,495,1086,10,64,173,1348,11,122,82,157,133,239,883,1686,7,11934,663,0,2,446,289,1
23286,172,7590,139,89,101,2,0,35,141,7,54,34,62,61,96,330,569,4,2287,127,0,2,1162,594,1
23287,172,7590,7,5,5,0,0,2,7,1,2,1,2,3,3,2,4,0,2,0,0,2,1162,594,1
23288,33,989,465,148,393,5,8,60,470,4,31,20,31,35,51,161,261,2,523,29,0,2,97,53,1
23289,33,989,16,12,9,0,0,6,16,1,2,1,2,3,3,2,4,0,2,0,0,2,97,53,1
23290,139,5899,1782,648,1425,9,47,279,1791,8,171,97,189,179,286,1292,2140,4,9462,525,0,2,528,372,1
23291,25,684,256,139,192,9,7,47,265,4,23,12,24,27,36,112,171,2,357,19,0,2,31,21,1
23292,6,328,180,34,164,0,0,16,180,1,12,6,12,13,18,43,66,0,33,1,0,2,89,64,1
23293,23,578,102,59,69,5,3,24,107,6,22,15,28,28,43,113,206,3,789,43,0,2,32,21,1
23294,111,4186,1450,624,1228,12,26,181,1462,14,306,186,354,320,540,2580,4493,8,36391,2021,1,2,478,384,1
23295,155,4437,1660,832,1314,41,38,274,1701,20,312,209,395,332,604,2671,5058,12,64042,3557,1,2,295,164,1
23296,36,2873,996,429,845,24,10,117,1020,7,76,50,88,83,138,494,879,4,3565,198,0,2,391,315,1
23297,129,5198,1513,682,1277,25,13,200,1538,11,199,116,219,210,335,1557,2584,6,15641,868,0,2,379,270,1
23298,73,3803,1296,573,1062,40,33,157,1336,8,201,118,231,209,349,1561,2689,4,12365,686,0,2,277,191,1
23299,14,341,207,111,150,11,0,50,218,5,26,19,36,31,55,133,272,3,943,52,0,2,24,15,1
23300,84,4433,1457,730,1242,11,6,188,1468,10,292,166,329,302,495,2424,4078,5,22973,1276,1,2,439,270,1
23301,39,2323,652,304,544,16,6,88,668,6,89,51,101,95,152,591,998,3,3399,188,0,2,180,111,1
23302,69,3174,1455,414,1257,16,76,112,1471,5,41,23,46,46,69,231,381,2,1069,59,0,2,511,345,1
23303,2,75,7,6,5,0,0,2,7,1,1,1,2,2,3,0,3,1,3,0,0,2,4,4,1
23304,8,271,74,35,59,1,0,14,75,3,14,7,14,17,21,58,85,1,128,7,0,2,19,24,1
23305,94,4592,1523,757,1297,19,12,193,1542,12,193,117,230,205,347,1508,2664,7,19053,1058,0,2,309,193,1
23306,87,3811,1020,354,843,12,15,144,1032,8,134,77,144,142,221,970,1580,4,6792,377,0,2,355,220,1
23307,38,1676,447,308,343,6,5,95,453,7,96,59,111,103,170,651,1136,4,4600,255,0,2,99,72,1
23308,1,107,53,23,39,0,0,13,53,2,8,4,8,10,12,26,39,1,39,2,0,2,13,10,1
23309,21,658,424,94,331,4,0,89,428,1,5,5,5,6,10,11,25,0,12,0,0,2,83,59,1
23310,38,2302,334,251,279,10,4,40,344,5,127,74,143,132,217,899,1528,2,4303,239,0,2,123,97,1
23311,12,493,184,100,137,2,15,30,186,6,38,20,39,44,59,214,322,3,991,55,0,2,47,32,1
23312,59,2582,1293,570,1093,25,15,163,1318,10,195,123,241,205,364,1516,2795,6,17273,959,0,2,198,124,1
23313,33,1883,384,251,317,7,8,52,391,11,70,44,84,81,128,467,811,6,5355,297,0,2,78,55,1
23314,45,2208,722,423,573,19,0,135,741,12,172,101,199,184,300,1320,2257,6,15668,870,0,2,61,38,1
23315,39,1727,386,256,301,16,9,68,402,4,59,35,69,63,104,355,621,2,1453,80,0,2,90,52,1
23316,16,1214,215,129,180,6,0,29,221,8,65,43,72,73,115,415,711,4,3153,175,0,2,75,60,1
23317,79,3060,1043,504,840,53,9,147,1096,9,180,112,198,189,310,1377,2344,4,11604,644,0,2,245,148,1
23318,14,530,295,56,236,0,4,54,295,2,9,5,10,11,15,30,51,1,57,3,0,2,85,52,1
23319,30,1241,373,158,315,8,0,51,381,5,76,44,79,81,123,486,779,2,2026,112,0,2,88,44,1
23320,77,3211,1178,367,1042,6,15,115,1184,9,94,51,95,103,146,644,976,4,4439,246,0,2,460,373,1
23321,91,4584,1943,715,1694,26,18,214,1969,12,185,120,237,197,357,1436,2721,7,20915,1161,0,2,582,518,1
23322,14,826,442,244,305,14,16,103,456,11,68,45,75,79,120,452,756,6,4588,254,0,2,58,34,1
23323,48,1744,1098,241,925,5,10,155,1103,7,46,25,49,53,74,273,423,3,1580,87,0,2,269,172,1
23324,19,682,601,196,481,2,23,85,603,8,63,36,72,71,108,400,664,4,3036,168,0,2,139,107,1
23325,213,4615,182,127,129,0,0,53,182,5,39,21,42,44,63,217,343,2,926,51,0,2,2,2,1
23326,213,4615,1165,710,800,67,119,181,1232,18,243,153,282,261,435,2000,3492,10,36473,2026,1,2,2,2,1
23327,58,1183,207,111,150,11,0,50,218,5,26,19,36,31,55,133,272,3,943,52,0,2,7,5,1
23328,58,1183,410,198,237,31,55,97,441,11,63,38,72,74,110,414,683,6,4293,238,0,2,7,5,1
23329,237,5397,4293,999,3693,19,54,507,4312,9,155,88,170,164,258,1156,1898,4,9368,520,0,2,3,2,1
23330,237,5397,1482,859,1002,125,135,219,1607,16,219,134,251,235,385,1766,3032,9,27804,1544,1,2,3,2,1
23331,285,6294,72,33,56,0,4,12,72,1,1,1,1,2,2,0,2,0,1,0,0,2,1,1,1
23332,285,6294,1454,835,1044,76,110,219,1530,17,275,158,296,292,454,2297,3718,9,34017,1889,1,2,1,1,1
23333,78,1580,757,253,292,73,244,162,830,13,61,38,67,74,105,409,651,7,4654,258,0,2,8,6,1
23334,2,40,9,6,6,0,0,3,9,0,0,0,0,0,0,0,0,0,0,0,0,2,2,2,1
23335,2,40,13,9,8,0,0,4,13,0,0,0,0,0,0,0,0,0,0,0,0,2,2,2,1
23336,60,1081,282,196,195,3,0,86,285,8,130,71,141,138,212,936,1507,4,6538,363,0,2,10,10,1
23337,4,77,127,75,83,2,11,30,129,4,14,7,14,18,21,61,87,2,175,9,0,2,2,1,1
23338,4,77,652,304,544,16,6,88,668,6,89,51,101,95,152,591,998,3,3399,188,0,2,2,1,1
23339,4,77,2,2,2,0,0,0,2,0,0,0,0,0,0,0,0,0,0,0,0,2,2,1,1
23340,4,77,8,5,5,0,0,3,8,0,0,0,0,0,0,0,0,0,0,0,0,2,2,1,1
23341,4,77,2,2,2,0,0,0,2,0,0,0,0,0,0,0,0,0,0,0,0,2,2,1,1
23342,4,77,14,8,8,0,0,6,14,0,0,0,0,0,0,0,0,0,0,0,0,2,2,1,1
23343,4,77,6,4,4,0,0,2,6,0,0,0,0,0,0,0,0,0,0,0,0,2,2,1,1
23344,4,77,6,4,4,0,0,2,6,1,2,1,2,3,3,2,4,0,2,0,0,2,2,1,1
23345,4,77,6,4,4,0,0,2,6,0,0,0,0,0,0,0,0,0,0,0,0,2,2,1,1
23346,4,77,7,5,5,0,0,2,7,0,0,0,0,0,0,0,0,0,0,0,0,2,2,1,1
23347,4,77,6,4,4,0,0,2,6,0,0,0,0,0,0,0,0,0,0,0,0,2,2,1,1
23348,4,77,10,6,6,0,0,4,10,0,0,0,0,0,0,0,0,0,0,0,0,2,2,1,1
23349,4,77,1,1,1,0,0,0,1,0,0,0,0,0,0,0,0,0,0,0,0,2,2,1,1
23350,4,77,1,1,1,0,0,0,1,0,0,0,0,0,0,0,0,0,0,0,0,2,2,1,1
23351,4,77,14,10,10,0,0,4,14,1,1,1,1,2,2,0,2,0,1,0,0,2,2,1,1
23352,4,77,46,26,30,3,0,12,49,3,6,3,6,9,9,20,28,1,42,2,0,2,2,1,1
23353,3,26,14,7,7,2,0,5,16,0,0,0,0,0,0,0,0,0,0,0,0,2,2,1,1
23354,17,378,85,59,61,8,0,16,93,5,18,10,18,23,28,86,126,2,316,17,0,2,2,3,1
23355,36,1088,182,127,129,0,0,53,182,5,39,21,42,44,63,217,343,2,926,51,0,2,3,2,1
23356,97,4401,1338,495,1086,10,64,173,1348,11,122,82,157,133,239,883,1686,7,11934,663,0,2,1,1,1
23357,125,5129,1513,682,1277,25,13,200,1538,11,199,116,219,210,335,1557,2584,6,15641,868,0,2,13,28,1
23358,73,3803,1296,573,1062,40,33,157,1336,8,201,118,231,209,349,1561,2689,4,12365,686,0,2,1,1,1
23359,88,2881,773,419,590,28,0,166,801,10,204,113,217,214,330,1598,2554,5,13587,754,0,2,4,4,0
23360,98,2655,1523,757,1297,19,12,193,1542,12,193,117,230,205,347,1508,2664,7,19053,1058,0,2,1,1,0
23361,98,2655,701,378,504,33,58,109,734,13,110,68,126,123,194,794,1346,7,10027,557,0,2,1,1,0
23362,95,4653,1523,757,1297,19,12,193,1542,12,193,117,230,205,347,1508,2664,7,19053,1058,0,2,17,0,0
23363,95,4653,1523,757,1297,19,12,193,1542,12,193,117,230,205,347,1508,2664,7,19053,1058,0,2,1,1,0
23364,49,1844,1098,241,925,5,10,155,1103,7,46,25,49,53,74,273,423,3,1580,87,0,2,47,0,0
23365,49,1845,1098,241,925,5,10,155,1103,7,46,25,49,53,74,273,423,3,1580,87,0,2,15,1,0
23366,237,5390,4293,999,3693,19,54,507,4312,9,155,88,170,164,258,1156,1898,4,9368,520,0,2,1,1,0
23367,237,5390,1482,859,1002,125,135,219,1607,16,219,134,251,235,385,1766,3032,9,27804,1544,1,2,1,1,0
23368,262,6287,72,33,56,0,4,12,72,1,1,1,1,2,2,0,2,0,1,0,0,2,1,1,0
23369,262,6287,1454,835,1044,76,110,219,1530,17,275,158,296,292,454,2297,3718,9,34017,1889,1,2,1,1,0
23370,62,1229,1098,241,925,5,10,155,1103,7,46,25,49,53,74,273,423,3,1580,87,0,2,2,1,0
23371,62,1229,282,202,222,14,2,44,296,8,42,24,43,50,67,250,378,4,1548,86,0,2,2,1,0
23372,237,5390,4293,999,3693,19,54,507,4312,9,155,88,170,164,258,1156,1898,4,9368,520,0,2,1,1,0
23373,237,5390,1482,859,1002,125,135,219,1607,16,219,134,251,235,385,1766,3032,9,27804,1544,1,2,1,1,0
23374,262,6287,72,33,56,0,4,12,72,1,1,1,1,2,2,0,2,0,1,0,0,2,1,1,0
23375,262,6287,1454,835,1044,76,110,219,1530,17,275,158,296,292,454,2297,3718,9,34017,1889,1,2,1,1,0
23376,62,1229,1098,241,925,5,10,155,1103,7,46,25,49,53,74,273,423,3,1580,87,0,2,2,1,0
23377,62,1229,282,202,222,14,2,44,296,8,42,24,43,50,67,250,378,4,1548,86,0,2,2,1,0
23378,49,1845,1098,241,925,5,10,155,1103,7,46,25,49,53,74,273,423,3,1580,87,0,2,61,0,0
23379,98,2655,1523,757,1297,19,12,193,1542,12,193,117,230,205,347,1508,2664,7,19053,1058,0,2,1,1,0
23380,98,2655,701,378,504,33,58,109,734,13,110,68,126,123,194,794,1346,7,10027,557,0,2,1,1,0
23381,95,4653,1523,757,1297,19,12,193,1542,12,193,117,230,205,347,1508,2664,7,19053,1058,0,2,17,0,0
23382,163,5014,1660,832,1314,41,38,274,1701,20,312,209,395,332,604,2671,5058,12,64042,3557,1,2,1,4,0
23383,163,5014,1057,646,719,113,100,145,1170,18,215,134,248,233,382,1740,3004,10,31186,1732,1,2,1,4,0
23384,237,5399,4293,999,3693,19,54,507,4312,9,155,88,170,164,258,1156,1898,4,9368,520,0,2,1,1,0
23385,237,5399,1482,859,1002,125,135,219,1607,16,219,134,251,235,385,1766,3032,9,27804,1544,1,2,1,1,0
23386,98,2661,1523,757,1297,19,12,193,1542,12,193,117,230,205,347,1508,2664,7,19053,1058,0,2,2,1,0
23387,98,2661,701,378,504,33,58,109,734,13,110,68,126,123,194,794,1346,7,10027,557,0,2,2,1,0
23388,285,6292,72,33,56,0,4,12,72,1,1,1,1,2,2,0,2,0,1,0,0,2,1,1,0
23389,285,6292,1454,835,1044,76,110,219,1530,17,275,158,296,292,454,2297,3718,9,34017,1889,1,2,1,1,0
23390,62,1230,1098,241,925,5,10,155,1103,7,46,25,49,53,74,273,423,3,1580,87,0,2,2,1,0
23391,62,1230,282,202,222,14,2,44,296,8,42,24,43,50,67,250,378,4,1548,86,0,2,2,1,0
23392,95,4654,1523,757,1297,19,12,193,1542,12,193,117,230,205,347,1508,2664,7,19053,1058,0,2,17,0,0
23393,49,1839,1098,241,925,5,10,155,1103,7,46,25,49,53,74,273,423,3,1580,87,0,2,61,0,0
23394,98,2661,1523,757,1297,19,12,193,1542,12,193,117,230,205,347,1508,2664,7,19053,1058,0,2,0,1,0
23395,98,2661,701,378,504,33,58,109,734,13,110,68,126,123,194,794,1346,7,10027,557,0,2,0,1,0
23396,95,4654,1523,757,1297,19,12,193,1542,12,193,117,230,205,347,1508,2664,7,19053,1058,0,2,6,4,0
23397,49,1838,1098,241,925,5,10,155,1103,7,46,25,49,53,74,273,423,3,1580,87,0,2,15,11,0
23398,11,238,19,8,11,5,0,4,24,2,5,3,6,7,9,13,25,1,30,1,0,2,10,6,0
23399,11,238,102,59,69,5,3,24,107,6,22,15,28,28,43,113,206,3,789,43,0,2,10,6,0
23400,11,238,106,40,36,3,49,17,109,8,17,13,23,25,36,93,167,5,904,50,0,2,10,6,0
23401,213,4615,182,127,129,0,0,53,182,5,39,21,42,44,63,217,343,2,926,51,0,2,123,63,0
23402,213,4615,1165,710,800,67,119,181,1232,18,243,153,282,261,435,2000,3492,10,36473,2026,1,2,123,63,0
23403,83,1808,773,419,590,28,0,166,801,10,204,113,217,214,330,1598,2554,5,13587,754,0,2,32,18,0
23404,83,1808,421,273,302,44,34,57,465,17,81,59,107,98,166,583,1098,11,12329,684,0,2,32,18,0
23405,26,525,2,2,2,0,0,0,2,0,0,0,0,0,0,0,0,0,0,0,0,2,21,16,0
23406,26,525,99,48,90,1,3,5,100,0,0,0,0,0,0,0,0,0,0,0,0,2,21,16,0
23407,26,525,8,5,5,2,0,1,10,0,0,0,0,0,0,0,0,0,0,0,0,2,21,16,0
23408,26,525,1217,716,841,84,126,174,1301,14,185,118,215,199,333,1446,2542,8,20687,1149,0,2,21,16,0
23409,26,525,160,89,115,0,13,31,160,7,15,11,17,22,28,78,124,3,495,27,0,2,21,16,0
23410,26,525,10,10,9,9,0,0,19,0,0,0,0,0,0,0,0,0,0,0,0,2,21,16,0
23411,26,525,173,84,99,8,29,36,181,5,12,7,13,17,20,54,81,2,221,12,0,2,21,16,0
23412,26,525,3,1,1,3,0,0,6,0,0,0,0,0,0,0,0,0,0,0,0,2,21,16,0
23413,164,5032,1660,832,1314,41,38,274,1701,20,312,209,395,332,604,2671,5058,12,64042,3557,1,2,78,58,0
23414,164,5032,1057,646,719,113,100,145,1170,18,215,134,248,233,382,1740,3004,10,31186,1732,1,2,78,58,0
23415,17,344,95,58,50,9,16,20,104,12,33,24,45,45,69,209,378,8,3100,172,0,2,6,9,0
23416,89,1830,477,336,357,30,23,73,507,16,194,134,250,210,384,1538,2962,10,30538,1696,0,2,81,63,0
23417,71,1702,996,429,845,24,10,117,1020,7,76,50,88,83,138,494,879,4,3565,198,0,2,65,41,0
23418,71,1702,456,277,329,12,42,72,468,13,85,50,97,98,147,592,972,7,7212,400,0,2,65,41,0
23419,145,3016,1513,682,1277,25,13,200,1538,11,199,116,219,210,335,1557,2584,6,15641,868,0,2,59,41,0
23420,145,3016,819,519,539,24,98,155,843,15,96,57,106,111,163,690,1107,8,9171,509,0,2,59,41,0
23421,58,1183,207,111,150,11,0,50,218,5,26,19,36,31,55,133,272,3,943,52,0,2,84,52,0
23422,58,1183,410,198,237,31,55,97,441,11,63,38,72,74,110,414,683,6,4293,238,0,2,84,52,0
23423,356,7117,1457,730,1242,11,6,188,1468,10,292,166,329,302,495,2424,4078,5,22973,1276,1,2,250,179,0
23424,356,7117,74,35,59,1,0,14,75,3,14,7,14,17,21,58,85,1,128,7,0,2,250,179,0
23425,356,7117,245,125,200,5,7,34,250,7,30,17,34,37,51,166,265,3,1053,58,0,2,250,179,0
23426,28,809,339,213,244,17,9,65,356,10,42,26,48,52,74,259,421,5,2410,133,0,2,23,11,0
23427,84,2154,1455,414,1257,16,76,112,1471,5,41,23,46,46,69,231,381,2,1069,59,0,2,138,85,0
23428,84,2154,669,365,481,22,61,110,691,15,103,63,122,118,185,747,1273,8,11311,628,0,2,138,85,0
23429,237,5399,4293,999,3693,19,54,507,4312,9,155,88,170,164,258,1156,1898,4,9368,520,0,2,145,87,0
23430,237,5399,1482,859,1002,125,135,219,1607,16,219,134,251,235,385,1766,3032,9,27804,1544,1,2,145,87,0
23431,6,136,44,22,19,0,19,6,44,2,10,6,12,12,18,35,64,1,77,4,0,2,5,3,0
23432,27,959,74,35,59,1,0,14,75,3,14,7,14,17,21,58,85,1,128,7,0,2,77,50,0
23433,27,959,245,125,200,5,7,34,250,7,30,17,34,37,51,166,265,3,1053,58,0,2,77,50,0
23434,51,595,647,139,84,35,284,233,682,0,0,0,0,0,0,0,0,0,0,0,0,2,11,0,0
23435,98,2661,1523,757,1297,19,12,193,1542,12,193,117,230,205,347,1508,2664,7,19053,1058,0,2,142,110,0
23436,98,2661,701,378,504,33,58,109,734,13,110,68,126,123,194,794,1346,7,10027,557,0,2,142,110,0
23437,86,2225,773,422,505,30,103,129,803,14,77,46,83,91,129,535,839,7,6334,351,0,2,157,104,0
23438,122,2937,77,34,69,0,0,8,77,3,24,16,29,27,45,114,213,1,387,21,0,2,152,75,0
23439,122,2937,712,438,573,51,9,84,763,14,102,71,128,116,199,733,1364,8,11988,666,0,2,152,75,0
23440,24,605,2,2,2,0,0,0,2,0,0,0,0,0,0,0,0,0,0,0,0,2,45,28,0
23441,24,605,99,48,90,1,3,5,100,0,0,0,0,0,0,0,0,0,0,0,0,2,45,28,0
23442,24,605,8,5,5,2,0,1,10,0,0,0,0,0,0,0,0,0,0,0,0,2,45,28,0
23443,24,605,1217,716,841,84,126,174,1301,14,185,118,215,199,333,1446,2542,8,20687,1149,0,2,45,28,0
23444,24,605,160,89,115,0,13,31,160,7,15,11,17,22,28,78,124,3,495,27,0,2,45,28,0
23445,24,605,10,10,9,9,0,0,19,0,0,0,0,0,0,0,0,0,0,0,0,2,45,28,0
23446,24,605,173,84,99,8,29,36,181,5,12,7,13,17,20,54,81,2,221,12,0,2,45,28,0
23447,24,605,3,1,1,3,0,0,6,0,0,0,0,0,0,0,0,0,0,0,0,2,45,28,0
23448,30,658,125,97,103,3,0,19,128,9,25,17,27,34,44,144,223,4,1087,60,0,2,23,20,0
23449,22,350,102,57,55,5,16,25,107,5,17,10,18,22,28,81,124,2,330,18,0,2,8,3,0
23450,79,1721,402,202,227,24,74,80,426,12,52,33,61,64,94,339,564,7,3969,220,0,2,37,34,0
23451,48,992,447,308,343,6,5,95,453,7,96,59,111,103,170,651,1136,4,4600,255,0,2,17,17,0
23452,48,992,322,174,179,16,74,51,338,10,41,26,46,51,72,252,408,5,2291,127,0,2,17,17,0
23453,72,1644,53,23,39,0,0,13,53,2,8,4,8,10,12,26,39,1,39,2,0,2,27,16,0
23454,72,1644,515,298,307,33,80,99,548,12,63,44,77,75,121,419,753,7,5527,307,0,2,27,16,0
23455,23,381,424,94,331,4,0,89,428,1,5,5,5,6,10,11,25,0,12,0,0,2,14,14,0
23456,23,381,38,23,23,6,0,8,44,3,11,7,11,14,18,42,68,1,102,5,0,2,14,14,0
23457,20,511,205,80,86,16,53,53,221,7,18,10,19,25,29,94,134,3,497,27,0,2,23,13,0
23458,17,519,184,100,137,2,15,30,186,6,38,20,39,44,59,214,322,3,991,55,0,2,30,21,0
23459,17,519,103,65,74,8,5,16,111,7,17,9,17,24,26,89,119,3,417,23,0,2,30,21,0
23460,226,5309,722,423,573,19,0,135,741,12,172,101,199,184,300,1320,2257,6,15668,870,0,2,125,77,0
23461,226,5309,1508,847,911,44,250,301,1552,14,148,88,169,162,257,1120,1886,7,15077,837,0,2,125,77,0
23462,285,6292,72,33,56,0,4,12,72,1,1,1,1,2,2,0,2,0,1,0,0,2,277,168,0
23463,285,6292,1454,835,1044,76,110,219,1530,17,275,158,296,292,454,2297,3718,9,34017,1889,1,2,277,168,0
23464,78,1580,757,253,292,73,244,162,830,13,61,38,67,74,105,409,651,7,4654,258,0,2,52,32,0
23465,46,955,386,256,301,16,9,68,402,4,59,35,69,63,104,355,621,2,1453,80,0,2,25,15,0
23466,46,955,264,131,164,11,41,46,275,6,38,22,40,44,62,214,338,3,1068,59,0,2,25,15,0
23467,30,650,215,129,180,6,0,29,221,8,65,43,72,73,115,415,711,4,3153,175,0,2,25,18,0
23468,30,650,97,69,77,3,3,16,100,6,22,13,23,28,36,113,173,3,542,30,0,2,25,18,0
23469,115,2577,1043,504,840,53,9,147,1096,9,180,112,198,189,310,1377,2344,4,11604,644,0,2,89,54,0
23470,115,2577,383,288,292,26,6,62,409,11,65,38,67,76,105,429,656,5,3719,206,0,2,89,54,0
23471,20,411,294,64,250,0,0,43,294,1,20,10,20,21,30,86,131,0,65,3,0,2,30,20,0
23472,20,411,78,46,62,3,0,14,81,3,8,4,8,11,12,28,41,1,62,3,0,2,30,20,0
23473,5,119,110,30,77,3,13,16,113,4,21,15,30,25,45,100,208,2,597,33,0,2,7,3,0
23474,5,119,28,15,21,1,0,6,29,0,0,0,0,0,0,0,0,0,0,0,0,2,7,3,0
23475,70,1380,1178,367,1042,6,15,115,1184,9,94,51,95,103,146,644,976,4,4439,246,0,2,77,67,0
23476,70,1380,177,108,140,8,0,27,185,6,30,16,32,36,48,162,248,3,794,44,0,2,77,67,0
23477,209,4543,1943,715,1694,26,18,214,1969,12,185,120,237,197,357,1436,2721,7,20915,1161,0,2,215,134,0
23478,209,4543,1168,838,957,57,25,144,1225,19,348,224,416,367,640,3018,5452,11,61921,3440,1,2,215,134,0
23479,16,480,442,244,305,14,16,103,456,11,68,45,75,79,120,452,756,6,4588,254,0,2,11,8,0
23480,16,480,182,102,99,11,40,35,193,3,11,6,11,14,17,42,64,1,97,5,0,2,11,8,0
23481,62,1230,1098,241,925,5,10,155,1103,7,46,25,49,53,74,273,423,3,1580,87,0,2,42,27,0
23482,62,1230,282,202,222,14,2,44,296,8,42,24,43,50,67,250,378,4,1548,86,0,2,42,27,0
23483,22,460,601,196,481,2,23,85,603,8,63,36,72,71,108,400,664,4,3036,168,0,2,34,17,0
23484,22,460,156,79,106,5,16,28,161,5,14,8,15,19,23,64,97,2,261,14,0,2,34,17,0
23485,3,42,14,8,8,0,0,6,14,0,0,0,0,0,0,0,0,0,0,0,0,2,5,2,0
23486,2,40,9,6,6,0,0,3,9,0,0,0,0,0,0,0,0,0,0,0,0,2,3,2,0
23487,2,40,13,9,8,0,0,4,13,0,0,0,0,0,0,0,0,0,0,0,0,2,3,2,0
23488,1,324,382,65,130,157,2,92,539,4,10,5,10,14,15,41,57,2,114,6,0,2,117,100,0
23489,60,1081,282,196,195,3,0,86,285,8,130,71,141,138,212,936,1507,4,6538,363,0,2,88,50,0
23490,4,77,127,75,83,2,11,30,129,4,14,7,14,18,21,61,87,2,175,9,0,2,6,3,0
23491,4,77,652,304,544,16,6,88,668,6,89,51,101,95,152,591,998,3,3399,188,0,2,6,3,0
23492,4,77,2,2,2,0,0,0,2,0,0,0,0,0,0,0,0,0,0,0,0,2,6,3,0
23493,4,77,8,5,5,0,0,3,8,0,0,0,0,0,0,0,0,0,0,0,0,2,6,3,0
23494,4,77,2,2,2,0,0,0,2,0,0,0,0,0,0,0,0,0,0,0,0,2,6,3,0
23495,4,77,14,8,8,0,0,6,14,0,0,0,0,0,0,0,0,0,0,0,0,2,6,3,0
23496,4,77,6,4,4,0,0,2,6,0,0,0,0,0,0,0,0,0,0,0,0,2,6,3,0
23497,4,77,6,4,4,0,0,2,6,1,2,1,2,3,3,2,4,0,2,0,0,2,6,3,0
23498,4,77,6,4,4,0,0,2,6,0,0,0,0,0,0,0,0,0,0,0,0,2,6,3,0
23499,4,77,7,5,5,0,0,2,7,0,0,0,0,0,0,0,0,0,0,0,0,2,6,3,0
23500,4,77,6,4,4,0,0,2,6,0,0,0,0,0,0,0,0,0,0,0,0,2,6,3,0
23501,4,77,10,6,6,0,0,4,10,0,0,0,0,0,0,0,0,0,0,0,0,2,6,3,0
23502,4,77,1,1,1,0,0,0,1,0,0,0,0,0,0,0,0,0,0,0,0,2,6,3,0
23503,4,77,1,1,1,0,0,0,1,0,0,0,0,0,0,0,0,0,0,0,0,2,6,3,0
23504,4,77,14,10,10,0,0,4,14,1,1,1,1,2,2,0,2,0,1,0,0,2,6,3,0
23505,4,77,46,26,30,3,0,12,49,3,6,3,6,9,9,20,28,1,42,2,0,2,6,3,0
23506,1,9,5,3,3,0,0,2,5,0,0,0,0,0,0,0,0,0,0,0,0,2,1,0,0
23507,1,88,13,10,10,0,0,3,13,1,2,1,2,3,3,2,4,0,2,0,0,2,5,5,0
23508,7,114,44,19,17,0,16,11,44,3,14,7,14,17,21,58,85,1,128,7,0,2,4,1,0
23509,3,66,127,75,83,2,11,30,129,4,14,7,14,18,21,61,87,2,175,9,0,2,5,1,0
23510,3,66,652,304,544,16,6,88,668,6,89,51,101,95,152,591,998,3,3399,188,0,2,5,1,0
23511,3,66,2,2,2,0,0,0,2,0,0,0,0,0,0,0,0,0,0,0,0,2,5,1,0
23512,3,66,8,5,5,0,0,3,8,0,0,0,0,0,0,0,0,0,0,0,0,2,5,1,0
23513,3,66,2,2,2,0,0,0,2,0,0,0,0,0,0,0,0,0,0,0,0,2,5,1,0
23514,3,66,14,8,8,0,0,6,14,0,0,0,0,0,0,0,0,0,0,0,0,2,5,1,0
23515,3,66,6,4,4,0,0,2,6,0,0,0,0,0,0,0,0,0,0,0,0,2,5,1,0
23516,3,66,6,4,4,0,0,2,6,1,2,1,2,3,3,2,4,0,2,0,0,2,5,1,0
23517,3,66,6,4,4,0,0,2,6,0,0,0,0,0,0,0,0,0,0,0,0,2,5,1,0
23518,3,66,7,5,5,0,0,2,7,0,0,0,0,0,0,0,0,0,0,0,0,2,5,1,0
23519,3,66,6,4,4,0,0,2,6,0,0,0,0,0,0,0,0,0,0,0,0,2,5,1,0
23520,3,66,10,6,6,0,0,4,10,0,0,0,0,0,0,0,0,0,0,0,0,2,5,1,0
23521,3,66,1,1,1,0,0,0,1,0,0,0,0,0,0,0,0,0,0,0,0,2,5,1,0
23522,3,66,1,1,1,0,0,0,1,0,0,0,0,0,0,0,0,0,0,0,0,2,5,1,0
23523,3,66,14,10,10,0,0,4,14,1,1,1,1,2,2,0,2,0,1,0,0,2,5,1,0
23524,3,66,46,26,30,3,0,12,49,3,6,3,6,9,9,20,28,1,42,2,0,2,5,1,0
23525,7,298,72,33,56,0,4,12,72,1,1,1,1,2,2,0,2,0,1,0,0,2,27,10,0
23526,12,229,127,75,83,2,11,30,129,4,14,7,14,18,21,61,87,2,175,9,0,2,15,6,0
23527,12,229,652,304,544,16,6,88,668,6,89,51,101,95,152,591,998,3,3399,188,0,2,15,6,0
23528,12,229,2,2,2,0,0,0,2,0,0,0,0,0,0,0,0,0,0,0,0,2,15,6,0
23529,12,229,8,5,5,0,0,3,8,0,0,0,0,0,0,0,0,0,0,0,0,2,15,6,0
23530,12,229,2,2,2,0,0,0,2,0,0,0,0,0,0,0,0,0,0,0,0,2,15,6,0
23531,12,229,14,8,8,0,0,6,14,0,0,0,0,0,0,0,0,0,0,0,0,2,15,6,0
23532,12,229,6,4,4,0,0,2,6,0,0,0,0,0,0,0,0,0,0,0,0,2,15,6,0
23533,12,229,6,4,4,0,0,2,6,1,2,1,2,3,3,2,4,0,2,0,0,2,15,6,0
23534,12,229,6,4,4,0,0,2,6,0,0,0,0,0,0,0,0,0,0,0,0,2,15,6,0
23535,12,229,7,5,5,0,0,2,7,0,0,0,0,0,0,0,0,0,0,0,0,2,15,6,0
23536,12,229,6,4,4,0,0,2,6,0,0,0,0,0,0,0,0,0,0,0,0,2,15,6,0
23537,12,229,10,6,6,0,0,4,10,0,0,0,0,0,0,0,0,0,0,0,0,2,15,6,0
23538,12,229,1,1,1,0,0,0,1,0,0,0,0,0,0,0,0,0,0,0,0,2,15,6,0
23539,12,229,1,1,1,0,0,0,1,0,0,0,0,0,0,0,0,0,0,0,0,2,15,6,0
23540,12,229,14,10,10,0,0,4,14,1,1,1,1,2,2,0,2,0,1,0,0,2,15,6,0
23541,12,229,46,26,30,3,0,12,49,3,6,3,6,9,9,20,28,1,42,2,0,2,15,6,0
23542,6,71,127,75,83,2,11,30,129,4,14,7,14,18,21,61,87,2,175,9,0,2,3,3,0
23543,6,71,652,304,544,16,6,88,668,6,89,51,101,95,152,591,998,3,3399,188,0,2,3,3,0
23544,6,71,2,2,2,0,0,0,2,0,0,0,0,0,0,0,0,0,0,0,0,2,3,3,0
23545,6,71,8,5,5,0,0,3,8,0,0,0,0,0,0,0,0,0,0,0,0,2,3,3,0
23546,6,71,2,2,2,0,0,0,2,0,0,0,0,0,0,0,0,0,0,0,0,2,3,3,0
23547,6,71,14,8,8,0,0,6,14,0,0,0,0,0,0,0,0,0,0,0,0,2,3,3,0
23548,6,71,6,4,4,0,0,2,6,0,0,0,0,0,0,0,0,0,0,0,0,2,3,3,0
23549,6,71,6,4,4,0,0,2,6,1,2,1,2,3,3,2,4,0,2,0,0,2,3,3,0
23550,6,71,6,4,4,0,0,2,6,0,0,0,0,0,0,0,0,0,0,0,0,2,3,3,0
23551,6,71,7,5,5,0,0,2,7,0,0,0,0,0,0,0,0,0,0,0,0,2,3,3,0
23552,6,71,6,4,4,0,0,2,6,0,0,0,0,0,0,0,0,0,0,0,0,2,3,3,0
23553,6,71,10,6,6,0,0,4,10,0,0,0,0,0,0,0,0,0,0,0,0,2,3,3,0
23554,6,71,1,1,1,0,0,0,1,0,0,0,0,0,0,0,0,0,0,0,0,2,3,3,0
23555,6,71,1,1,1,0,0,0,1,0,0,0,0,0,0,0,0,0,0,0,0,2,3,3,0
23556,6,71,14,10,10,0,0,4,14,1,1,1,1,2,2,0,2,0,1,0,0,2,3,3,0
23557,6,71,46,26,30,3,0,12,49,3,6,3,6,9,9,20,28,1,42,2,0,2,3,3,0
23558,3,26,14,7,7,2,0,5,16,0,0,0,0,0,0,0,0,0,0,0,0,2,5,1,0
23559,7,103,38,23,23,0,0,15,38,0,0,0,0,0,0,0,0,0,0,0,0,2,8,0,0
23560,17,378,85,59,61,8,0,16,93,5,18,10,18,23,28,86,126,2,316,17,0,2,20,19,0
23561,15,484,42,7,35,4,0,5,46,1,2,1,2,3,3,2,4,0,2,0,0,2,49,50,0
23562,15,484,11,6,10,0,0,1,11,2,4,2,4,6,6,10,15,1,15,0,0,2,49,50,0
23563,92,3866,1289,550,1043,56,32,155,1345,10,167,93,185,177,278,1266,2075,5,11498,638,0,2,316,270,0
23564,36,1088,182,127,129,0,0,53,182,5,39,21,42,44,63,217,343,2,926,51,0,2,45,31,0
23565,147,6916,1392,870,1177,35,17,170,1427,14,494,280,531,508,811,4473,7289,7,54850,3047,2,2,280,169,0
23566,88,2881,773,419,590,28,0,166,801,10,204,113,217,214,330,1598,2554,5,13587,754,0,2,167,86,0
23567,15,742,75,38,59,1,3,12,76,2,4,2,4,6,6,10,15,1,15,0,0,2,139,77,0
23568,2,26,6,4,4,0,0,2,6,1,4,2,4,5,6,8,13,0,6,0,0,2,2,3,0
23569,13,570,139,89,101,2,0,35,141,7,54,34,62,61,96,330,569,4,2287,127,0,2,45,48,0
23570,1,138,149,67,118,4,0,27,153,1,17,14,28,18,42,69,175,0,144,8,0,2,15,7,0
23571,31,1983,1157,318,931,29,22,177,1186,6,104,63,125,110,188,712,1274,3,4596,255,0,2,370,273,0
23572,54,3598,520,294,400,33,13,81,553,10,261,204,367,271,571,2128,4614,7,32445,1802,1,2,81,90,0
23573,97,4401,1338,495,1086,10,64,173,1348,11,122,82,157,133,239,883,1686,7,11934,663,0,2,447,290,0
23574,172,7590,139,89,101,2,0,35,141,7,54,34,62,61,96,330,569,4,2287,127,0,2,1171,603,0
23575,172,7590,7,5,5,0,0,2,7,1,2,1,2,3,3,2,4,0,2,0,0,2,1171,603,0
23576,33,989,465,148,393,5,8,60,470,4,31,20,31,35,51,161,261,2,523,29,0,2,97,53,0
23577,33,989,16,12,9,0,0,6,16,1,2,1,2,3,3,2,4,0,2,0,0,2,97,53,0
23578,139,5899,1782,648,1425,9,47,279,1791,8,171,97,189,179,286,1292,2140,4,9462,525,0,2,529,373,0
23579,25,684,256,139,192,9,7,47,265,4,23,12,24,27,36,112,171,2,357,19,0,2,33,23,0
23580,6,328,180,34,164,0,0,16,180,1,12,6,12,13,18,43,66,0,33,1,0,2,89,64,0
23581,23,578,102,59,69,5,3,24,107,6,22,15,28,28,43,113,206,3,789,43,0,2,32,21,0
23582,111,4186,1450,624,1228,12,26,181,1462,14,306,186,354,320,540,2580,4493,8,36391,2021,1,2,482,388,0
23583,155,4437,1660,832,1314,41,38,274,1701,20,312,209,395,332,604,2671,5058,12,64042,3557,1,2,295,164,0
23584,36,2873,996,429,845,24,10,117,1020,7,76,50,88,83,138,494,879,4,3565,198,0,2,391,315,0
23585,125,5129,1513,682,1277,25,13,200,1538,11,199,116,219,210,335,1557,2584,6,15641,868,0,2,386,292,0
23586,73,3803,1296,573,1062,40,33,157,1336,8,201,118,231,209,349,1561,2689,4,12365,686,0,2,278,192,0
23587,14,341,207,111,150,11,0,50,218,5,26,19,36,31,55,133,272,3,943,52,0,2,24,15,0
23588,84,4433,1457,730,1242,11,6,188,1468,10,292,166,329,302,495,2424,4078,5,22973,1276,1,2,439,270,0
23589,39,2323,652,304,544,16,6,88,668,6,89,51,101,95,152,591,998,3,3399,188,0,2,180,111,0
23590,69,3174,1455,414,1257,16,76,112,1471,5,41,23,46,46,69,231,381,2,1069,59,0,2,515,349,0
23591,2,75,7,6,5,0,0,2,7,1,1,1,2,2,3,0,3,1,3,0,0,2,4,4,0
23592,8,271,74,35,59,1,0,14,75,3,14,7,14,17,21,58,85,1,128,7,0,2,19,24,0
23593,95,4654,1523,757,1297,19,12,193,1542,12,193,117,230,205,347,1508,2664,7,19053,1058,0,2,318,200,0
23594,87,3811,1020,354,843,12,15,144,1032,8,134,77,144,142,221,970,1580,4,6792,377,0,2,358,221,0
23595,38,1676,447,308,343,6,5,95,453,7,96,59,111,103,170,651,1136,4,4600,255,0,2,99,72,0
23596,1,107,53,23,39,0,0,13,53,2,8,4,8,10,12,26,39,1,39,2,0,2,13,10,0
23597,21,658,424,94,331,4,0,89,428,1,5,5,5,6,10,11,25,0,12,0,0,2,83,59,0
23598,38,2302,334,251,279,10,4,40,344,5,127,74,143,132,217,899,1528,2,4303,239,0,2,124,98,0
23599,12,493,184,100,137,2,15,30,186,6,38,20,39,44,59,214,322,3,991,55,0,2,47,32,0
23600,59,2582,1293,570,1093,25,15,163,1318,10,195,123,241,205,364,1516,2795,6,17273,959,0,2,198,124,0
23601,33,1883,384,251,317,7,8,52,391,11,70,44,84,81,128,467,811,6,5355,297,0,2,78,55,0
23602,45,2208,722,423,573,19,0,135,741,12,172,101,199,184,300,1320,2257,6,15668,870,0,2,61,38,0
23603,39,1727,386,256,301,16,9,68,402,4,59,35,69,63,104,355,621,2,1453,80,0,2,90,52,0
23604,16,1214,215,129,180,6,0,29,221,8,65,43,72,73,115,415,711,4,3153,175,0,2,75,60,0
23605,79,3060,1043,504,840,53,9,147,1096,9,180,112,198,189,310,1377,2344,4,11604,644,0,2,245,148,0
23606,14,530,295,56,236,0,4,54,295,2,9,5,10,11,15,30,51,1,57,3,0,2,85,52,0
23607,30,1241,373,158,315,8,0,51,381,5,76,44,79,81,123,486,779,2,2026,112,0,2,88,44,0
23608,77,3211,1178,367,1042,6,15,115,1184,9,94,51,95,103,146,644,976,4,4439,246,0,2,460,373,0
23609,91,4584,1943,715,1694,26,18,214,1969,12,185,120,237,197,357,1436,2721,7,20915,1161,0,2,582,518,0
23610,14,826,442,244,305,14,16,103,456,11,68,45,75,79,120,452,756,6,4588,254,0,2,58,34,0
23611,49,1838,1098,241,925,5,10,155,1103,7,46,25,49,53,74,273,423,3,1580,87,0,2,284,183,0
23612,19,682,601,196,481,2,23,85,603,8,63,36,72,71,108,400,664,4,3036,168,0,2,139,107,0
23613,163,5018,1660,832,1314,41,38,274,1701,20,312,209,395,332,604,2671,5058,12,64042,3557,1,2,1,4,0
23614,163,5018,1057,646,719,113,100,145,1170,18,215,134,248,233,382,1740,3004,10,31186,1732,1,2,1,4,0
23615,15,492,42,7,35,4,0,5,46,1,2,1,2,3,3,2,4,0,2,0,0,2,8,4,0
23616,15,492,11,6,10,0,0,1,11,2,4,2,4,6,6,10,15,1,15,0,0,2,8,4,0
23617,15,492,42,7,35,4,0,5,46,1,2,1,2,3,3,2,4,0,2,0,0,2,8,4,0
23618,15,492,11,6,10,0,0,1,11,2,4,2,4,6,6,10,15,1,15,0,0,2,8,4,0
23619,111,4174,1450,624,1228,12,26,181,1462,14,306,186,354,320,540,2580,4493,8,36391,2021,1,2,3,3,0
23620,58,1178,207,111,150,11,0,50,218,5,26,19,36,31,55,133,272,3,943,52,0,2,1,1,0
23621,58,1178,410,198,237,31,55,97,441,11,63,38,72,74,110,414,683,6,4293,238,0,2,1,1,0
23622,236,5393,4293,999,3693,19,54,507,4312,9,155,88,170,164,258,1156,1898,4,9368,520,0,2,1,2,0
23623,236,5393,1482,859,1002,125,135,219,1607,16,219,134,251,235,385,1766,3032,9,27804,1544,1,2,1,2,0
23624,147,6910,1392,870,1177,35,17,170,1427,14,494,280,531,508,811,4473,7289,7,54850,3047,2,2,1,2,0
23625,157,4456,1660,832,1314,41,38,274,1701,20,312,209,395,332,604,2671,5058,12,64042,3557,1,2,23,7,1
23626,154,4341,1660,832,1314,41,38,274,1701,20,312,209,395,332,604,2671,5058,12,64042,3557,1,2,15,25,1
23627,58,1178,207,111,150,11,0,50,218,5,26,19,36,31,55,133,272,3,943,52,0,2,1,1,0
23628,58,1178,410,198,237,31,55,97,441,11,63,38,72,74,110,414,683,6,4293,238,0,2,1,1,0
23629,236,5393,4293,999,3693,19,54,507,4312,9,155,88,170,164,258,1156,1898,4,9368,520,0,2,1,2,0
23630,236,5393,1482,859,1002,125,135,219,1607,16,219,134,251,235,385,1766,3032,9,27804,1544,1,2,1,2,0
23631,147,6910,1392,870,1177,35,17,170,1427,14,494,280,531,508,811,4473,7289,7,54850,3047,2,2,1,2,0
23632,111,4174,1450,624,1228,12,26,181,1462,14,306,186,354,320,540,2580,4493,8,36391,2021,1,2,3,3,0
23633,154,4341,1660,832,1314,41,38,274,1701,20,312,209,395,332,604,2671,5058,12,64042,3557,1,2,28,22,0
23634,15,495,42,7,35,4,0,5,46,1,2,1,2,3,3,2,4,0,2,0,0,2,7,1,0
23635,15,495,11,6,10,0,0,1,11,2,4,2,4,6,6,10,15,1,15,0,0,2,7,1,0
23636,356,7161,2,2,2,0,0,0,2,0,0,0,0,0,0,0,0,0,0,0,0,2,27,5,0
23637,356,7161,99,48,90,1,3,5,100,0,0,0,0,0,0,0,0,0,0,0,0,2,27,5,0
23638,356,7161,8,5,5,2,0,1,10,0,0,0,0,0,0,0,0,0,0,0,0,2,27,5,0
23639,356,7161,1217,716,841,84,126,174,1301,14,185,118,215,199,333,1446,2542,8,20687,1149,0,2,27,5,0
23640,356,7161,160,89,115,0,13,31,160,7,15,11,17,22,28,78,124,3,495,27,0,2,27,5,0
23641,356,7161,10,10,9,9,0,0,19,0,0,0,0,0,0,0,0,0,0,0,0,2,27,5,0
23642,356,7161,173,84,99,8,29,36,181,5,12,7,13,17,20,54,81,2,221,12,0,2,27,5,0
23643,356,7161,3,1,1,3,0,0,6,0,0,0,0,0,0,0,0,0,0,0,0,2,27,5,0
23644,262,5263,2,2,2,0,0,0,2,0,0,0,0,0,0,0,0,0,0,0,0,2,2,390,1
23645,262,5263,99,48,90,1,3,5,100,0,0,0,0,0,0,0,0,0,0,0,0,2,2,390,1
23646,262,5263,8,5,5,2,0,1,10,0,0,0,0,0,0,0,0,0,0,0,0,2,2,390,1
23647,262,5263,1217,716,841,84,126,174,1301,14,185,118,215,199,333,1446,2542,8,20687,1149,0,2,2,390,1
23648,262,5263,160,89,115,0,13,31,160,7,15,11,17,22,28,78,124,3,495,27,0,2,2,390,1
23649,262,5263,10,10,9,9,0,0,19,0,0,0,0,0,0,0,0,0,0,0,0,2,2,390,1
23650,262,5263,173,84,99,8,29,36,181,5,12,7,13,17,20,54,81,2,221,12,0,2,2,390,1
23651,262,5263,3,1,1,3,0,0,6,0,0,0,0,0,0,0,0,0,0,0,0,2,2,390,1
23652,94,1911,463,295,324,28,62,57,491,12,134,82,154,146,236,989,1696,6,11700,650,0,0,394,0,1
23653,211,4544,2,2,2,0,0,0,2,0,0,0,0,0,0,0,0,0,0,0,0,2,2,147,1
23654,211,4544,99,48,90,1,3,5,100,0,0,0,0,0,0,0,0,0,0,0,0,2,2,147,1
23655,211,4544,8,5,5,2,0,1,10,0,0,0,0,0,0,0,0,0,0,0,0,2,2,147,1
23656,211,4544,1217,716,841,84,126,174,1301,14,185,118,215,199,333,1446,2542,8,20687,1149,0,2,2,147,1
23657,211,4544,160,89,115,0,13,31,160,7,15,11,17,22,28,78,124,3,495,27,0,2,2,147,1
23658,211,4544,10,10,9,9,0,0,19,0,0,0,0,0,0,0,0,0,0,0,0,2,2,147,1
23659,211,4544,173,84,99,8,29,36,181,5,12,7,13,17,20,54,81,2,221,12,0,2,2,147,1
23660,211,4544,3,1,1,3,0,0,6,0,0,0,0,0,0,0,0,0,0,0,0,2,2,147,1
23661,51,727,167,116,138,4,5,22,171,8,48,30,56,56,86,292,499,4,2330,129,0,0,140,0,1
23662,125,5131,1513,682,1277,25,13,200,1538,11,199,116,219,210,335,1557,2584,6,15641,868,0,2,1,1,0
23663,84,4436,1457,730,1242,11,6,188,1468,10,292,166,329,302,495,2424,4078,5,22973,1276,1,2,2,6,0
23664,38,2304,334,251,279,10,4,40,344,5,127,74,143,132,217,899,1528,2,4303,239,0,2,1,1,0
23665,209,4543,1943,715,1694,26,18,214,1969,12,185,120,237,197,357,1436,2721,7,20915,1161,0,2,2,2,0
23666,209,4543,1168,838,957,57,25,144,1225,19,348,224,416,367,640,3018,5452,11,61921,3440,1,2,2,2,0
23667,91,4584,1943,715,1694,26,18,214,1969,12,185,120,237,197,357,1436,2721,7,20915,1161,0,2,1,1,0
23668,209,4543,1943,715,1694,26,18,214,1969,12,185,120,237,197,357,1436,2721,7,20915,1161,0,2,2,2,0
23669,209,4543,1168,838,957,57,25,144,1225,19,348,224,416,367,640,3018,5452,11,61921,3440,1,2,2,2,0
23670,91,4584,1943,715,1694,26,18,214,1969,12,185,120,237,197,357,1436,2721,7,20915,1161,0,2,1,1,0
23671,10,379,42,7,35,4,0,5,46,1,2,1,2,3,3,2,4,0,2,0,0,2,1,21,0
23672,10,379,11,6,10,0,0,1,11,2,4,2,4,6,6,10,15,1,15,0,0,2,1,21,0
23673,10,379,42,7,35,4,0,5,46,1,2,1,2,3,3,2,4,0,2,0,0,2,1,21,0
23674,10,379,11,6,10,0,0,1,11,2,4,2,4,6,6,10,15,1,15,0,0,2,1,21,0
23675,115,2582,1043,504,840,53,9,147,1096,9,180,112,198,189,310,1377,2344,4,11604,644,0,2,1,0,0
23676,115,2582,383,288,292,26,6,62,409,11,65,38,67,76,105,429,656,5,3719,206,0,2,1,0,0
23677,79,3058,1043,504,840,53,9,147,1096,9,180,112,198,189,310,1377,2344,4,11604,644,0,2,1,1,0
23678,115,2582,1043,504,840,53,9,147,1096,9,180,112,198,189,310,1377,2344,4,11604,644,0,2,1,0,0
23679,115,2582,383,288,292,26,6,62,409,11,65,38,67,76,105,429,656,5,3719,206,0,2,1,0,0
23680,79,3058,1043,504,840,53,9,147,1096,9,180,112,198,189,310,1377,2344,4,11604,644,0,2,1,1,0
23681,115,2577,1043,504,840,53,9,147,1096,9,180,112,198,189,310,1377,2344,4,11604,644,0,2,0,1,0
23682,115,2577,383,288,292,26,6,62,409,11,65,38,67,76,105,429,656,5,3719,206,0,2,0,1,0
23683,79,3060,1043,504,840,53,9,147,1096,9,180,112,198,189,310,1377,2344,4,11604,644,0,2,1,1,0
23684,209,4545,1943,715,1694,26,18,214,1969,12,185,120,237,197,357,1436,2721,7,20915,1161,0,2,1,1,0
23685,209,4545,1168,838,957,57,25,144,1225,19,348,224,416,367,640,3018,5452,11,61921,3440,1,2,1,1,0
23686,91,4597,1943,715,1694,26,18,214,1969,12,185,120,237,197,357,1436,2721,7,20915,1161,0,2,4,1,0
23687,209,4545,1943,715,1694,26,18,214,1969,12,185,120,237,197,357,1436,2721,7,20915,1161,0,2,1,1,0
23688,209,4545,1168,838,957,57,25,144,1225,19,348,224,416,367,640,3018,5452,11,61921,3440,1,2,1,1,0
23689,91,4597,1943,715,1694,26,18,214,1969,12,185,120,237,197,357,1436,2721,7,20915,1161,0,2,4,1,0
23690,172,7590,139,89,101,2,0,35,141,7,54,34,62,61,96,330,569,4,2287,127,0,2,2,2,1
23691,172,7590,7,5,5,0,0,2,7,1,2,1,2,3,3,2,4,0,2,0,0,2,2,2,1
23692,115,2577,1043,504,840,53,9,147,1096,9,180,112,198,189,310,1377,2344,4,11604,644,0,2,0,1,0
23693,115,2577,383,288,292,26,6,62,409,11,65,38,67,76,105,429,656,5,3719,206,0,2,0,1,0
23694,79,3060,1043,504,840,53,9,147,1096,9,180,112,198,189,310,1377,2344,4,11604,644,0,2,1,1,0
23695,172,7590,139,89,101,2,0,35,141,7,54,34,62,61,96,330,569,4,2287,127,0,2,2,2,0
23696,172,7590,7,5,5,0,0,2,7,1,2,1,2,3,3,2,4,0,2,0,0,2,2,2,0
23697,118,2609,1043,504,840,53,9,147,1096,9,180,112,198,189,310,1377,2344,4,11604,644,0,2,10,1,1
23698,118,2609,383,288,292,26,6,62,409,11,65,38,67,76,105,429,656,5,3719,206,0,2,10,1,1
23699,82,3156,1043,504,840,53,9,147,1096,9,180,112,198,189,310,1377,2344,4,11604,644,0,2,17,0,1
23700,82,3156,1043,504,840,53,9,147,1096,9,180,112,198,189,310,1377,2344,4,11604,644,0,2,1,0,0
23701,82,3160,1043,504,840,53,9,147,1096,9,180,112,198,189,310,1377,2344,4,11604,644,0,2,1,1,0
23702,118,2609,1043,504,840,53,9,147,1096,9,180,112,198,189,310,1377,2344,4,11604,644,0,2,10,1,0
23703,118,2609,383,288,292,26,6,62,409,11,65,38,67,76,105,429,656,5,3719,206,0,2,10,1,0
23704,82,3160,1043,504,840,53,9,147,1096,9,180,112,198,189,310,1377,2344,4,11604,644,0,2,18,0,0
23705,82,1757,402,202,227,24,74,80,426,12,52,33,61,64,94,339,564,7,3969,220,0,2,8,1,1
23706,72,1650,53,23,39,0,0,13,53,2,8,4,8,10,12,26,39,1,39,2,0,2,4,2,1
23707,72,1650,515,298,307,33,80,99,548,12,63,44,77,75,121,419,753,7,5527,307,0,2,4,2,1
23708,88,3885,1020,354,843,12,15,144,1032,8,134,77,144,142,221,970,1580,4,6792,377,0,2,10,1,1
23709,82,1767,402,202,227,24,74,80,426,12,52,33,61,64,94,339,564,7,3969,220,0,2,5,1,1
23710,72,1646,53,23,39,0,0,13,53,2,8,4,8,10,12,26,39,1,39,2,0,2,3,5,1
23711,72,1646,515,298,307,33,80,99,548,12,63,44,77,75,121,419,753,7,5527,307,0,2,3,5,1
23712,33,1004,465,148,393,5,8,60,470,4,31,20,31,35,51,161,261,2,523,29,0,2,3,0,0
23713,33,1004,16,12,9,0,0,6,16,1,2,1,2,3,3,2,4,0,2,0,0,2,3,0,0
23714,82,1767,402,202,227,24,74,80,426,12,52,33,61,64,94,339,564,7,3969,220,0,2,12,1,0
23715,72,1646,53,23,39,0,0,13,53,2,8,4,8,10,12,26,39,1,39,2,0,2,3,3,0
23716,72,1646,515,298,307,33,80,99,548,12,63,44,77,75,121,419,753,7,5527,307,0,2,3,3,0
23717,33,1004,465,148,393,5,8,60,470,4,31,20,31,35,51,161,261,2,523,29,0,2,3,0,0
23718,33,1004,16,12,9,0,0,6,16,1,2,1,2,3,3,2,4,0,2,0,0,2,3,0,0
23719,88,3885,1020,354,843,12,15,144,1032,8,134,77,144,142,221,970,1580,4,6792,377,0,2,10,1,0
23720,73,1667,53,23,39,0,0,13,53,2,8,4,8,10,12,26,39,1,39,2,0,2,7,2,0
23721,73,1667,515,298,307,33,80,99,548,12,63,44,77,75,121,419,753,7,5527,307,0,2,7,2,0
23722,90,3963,1020,354,843,12,15,144,1032,8,134,77,144,142,221,970,1580,4,6792,377,0,2,9,0,0
23723,73,1667,53,23,39,0,0,13,53,2,8,4,8,10,12,26,39,1,39,2,0,2,4,3,1
23724,73,1667,515,298,307,33,80,99,548,12,63,44,77,75,121,419,753,7,5527,307,0,2,4,3,1
23725,73,1667,53,23,39,0,0,13,53,2,8,4,8,10,12,26,39,1,39,2,0,2,1,1,0
23726,73,1667,515,298,307,33,80,99,548,12,63,44,77,75,121,419,753,7,5527,307,0,2,1,1,0
23727,82,1767,402,202,227,24,74,80,426,12,52,33,61,64,94,339,564,7,3969,220,0,2,12,1,0
23728,73,1667,53,23,39,0,0,13,53,2,8,4,8,10,12,26,39,1,39,2,0,2,10,4,0
23729,73,1667,515,298,307,33,80,99,548,12,63,44,77,75,121,419,753,7,5527,307,0,2,10,4,0
23730,33,1004,465,148,393,5,8,60,470,4,31,20,31,35,51,161,261,2,523,29,0,2,3,0,0
23731,33,1004,16,12,9,0,0,6,16,1,2,1,2,3,3,2,4,0,2,0,0,2,3,0,0
23732,90,3963,1020,354,843,12,15,144,1032,8,134,77,144,142,221,970,1580,4,6792,377,0,2,19,1,0
23733,88,2248,773,422,505,30,103,129,803,14,77,46,83,91,129,535,839,7,6334,351,0,2,16,0,0
23734,15,703,139,89,101,2,0,35,141,7,54,34,62,61,96,330,569,4,2287,127,0,2,21,0,0
23735,88,2248,773,422,505,30,103,129,803,14,77,46,83,91,129,535,839,7,6334,351,0,2,16,0,0
23736,15,703,139,89,101,2,0,35,141,7,54,34,62,61,96,330,569,4,2287,127,0,2,21,0,0
23737,8,183,51,25,36,0,0,15,51,3,11,6,12,14,18,42,68,1,112,6,0,0,34,0,1
23738,8,263,51,25,36,0,0,15,51,3,11,6,12,14,18,42,68,1,112,6,0,2,17,1,0
23739,8,265,51,25,36,0,0,15,51,3,11,6,12,14,18,42,68,1,112,6,0,2,34,30,0
23740,70,3212,1455,414,1257,16,76,112,1471,5,41,23,46,46,69,231,381,2,1069,59,0,2,16,0,1
23741,85,2161,1455,414,1257,16,76,112,1471,5,41,23,46,46,69,231,381,2,1069,59,0,2,1,1,0
23742,85,2161,669,365,481,22,61,110,691,15,103,63,122,118,185,747,1273,8,11311,628,0,2,1,1,0
23743,10,382,42,7,35,4,0,5,46,1,2,1,2,3,3,2,4,0,2,0,0,2,7,1,0
23744,10,382,11,6,10,0,0,1,11,2,4,2,4,6,6,10,15,1,15,0,0,2,7,1,0
23745,211,4544,2,2,2,0,0,0,2,0,0,0,0,0,0,0,0,0,0,0,0,3,31,542,0
23746,211,4544,99,48,90,1,3,5,100,0,0,0,0,0,0,0,0,0,0,0,0,3,31,542,0
23747,211,4544,8,5,5,2,0,1,10,0,0,0,0,0,0,0,0,0,0,0,0,3,31,542,0
23748,211,4544,1217,716,841,84,126,174,1301,14,185,118,215,199,333,1446,2542,8,20687,1149,0,3,31,542,0
23749,211,4544,160,89,115,0,13,31,160,7,15,11,17,22,28,78,124,3,495,27,0,3,31,542,0
23750,211,4544,10,10,9,9,0,0,19,0,0,0,0,0,0,0,0,0,0,0,0,3,31,542,0
23751,211,4544,173,84,99,8,29,36,181,5,12,7,13,17,20,54,81,2,221,12,0,3,31,542,0
23752,211,4544,3,1,1,3,0,0,6,0,0,0,0,0,0,0,0,0,0,0,0,3,31,542,0
23753,94,1911,463,295,324,28,62,57,491,12,134,82,154,146,236,989,1696,6,11700,650,0,0,394,0,0
23754,51,727,167,116,138,4,5,22,171,8,48,30,56,56,86,292,499,4,2330,129,0,0,140,0,0
23755,125,5131,1513,682,1277,25,13,200,1538,11,199,116,219,210,335,1557,2584,6,15641,868,0,2,1,1,0
23756,84,4436,1457,730,1242,11,6,188,1468,10,292,166,329,302,495,2424,4078,5,22973,1276,1,2,2,6,0
23757,38,2304,334,251,279,10,4,40,344,5,127,74,143,132,217,899,1528,2,4303,239,0,2,1,1,0
23758,8,265,51,25,36,0,0,15,51,3,11,6,12,14,18,42,68,1,112,6,0,0,54,0,0
23759,78,1581,757,253,292,73,244,162,830,13,61,38,67,74,105,409,651,7,4654,258,0,2,1,1,0
23760,46,956,386,256,301,16,9,68,402,4,59,35,69,63,104,355,621,2,1453,80,0,2,1,1,0
23761,46,956,264,131,164,11,41,46,275,6,38,22,40,44,62,214,338,3,1068,59,0,2,1,1,0
23762,78,1581,757,253,292,73,244,162,830,13,61,38,67,74,105,409,651,7,4654,258,0,2,1,1,0
23763,46,956,386,256,301,16,9,68,402,4,59,35,69,63,104,355,621,2,1453,80,0,2,1,1,0
23764,46,956,264,131,164,11,41,46,275,6,38,22,40,44,62,214,338,3,1068,59,0,2,1,1,0
23765,85,2161,1455,414,1257,16,76,112,1471,5,41,23,46,46,69,231,381,2,1069,59,0,2,1,1,0
23766,85,2161,669,365,481,22,61,110,691,15,103,63,122,118,185,747,1273,8,11311,628,0,2,1,1,0
23767,70,3212,1455,414,1257,16,76,112,1471,5,41,23,46,46,69,231,381,2,1069,59,0,2,16,0,0
23768,285,6275,72,33,56,0,4,12,72,1,1,1,1,2,2,0,2,0,1,0,0,2,2,4,0
23769,285,6275,1454,835,1044,76,110,219,1530,17,275,158,296,292,454,2297,3718,9,34017,1889,1,2,2,4,0
23770,285,6275,72,33,56,0,4,12,72,1,1,1,1,2,2,0,2,0,1,0,0,2,2,4,0
23771,285,6275,1454,835,1044,76,110,219,1530,17,275,158,296,292,454,2297,3718,9,34017,1889,1,2,2,4,0
23772,74,1755,996,429,845,24,10,117,1020,7,76,50,88,83,138,494,879,4,3565,198,0,2,16,0,1
23773,74,1755,456,277,329,12,42,72,468,13,85,50,97,98,147,592,972,7,7212,400,0,2,16,0,1
23774,74,1755,996,429,845,24,10,117,1020,7,76,50,88,83,138,494,879,4,3565,198,0,2,3,6,1
23775,74,1755,456,277,329,12,42,72,468,13,85,50,97,98,147,592,972,7,7212,400,0,2,3,6,1
23776,74,1755,996,429,845,24,10,117,1020,7,76,50,88,83,138,494,879,4,3565,198,0,2,5,2,0
23777,74,1755,456,277,329,12,42,72,468,13,85,50,97,98,147,592,972,7,7212,400,0,2,5,2,0
23778,74,1762,996,429,845,24,10,117,1020,7,76,50,88,83,138,494,879,4,3565,198,0,2,10,5,0
23779,74,1762,456,277,329,12,42,72,468,13,85,50,97,98,147,592,972,7,7212,400,0,2,10,5,0
23780,39,2970,996,429,845,24,10,117,1020,7,76,50,88,83,138,494,879,4,3565,198,0,2,29,1,0
23781,82,1769,402,202,227,24,74,80,426,12,52,33,61,64,94,339,564,7,3969,220,0,2,2,1,0
23782,82,1769,402,202,227,24,74,80,426,12,52,33,61,64,94,339,564,7,3969,220,0,2,2,1,0
23783,74,1762,996,429,845,24,10,117,1020,7,76,50,88,83,138,494,879,4,3565,198,0,2,1,1,0
23784,74,1762,456,277,329,12,42,72,468,13,85,50,97,98,147,592,972,7,7212,400,0,2,1,1,0
23785,74,1762,996,429,845,24,10,117,1020,7,76,50,88,83,138,494,879,4,3565,198,0,2,21,0,0
23786,74,1762,456,277,329,12,42,72,468,13,85,50,97,98,147,592,972,7,7212,400,0,2,21,0,0
23787,39,2970,996,429,845,24,10,117,1020,7,76,50,88,83,138,494,879,4,3565,198,0,2,29,1,0
23788,10,393,42,7,35,4,0,5,46,1,2,1,2,3,3,2,4,0,2,0,0,2,3,1,1
23789,10,393,11,6,10,0,0,1,11,2,4,2,4,6,6,10,15,1,15,0,0,2,3,1,1
23790,73,1672,996,429,845,24,10,117,1020,7,76,50,88,83,138,494,879,4,3565,198,0,2,48,53,1
23791,73,1672,456,277,329,12,42,72,468,13,85,50,97,98,147,592,972,7,7212,400,0,2,48,53,1
23792,58,1187,207,111,150,11,0,50,218,5,26,19,36,31,55,133,272,3,943,52,0,2,3,0,1
23793,58,1187,410,198,237,31,55,97,441,11,63,38,72,74,110,414,683,6,4293,238,0,2,3,0,1
23794,39,2971,996,429,845,24,10,117,1020,7,76,50,88,83,138,494,879,4,3565,198,0,2,3,1,1
23795,2,71,167,116,138,4,5,22,171,8,48,30,56,56,86,292,499,4,2330,129,0,0,13,0,0
23796,73,1672,996,429,845,24,10,117,1020,7,76,50,88,83,138,494,879,4,3565,198,0,2,2,2,0
23797,73,1672,456,277,329,12,42,72,468,13,85,50,97,98,147,592,972,7,7212,400,0,2,2,2,0
23798,58,1191,207,111,150,11,0,50,218,5,26,19,36,31,55,133,272,3,943,52,0,2,1,1,0
23799,58,1191,410,198,237,31,55,97,441,11,63,38,72,74,110,414,683,6,4293,238,0,2,1,1,0
23800,76,1730,996,429,845,24,10,117,1020,7,76,50,88,83,138,494,879,4,3565,198,0,2,12,12,0
23801,76,1730,456,277,329,12,42,72,468,13,85,50,97,98,147,592,972,7,7212,400,0,2,12,12,0
23802,11,410,42,7,35,4,0,5,46,1,2,1,2,3,3,2,4,0,2,0,0,2,4,2,0
23803,11,410,11,6,10,0,0,1,11,2,4,2,4,6,6,10,15,1,15,0,0,2,4,2,0
23804,58,1196,207,111,150,11,0,50,218,5,26,19,36,31,55,133,272,3,943,52,0,2,6,3,0
23805,58,1196,410,198,237,31,55,97,441,11,63,38,72,74,110,414,683,6,4293,238,0,2,6,3,0
23806,11,410,42,7,35,4,0,5,46,1,2,1,2,3,3,2,4,0,2,0,0,2,3,3,1
23807,11,410,11,6,10,0,0,1,11,2,4,2,4,6,6,10,15,1,15,0,0,2,3,3,1
23808,58,1196,207,111,150,11,0,50,218,5,26,19,36,31,55,133,272,3,943,52,0,2,1,1,1
23809,58,1196,410,198,237,31,55,97,441,11,63,38,72,74,110,414,683,6,4293,238,0,2,1,1,1
23810,76,1711,996,429,845,24,10,117,1020,7,76,50,88,83,138,494,879,4,3565,198,0,2,18,19,0
23811,76,1711,456,277,329,12,42,72,468,13,85,50,97,98,147,592,972,7,7212,400,0,2,18,19,0
23812,39,2971,996,429,845,24,10,117,1020,7,76,50,88,83,138,494,879,4,3565,198,0,2,2,2,0
23813,74,1700,996,429,845,24,10,117,1020,7,76,50,88,83,138,494,879,4,3565,198,0,2,4,4,0
23814,74,1700,456,277,329,12,42,72,468,13,85,50,97,98,147,592,972,7,7212,400,0,2,4,4,0
23815,74,1693,996,429,845,24,10,117,1020,7,76,50,88,83,138,494,879,4,3565,198,0,2,1,1,0
23816,74,1693,456,277,329,12,42,72,468,13,85,50,97,98,147,592,972,7,7212,400,0,2,1,1,0
23817,164,5065,1660,832,1314,41,38,274,1701,20,312,209,395,332,604,2671,5058,12,64042,3557,1,2,10,0,0
23818,164,5065,1057,646,719,113,100,145,1170,18,215,134,248,233,382,1740,3004,10,31186,1732,1,2,10,0,0
23819,88,3896,1020,354,843,12,15,144,1032,8,134,77,144,142,221,970,1580,4,6792,377,0,2,5,1,0
23820,164,5065,1660,832,1314,41,38,274,1701,20,312,209,395,332,604,2671,5058,12,64042,3557,1,2,10,0,0
23821,164,5065,1057,646,719,113,100,145,1170,18,215,134,248,233,382,1740,3004,10,31186,1732,1,2,10,0,0
23822,88,3896,1020,354,843,12,15,144,1032,8,134,77,144,142,221,970,1580,4,6792,377,0,2,5,1,0
23823,11,410,42,7,35,4,0,5,46,1,2,1,2,3,3,2,4,0,2,0,0,2,4,0,0
23824,11,410,11,6,10,0,0,1,11,2,4,2,4,6,6,10,15,1,15,0,0,2,4,0,0
23825,74,1693,996,429,845,24,10,117,1020,7,76,50,88,83,138,494,879,4,3565,198,0,2,68,74,0
23826,74,1693,456,277,329,12,42,72,468,13,85,50,97,98,147,592,972,7,7212,400,0,2,68,74,0
23827,58,1196,207,111,150,11,0,50,218,5,26,19,36,31,55,133,272,3,943,52,0,2,7,1,0
23828,58,1196,410,198,237,31,55,97,441,11,63,38,72,74,110,414,683,6,4293,238,0,2,7,1,0
23829,2,71,167,116,138,4,5,22,171,8,48,30,56,56,86,292,499,4,2330,129,0,0,13,0,0
23830,39,2971,996,429,845,24,10,117,1020,7,76,50,88,83,138,494,879,4,3565,198,0,2,5,3,0
23831,78,1601,757,253,292,73,244,162,830,13,61,38,67,74,105,409,651,7,4654,258,0,2,5,3,0
23832,56,3691,520,294,400,33,13,81,553,10,261,204,367,271,571,2128,4614,7,32445,1802,1,2,17,2,0
23833,78,1601,757,253,292,73,244,162,830,13,61,38,67,74,105,409,651,7,4654,258,0,2,5,3,0
23834,56,3691,520,294,400,33,13,81,553,10,261,204,367,271,571,2128,4614,7,32445,1802,1,2,17,2,0
23835,60,1081,282,196,195,3,0,86,285,8,130,71,141,138,212,936,1507,4,6538,363,0,2,0,17,1
23836,1,90,13,10,10,0,0,3,13,1,2,1,2,3,3,2,4,0,2,0,0,2,1,1,1
23837,7,114,44,19,17,0,16,11,44,3,14,7,14,17,21,58,85,1,128,7,0,2,0,1,1
23838,3,66,127,75,83,2,11,30,129,4,14,7,14,18,21,61,87,2,175,9,0,2,0,1,1
23839,3,66,652,304,544,16,6,88,668,6,89,51,101,95,152,591,998,3,3399,188,0,2,0,1,1
23840,3,66,2,2,2,0,0,0,2,0,0,0,0,0,0,0,0,0,0,0,0,2,0,1,1
23841,3,66,8,5,5,0,0,3,8,0,0,0,0,0,0,0,0,0,0,0,0,2,0,1,1
23842,3,66,2,2,2,0,0,0,2,0,0,0,0,0,0,0,0,0,0,0,0,2,0,1,1
23843,3,66,14,8,8,0,0,6,14,0,0,0,0,0,0,0,0,0,0,0,0,2,0,1,1
23844,3,66,6,4,4,0,0,2,6,0,0,0,0,0,0,0,0,0,0,0,0,2,0,1,1
23845,3,66,6,4,4,0,0,2,6,1,2,1,2,3,3,2,4,0,2,0,0,2,0,1,1
23846,3,66,6,4,4,0,0,2,6,0,0,0,0,0,0,0,0,0,0,0,0,2,0,1,1
23847,3,66,7,5,5,0,0,2,7,0,0,0,0,0,0,0,0,0,0,0,0,2,0,1,1
23848,3,66,6,4,4,0,0,2,6,0,0,0,0,0,0,0,0,0,0,0,0,2,0,1,1
23849,3,66,10,6,6,0,0,4,10,0,0,0,0,0,0,0,0,0,0,0,0,2,0,1,1
23850,3,66,1,1,1,0,0,0,1,0,0,0,0,0,0,0,0,0,0,0,0,2,0,1,1
23851,3,66,1,1,1,0,0,0,1,0,0,0,0,0,0,0,0,0,0,0,0,2,0,1,1
23852,3,66,14,10,10,0,0,4,14,1,1,1,1,2,2,0,2,0,1,0,0,2,0,1,1
23853,3,66,46,26,30,3,0,12,49,3,6,3,6,9,9,20,28,1,42,2,0,2,0,1,1
23854,7,298,72,33,56,0,4,12,72,1,1,1,1,2,2,0,2,0,1,0,0,2,0,1,1
23855,12,229,127,75,83,2,11,30,129,4,14,7,14,18,21,61,87,2,175,9,0,2,0,2,1
23856,12,229,652,304,544,16,6,88,668,6,89,51,101,95,152,591,998,3,3399,188,0,2,0,2,1
23857,12,229,2,2,2,0,0,0,2,0,0,0,0,0,0,0,0,0,0,0,0,2,0,2,1
23858,12,229,8,5,5,0,0,3,8,0,0,0,0,0,0,0,0,0,0,0,0,2,0,2,1
23859,12,229,2,2,2,0,0,0,2,0,0,0,0,0,0,0,0,0,0,0,0,2,0,2,1
23860,12,229,14,8,8,0,0,6,14,0,0,0,0,0,0,0,0,0,0,0,0,2,0,2,1
23861,12,229,6,4,4,0,0,2,6,0,0,0,0,0,0,0,0,0,0,0,0,2,0,2,1
23862,12,229,6,4,4,0,0,2,6,1,2,1,2,3,3,2,4,0,2,0,0,2,0,2,1
23863,12,229,6,4,4,0,0,2,6,0,0,0,0,0,0,0,0,0,0,0,0,2,0,2,1
23864,12,229,7,5,5,0,0,2,7,0,0,0,0,0,0,0,0,0,0,0,0,2,0,2,1
23865,12,229,6,4,4,0,0,2,6,0,0,0,0,0,0,0,0,0,0,0,0,2,0,2,1
23866,12,229,10,6,6,0,0,4,10,0,0,0,0,0,0,0,0,0,0,0,0,2,0,2,1
23867,12,229,1,1,1,0,0,0,1,0,0,0,0,0,0,0,0,0,0,0,0,2,0,2,1
23868,12,229,1,1,1,0,0,0,1,0,0,0,0,0,0,0,0,0,0,0,0,2,0,2,1
23869,12,229,14,10,10,0,0,4,14,1,1,1,1,2,2,0,2,0,1,0,0,2,0,2,1
23870,12,229,46,26,30,3,0,12,49,3,6,3,6,9,9,20,28,1,42,2,0,2,0,2,1
23871,6,71,127,75,83,2,11,30,129,4,14,7,14,18,21,61,87,2,175,9,0,2,0,1,1
23872,6,71,652,304,544,16,6,88,668,6,89,51,101,95,152,591,998,3,3399,188,0,2,0,1,1
23873,6,71,2,2,2,0,0,0,2,0,0,0,0,0,0,0,0,0,0,0,0,2,0,1,1
23874,6,71,8,5,5,0,0,3,8,0,0,0,0,0,0,0,0,0,0,0,0,2,0,1,1
23875,6,71,2,2,2,0,0,0,2,0,0,0,0,0,0,0,0,0,0,0,0,2,0,1,1
23876,6,71,14,8,8,0,0,6,14,0,0,0,0,0,0,0,0,0,0,0,0,2,0,1,1
23877,6,71,6,4,4,0,0,2,6,0,0,0,0,0,0,0,0,0,0,0,0,2,0,1,1
23878,6,71,6,4,4,0,0,2,6,1,2,1,2,3,3,2,4,0,2,0,0,2,0,1,1
23879,6,71,6,4,4,0,0,2,6,0,0,0,0,0,0,0,0,0,0,0,0,2,0,1,1
23880,6,71,7,5,5,0,0,2,7,0,0,0,0,0,0,0,0,0,0,0,0,2,0,1,1
23881,6,71,6,4,4,0,0,2,6,0,0,0,0,0,0,0,0,0,0,0,0,2,0,1,1
23882,6,71,10,6,6,0,0,4,10,0,0,0,0,0,0,0,0,0,0,0,0,2,0,1,1
23883,6,71,1,1,1,0,0,0,1,0,0,0,0,0,0,0,0,0,0,0,0,2,0,1,1
23884,6,71,1,1,1,0,0,0,1,0,0,0,0,0,0,0,0,0,0,0,0,2,0,1,1
23885,6,71,14,10,10,0,0,4,14,1,1,1,1,2,2,0,2,0,1,0,0,2,0,1,1
23886,6,71,46,26,30,3,0,12,49,3,6,3,6,9,9,20,28,1,42,2,0,2,0,1,1
23887,3,26,14,7,7,2,0,5,16,0,0,0,0,0,0,0,0,0,0,0,0,2,0,1,1
23888,213,4619,182,127,129,0,0,53,182,5,39,21,42,44,63,217,343,2,926,51,0,2,20,19,1
23889,213,4619,1165,710,800,67,119,181,1232,18,243,153,282,261,435,2000,3492,10,36473,2026,1,2,20,19,1
23890,83,1808,773,419,590,28,0,166,801,10,204,113,217,214,330,1598,2554,5,13587,754,0,2,4,3,1
23891,83,1808,421,273,302,44,34,57,465,17,81,59,107,98,166,583,1098,11,12329,684,0,2,4,3,1
23892,164,5065,1660,832,1314,41,38,274,1701,20,312,209,395,332,604,2671,5058,12,64042,3557,1,2,1,1,1
23893,164,5065,1057,646,719,113,100,145,1170,18,215,134,248,233,382,1740,3004,10,31186,1732,1,2,1,1,1
23894,89,1830,477,336,357,30,23,73,507,16,194,134,250,210,384,1538,2962,10,30538,1696,0,2,1,1,1
23895,71,1702,996,429,845,24,10,117,1020,7,76,50,88,83,138,494,879,4,3565,198,0,2,1,4,1
23896,71,1702,456,277,329,12,42,72,468,13,85,50,97,98,147,592,972,7,7212,400,0,2,1,4,1
23897,145,3016,1513,682,1277,25,13,200,1538,11,199,116,219,210,335,1557,2584,6,15641,868,0,2,0,2,1
23898,145,3016,819,519,539,24,98,155,843,15,96,57,106,111,163,690,1107,8,9171,509,0,2,0,2,1
23899,58,1174,207,111,150,11,0,50,218,5,26,19,36,31,55,133,272,3,943,52,0,2,5,15,1
23900,58,1174,410,198,237,31,55,97,441,11,63,38,72,74,110,414,683,6,4293,238,0,2,5,15,1
23901,211,4551,2,2,2,0,0,0,2,0,0,0,0,0,0,0,0,0,0,0,0,2,15,10,1
23902,211,4551,99,48,90,1,3,5,100,0,0,0,0,0,0,0,0,0,0,0,0,2,15,10,1
23903,211,4551,8,5,5,2,0,1,10,0,0,0,0,0,0,0,0,0,0,0,0,2,15,10,1
23904,211,4551,1217,716,841,84,126,174,1301,14,185,118,215,199,333,1446,2542,8,20687,1149,0,2,15,10,1
23905,211,4551,160,89,115,0,13,31,160,7,15,11,17,22,28,78,124,3,495,27,0,2,15,10,1
23906,211,4551,10,10,9,9,0,0,19,0,0,0,0,0,0,0,0,0,0,0,0,2,15,10,1
23907,211,4551,173,84,99,8,29,36,181,5,12,7,13,17,20,54,81,2,221,12,0,2,15,10,1
23908,211,4551,3,1,1,3,0,0,6,0,0,0,0,0,0,0,0,0,0,0,0,2,15,10,1
23909,94,1909,463,295,324,28,62,57,491,12,134,82,154,146,236,989,1696,6,11700,650,0,2,3,5,1
23910,51,727,167,116,138,4,5,22,171,8,48,30,56,56,86,292,499,4,2330,129,0,2,0,1,1
23911,28,810,339,213,244,17,9,65,356,10,42,26,48,52,74,259,421,5,2410,133,0,2,4,4,1
23912,85,2161,1455,414,1257,16,76,112,1471,5,41,23,46,46,69,231,381,2,1069,59,0,2,3,12,1
23913,85,2161,669,365,481,22,61,110,691,15,103,63,122,118,185,747,1273,8,11311,628,0,2,3,12,1
23914,236,5392,4293,999,3693,19,54,507,4312,9,155,88,170,164,258,1156,1898,4,9368,520,0,2,6,8,1
23915,236,5392,1482,859,1002,125,135,219,1607,16,219,134,251,235,385,1766,3032,9,27804,1544,1,2,6,8,1
23916,27,959,74,35,59,1,0,14,75,3,14,7,14,17,21,58,85,1,128,7,0,2,1,1,1
23917,27,959,245,125,200,5,7,34,250,7,30,17,34,37,51,166,265,3,1053,58,0,2,1,1,1
23918,98,2661,1523,757,1297,19,12,193,1542,12,193,117,230,205,347,1508,2664,7,19053,1058,0,2,1,6,1
23919,98,2661,701,378,504,33,58,109,734,13,110,68,126,123,194,794,1346,7,10027,557,0,2,1,6,1
23920,86,2225,773,422,505,30,103,129,803,14,77,46,83,91,129,535,839,7,6334,351,0,2,1,3,1
23921,122,2937,77,34,69,0,0,8,77,3,24,16,29,27,45,114,213,1,387,21,0,2,1,1,1
23922,122,2937,712,438,573,51,9,84,763,14,102,71,128,116,199,733,1364,8,11988,666,0,2,1,1,1
23923,30,658,125,97,103,3,0,19,128,9,25,17,27,34,44,144,223,4,1087,60,0,2,0,1,1
23924,82,1776,402,202,227,24,74,80,426,12,52,33,61,64,94,339,564,7,3969,220,0,2,12,8,1
23925,48,992,447,308,343,6,5,95,453,7,96,59,111,103,170,651,1136,4,4600,255,0,2,0,1,1
23926,48,992,322,174,179,16,74,51,338,10,41,26,46,51,72,252,408,5,2291,127,0,2,0,1,1
23927,72,1646,53,23,39,0,0,13,53,2,8,4,8,10,12,26,39,1,39,2,0,2,2,2,1
23928,72,1646,515,298,307,33,80,99,548,12,63,44,77,75,121,419,753,7,5527,307,0,2,2,2,1
23929,20,511,205,80,86,16,53,53,221,7,18,10,19,25,29,94,134,3,497,27,0,2,1,0,1
23930,226,5306,722,423,573,19,0,135,741,12,172,101,199,184,300,1320,2257,6,15668,870,0,2,7,14,1
23931,226,5306,1508,847,911,44,250,301,1552,14,148,88,169,162,257,1120,1886,7,15077,837,0,2,7,14,1
23932,285,6283,72,33,56,0,4,12,72,1,1,1,1,2,2,0,2,0,1,0,0,2,14,15,1
23933,285,6283,1454,835,1044,76,110,219,1530,17,275,158,296,292,454,2297,3718,9,34017,1889,1,2,14,15,1
23934,78,1601,757,253,292,73,244,162,830,13,61,38,67,74,105,409,651,7,4654,258,0,2,2,4,1
23935,46,954,386,256,301,16,9,68,402,4,59,35,69,63,104,355,621,2,1453,80,0,2,1,4,1
23936,46,954,264,131,164,11,41,46,275,6,38,22,40,44,62,214,338,3,1068,59,0,2,1,4,1
23937,30,650,215,129,180,6,0,29,221,8,65,43,72,73,115,415,711,4,3153,175,0,2,0,1,1
23938,30,650,97,69,77,3,3,16,100,6,22,13,23,28,36,113,173,3,542,30,0,2,0,1,1
23939,118,2612,1043,504,840,53,9,147,1096,9,180,112,198,189,310,1377,2344,4,11604,644,0,2,13,8,1
23940,118,2612,383,288,292,26,6,62,409,11,65,38,67,76,105,429,656,5,3719,206,0,2,13,8,1
23941,70,1382,1178,367,1042,6,15,115,1184,9,94,51,95,103,146,644,976,4,4439,246,0,2,5,4,1
23942,70,1382,177,108,140,8,0,27,185,6,30,16,32,36,48,162,248,3,794,44,0,2,5,4,1
23943,209,4552,1943,715,1694,26,18,214,1969,12,185,120,237,197,357,1436,2721,7,20915,1161,0,2,15,12,1
23944,209,4552,1168,838,957,57,25,144,1225,19,348,224,416,367,640,3018,5452,11,61921,3440,1,2,15,12,1
23945,62,1226,1098,241,925,5,10,155,1103,7,46,25,49,53,74,273,423,3,1580,87,0,2,5,7,1
23946,62,1226,282,202,222,14,2,44,296,8,42,24,43,50,67,250,378,4,1548,86,0,2,5,7,1
23947,22,458,601,196,481,2,23,85,603,8,63,36,72,71,108,400,664,4,3036,168,0,2,2,3,1
23948,22,458,156,79,106,5,16,28,161,5,14,8,15,19,23,64,97,2,261,14,0,2,2,3,1
23949,92,3868,1289,550,1043,56,32,155,1345,10,167,93,185,177,278,1266,2075,5,11498,638,0,2,4,7,1
23950,36,1088,182,127,129,0,0,53,182,5,39,21,42,44,63,217,343,2,926,51,0,2,0,8,1
23951,147,6910,1392,870,1177,35,17,170,1427,14,494,280,531,508,811,4473,7289,7,54850,3047,2,2,0,15,1
23952,88,2881,773,419,590,28,0,166,801,10,204,113,217,214,330,1598,2554,5,13587,754,0,2,0,12,1
23953,15,744,75,38,59,1,3,12,76,2,4,2,4,6,6,10,15,1,15,0,0,2,4,4,1
23954,1,136,149,67,118,4,0,27,153,1,17,14,28,18,42,69,175,0,144,8,0,2,2,4,1
23955,31,1986,1157,318,931,29,22,177,1186,6,104,63,125,110,188,712,1274,3,4596,255,0,2,20,15,1
23956,56,3685,520,294,400,33,13,81,553,10,261,204,367,271,571,2128,4614,7,32445,1802,1,2,10,15,1
23957,97,4403,1338,495,1086,10,64,173,1348,11,122,82,157,133,239,883,1686,7,11934,663,0,2,4,11,1
23958,172,7588,139,89,101,2,0,35,141,7,54,34,62,61,96,330,569,4,2287,127,0,2,12,30,1
23959,172,7588,7,5,5,0,0,2,7,1,2,1,2,3,3,2,4,0,2,0,0,2,12,30,1
23960,33,1004,465,148,393,5,8,60,470,4,31,20,31,35,51,161,261,2,523,29,0,2,0,8,1
23961,33,1004,16,12,9,0,0,6,16,1,2,1,2,3,3,2,4,0,2,0,0,2,0,8,1
23962,139,5895,1782,648,1425,9,47,279,1791,8,171,97,189,179,286,1292,2140,4,9462,525,0,2,28,58,1
23963,25,684,256,139,192,9,7,47,265,4,23,12,24,27,36,112,171,2,357,19,0,2,0,5,1
23964,23,578,102,59,69,5,3,24,107,6,22,15,28,28,43,113,206,3,789,43,0,2,0,1,1
23965,111,4174,1450,624,1228,12,26,181,1462,14,306,186,354,320,540,2580,4493,8,36391,2021,1,2,12,25,1
23966,154,4337,1660,832,1314,41,38,274,1701,20,312,209,395,332,604,2671,5058,12,64042,3557,1,2,4,30,1
23967,36,2870,996,429,845,24,10,117,1020,7,76,50,88,83,138,494,879,4,3565,198,0,2,11,16,1
23968,125,5131,1513,682,1277,25,13,200,1538,11,199,116,219,210,335,1557,2584,6,15641,868,0,2,0,6,1
23969,73,3803,1296,573,1062,40,33,157,1336,8,201,118,231,209,349,1561,2689,4,12365,686,0,2,0,11,1
23970,14,341,207,111,150,11,0,50,218,5,26,19,36,31,55,133,272,3,943,52,0,2,0,4,1
23971,84,4438,1457,730,1242,11,6,188,1468,10,292,166,329,302,495,2424,4078,5,22973,1276,1,2,3,14,1
23972,39,2323,652,304,544,16,6,88,668,6,89,51,101,95,152,591,998,3,3399,188,0,2,0,4,1
23973,70,3212,1455,414,1257,16,76,112,1471,5,41,23,46,46,69,231,381,2,1069,59,0,2,0,4,1
23974,95,4652,1523,757,1297,19,12,193,1542,12,193,117,230,205,347,1508,2664,7,19053,1058,0,2,9,16,1
23975,88,3896,1020,354,843,12,15,144,1032,8,134,77,144,142,221,970,1580,4,6792,377,0,2,0,6,1
23976,38,1676,447,308,343,6,5,95,453,7,96,59,111,103,170,651,1136,4,4600,255,0,2,0,4,1
23977,21,658,424,94,331,4,0,89,428,1,5,5,5,6,10,11,25,0,12,0,0,2,0,1,1
23978,38,2302,334,251,279,10,4,40,344,5,127,74,143,132,217,899,1528,2,4303,239,0,2,5,14,1
23979,12,493,184,100,137,2,15,30,186,6,38,20,39,44,59,214,322,3,991,55,0,2,0,3,1
23980,59,2582,1293,570,1093,25,15,163,1318,10,195,123,241,205,364,1516,2795,6,17273,959,0,2,0,4,1
23981,33,1883,384,251,317,7,8,52,391,11,70,44,84,81,128,467,811,6,5355,297,0,2,0,8,1
23982,45,2209,722,423,573,19,0,135,741,12,172,101,199,184,300,1320,2257,6,15668,870,0,2,2,7,1
23983,39,1727,386,256,301,16,9,68,402,4,59,35,69,63,104,355,621,2,1453,80,0,2,0,2,1
23984,82,3157,1043,504,840,53,9,147,1096,9,180,112,198,189,310,1377,2344,4,11604,644,0,2,9,17,1
23985,30,1241,373,158,315,8,0,51,381,5,76,44,79,81,123,486,779,2,2026,112,0,2,0,2,1
23986,77,3213,1178,367,1042,6,15,115,1184,9,94,51,95,103,146,644,976,4,4439,246,0,2,4,7,1
23987,91,4597,1943,715,1694,26,18,214,1969,12,185,120,237,197,357,1436,2721,7,20915,1161,0,2,0,8,1
23988,14,826,442,244,305,14,16,103,456,11,68,45,75,79,120,452,756,6,4588,254,0,2,0,2,1
23989,49,1838,1098,241,925,5,10,155,1103,7,46,25,49,53,74,273,423,3,1580,87,0,2,0,1,1
23990,19,680,601,196,481,2,23,85,603,8,63,36,72,71,108,400,664,4,3036,168,0,2,2,3,1
23991,88,2881,773,419,590,28,0,166,801,10,204,113,217,214,330,1598,2554,5,13587,754,0,2,2,2,0
23992,60,1081,282,196,195,3,0,86,285,8,130,71,141,138,212,936,1507,4,6538,363,0,2,0,17,0
23993,1,90,13,10,10,0,0,3,13,1,2,1,2,3,3,2,4,0,2,0,0,2,1,1,0
23994,7,114,44,19,17,0,16,11,44,3,14,7,14,17,21,58,85,1,128,7,0,2,0,1,0
23995,3,66,127,75,83,2,11,30,129,4,14,7,14,18,21,61,87,2,175,9,0,2,0,1,0
23996,3,66,652,304,544,16,6,88,668,6,89,51,101,95,152,591,998,3,3399,188,0,2,0,1,0
23997,3,66,2,2,2,0,0,0,2,0,0,0,0,0,0,0,0,0,0,0,0,2,0,1,0
23998,3,66,8,5,5,0,0,3,8,0,0,0,0,0,0,0,0,0,0,0,0,2,0,1,0
23999,3,66,2,2,2,0,0,0,2,0,0,0,0,0,0,0,0,0,0,0,0,2,0,1,0
24000,3,66,14,8,8,0,0,6,14,0,0,0,0,0,0,0,0,0,0,0,0,2,0,1,0
24001,3,66,6,4,4,0,0,2,6,0,0,0,0,0,0,0,0,0,0,0,0,2,0,1,0
24002,3,66,6,4,4,0,0,2,6,1,2,1,2,3,3,2,4,0,2,0,0,2,0,1,0
24003,3,66,6,4,4,0,0,2,6,0,0,0,0,0,0,0,0,0,0,0,0,2,0,1,0
24004,3,66,7,5,5,0,0,2,7,0,0,0,0,0,0,0,0,0,0,0,0,2,0,1,0
24005,3,66,6,4,4,0,0,2,6,0,0,0,0,0,0,0,0,0,0,0,0,2,0,1,0
24006,3,66,10,6,6,0,0,4,10,0,0,0,0,0,0,0,0,0,0,0,0,2,0,1,0
24007,3,66,1,1,1,0,0,0,1,0,0,0,0,0,0,0,0,0,0,0,0,2,0,1,0
24008,3,66,1,1,1,0,0,0,1,0,0,0,0,0,0,0,0,0,0,0,0,2,0,1,0
24009,3,66,14,10,10,0,0,4,14,1,1,1,1,2,2,0,2,0,1,0,0,2,0,1,0
24010,3,66,46,26,30,3,0,12,49,3,6,3,6,9,9,20,28,1,42,2,0,2,0,1,0
24011,7,298,72,33,56,0,4,12,72,1,1,1,1,2,2,0,2,0,1,0,0,2,0,1,0
24012,12,229,127,75,83,2,11,30,129,4,14,7,14,18,21,61,87,2,175,9,0,2,0,2,0
24013,12,229,652,304,544,16,6,88,668,6,89,51,101,95,152,591,998,3,3399,188,0,2,0,2,0
24014,12,229,2,2,2,0,0,0,2,0,0,0,0,0,0,0,0,0,0,0,0,2,0,2,0
24015,12,229,8,5,5,0,0,3,8,0,0,0,0,0,0,0,0,0,0,0,0,2,0,2,0
24016,12,229,2,2,2,0,0,0,2,0,0,0,0,0,0,0,0,0,0,0,0,2,0,2,0
24017,12,229,14,8,8,0,0,6,14,0,0,0,0,0,0,0,0,0,0,0,0,2,0,2,0
24018,12,229,6,4,4,0,0,2,6,0,0,0,0,0,0,0,0,0,0,0,0,2,0,2,0
24019,12,229,6,4,4,0,0,2,6,1,2,1,2,3,3,2,4,0,2,0,0,2,0,2,0
24020,12,229,6,4,4,0,0,2,6,0,0,0,0,0,0,0,0,0,0,0,0,2,0,2,0
24021,12,229,7,5,5,0,0,2,7,0,0,0,0,0,0,0,0,0,0,0,0,2,0,2,0
24022,12,229,6,4,4,0,0,2,6,0,0,0,0,0,0,0,0,0,0,0,0,2,0,2,0
24023,12,229,10,6,6,0,0,4,10,0,0,0,0,0,0,0,0,0,0,0,0,2,0,2,0
24024,12,229,1,1,1,0,0,0,1,0,0,0,0,0,0,0,0,0,0,0,0,2,0,2,0
24025,12,229,1,1,1,0,0,0,1,0,0,0,0,0,0,0,0,0,0,0,0,2,0,2,0
24026,12,229,14,10,10,0,0,4,14,1,1,1,1,2,2,0,2,0,1,0,0,2,0,2,0
24027,12,229,46,26,30,3,0,12,49,3,6,3,6,9,9,20,28,1,42,2,0,2,0,2,0
24028,6,71,127,75,83,2,11,30,129,4,14,7,14,18,21,61,87,2,175,9,0,2,0,1,0
24029,6,71,652,304,544,16,6,88,668,6,89,51,101,95,152,591,998,3,3399,188,0,2,0,1,0
24030,6,71,2,2,2,0,0,0,2,0,0,0,0,0,0,0,0,0,0,0,0,2,0,1,0
24031,6,71,8,5,5,0,0,3,8,0,0,0,0,0,0,0,0,0,0,0,0,2,0,1,0
24032,6,71,2,2,2,0,0,0,2,0,0,0,0,0,0,0,0,0,0,0,0,2,0,1,0
24033,6,71,14,8,8,0,0,6,14,0,0,0,0,0,0,0,0,0,0,0,0,2,0,1,0
24034,6,71,6,4,4,0,0,2,6,0,0,0,0,0,0,0,0,0,0,0,0,2,0,1,0
24035,6,71,6,4,4,0,0,2,6,1,2,1,2,3,3,2,4,0,2,0,0,2,0,1,0
24036,6,71,6,4,4,0,0,2,6,0,0,0,0,0,0,0,0,0,0,0,0,2,0,1,0
24037,6,71,7,5,5,0,0,2,7,0,0,0,0,0,0,0,0,0,0,0,0,2,0,1,0
24038,6,71,6,4,4,0,0,2,6,0,0,0,0,0,0,0,0,0,0,0,0,2,0,1,0
24039,6,71,10,6,6,0,0,4,10,0,0,0,0,0,0,0,0,0,0,0,0,2,0,1,0
24040,6,71,1,1,1,0,0,0,1,0,0,0,0,0,0,0,0,0,0,0,0,2,0,1,0
24041,6,71,1,1,1,0,0,0,1,0,0,0,0,0,0,0,0,0,0,0,0,2,0,1,0
24042,6,71,14,10,10,0,0,4,14,1,1,1,1,2,2,0,2,0,1,0,0,2,0,1,0
24043,6,71,46,26,30,3,0,12,49,3,6,3,6,9,9,20,28,1,42,2,0,2,0,1,0
24044,3,26,14,7,7,2,0,5,16,0,0,0,0,0,0,0,0,0,0,0,0,2,0,1,0
24045,213,4619,182,127,129,0,0,53,182,5,39,21,42,44,63,217,343,2,926,51,0,2,20,19,0
24046,213,4619,1165,710,800,67,119,181,1232,18,243,153,282,261,435,2000,3492,10,36473,2026,1,2,20,19,0
24047,83,1808,773,419,590,28,0,166,801,10,204,113,217,214,330,1598,2554,5,13587,754,0,2,4,3,0
24048,83,1808,421,273,302,44,34,57,465,17,81,59,107,98,166,583,1098,11,12329,684,0,2,4,3,0
24049,164,5065,1660,832,1314,41,38,274,1701,20,312,209,395,332,604,2671,5058,12,64042,3557,1,2,1,1,0
24050,164,5065,1057,646,719,113,100,145,1170,18,215,134,248,233,382,1740,3004,10,31186,1732,1,2,1,1,0
24051,89,1830,477,336,357,30,23,73,507,16,194,134,250,210,384,1538,2962,10,30538,1696,0,2,1,1,0
24052,71,1702,996,429,845,24,10,117,1020,7,76,50,88,83,138,494,879,4,3565,198,0,2,1,4,0
24053,71,1702,456,277,329,12,42,72,468,13,85,50,97,98,147,592,972,7,7212,400,0,2,1,4,0
24054,145,3016,1513,682,1277,25,13,200,1538,11,199,116,219,210,335,1557,2584,6,15641,868,0,2,0,2,0
24055,145,3016,819,519,539,24,98,155,843,15,96,57,106,111,163,690,1107,8,9171,509,0,2,0,2,0
24056,58,1174,207,111,150,11,0,50,218,5,26,19,36,31,55,133,272,3,943,52,0,2,5,15,0
24057,58,1174,410,198,237,31,55,97,441,11,63,38,72,74,110,414,683,6,4293,238,0,2,5,15,0
24058,211,4551,2,2,2,0,0,0,2,0,0,0,0,0,0,0,0,0,0,0,0,2,15,10,0
24059,211,4551,99,48,90,1,3,5,100,0,0,0,0,0,0,0,0,0,0,0,0,2,15,10,0
24060,211,4551,8,5,5,2,0,1,10,0,0,0,0,0,0,0,0,0,0,0,0,2,15,10,0
24061,211,4551,1217,716,841,84,126,174,1301,14,185,118,215,199,333,1446,2542,8,20687,1149,0,2,15,10,0
24062,211,4551,160,89,115,0,13,31,160,7,15,11,17,22,28,78,124,3,495,27,0,2,15,10,0
24063,211,4551,10,10,9,9,0,0,19,0,0,0,0,0,0,0,0,0,0,0,0,2,15,10,0
24064,211,4551,173,84,99,8,29,36,181,5,12,7,13,17,20,54,81,2,221,12,0,2,15,10,0
24065,211,4551,3,1,1,3,0,0,6,0,0,0,0,0,0,0,0,0,0,0,0,2,15,10,0
24066,94,1909,463,295,324,28,62,57,491,12,134,82,154,146,236,989,1696,6,11700,650,0,2,3,5,0
24067,51,727,167,116,138,4,5,22,171,8,48,30,56,56,86,292,499,4,2330,129,0,2,0,1,0
24068,28,810,339,213,244,17,9,65,356,10,42,26,48,52,74,259,421,5,2410,133,0,2,4,4,0
24069,85,2161,1455,414,1257,16,76,112,1471,5,41,23,46,46,69,231,381,2,1069,59,0,2,3,12,0
24070,85,2161,669,365,481,22,61,110,691,15,103,63,122,118,185,747,1273,8,11311,628,0,2,3,12,0
24071,236,5392,4293,999,3693,19,54,507,4312,9,155,88,170,164,258,1156,1898,4,9368,520,0,2,6,8,0
24072,236,5392,1482,859,1002,125,135,219,1607,16,219,134,251,235,385,1766,3032,9,27804,1544,1,2,6,8,0
24073,27,959,74,35,59,1,0,14,75,3,14,7,14,17,21,58,85,1,128,7,0,2,1,1,0
24074,27,959,245,125,200,5,7,34,250,7,30,17,34,37,51,166,265,3,1053,58,0,2,1,1,0
24075,98,2661,1523,757,1297,19,12,193,1542,12,193,117,230,205,347,1508,2664,7,19053,1058,0,2,1,6,0
24076,98,2661,701,378,504,33,58,109,734,13,110,68,126,123,194,794,1346,7,10027,557,0,2,1,6,0
24077,86,2225,773,422,505,30,103,129,803,14,77,46,83,91,129,535,839,7,6334,351,0,2,1,3,0
24078,122,2937,77,34,69,0,0,8,77,3,24,16,29,27,45,114,213,1,387,21,0,2,1,1,0
24079,122,2937,712,438,573,51,9,84,763,14,102,71,128,116,199,733,1364,8,11988,666,0,2,1,1,0
24080,30,658,125,97,103,3,0,19,128,9,25,17,27,34,44,144,223,4,1087,60,0,2,0,1,0
24081,82,1776,402,202,227,24,74,80,426,12,52,33,61,64,94,339,564,7,3969,220,0,2,12,8,0
24082,48,992,447,308,343,6,5,95,453,7,96,59,111,103,170,651,1136,4,4600,255,0,2,0,1,0
24083,48,992,322,174,179,16,74,51,338,10,41,26,46,51,72,252,408,5,2291,127,0,2,0,1,0
24084,72,1646,53,23,39,0,0,13,53,2,8,4,8,10,12,26,39,1,39,2,0,2,2,2,0
24085,72,1646,515,298,307,33,80,99,548,12,63,44,77,75,121,419,753,7,5527,307,0,2,2,2,0
24086,20,511,205,80,86,16,53,53,221,7,18,10,19,25,29,94,134,3,497,27,0,2,1,0,0
24087,226,5306,722,423,573,19,0,135,741,12,172,101,199,184,300,1320,2257,6,15668,870,0,2,7,14,0
24088,226,5306,1508,847,911,44,250,301,1552,14,148,88,169,162,257,1120,1886,7,15077,837,0,2,7,14,0
24089,285,6283,72,33,56,0,4,12,72,1,1,1,1,2,2,0,2,0,1,0,0,2,14,15,0
24090,285,6283,1454,835,1044,76,110,219,1530,17,275,158,296,292,454,2297,3718,9,34017,1889,1,2,14,15,0
24091,78,1601,757,253,292,73,244,162,830,13,61,38,67,74,105,409,651,7,4654,258,0,2,2,4,0
24092,46,954,386,256,301,16,9,68,402,4,59,35,69,63,104,355,621,2,1453,80,0,2,1,4,0
24093,46,954,264,131,164,11,41,46,275,6,38,22,40,44,62,214,338,3,1068,59,0,2,1,4,0
24094,30,650,215,129,180,6,0,29,221,8,65,43,72,73,115,415,711,4,3153,175,0,2,0,1,0
24095,30,650,97,69,77,3,3,16,100,6,22,13,23,28,36,113,173,3,542,30,0,2,0,1,0
24096,118,2612,1043,504,840,53,9,147,1096,9,180,112,198,189,310,1377,2344,4,11604,644,0,2,13,8,0
24097,118,2612,383,288,292,26,6,62,409,11,65,38,67,76,105,429,656,5,3719,206,0,2,13,8,0
24098,70,1382,1178,367,1042,6,15,115,1184,9,94,51,95,103,146,644,976,4,4439,246,0,2,5,4,0
24099,70,1382,177,108,140,8,0,27,185,6,30,16,32,36,48,162,248,3,794,44,0,2,5,4,0
24100,209,4552,1943,715,1694,26,18,214,1969,12,185,120,237,197,357,1436,2721,7,20915,1161,0,2,15,12,0
24101,209,4552,1168,838,957,57,25,144,1225,19,348,224,416,367,640,3018,5452,11,61921,3440,1,2,15,12,0
24102,62,1226,1098,241,925,5,10,155,1103,7,46,25,49,53,74,273,423,3,1580,87,0,2,5,7,0
24103,62,1226,282,202,222,14,2,44,296,8,42,24,43,50,67,250,378,4,1548,86,0,2,5,7,0
24104,22,458,601,196,481,2,23,85,603,8,63,36,72,71,108,400,664,4,3036,168,0,2,2,3,0
24105,22,458,156,79,106,5,16,28,161,5,14,8,15,19,23,64,97,2,261,14,0,2,2,3,0
24106,92,3868,1289,550,1043,56,32,155,1345,10,167,93,185,177,278,1266,2075,5,11498,638,0,2,4,7,0
24107,36,1088,182,127,129,0,0,53,182,5,39,21,42,44,63,217,343,2,926,51,0,2,0,8,0
24108,147,6910,1392,870,1177,35,17,170,1427,14,494,280,531,508,811,4473,7289,7,54850,3047,2,2,0,15,0
24109,88,2881,773,419,590,28,0,166,801,10,204,113,217,214,330,1598,2554,5,13587,754,0,2,2,14,0
24110,15,744,75,38,59,1,3,12,76,2,4,2,4,6,6,10,15,1,15,0,0,2,4,4,0
24111,1,136,149,67,118,4,0,27,153,1,17,14,28,18,42,69,175,0,144,8,0,2,2,4,0
24112,31,1986,1157,318,931,29,22,177,1186,6,104,63,125,110,188,712,1274,3,4596,255,0,2,20,15,0
24113,56,3685,520,294,400,33,13,81,553,10,261,204,367,271,571,2128,4614,7,32445,1802,1,2,10,15,0
24114,97,4403,1338,495,1086,10,64,173,1348,11,122,82,157,133,239,883,1686,7,11934,663,0,2,4,11,0
24115,172,7588,139,89,101,2,0,35,141,7,54,34,62,61,96,330,569,4,2287,127,0,2,12,30,0
24116,172,7588,7,5,5,0,0,2,7,1,2,1,2,3,3,2,4,0,2,0,0,2,12,30,0
24117,33,1004,465,148,393,5,8,60,470,4,31,20,31,35,51,161,261,2,523,29,0,2,0,8,0
24118,33,1004,16,12,9,0,0,6,16,1,2,1,2,3,3,2,4,0,2,0,0,2,0,8,0
24119,139,5895,1782,648,1425,9,47,279,1791,8,171,97,189,179,286,1292,2140,4,9462,525,0,2,28,58,0
24120,25,684,256,139,192,9,7,47,265,4,23,12,24,27,36,112,171,2,357,19,0,2,0,5,0
24121,23,578,102,59,69,5,3,24,107,6,22,15,28,28,43,113,206,3,789,43,0,2,0,1,0
24122,111,4174,1450,624,1228,12,26,181,1462,14,306,186,354,320,540,2580,4493,8,36391,2021,1,2,12,25,0
24123,154,4337,1660,832,1314,41,38,274,1701,20,312,209,395,332,604,2671,5058,12,64042,3557,1,2,4,30,0
24124,36,2870,996,429,845,24,10,117,1020,7,76,50,88,83,138,494,879,4,3565,198,0,2,11,16,0
24125,125,5131,1513,682,1277,25,13,200,1538,11,199,116,219,210,335,1557,2584,6,15641,868,0,2,0,6,0
24126,73,3803,1296,573,1062,40,33,157,1336,8,201,118,231,209,349,1561,2689,4,12365,686,0,2,0,11,0
24127,14,341,207,111,150,11,0,50,218,5,26,19,36,31,55,133,272,3,943,52,0,2,0,4,0
24128,84,4438,1457,730,1242,11,6,188,1468,10,292,166,329,302,495,2424,4078,5,22973,1276,1,2,3,14,0
24129,39,2323,652,304,544,16,6,88,668,6,89,51,101,95,152,591,998,3,3399,188,0,2,0,4,0
24130,70,3212,1455,414,1257,16,76,112,1471,5,41,23,46,46,69,231,381,2,1069,59,0,2,0,4,0
24131,95,4652,1523,757,1297,19,12,193,1542,12,193,117,230,205,347,1508,2664,7,19053,1058,0,2,9,16,0
24132,88,3896,1020,354,843,12,15,144,1032,8,134,77,144,142,221,970,1580,4,6792,377,0,2,0,6,0
24133,38,1676,447,308,343,6,5,95,453,7,96,59,111,103,170,651,1136,4,4600,255,0,2,0,4,0
24134,21,658,424,94,331,4,0,89,428,1,5,5,5,6,10,11,25,0,12,0,0,2,0,1,0
24135,38,2302,334,251,279,10,4,40,344,5,127,74,143,132,217,899,1528,2,4303,239,0,2,5,14,0
24136,12,493,184,100,137,2,15,30,186,6,38,20,39,44,59,214,322,3,991,55,0,2,0,3,0
24137,59,2582,1293,570,1093,25,15,163,1318,10,195,123,241,205,364,1516,2795,6,17273,959,0,2,0,4,0
24138,33,1883,384,251,317,7,8,52,391,11,70,44,84,81,128,467,811,6,5355,297,0,2,0,8,0
24139,45,2209,722,423,573,19,0,135,741,12,172,101,199,184,300,1320,2257,6,15668,870,0,2,2,7,0
24140,39,1727,386,256,301,16,9,68,402,4,59,35,69,63,104,355,621,2,1453,80,0,2,0,2,0
24141,82,3157,1043,504,840,53,9,147,1096,9,180,112,198,189,310,1377,2344,4,11604,644,0,2,9,17,0
24142,30,1241,373,158,315,8,0,51,381,5,76,44,79,81,123,486,779,2,2026,112,0,2,0,2,0
24143,77,3213,1178,367,1042,6,15,115,1184,9,94,51,95,103,146,644,976,4,4439,246,0,2,4,7,0
24144,91,4597,1943,715,1694,26,18,214,1969,12,185,120,237,197,357,1436,2721,7,20915,1161,0,2,0,8,0
24145,14,826,442,244,305,14,16,103,456,11,68,45,75,79,120,452,756,6,4588,254,0,2,0,2,0
24146,49,1838,1098,241,925,5,10,155,1103,7,46,25,49,53,74,273,423,3,1580,87,0,2,0,1,0
24147,19,680,601,196,481,2,23,85,603,8,63,36,72,71,108,400,664,4,3036,168,0,2,2,3,0
24148,60,1081,282,196,195,3,0,86,285,8,130,71,141,138,212,936,1507,4,6538,363,0,2,0,17,0
24149,1,90,13,10,10,0,0,3,13,1,2,1,2,3,3,2,4,0,2,0,0,2,1,1,0
24150,7,114,44,19,17,0,16,11,44,3,14,7,14,17,21,58,85,1,128,7,0,2,0,1,0
24151,3,66,127,75,83,2,11,30,129,4,14,7,14,18,21,61,87,2,175,9,0,2,0,1,0
24152,3,66,652,304,544,16,6,88,668,6,89,51,101,95,152,591,998,3,3399,188,0,2,0,1,0
24153,3,66,2,2,2,0,0,0,2,0,0,0,0,0,0,0,0,0,0,0,0,2,0,1,0
24154,3,66,8,5,5,0,0,3,8,0,0,0,0,0,0,0,0,0,0,0,0,2,0,1,0
24155,3,66,2,2,2,0,0,0,2,0,0,0,0,0,0,0,0,0,0,0,0,2,0,1,0
24156,3,66,14,8,8,0,0,6,14,0,0,0,0,0,0,0,0,0,0,0,0,2,0,1,0
24157,3,66,6,4,4,0,0,2,6,0,0,0,0,0,0,0,0,0,0,0,0,2,0,1,0
24158,3,66,6,4,4,0,0,2,6,1,2,1,2,3,3,2,4,0,2,0,0,2,0,1,0
24159,3,66,6,4,4,0,0,2,6,0,0,0,0,0,0,0,0,0,0,0,0,2,0,1,0
24160,3,66,7,5,5,0,0,2,7,0,0,0,0,0,0,0,0,0,0,0,0,2,0,1,0
24161,3,66,6,4,4,0,0,2,6,0,0,0,0,0,0,0,0,0,0,0,0,2,0,1,0
24162,3,66,10,6,6,0,0,4,10,0,0,0,0,0,0,0,0,0,0,0,0,2,0,1,0
24163,3,66,1,1,1,0,0,0,1,0,0,0,0,0,0,0,0,0,0,0,0,2,0,1,0
24164,3,66,1,1,1,0,0,0,1,0,0,0,0,0,0,0,0,0,0,0,0,2,0,1,0
24165,3,66,14,10,10,0,0,4,14,1,1,1,1,2,2,0,2,0,1,0,0,2,0,1,0
24166,3,66,46,26,30,3,0,12,49,3,6,3,6,9,9,20,28,1,42,2,0,2,0,1,0
24167,7,298,72,33,56,0,4,12,72,1,1,1,1,2,2,0,2,0,1,0,0,2,0,1,0
24168,12,229,127,75,83,2,11,30,129,4,14,7,14,18,21,61,87,2,175,9,0,2,0,2,0
24169,12,229,652,304,544,16,6,88,668,6,89,51,101,95,152,591,998,3,3399,188,0,2,0,2,0
24170,12,229,2,2,2,0,0,0,2,0,0,0,0,0,0,0,0,0,0,0,0,2,0,2,0
24171,12,229,8,5,5,0,0,3,8,0,0,0,0,0,0,0,0,0,0,0,0,2,0,2,0
24172,12,229,2,2,2,0,0,0,2,0,0,0,0,0,0,0,0,0,0,0,0,2,0,2,0
24173,12,229,14,8,8,0,0,6,14,0,0,0,0,0,0,0,0,0,0,0,0,2,0,2,0
24174,12,229,6,4,4,0,0,2,6,0,0,0,0,0,0,0,0,0,0,0,0,2,0,2,0
24175,12,229,6,4,4,0,0,2,6,1,2,1,2,3,3,2,4,0,2,0,0,2,0,2,0
24176,12,229,6,4,4,0,0,2,6,0,0,0,0,0,0,0,0,0,0,0,0,2,0,2,0
24177,12,229,7,5,5,0,0,2,7,0,0,0,0,0,0,0,0,0,0,0,0,2,0,2,0
24178,12,229,6,4,4,0,0,2,6,0,0,0,0,0,0,0,0,0,0,0,0,2,0,2,0
24179,12,229,10,6,6,0,0,4,10,0,0,0,0,0,0,0,0,0,0,0,0,2,0,2,0
24180,12,229,1,1,1,0,0,0,1,0,0,0,0,0,0,0,0,0,0,0,0,2,0,2,0
24181,12,229,1,1,1,0,0,0,1,0,0,0,0,0,0,0,0,0,0,0,0,2,0,2,0
24182,12,229,14,10,10,0,0,4,14,1,1,1,1,2,2,0,2,0,1,0,0,2,0,2,0
24183,12,229,46,26,30,3,0,12,49,3,6,3,6,9,9,20,28,1,42,2,0,2,0,2,0
24184,6,71,127,75,83,2,11,30,129,4,14,7,14,18,21,61,87,2,175,9,0,2,0,1,0
24185,6,71,652,304,544,16,6,88,668,6,89,51,101,95,152,591,998,3,3399,188,0,2,0,1,0
24186,6,71,2,2,2,0,0,0,2,0,0,0,0,0,0,0,0,0,0,0,0,2,0,1,0
24187,6,71,8,5,5,0,0,3,8,0,0,0,0,0,0,0,0,0,0,0,0,2,0,1,0
24188,6,71,2,2,2,0,0,0,2,0,0,0,0,0,0,0,0,0,0,0,0,2,0,1,0
24189,6,71,14,8,8,0,0,6,14,0,0,0,0,0,0,0,0,0,0,0,0,2,0,1,0
24190,6,71,6,4,4,0,0,2,6,0,0,0,0,0,0,0,0,0,0,0,0,2,0,1,0
24191,6,71,6,4,4,0,0,2,6,1,2,1,2,3,3,2,4,0,2,0,0,2,0,1,0
24192,6,71,6,4,4,0,0,2,6,0,0,0,0,0,0,0,0,0,0,0,0,2,0,1,0
24193,6,71,7,5,5,0,0,2,7,0,0,0,0,0,0,0,0,0,0,0,0,2,0,1,0
24194,6,71,6,4,4,0,0,2,6,0,0,0,0,0,0,0,0,0,0,0,0,2,0,1,0
24195,6,71,10,6,6,0,0,4,10,0,0,0,0,0,0,0,0,0,0,0,0,2,0,1,0
24196,6,71,1,1,1,0,0,0,1,0,0,0,0,0,0,0,0,0,0,0,0,2,0,1,0
24197,6,71,1,1,1,0,0,0,1,0,0,0,0,0,0,0,0,0,0,0,0,2,0,1,0
24198,6,71,14,10,10,0,0,4,14,1,1,1,1,2,2,0,2,0,1,0,0,2,0,1,0
24199,6,71,46,26,30,3,0,12,49,3,6,3,6,9,9,20,28,1,42,2,0,2,0,1,0
24200,3,26,14,7,7,2,0,5,16,0,0,0,0,0,0,0,0,0,0,0,0,2,0,1,0
24201,11,413,42,7,35,4,0,5,46,1,2,1,2,3,3,2,4,0,2,0,0,2,7,1,0
24202,11,413,11,6,10,0,0,1,11,2,4,2,4,6,6,10,15,1,15,0,0,2,7,1,0
24203,213,4619,182,127,129,0,0,53,182,5,39,21,42,44,63,217,343,2,926,51,0,2,20,19,0
24204,213,4619,1165,710,800,67,119,181,1232,18,243,153,282,261,435,2000,3492,10,36473,2026,1,2,20,19,0
24205,83,1808,773,419,590,28,0,166,801,10,204,113,217,214,330,1598,2554,5,13587,754,0,2,4,3,0
24206,83,1808,421,273,302,44,34,57,465,17,81,59,107,98,166,583,1098,11,12329,684,0,2,4,3,0
24207,164,5065,1660,832,1314,41,38,274,1701,20,312,209,395,332,604,2671,5058,12,64042,3557,1,2,11,1,0
24208,164,5065,1057,646,719,113,100,145,1170,18,215,134,248,233,382,1740,3004,10,31186,1732,1,2,11,1,0
24209,89,1830,477,336,357,30,23,73,507,16,194,134,250,210,384,1538,2962,10,30538,1696,0,2,1,1,0
24210,74,1693,996,429,845,24,10,117,1020,7,76,50,88,83,138,494,879,4,3565,198,0,2,1,4,0
24211,74,1693,456,277,329,12,42,72,468,13,85,50,97,98,147,592,972,7,7212,400,0,2,1,4,0
24212,145,3016,1513,682,1277,25,13,200,1538,11,199,116,219,210,335,1557,2584,6,15641,868,0,2,0,2,0
24213,145,3016,819,519,539,24,98,155,843,15,96,57,106,111,163,690,1107,8,9171,509,0,2,0,2,0
24214,58,1192,207,111,150,11,0,50,218,5,26,19,36,31,55,133,272,3,943,52,0,2,5,15,0
24215,58,1192,410,198,237,31,55,97,441,11,63,38,72,74,110,414,683,6,4293,238,0,2,5,15,0
24216,211,4551,2,2,2,0,0,0,2,0,0,0,0,0,0,0,0,0,0,0,0,3,46,552,0
24217,211,4551,99,48,90,1,3,5,100,0,0,0,0,0,0,0,0,0,0,0,0,3,46,552,0
24218,211,4551,8,5,5,2,0,1,10,0,0,0,0,0,0,0,0,0,0,0,0,3,46,552,0
24219,211,4551,1217,716,841,84,126,174,1301,14,185,118,215,199,333,1446,2542,8,20687,1149,0,3,46,552,0
24220,211,4551,160,89,115,0,13,31,160,7,15,11,17,22,28,78,124,3,495,27,0,3,46,552,0
24221,211,4551,10,10,9,9,0,0,19,0,0,0,0,0,0,0,0,0,0,0,0,3,46,552,0
24222,211,4551,173,84,99,8,29,36,181,5,12,7,13,17,20,54,81,2,221,12,0,3,46,552,0
24223,211,4551,3,1,1,3,0,0,6,0,0,0,0,0,0,0,0,0,0,0,0,3,46,552,0
24224,94,1909,463,295,324,28,62,57,491,12,134,82,154,146,236,989,1696,6,11700,650,0,0,392,0,0
24225,51,727,167,116,138,4,5,22,171,8,48,30,56,56,86,292,499,4,2330,129,0,0,139,0,0
24226,28,810,339,213,244,17,9,65,356,10,42,26,48,52,74,259,421,5,2410,133,0,2,4,4,0
24227,85,2161,1455,414,1257,16,76,112,1471,5,41,23,46,46,69,231,381,2,1069,59,0,2,4,13,0
24228,85,2161,669,365,481,22,61,110,691,15,103,63,122,118,185,747,1273,8,11311,628,0,2,4,13,0
24229,236,5392,4293,999,3693,19,54,507,4312,9,155,88,170,164,258,1156,1898,4,9368,520,0,2,6,8,0
24230,236,5392,1482,859,1002,125,135,219,1607,16,219,134,251,235,385,1766,3032,9,27804,1544,1,2,6,8,0
24231,27,959,74,35,59,1,0,14,75,3,14,7,14,17,21,58,85,1,128,7,0,2,1,1,0
24232,27,959,245,125,200,5,7,34,250,7,30,17,34,37,51,166,265,3,1053,58,0,2,1,1,0
24233,98,2661,1523,757,1297,19,12,193,1542,12,193,117,230,205,347,1508,2664,7,19053,1058,0,2,1,6,0
24234,98,2661,701,378,504,33,58,109,734,13,110,68,126,123,194,794,1346,7,10027,557,0,2,1,6,0
24235,88,2248,773,422,505,30,103,129,803,14,77,46,83,91,129,535,839,7,6334,351,0,2,1,3,0
24236,122,2937,77,34,69,0,0,8,77,3,24,16,29,27,45,114,213,1,387,21,0,2,1,1,0
24237,122,2937,712,438,573,51,9,84,763,14,102,71,128,116,199,733,1364,8,11988,666,0,2,1,1,0
24238,30,658,125,97,103,3,0,19,128,9,25,17,27,34,44,144,223,4,1087,60,0,2,0,1,0
24239,82,1776,402,202,227,24,74,80,426,12,52,33,61,64,94,339,564,7,3969,220,0,2,14,9,0
24240,48,992,447,308,343,6,5,95,453,7,96,59,111,103,170,651,1136,4,4600,255,0,2,0,1,0
24241,48,992,322,174,179,16,74,51,338,10,41,26,46,51,72,252,408,5,2291,127,0,2,0,1,0
24242,73,1667,53,23,39,0,0,13,53,2,8,4,8,10,12,26,39,1,39,2,0,2,2,2,0
24243,73,1667,515,298,307,33,80,99,548,12,63,44,77,75,121,419,753,7,5527,307,0,2,2,2,0
24244,20,511,205,80,86,16,53,53,221,7,18,10,19,25,29,94,134,3,497,27,0,2,1,0,0
24245,226,5306,722,423,573,19,0,135,741,12,172,101,199,184,300,1320,2257,6,15668,870,0,2,7,14,0
24246,226,5306,1508,847,911,44,250,301,1552,14,148,88,169,162,257,1120,1886,7,15077,837,0,2,7,14,0
24247,285,6283,72,33,56,0,4,12,72,1,1,1,1,2,2,0,2,0,1,0,0,2,16,19,0
24248,285,6283,1454,835,1044,76,110,219,1530,17,275,158,296,292,454,2297,3718,9,34017,1889,1,2,16,19,0
24249,78,1601,757,253,292,73,244,162,830,13,61,38,67,74,105,409,651,7,4654,258,0,2,8,8,0
24250,46,954,386,256,301,16,9,68,402,4,59,35,69,63,104,355,621,2,1453,80,0,2,2,5,0
24251,46,954,264,131,164,11,41,46,275,6,38,22,40,44,62,214,338,3,1068,59,0,2,2,5,0
24252,30,650,215,129,180,6,0,29,221,8,65,43,72,73,115,415,711,4,3153,175,0,2,0,1,0
24253,30,650,97,69,77,3,3,16,100,6,22,13,23,28,36,113,173,3,542,30,0,2,0,1,0
24254,118,2612,1043,504,840,53,9,147,1096,9,180,112,198,189,310,1377,2344,4,11604,644,0,2,13,8,0
24255,118,2612,383,288,292,26,6,62,409,11,65,38,67,76,105,429,656,5,3719,206,0,2,13,8,0
24256,70,1382,1178,367,1042,6,15,115,1184,9,94,51,95,103,146,644,976,4,4439,246,0,2,5,4,0
24257,70,1382,177,108,140,8,0,27,185,6,30,16,32,36,48,162,248,3,794,44,0,2,5,4,0
24258,209,4552,1943,715,1694,26,18,214,1969,12,185,120,237,197,357,1436,2721,7,20915,1161,0,2,15,12,0
24259,209,4552,1168,838,957,57,25,144,1225,19,348,224,416,367,640,3018,5452,11,61921,3440,1,2,15,12,0
24260,62,1226,1098,241,925,5,10,155,1103,7,46,25,49,53,74,273,423,3,1580,87,0,2,5,7,0
24261,62,1226,282,202,222,14,2,44,296,8,42,24,43,50,67,250,378,4,1548,86,0,2,5,7,0
24262,22,458,601,196,481,2,23,85,603,8,63,36,72,71,108,400,664,4,3036,168,0,2,2,3,0
24263,22,458,156,79,106,5,16,28,161,5,14,8,15,19,23,64,97,2,261,14,0,2,2,3,0
24264,92,3868,1289,550,1043,56,32,155,1345,10,167,93,185,177,278,1266,2075,5,11498,638,0,2,4,7,0
24265,36,1088,182,127,129,0,0,53,182,5,39,21,42,44,63,217,343,2,926,51,0,2,0,8,0
24266,147,6910,1392,870,1177,35,17,170,1427,14,494,280,531,508,811,4473,7289,7,54850,3047,2,2,0,15,0
24267,88,2881,773,419,590,28,0,166,801,10,204,113,217,214,330,1598,2554,5,13587,754,0,2,2,14,0
24268,15,744,75,38,59,1,3,12,76,2,4,2,4,6,6,10,15,1,15,0,0,2,4,4,0
24269,8,263,51,25,36,0,0,15,51,3,11,6,12,14,18,42,68,1,112,6,0,2,12,15,0
24270,1,136,149,67,118,4,0,27,153,1,17,14,28,18,42,69,175,0,144,8,0,2,2,4,0
24271,31,1986,1157,318,931,29,22,177,1186,6,104,63,125,110,188,712,1274,3,4596,255,0,2,20,15,0
24272,56,3685,520,294,400,33,13,81,553,10,261,204,367,271,571,2128,4614,7,32445,1802,1,2,26,16,0
24273,97,4403,1338,495,1086,10,64,173,1348,11,122,82,157,133,239,883,1686,7,11934,663,0,2,4,11,0
24274,172,7588,139,89,101,2,0,35,141,7,54,34,62,61,96,330,569,4,2287,127,0,2,12,30,0
24275,172,7588,7,5,5,0,0,2,7,1,2,1,2,3,3,2,4,0,2,0,0,2,12,30,0
24276,33,1004,465,148,393,5,8,60,470,4,31,20,31,35,51,161,261,2,523,29,0,2,0,8,0
24277,33,1004,16,12,9,0,0,6,16,1,2,1,2,3,3,2,4,0,2,0,0,2,0,8,0
24278,139,5895,1782,648,1425,9,47,279,1791,8,171,97,189,179,286,1292,2140,4,9462,525,0,2,28,58,0
24279,25,684,256,139,192,9,7,47,265,4,23,12,24,27,36,112,171,2,357,19,0,2,0,5,0
24280,23,578,102,59,69,5,3,24,107,6,22,15,28,28,43,113,206,3,789,43,0,2,0,1,0
24281,111,4174,1450,624,1228,12,26,181,1462,14,306,186,354,320,540,2580,4493,8,36391,2021,1,2,12,25,0
24282,154,4337,1660,832,1314,41,38,274,1701,20,312,209,395,332,604,2671,5058,12,64042,3557,1,2,4,30,0
24283,39,2966,996,429,845,24,10,117,1020,7,76,50,88,83,138,494,879,4,3565,198,0,2,10,16,0
24284,125,5131,1513,682,1277,25,13,200,1538,11,199,116,219,210,335,1557,2584,6,15641,868,0,2,1,7,0
24285,73,3803,1296,573,1062,40,33,157,1336,8,201,118,231,209,349,1561,2689,4,12365,686,0,2,0,11,0
24286,14,341,207,111,150,11,0,50,218,5,26,19,36,31,55,133,272,3,943,52,0,2,0,4,0
24287,84,4438,1457,730,1242,11,6,188,1468,10,292,166,329,302,495,2424,4078,5,22973,1276,1,2,5,20,0
24288,39,2323,652,304,544,16,6,88,668,6,89,51,101,95,152,591,998,3,3399,188,0,2,0,4,0
24289,70,3212,1455,414,1257,16,76,112,1471,5,41,23,46,46,69,231,381,2,1069,59,0,2,16,4,0
24290,95,4652,1523,757,1297,19,12,193,1542,12,193,117,230,205,347,1508,2664,7,19053,1058,0,2,9,16,0
24291,90,3974,1020,354,843,12,15,144,1032,8,134,77,144,142,221,970,1580,4,6792,377,0,2,5,7,0
24292,38,1676,447,308,343,6,5,95,453,7,96,59,111,103,170,651,1136,4,4600,255,0,2,0,4,0
24293,21,658,424,94,331,4,0,89,428,1,5,5,5,6,10,11,25,0,12,0,0,2,0,1,0
24294,38,2302,334,251,279,10,4,40,344,5,127,74,143,132,217,899,1528,2,4303,239,0,2,6,15,0
24295,12,493,184,100,137,2,15,30,186,6,38,20,39,44,59,214,322,3,991,55,0,2,0,3,0
24296,59,2582,1293,570,1093,25,15,163,1318,10,195,123,241,205,364,1516,2795,6,17273,959,0,2,0,4,0
24297,33,1883,384,251,317,7,8,52,391,11,70,44,84,81,128,467,811,6,5355,297,0,2,0,8,0
24298,45,2209,722,423,573,19,0,135,741,12,172,101,199,184,300,1320,2257,6,15668,870,0,2,2,7,0
24299,39,1727,386,256,301,16,9,68,402,4,59,35,69,63,104,355,621,2,1453,80,0,2,0,2,0
24300,82,3157,1043,504,840,53,9,147,1096,9,180,112,198,189,310,1377,2344,4,11604,644,0,2,9,17,0
24301,30,1241,373,158,315,8,0,51,381,5,76,44,79,81,123,486,779,2,2026,112,0,2,0,2,0
24302,77,3213,1178,367,1042,6,15,115,1184,9,94,51,95,103,146,644,976,4,4439,246,0,2,4,7,0
24303,91,4597,1943,715,1694,26,18,214,1969,12,185,120,237,197,357,1436,2721,7,20915,1161,0,2,0,8,0
24304,14,826,442,244,305,14,16,103,456,11,68,45,75,79,120,452,756,6,4588,254,0,2,0,2,0
24305,49,1838,1098,241,925,5,10,155,1103,7,46,25,49,53,74,273,423,3,1580,87,0,2,0,1,0
24306,19,680,601,196,481,2,23,85,603,8,63,36,72,71,108,400,664,4,3036,168,0,2,2,3,0
24307,60,1081,282,196,195,3,0,86,285,8,130,71,141,138,212,936,1507,4,6538,363,0,2,0,17,0
24308,1,90,13,10,10,0,0,3,13,1,2,1,2,3,3,2,4,0,2,0,0,2,1,1,0
24309,7,114,44,19,17,0,16,11,44,3,14,7,14,17,21,58,85,1,128,7,0,2,0,1,0
24310,3,66,127,75,83,2,11,30,129,4,14,7,14,18,21,61,87,2,175,9,0,2,0,1,0
24311,3,66,652,304,544,16,6,88,668,6,89,51,101,95,152,591,998,3,3399,188,0,2,0,1,0
24312,3,66,2,2,2,0,0,0,2,0,0,0,0,0,0,0,0,0,0,0,0,2,0,1,0
24313,3,66,8,5,5,0,0,3,8,0,0,0,0,0,0,0,0,0,0,0,0,2,0,1,0
24314,3,66,2,2,2,0,0,0,2,0,0,0,0,0,0,0,0,0,0,0,0,2,0,1,0
24315,3,66,14,8,8,0,0,6,14,0,0,0,0,0,0,0,0,0,0,0,0,2,0,1,0
24316,3,66,6,4,4,0,0,2,6,0,0,0,0,0,0,0,0,0,0,0,0,2,0,1,0
24317,3,66,6,4,4,0,0,2,6,1,2,1,2,3,3,2,4,0,2,0,0,2,0,1,0
24318,3,66,6,4,4,0,0,2,6,0,0,0,0,0,0,0,0,0,0,0,0,2,0,1,0
24319,3,66,7,5,5,0,0,2,7,0,0,0,0,0,0,0,0,0,0,0,0,2,0,1,0
24320,3,66,6,4,4,0,0,2,6,0,0,0,0,0,0,0,0,0,0,0,0,2,0,1,0
24321,3,66,10,6,6,0,0,4,10,0,0,0,0,0,0,0,0,0,0,0,0,2,0,1,0
24322,3,66,1,1,1,0,0,0,1,0,0,0,0,0,0,0,0,0,0,0,0,2,0,1,0
24323,3,66,1,1,1,0,0,0,1,0,0,0,0,0,0,0,0,0,0,0,0,2,0,1,0
24324,3,66,14,10,10,0,0,4,14,1,1,1,1,2,2,0,2,0,1,0,0,2,0,1,0
24325,3,66,46,26,30,3,0,12,49,3,6,3,6,9,9,20,28,1,42,2,0,2,0,1,0
24326,7,298,72,33,56,0,4,12,72,1,1,1,1,2,2,0,2,0,1,0,0,2,0,1,0
24327,12,229,127,75,83,2,11,30,129,4,14,7,14,18,21,61,87,2,175,9,0,2,0,2,0
24328,12,229,652,304,544,16,6,88,668,6,89,51,101,95,152,591,998,3,3399,188,0,2,0,2,0
24329,12,229,2,2,2,0,0,0,2,0,0,0,0,0,0,0,0,0,0,0,0,2,0,2,0
24330,12,229,8,5,5,0,0,3,8,0,0,0,0,0,0,0,0,0,0,0,0,2,0,2,0
24331,12,229,2,2,2,0,0,0,2,0,0,0,0,0,0,0,0,0,0,0,0,2,0,2,0
24332,12,229,14,8,8,0,0,6,14,0,0,0,0,0,0,0,0,0,0,0,0,2,0,2,0
24333,12,229,6,4,4,0,0,2,6,0,0,0,0,0,0,0,0,0,0,0,0,2,0,2,0
24334,12,229,6,4,4,0,0,2,6,1,2,1,2,3,3,2,4,0,2,0,0,2,0,2,0
24335,12,229,6,4,4,0,0,2,6,0,0,0,0,0,0,0,0,0,0,0,0,2,0,2,0
24336,12,229,7,5,5,0,0,2,7,0,0,0,0,0,0,0,0,0,0,0,0,2,0,2,0
24337,12,229,6,4,4,0,0,2,6,0,0,0,0,0,0,0,0,0,0,0,0,2,0,2,0
24338,12,229,10,6,6,0,0,4,10,0,0,0,0,0,0,0,0,0,0,0,0,2,0,2,0
24339,12,229,1,1,1,0,0,0,1,0,0,0,0,0,0,0,0,0,0,0,0,2,0,2,0
24340,12,229,1,1,1,0,0,0,1,0,0,0,0,0,0,0,0,0,0,0,0,2,0,2,0
24341,12,229,14,10,10,0,0,4,14,1,1,1,1,2,2,0,2,0,1,0,0,2,0,2,0
24342,12,229,46,26,30,3,0,12,49,3,6,3,6,9,9,20,28,1,42,2,0,2,0,2,0
24343,6,71,127,75,83,2,11,30,129,4,14,7,14,18,21,61,87,2,175,9,0,2,0,1,0
24344,6,71,652,304,544,16,6,88,668,6,89,51,101,95,152,591,998,3,3399,188,0,2,0,1,0
24345,6,71,2,2,2,0,0,0,2,0,0,0,0,0,0,0,0,0,0,0,0,2,0,1,0
24346,6,71,8,5,5,0,0,3,8,0,0,0,0,0,0,0,0,0,0,0,0,2,0,1,0
24347,6,71,2,2,2,0,0,0,2,0,0,0,0,0,0,0,0,0,0,0,0,2,0,1,0
24348,6,71,14,8,8,0,0,6,14,0,0,0,0,0,0,0,0,0,0,0,0,2,0,1,0
24349,6,71,6,4,4,0,0,2,6,0,0,0,0,0,0,0,0,0,0,0,0,2,0,1,0
24350,6,71,6,4,4,0,0,2,6,1,2,1,2,3,3,2,4,0,2,0,0,2,0,1,0
24351,6,71,6,4,4,0,0,2,6,0,0,0,0,0,0,0,0,0,0,0,0,2,0,1,0
24352,6,71,7,5,5,0,0,2,7,0,0,0,0,0,0,0,0,0,0,0,0,2,0,1,0
24353,6,71,6,4,4,0,0,2,6,0,0,0,0,0,0,0,0,0,0,0,0,2,0,1,0
24354,6,71,10,6,6,0,0,4,10,0,0,0,0,0,0,0,0,0,0,0,0,2,0,1,0
24355,6,71,1,1,1,0,0,0,1,0,0,0,0,0,0,0,0,0,0,0,0,2,0,1,0
24356,6,71,1,1,1,0,0,0,1,0,0,0,0,0,0,0,0,0,0,0,0,2,0,1,0
24357,6,71,14,10,10,0,0,4,14,1,1,1,1,2,2,0,2,0,1,0,0,2,0,1,0
24358,6,71,46,26,30,3,0,12,49,3,6,3,6,9,9,20,28,1,42,2,0,2,0,1,0
24359,3,26,14,7,7,2,0,5,16,0,0,0,0,0,0,0,0,0,0,0,0,2,0,1,0
24360,11,413,42,7,35,4,0,5,46,1,2,1,2,3,3,2,4,0,2,0,0,2,7,1,0
24361,11,413,11,6,10,0,0,1,11,2,4,2,4,6,6,10,15,1,15,0,0,2,7,1,0
24362,213,4619,182,127,129,0,0,53,182,5,39,21,42,44,63,217,343,2,926,51,0,2,20,19,0
24363,213,4619,1165,710,800,67,119,181,1232,18,243,153,282,261,435,2000,3492,10,36473,2026,1,2,20,19,0
24364,83,1808,773,419,590,28,0,166,801,10,204,113,217,214,330,1598,2554,5,13587,754,0,2,4,3,0
24365,83,1808,421,273,302,44,34,57,465,17,81,59,107,98,166,583,1098,11,12329,684,0,2,4,3,0
24366,164,5065,1660,832,1314,41,38,274,1701,20,312,209,395,332,604,2671,5058,12,64042,3557,1,2,11,1,0
24367,164,5065,1057,646,719,113,100,145,1170,18,215,134,248,233,382,1740,3004,10,31186,1732,1,2,11,1,0
24368,89,1830,477,336,357,30,23,73,507,16,194,134,250,210,384,1538,2962,10,30538,1696,0,2,1,1,0
24369,74,1693,996,429,845,24,10,117,1020,7,76,50,88,83,138,494,879,4,3565,198,0,2,1,4,0
24370,74,1693,456,277,329,12,42,72,468,13,85,50,97,98,147,592,972,7,7212,400,0,2,1,4,0
24371,145,3016,1513,682,1277,25,13,200,1538,11,199,116,219,210,335,1557,2584,6,15641,868,0,2,0,2,0
24372,145,3016,819,519,539,24,98,155,843,15,96,57,106,111,163,690,1107,8,9171,509,0,2,0,2,0
24373,58,1192,207,111,150,11,0,50,218,5,26,19,36,31,55,133,272,3,943,52,0,2,5,15,0
24374,58,1192,410,198,237,31,55,97,441,11,63,38,72,74,110,414,683,6,4293,238,0,2,5,15,0
24375,211,4551,2,2,2,0,0,0,2,0,0,0,0,0,0,0,0,0,0,0,0,3,46,552,0
24376,211,4551,99,48,90,1,3,5,100,0,0,0,0,0,0,0,0,0,0,0,0,3,46,552,0
24377,211,4551,8,5,5,2,0,1,10,0,0,0,0,0,0,0,0,0,0,0,0,3,46,552,0
24378,211,4551,1217,716,841,84,126,174,1301,14,185,118,215,199,333,1446,2542,8,20687,1149,0,3,46,552,0
24379,211,4551,160,89,115,0,13,31,160,7,15,11,17,22,28,78,124,3,495,27,0,3,46,552,0
24380,211,4551,10,10,9,9,0,0,19,0,0,0,0,0,0,0,0,0,0,0,0,3,46,552,0
24381,211,4551,173,84,99,8,29,36,181,5,12,7,13,17,20,54,81,2,221,12,0,3,46,552,0
24382,211,4551,3,1,1,3,0,0,6,0,0,0,0,0,0,0,0,0,0,0,0,3,46,552,0
24383,94,1909,463,295,324,28,62,57,491,12,134,82,154,146,236,989,1696,6,11700,650,0,0,392,0,0
24384,51,727,167,116,138,4,5,22,171,8,48,30,56,56,86,292,499,4,2330,129,0,0,139,0,0
24385,28,810,339,213,244,17,9,65,356,10,42,26,48,52,74,259,421,5,2410,133,0,2,4,4,0
24386,85,2161,1455,414,1257,16,76,112,1471,5,41,23,46,46,69,231,381,2,1069,59,0,2,4,13,0
24387,85,2161,669,365,481,22,61,110,691,15,103,63,122,118,185,747,1273,8,11311,628,0,2,4,13,0
24388,236,5392,4293,999,3693,19,54,507,4312,9,155,88,170,164,258,1156,1898,4,9368,520,0,2,6,8,0
24389,236,5392,1482,859,1002,125,135,219,1607,16,219,134,251,235,385,1766,3032,9,27804,1544,1,2,6,8,0
24390,27,959,74,35,59,1,0,14,75,3,14,7,14,17,21,58,85,1,128,7,0,2,1,1,0
24391,27,959,245,125,200,5,7,34,250,7,30,17,34,37,51,166,265,3,1053,58,0,2,1,1,0
24392,98,2661,1523,757,1297,19,12,193,1542,12,193,117,230,205,347,1508,2664,7,19053,1058,0,2,1,6,0
24393,98,2661,701,378,504,33,58,109,734,13,110,68,126,123,194,794,1346,7,10027,557,0,2,1,6,0
24394,88,2248,773,422,505,30,103,129,803,14,77,46,83,91,129,535,839,7,6334,351,0,2,1,3,0
24395,122,2937,77,34,69,0,0,8,77,3,24,16,29,27,45,114,213,1,387,21,0,2,1,1,0
24396,122,2937,712,438,573,51,9,84,763,14,102,71,128,116,199,733,1364,8,11988,666,0,2,1,1,0
24397,30,658,125,97,103,3,0,19,128,9,25,17,27,34,44,144,223,4,1087,60,0,2,0,1,0
24398,82,1776,402,202,227,24,74,80,426,12,52,33,61,64,94,339,564,7,3969,220,0,2,14,9,0
24399,48,992,447,308,343,6,5,95,453,7,96,59,111,103,170,651,1136,4,4600,255,0,2,0,1,0
24400,48,992,322,174,179,16,74,51,338,10,41,26,46,51,72,252,408,5,2291,127,0,2,0,1,0
24401,73,1667,53,23,39,0,0,13,53,2,8,4,8,10,12,26,39,1,39,2,0,2,2,2,0
24402,73,1667,515,298,307,33,80,99,548,12,63,44,77,75,121,419,753,7,5527,307,0,2,2,2,0
24403,20,511,205,80,86,16,53,53,221,7,18,10,19,25,29,94,134,3,497,27,0,2,1,0,0
24404,226,5306,722,423,573,19,0,135,741,12,172,101,199,184,300,1320,2257,6,15668,870,0,2,7,14,0
24405,226,5306,1508,847,911,44,250,301,1552,14,148,88,169,162,257,1120,1886,7,15077,837,0,2,7,14,0
24406,285,6283,72,33,56,0,4,12,72,1,1,1,1,2,2,0,2,0,1,0,0,2,16,19,0
24407,285,6283,1454,835,1044,76,110,219,1530,17,275,158,296,292,454,2297,3718,9,34017,1889,1,2,16,19,0
24408,78,1601,757,253,292,73,244,162,830,13,61,38,67,74,105,409,651,7,4654,258,0,2,8,8,0
24409,46,954,386,256,301,16,9,68,402,4,59,35,69,63,104,355,621,2,1453,80,0,2,2,5,0
24410,46,954,264,131,164,11,41,46,275,6,38,22,40,44,62,214,338,3,1068,59,0,2,2,5,0
24411,30,650,215,129,180,6,0,29,221,8,65,43,72,73,115,415,711,4,3153,175,0,2,0,1,0
24412,30,650,97,69,77,3,3,16,100,6,22,13,23,28,36,113,173,3,542,30,0,2,0,1,0
24413,118,2612,1043,504,840,53,9,147,1096,9,180,112,198,189,310,1377,2344,4,11604,644,0,2,13,8,0
24414,118,2612,383,288,292,26,6,62,409,11,65,38,67,76,105,429,656,5,3719,206,0,2,13,8,0
24415,70,1382,1178,367,1042,6,15,115,1184,9,94,51,95,103,146,644,976,4,4439,246,0,2,5,4,0
24416,70,1382,177,108,140,8,0,27,185,6,30,16,32,36,48,162,248,3,794,44,0,2,5,4,0
24417,209,4552,1943,715,1694,26,18,214,1969,12,185,120,237,197,357,1436,2721,7,20915,1161,0,2,15,12,0
24418,209,4552,1168,838,957,57,25,144,1225,19,348,224,416,367,640,3018,5452,11,61921,3440,1,2,15,12,0
24419,62,1226,1098,241,925,5,10,155,1103,7,46,25,49,53,74,273,423,3,1580,87,0,2,5,7,0
24420,62,1226,282,202,222,14,2,44,296,8,42,24,43,50,67,250,378,4,1548,86,0,2,5,7,0
24421,22,458,601,196,481,2,23,85,603,8,63,36,72,71,108,400,664,4,3036,168,0,2,2,3,0
24422,22,458,156,79,106,5,16,28,161,5,14,8,15,19,23,64,97,2,261,14,0,2,2,3,0
24423,92,3868,1289,550,1043,56,32,155,1345,10,167,93,185,177,278,1266,2075,5,11498,638,0,2,4,7,0
24424,36,1088,182,127,129,0,0,53,182,5,39,21,42,44,63,217,343,2,926,51,0,2,0,8,0
24425,147,6910,1392,870,1177,35,17,170,1427,14,494,280,531,508,811,4473,7289,7,54850,3047,2,2,0,15,0
24426,88,2881,773,419,590,28,0,166,801,10,204,113,217,214,330,1598,2554,5,13587,754,0,2,2,14,0
24427,15,744,75,38,59,1,3,12,76,2,4,2,4,6,6,10,15,1,15,0,0,2,4,4,0
24428,8,263,51,25,36,0,0,15,51,3,11,6,12,14,18,42,68,1,112,6,0,2,12,15,0
24429,1,136,149,67,118,4,0,27,153,1,17,14,28,18,42,69,175,0,144,8,0,2,2,4,0
24430,31,1986,1157,318,931,29,22,177,1186,6,104,63,125,110,188,712,1274,3,4596,255,0,2,20,15,0
24431,56,3685,520,294,400,33,13,81,553,10,261,204,367,271,571,2128,4614,7,32445,1802,1,2,26,16,0
24432,97,4403,1338,495,1086,10,64,173,1348,11,122,82,157,133,239,883,1686,7,11934,663,0,2,4,11,0
24433,172,7588,139,89,101,2,0,35,141,7,54,34,62,61,96,330,569,4,2287,127,0,2,12,30,0
24434,172,7588,7,5,5,0,0,2,7,1,2,1,2,3,3,2,4,0,2,0,0,2,12,30,0
24435,33,1004,465,148,393,5,8,60,470,4,31,20,31,35,51,161,261,2,523,29,0,2,0,8,0
24436,33,1004,16,12,9,0,0,6,16,1,2,1,2,3,3,2,4,0,2,0,0,2,0,8,0
24437,139,5895,1782,648,1425,9,47,279,1791,8,171,97,189,179,286,1292,2140,4,9462,525,0,2,28,58,0
24438,25,684,256,139,192,9,7,47,265,4,23,12,24,27,36,112,171,2,357,19,0,2,0,5,0
24439,23,578,102,59,69,5,3,24,107,6,22,15,28,28,43,113,206,3,789,43,0,2,0,1,0
24440,111,4174,1450,624,1228,12,26,181,1462,14,306,186,354,320,540,2580,4493,8,36391,2021,1,2,12,25,0
24441,154,4337,1660,832,1314,41,38,274,1701,20,312,209,395,332,604,2671,5058,12,64042,3557,1,2,4,30,0
24442,39,2966,996,429,845,24,10,117,1020,7,76,50,88,83,138,494,879,4,3565,198,0,2,10,16,0
24443,125,5131,1513,682,1277,25,13,200,1538,11,199,116,219,210,335,1557,2584,6,15641,868,0,2,1,7,0
24444,73,3803,1296,573,1062,40,33,157,1336,8,201,118,231,209,349,1561,2689,4,12365,686,0,2,0,11,0
24445,14,341,207,111,150,11,0,50,218,5,26,19,36,31,55,133,272,3,943,52,0,2,0,4,0
24446,84,4438,1457,730,1242,11,6,188,1468,10,292,166,329,302,495,2424,4078,5,22973,1276,1,2,5,20,0
24447,39,2323,652,304,544,16,6,88,668,6,89,51,101,95,152,591,998,3,3399,188,0,2,0,4,0
24448,70,3212,1455,414,1257,16,76,112,1471,5,41,23,46,46,69,231,381,2,1069,59,0,2,16,4,0
24449,95,4652,1523,757,1297,19,12,193,1542,12,193,117,230,205,347,1508,2664,7,19053,1058,0,2,9,16,0
24450,90,3974,1020,354,843,12,15,144,1032,8,134,77,144,142,221,970,1580,4,6792,377,0,2,5,7,0
24451,38,1676,447,308,343,6,5,95,453,7,96,59,111,103,170,651,1136,4,4600,255,0,2,0,4,0
24452,21,658,424,94,331,4,0,89,428,1,5,5,5,6,10,11,25,0,12,0,0,2,0,1,0
24453,38,2302,334,251,279,10,4,40,344,5,127,74,143,132,217,899,1528,2,4303,239,0,2,6,15,0
24454,12,493,184,100,137,2,15,30,186,6,38,20,39,44,59,214,322,3,991,55,0,2,0,3,0
24455,59,2582,1293,570,1093,25,15,163,1318,10,195,123,241,205,364,1516,2795,6,17273,959,0,2,0,4,0
24456,33,1883,384,251,317,7,8,52,391,11,70,44,84,81,128,467,811,6,5355,297,0,2,0,8,0
24457,45,2209,722,423,573,19,0,135,741,12,172,101,199,184,300,1320,2257,6,15668,870,0,2,2,7,0
24458,39,1727,386,256,301,16,9,68,402,4,59,35,69,63,104,355,621,2,1453,80,0,2,0,2,0
24459,82,3157,1043,504,840,53,9,147,1096,9,180,112,198,189,310,1377,2344,4,11604,644,0,2,9,17,0
24460,30,1241,373,158,315,8,0,51,381,5,76,44,79,81,123,486,779,2,2026,112,0,2,0,2,0
24461,77,3213,1178,367,1042,6,15,115,1184,9,94,51,95,103,146,644,976,4,4439,246,0,2,4,7,0
24462,91,4597,1943,715,1694,26,18,214,1969,12,185,120,237,197,357,1436,2721,7,20915,1161,0,2,0,8,0
24463,14,826,442,244,305,14,16,103,456,11,68,45,75,79,120,452,756,6,4588,254,0,2,0,2,0
24464,49,1838,1098,241,925,5,10,155,1103,7,46,25,49,53,74,273,423,3,1580,87,0,2,0,1,0
24465,19,680,601,196,481,2,23,85,603,8,63,36,72,71,108,400,664,4,3036,168,0,2,2,3,0
24466,89,3932,1020,354,843,12,15,144,1032,8,134,77,144,142,221,970,1580,4,6792,377,0,2,38,0,0
24467,89,3941,1020,354,843,12,15,144,1032,8,134,77,144,142,221,970,1580,4,6792,377,0,2,2,1,1
24468,83,1787,402,202,227,24,74,80,426,12,52,33,61,64,94,339,564,7,3969,220,0,2,4,1,1
24469,285,6294,72,33,56,0,4,12,72,1,1,1,1,2,2,0,2,0,1,0,0,2,7,3,1
24470,285,6294,1454,835,1044,76,110,219,1530,17,275,158,296,292,454,2297,3718,9,34017,1889,1,2,7,3,1
24471,89,3941,1020,354,843,12,15,144,1032,8,134,77,144,142,221,970,1580,4,6792,377,0,2,1,1,1
24472,83,1788,402,202,227,24,74,80,426,12,52,33,61,64,94,339,564,7,3969,220,0,2,6,0,0
24473,28,699,466,257,367,18,25,50,484,7,126,86,171,133,257,898,1813,4,8612,478,0,0,192,0,1
24474,28,699,507,281,342,29,59,88,536,10,53,29,57,63,86,336,514,5,2764,153,0,0,192,0,1
24475,97,2135,1043,504,840,53,9,147,1096,9,180,112,198,189,310,1377,2344,4,11604,644,0,2,37,189,1
24476,97,2135,383,288,292,26,6,62,409,11,65,38,67,76,105,429,656,5,3719,206,0,2,37,189,1
24477,95,4640,1523,757,1297,19,12,193,1542,12,193,117,230,205,347,1508,2664,7,19053,1058,0,2,2,3,1
24478,82,3159,1043,504,840,53,9,147,1096,9,180,112,198,189,310,1377,2344,4,11604,644,0,2,5,5,1
24479,28,702,466,257,367,18,25,50,484,7,126,86,171,133,257,898,1813,4,8612,478,0,2,10,6,0
24480,28,702,507,281,342,29,59,88,536,10,53,29,57,63,86,336,514,5,2764,153,0,2,10,6,0
24481,90,1927,1043,504,840,53,9,147,1096,9,180,112,198,189,310,1377,2344,4,11604,644,0,2,0,40,0
24482,90,1927,383,288,292,26,6,62,409,11,65,38,67,76,105,429,656,5,3719,206,0,2,0,40,0
24483,227,5367,722,423,573,19,0,135,741,12,172,101,199,184,300,1320,2257,6,15668,870,0,2,9,0,1
24484,227,5367,1508,847,911,44,250,301,1552,14,148,88,169,162,257,1120,1886,7,15077,837,0,2,9,0,1
24485,229,5396,722,423,573,19,0,135,741,12,172,101,199,184,300,1320,2257,6,15668,870,0,2,4,1,1
24486,229,5396,1508,847,911,44,250,301,1552,14,148,88,169,162,257,1120,1886,7,15077,837,0,2,4,1,1
24487,92,3868,1289,550,1043,56,32,155,1345,10,167,93,185,177,278,1266,2075,5,11498,638,0,2,2,19,1
24488,1,15,127,75,83,2,11,30,129,4,14,7,14,18,21,61,87,2,175,9,0,0,4,0,1
24489,1,15,652,304,544,16,6,88,668,6,89,51,101,95,152,591,998,3,3399,188,0,0,4,0,1
24490,1,15,2,2,2,0,0,0,2,0,0,0,0,0,0,0,0,0,0,0,0,0,4,0,1
24491,1,15,8,5,5,0,0,3,8,0,0,0,0,0,0,0,0,0,0,0,0,0,4,0,1
24492,1,15,2,2,2,0,0,0,2,0,0,0,0,0,0,0,0,0,0,0,0,0,4,0,1
24493,1,15,14,8,8,0,0,6,14,0,0,0,0,0,0,0,0,0,0,0,0,0,4,0,1
24494,1,15,6,4,4,0,0,2,6,0,0,0,0,0,0,0,0,0,0,0,0,0,4,0,1
24495,1,15,6,4,4,0,0,2,6,1,2,1,2,3,3,2,4,0,2,0,0,0,4,0,1
24496,1,15,6,4,4,0,0,2,6,0,0,0,0,0,0,0,0,0,0,0,0,0,4,0,1
24497,1,15,7,5,5,0,0,2,7,0,0,0,0,0,0,0,0,0,0,0,0,0,4,0,1
24498,1,15,6,4,4,0,0,2,6,0,0,0,0,0,0,0,0,0,0,0,0,0,4,0,1
24499,1,15,10,6,6,0,0,4,10,0,0,0,0,0,0,0,0,0,0,0,0,0,4,0,1
24500,1,15,1,1,1,0,0,0,1,0,0,0,0,0,0,0,0,0,0,0,0,0,4,0,1
24501,1,15,1,1,1,0,0,0,1,0,0,0,0,0,0,0,0,0,0,0,0,0,4,0,1
24502,1,15,14,10,10,0,0,4,14,1,1,1,1,2,2,0,2,0,1,0,0,0,4,0,1
24503,1,15,46,26,30,3,0,12,49,3,6,3,6,9,9,20,28,1,42,2,0,0,4,0,1
24504,2,51,127,75,83,2,11,30,129,4,14,7,14,18,21,61,87,2,175,9,0,0,14,0,1
24505,2,51,652,304,544,16,6,88,668,6,89,51,101,95,152,591,998,3,3399,188,0,0,14,0,1
24506,2,51,2,2,2,0,0,0,2,0,0,0,0,0,0,0,0,0,0,0,0,0,14,0,1
24507,2,51,8,5,5,0,0,3,8,0,0,0,0,0,0,0,0,0,0,0,0,0,14,0,1
24508,2,51,2,2,2,0,0,0,2,0,0,0,0,0,0,0,0,0,0,0,0,0,14,0,1
24509,2,51,14,8,8,0,0,6,14,0,0,0,0,0,0,0,0,0,0,0,0,0,14,0,1
24510,2,51,6,4,4,0,0,2,6,0,0,0,0,0,0,0,0,0,0,0,0,0,14,0,1
24511,2,51,6,4,4,0,0,2,6,1,2,1,2,3,3,2,4,0,2,0,0,0,14,0,1
24512,2,51,6,4,4,0,0,2,6,0,0,0,0,0,0,0,0,0,0,0,0,0,14,0,1
24513,2,51,7,5,5,0,0,2,7,0,0,0,0,0,0,0,0,0,0,0,0,0,14,0,1
24514,2,51,6,4,4,0,0,2,6,0,0,0,0,0,0,0,0,0,0,0,0,0,14,0,1
24515,2,51,10,6,6,0,0,4,10,0,0,0,0,0,0,0,0,0,0,0,0,0,14,0,1
24516,2,51,1,1,1,0,0,0,1,0,0,0,0,0,0,0,0,0,0,0,0,0,14,0,1
24517,2,51,1,1,1,0,0,0,1,0,0,0,0,0,0,0,0,0,0,0,0,0,14,0,1
24518,2,51,14,10,10,0,0,4,14,1,1,1,1,2,2,0,2,0,1,0,0,0,14,0,1
24519,2,51,46,26,30,3,0,12,49,3,6,3,6,9,9,20,28,1,42,2,0,0,14,0,1
24520,1,6,2,2,2,0,0,0,2,0,0,0,0,0,0,0,0,0,0,0,0,0,2,0,1
24521,1,18,3,3,3,0,0,0,3,0,0,0,0,0,0,0,0,0,0,0,0,0,3,0,1
24522,83,1788,402,202,227,24,74,80,426,12,52,33,61,64,94,339,564,7,3969,220,0,2,10,1,0
24523,285,6294,72,33,56,0,4,12,72,1,1,1,1,2,2,0,2,0,1,0,0,2,7,3,0
24524,285,6294,1454,835,1044,76,110,219,1530,17,275,158,296,292,454,2297,3718,9,34017,1889,1,2,7,3,0
24525,89,3941,1020,354,843,12,15,144,1032,8,134,77,144,142,221,970,1580,4,6792,377,0,2,39,0,0
24526,231,5436,722,423,573,19,0,135,741,12,172,101,199,184,300,1320,2257,6,15668,870,0,2,9,1,1
24527,231,5436,1508,847,911,44,250,301,1552,14,148,88,169,162,257,1120,1886,7,15077,837,0,2,9,1,1
24528,231,5436,722,423,573,19,0,135,741,12,172,101,199,184,300,1320,2257,6,15668,870,0,2,20,0,0
24529,231,5436,1508,847,911,44,250,301,1552,14,148,88,169,162,257,1120,1886,7,15077,837,0,2,20,0,0
24530,92,3868,1289,550,1043,56,32,155,1345,10,167,93,185,177,278,1266,2075,5,11498,638,0,2,2,19,0
24531,1,15,127,75,83,2,11,30,129,4,14,7,14,18,21,61,87,2,175,9,0,0,4,0,0
24532,1,15,652,304,544,16,6,88,668,6,89,51,101,95,152,591,998,3,3399,188,0,0,4,0,0
24533,1,15,2,2,2,0,0,0,2,0,0,0,0,0,0,0,0,0,0,0,0,0,4,0,0
24534,1,15,8,5,5,0,0,3,8,0,0,0,0,0,0,0,0,0,0,0,0,0,4,0,0
24535,1,15,2,2,2,0,0,0,2,0,0,0,0,0,0,0,0,0,0,0,0,0,4,0,0
24536,1,15,14,8,8,0,0,6,14,0,0,0,0,0,0,0,0,0,0,0,0,0,4,0,0
24537,1,15,6,4,4,0,0,2,6,0,0,0,0,0,0,0,0,0,0,0,0,0,4,0,0
24538,1,15,6,4,4,0,0,2,6,1,2,1,2,3,3,2,4,0,2,0,0,0,4,0,0
24539,1,15,6,4,4,0,0,2,6,0,0,0,0,0,0,0,0,0,0,0,0,0,4,0,0
24540,1,15,7,5,5,0,0,2,7,0,0,0,0,0,0,0,0,0,0,0,0,0,4,0,0
24541,1,15,6,4,4,0,0,2,6,0,0,0,0,0,0,0,0,0,0,0,0,0,4,0,0
24542,1,15,10,6,6,0,0,4,10,0,0,0,0,0,0,0,0,0,0,0,0,0,4,0,0
24543,1,15,1,1,1,0,0,0,1,0,0,0,0,0,0,0,0,0,0,0,0,0,4,0,0
24544,1,15,1,1,1,0,0,0,1,0,0,0,0,0,0,0,0,0,0,0,0,0,4,0,0
24545,1,15,14,10,10,0,0,4,14,1,1,1,1,2,2,0,2,0,1,0,0,0,4,0,0
24546,1,15,46,26,30,3,0,12,49,3,6,3,6,9,9,20,28,1,42,2,0,0,4,0,0
24547,2,51,127,75,83,2,11,30,129,4,14,7,14,18,21,61,87,2,175,9,0,0,14,0,0
24548,2,51,652,304,544,16,6,88,668,6,89,51,101,95,152,591,998,3,3399,188,0,0,14,0,0
24549,2,51,2,2,2,0,0,0,2,0,0,0,0,0,0,0,0,0,0,0,0,0,14,0,0
24550,2,51,8,5,5,0,0,3,8,0,0,0,0,0,0,0,0,0,0,0,0,0,14,0,0
24551,2,51,2,2,2,0,0,0,2,0,0,0,0,0,0,0,0,0,0,0,0,0,14,0,0
24552,2,51,14,8,8,0,0,6,14,0,0,0,0,0,0,0,0,0,0,0,0,0,14,0,0
24553,2,51,6,4,4,0,0,2,6,0,0,0,0,0,0,0,0,0,0,0,0,0,14,0,0
24554,2,51,6,4,4,0,0,2,6,1,2,1,2,3,3,2,4,0,2,0,0,0,14,0,0
24555,2,51,6,4,4,0,0,2,6,0,0,0,0,0,0,0,0,0,0,0,0,0,14,0,0
24556,2,51,7,5,5,0,0,2,7,0,0,0,0,0,0,0,0,0,0,0,0,0,14,0,0
24557,2,51,6,4,4,0,0,2,6,0,0,0,0,0,0,0,0,0,0,0,0,0,14,0,0
24558,2,51,10,6,6,0,0,4,10,0,0,0,0,0,0,0,0,0,0,0,0,0,14,0,0
24559,2,51,1,1,1,0,0,0,1,0,0,0,0,0,0,0,0,0,0,0,0,0,14,0,0
24560,2,51,1,1,1,0,0,0,1,0,0,0,0,0,0,0,0,0,0,0,0,0,14,0,0
24561,2,51,14,10,10,0,0,4,14,1,1,1,1,2,2,0,2,0,1,0,0,0,14,0,0
24562,2,51,46,26,30,3,0,12,49,3,6,3,6,9,9,20,28,1,42,2,0,0,14,0,0
24563,1,6,2,2,2,0,0,0,2,0,0,0,0,0,0,0,0,0,0,0,0,0,2,0,0
24564,1,18,3,3,3,0,0,0,3,0,0,0,0,0,0,0,0,0,0,0,0,0,3,0,0
24565,28,702,466,257,367,18,25,50,484,7,126,86,171,133,257,898,1813,4,8612,478,0,0,196,0,0
24566,28,702,507,281,342,29,59,88,536,10,53,29,57,63,86,336,514,5,2764,153,0,0,196,0,0
24567,90,1927,1043,504,840,53,9,147,1096,9,180,112,198,189,310,1377,2344,4,11604,644,0,2,3,195,0
24568,90,1927,383,288,292,26,6,62,409,11,65,38,67,76,105,429,656,5,3719,206,0,2,3,195,0
24569,95,4640,1523,757,1297,19,12,193,1542,12,193,117,230,205,347,1508,2664,7,19053,1058,0,2,2,3,0
24570,82,3159,1043,504,840,53,9,147,1096,9,180,112,198,189,310,1377,2344,4,11604,644,0,2,5,5,0
24571,240,5520,4293,999,3693,19,54,507,4312,9,155,88,170,164,258,1156,1898,4,9368,520,0,2,50,9,1
24572,240,5520,1482,859,1002,125,135,219,1607,16,219,134,251,235,385,1766,3032,9,27804,1544,1,2,50,9,1
24573,285,6299,72,33,56,0,4,12,72,1,1,1,1,2,2,0,2,0,1,0,0,2,5,0,1
24574,285,6299,1454,835,1044,76,110,219,1530,17,275,158,296,292,454,2297,3718,9,34017,1889,1,2,5,0,1
24575,98,4433,1338,495,1086,10,64,173,1348,11,122,82,157,133,239,883,1686,7,11934,663,0,2,31,0,1
24576,240,5514,4293,999,3693,19,54,507,4312,9,155,88,170,164,258,1156,1898,4,9368,520,0,2,1,3,0
24577,240,5514,1482,859,1002,125,135,219,1607,16,219,134,251,235,385,1766,3032,9,27804,1544,1,2,1,3,0
24578,83,1788,402,202,227,24,74,80,426,12,52,33,61,64,94,339,564,7,3969,220,0,2,10,1,0
24579,285,6294,72,33,56,0,4,12,72,1,1,1,1,2,2,0,2,0,1,0,0,2,7,3,0
24580,285,6294,1454,835,1044,76,110,219,1530,17,275,158,296,292,454,2297,3718,9,34017,1889,1,2,7,3,0
24581,91,4019,1020,354,843,12,15,144,1032,8,134,77,144,142,221,970,1580,4,6792,377,0,2,39,0,0
24582,83,1788,402,202,227,24,74,80,426,12,52,33,61,64,94,339,564,7,3969,220,0,2,10,1,0
24583,285,6294,72,33,56,0,4,12,72,1,1,1,1,2,2,0,2,0,1,0,0,2,7,3,0
24584,285,6294,1454,835,1044,76,110,219,1530,17,275,158,296,292,454,2297,3718,9,34017,1889,1,2,7,3,0
24585,91,4019,1020,354,843,12,15,144,1032,8,134,77,144,142,221,970,1580,4,6792,377,0,2,39,0,0
24586,240,5514,4293,999,3693,19,54,507,4312,9,155,88,170,164,258,1156,1898,4,9368,520,0,2,48,9,0
24587,240,5514,1482,859,1002,125,135,219,1607,16,219,134,251,235,385,1766,3032,9,27804,1544,1,2,48,9,0
24588,285,6299,72,33,56,0,4,12,72,1,1,1,1,2,2,0,2,0,1,0,0,2,5,0,0
24589,285,6299,1454,835,1044,76,110,219,1530,17,275,158,296,292,454,2297,3718,9,34017,1889,1,2,5,0,0
24590,98,4433,1338,495,1086,10,64,173,1348,11,122,82,157,133,239,883,1686,7,11934,663,0,2,31,0,0
24591,173,7581,139,89,101,2,0,35,141,7,54,34,62,61,96,330,569,4,2287,127,0,2,40,32,0
24592,173,7581,7,5,5,0,0,2,7,1,2,1,2,3,3,2,4,0,2,0,0,2,40,32,0
24593,173,7528,139,89,101,2,0,35,141,7,54,34,62,61,96,330,569,4,2287,127,0,2,20,30,1
24594,173,7528,7,5,5,0,0,2,7,1,2,1,2,3,3,2,4,0,2,0,0,2,20,30,1
24595,173,7537,139,89,101,2,0,35,141,7,54,34,62,61,96,330,569,4,2287,127,0,2,16,7,1
24596,173,7537,7,5,5,0,0,2,7,1,2,1,2,3,3,2,4,0,2,0,0,2,16,7,1
24597,173,7537,139,89,101,2,0,35,141,7,54,34,62,61,96,330,569,4,2287,127,0,2,1,1,0
24598,173,7537,7,5,5,0,0,2,7,1,2,1,2,3,3,2,4,0,2,0,0,2,1,1,0
24599,236,5588,722,423,573,19,0,135,741,12,172,101,199,184,300,1320,2257,6,15668,870,0,2,37,9,1
24600,236,5588,1508,847,911,44,250,301,1552,14,148,88,169,162,257,1120,1886,7,15077,837,0,2,37,9,1
24601,1,26,127,75,83,2,11,30,129,4,14,7,14,18,21,61,87,2,175,9,0,0,7,0,1
24602,1,26,652,304,544,16,6,88,668,6,89,51,101,95,152,591,998,3,3399,188,0,0,7,0,1
24603,1,26,2,2,2,0,0,0,2,0,0,0,0,0,0,0,0,0,0,0,0,0,7,0,1
24604,1,26,8,5,5,0,0,3,8,0,0,0,0,0,0,0,0,0,0,0,0,0,7,0,1
24605,1,26,2,2,2,0,0,0,2,0,0,0,0,0,0,0,0,0,0,0,0,0,7,0,1
24606,1,26,14,8,8,0,0,6,14,0,0,0,0,0,0,0,0,0,0,0,0,0,7,0,1
24607,1,26,6,4,4,0,0,2,6,0,0,0,0,0,0,0,0,0,0,0,0,0,7,0,1
24608,1,26,6,4,4,0,0,2,6,1,2,1,2,3,3,2,4,0,2,0,0,0,7,0,1
24609,1,26,6,4,4,0,0,2,6,0,0,0,0,0,0,0,0,0,0,0,0,0,7,0,1
24610,1,26,7,5,5,0,0,2,7,0,0,0,0,0,0,0,0,0,0,0,0,0,7,0,1
24611,1,26,6,4,4,0,0,2,6,0,0,0,0,0,0,0,0,0,0,0,0,0,7,0,1
24612,1,26,10,6,6,0,0,4,10,0,0,0,0,0,0,0,0,0,0,0,0,0,7,0,1
24613,1,26,1,1,1,0,0,0,1,0,0,0,0,0,0,0,0,0,0,0,0,0,7,0,1
24614,1,26,1,1,1,0,0,0,1,0,0,0,0,0,0,0,0,0,0,0,0,0,7,0,1
24615,1,26,14,10,10,0,0,4,14,1,1,1,1,2,2,0,2,0,1,0,0,0,7,0,1
24616,1,26,46,26,30,3,0,12,49,3,6,3,6,9,9,20,28,1,42,2,0,0,7,0,1
24617,1,7,2,2,2,0,0,0,2,0,0,0,0,0,0,0,0,0,0,0,0,0,2,0,1
24618,1,20,127,75,83,2,11,30,129,4,14,7,14,18,21,61,87,2,175,9,0,0,7,0,1
24619,1,20,652,304,544,16,6,88,668,6,89,51,101,95,152,591,998,3,3399,188,0,0,7,0,1
24620,1,20,2,2,2,0,0,0,2,0,0,0,0,0,0,0,0,0,0,0,0,0,7,0,1
24621,1,20,8,5,5,0,0,3,8,0,0,0,0,0,0,0,0,0,0,0,0,0,7,0,1
24622,1,20,2,2,2,0,0,0,2,0,0,0,0,0,0,0,0,0,0,0,0,0,7,0,1
24623,1,20,14,8,8,0,0,6,14,0,0,0,0,0,0,0,0,0,0,0,0,0,7,0,1
24624,1,20,6,4,4,0,0,2,6,0,0,0,0,0,0,0,0,0,0,0,0,0,7,0,1
24625,1,20,6,4,4,0,0,2,6,1,2,1,2,3,3,2,4,0,2,0,0,0,7,0,1
24626,1,20,6,4,4,0,0,2,6,0,0,0,0,0,0,0,0,0,0,0,0,0,7,0,1
24627,1,20,7,5,5,0,0,2,7,0,0,0,0,0,0,0,0,0,0,0,0,0,7,0,1
24628,1,20,6,4,4,0,0,2,6,0,0,0,0,0,0,0,0,0,0,0,0,0,7,0,1
24629,1,20,10,6,6,0,0,4,10,0,0,0,0,0,0,0,0,0,0,0,0,0,7,0,1
24630,1,20,1,1,1,0,0,0,1,0,0,0,0,0,0,0,0,0,0,0,0,0,7,0,1
24631,1,20,1,1,1,0,0,0,1,0,0,0,0,0,0,0,0,0,0,0,0,0,7,0,1
24632,1,20,14,10,10,0,0,4,14,1,1,1,1,2,2,0,2,0,1,0,0,0,7,0,1
24633,1,20,46,26,30,3,0,12,49,3,6,3,6,9,9,20,28,1,42,2,0,0,7,0,1
24634,1,7,2,2,2,0,0,0,2,0,0,0,0,0,0,0,0,0,0,0,0,0,2,0,1
24635,1,13,127,75,83,2,11,30,129,4,14,7,14,18,21,61,87,2,175,9,0,0,6,0,1
24636,1,13,652,304,544,16,6,88,668,6,89,51,101,95,152,591,998,3,3399,188,0,0,6,0,1
24637,1,13,2,2,2,0,0,0,2,0,0,0,0,0,0,0,0,0,0,0,0,0,6,0,1
24638,1,13,8,5,5,0,0,3,8,0,0,0,0,0,0,0,0,0,0,0,0,0,6,0,1
24639,1,13,2,2,2,0,0,0,2,0,0,0,0,0,0,0,0,0,0,0,0,0,6,0,1
24640,1,13,14,8,8,0,0,6,14,0,0,0,0,0,0,0,0,0,0,0,0,0,6,0,1
24641,1,13,6,4,4,0,0,2,6,0,0,0,0,0,0,0,0,0,0,0,0,0,6,0,1
24642,1,13,6,4,4,0,0,2,6,1,2,1,2,3,3,2,4,0,2,0,0,0,6,0,1
24643,1,13,6,4,4,0,0,2,6,0,0,0,0,0,0,0,0,0,0,0,0,0,6,0,1
24644,1,13,7,5,5,0,0,2,7,0,0,0,0,0,0,0,0,0,0,0,0,0,6,0,1
24645,1,13,6,4,4,0,0,2,6,0,0,0,0,0,0,0,0,0,0,0,0,0,6,0,1
24646,1,13,10,6,6,0,0,4,10,0,0,0,0,0,0,0,0,0,0,0,0,0,6,0,1
24647,1,13,1,1,1,0,0,0,1,0,0,0,0,0,0,0,0,0,0,0,0,0,6,0,1
24648,1,13,1,1,1,0,0,0,1,0,0,0,0,0,0,0,0,0,0,0,0,0,6,0,1
24649,1,13,14,10,10,0,0,4,14,1,1,1,1,2,2,0,2,0,1,0,0,0,6,0,1
24650,1,13,46,26,30,3,0,12,49,3,6,3,6,9,9,20,28,1,42,2,0,0,6,0,1
24651,1,16,127,75,83,2,11,30,129,4,14,7,14,18,21,61,87,2,175,9,0,0,6,0,1
24652,1,16,652,304,544,16,6,88,668,6,89,51,101,95,152,591,998,3,3399,188,0,0,6,0,1
24653,1,16,2,2,2,0,0,0,2,0,0,0,0,0,0,0,0,0,0,0,0,0,6,0,1
24654,1,16,8,5,5,0,0,3,8,0,0,0,0,0,0,0,0,0,0,0,0,0,6,0,1
24655,1,16,2,2,2,0,0,0,2,0,0,0,0,0,0,0,0,0,0,0,0,0,6,0,1
24656,1,16,14,8,8,0,0,6,14,0,0,0,0,0,0,0,0,0,0,0,0,0,6,0,1
24657,1,16,6,4,4,0,0,2,6,0,0,0,0,0,0,0,0,0,0,0,0,0,6,0,1
24658,1,16,6,4,4,0,0,2,6,1,2,1,2,3,3,2,4,0,2,0,0,0,6,0,1
24659,1,16,6,4,4,0,0,2,6,0,0,0,0,0,0,0,0,0,0,0,0,0,6,0,1
24660,1,16,7,5,5,0,0,2,7,0,0,0,0,0,0,0,0,0,0,0,0,0,6,0,1
24661,1,16,6,4,4,0,0,2,6,0,0,0,0,0,0,0,0,0,0,0,0,0,6,0,1
24662,1,16,10,6,6,0,0,4,10,0,0,0,0,0,0,0,0,0,0,0,0,0,6,0,1
24663,1,16,1,1,1,0,0,0,1,0,0,0,0,0,0,0,0,0,0,0,0,0,6,0,1
24664,1,16,1,1,1,0,0,0,1,0,0,0,0,0,0,0,0,0,0,0,0,0,6,0,1
24665,1,16,14,10,10,0,0,4,14,1,1,1,1,2,2,0,2,0,1,0,0,0,6,0,1
24666,1,16,46,26,30,3,0,12,49,3,6,3,6,9,9,20,28,1,42,2,0,0,6,0,1
24667,1,10,2,2,2,0,0,0,2,1,2,1,2,3,3,2,4,0,2,0,0,0,2,0,1
24668,1,13,127,75,83,2,11,30,129,4,14,7,14,18,21,61,87,2,175,9,0,0,6,0,1
24669,1,13,652,304,544,16,6,88,668,6,89,51,101,95,152,591,998,3,3399,188,0,0,6,0,1
24670,1,13,2,2,2,0,0,0,2,0,0,0,0,0,0,0,0,0,0,0,0,0,6,0,1
24671,1,13,8,5,5,0,0,3,8,0,0,0,0,0,0,0,0,0,0,0,0,0,6,0,1
24672,1,13,2,2,2,0,0,0,2,0,0,0,0,0,0,0,0,0,0,0,0,0,6,0,1
24673,1,13,14,8,8,0,0,6,14,0,0,0,0,0,0,0,0,0,0,0,0,0,6,0,1
24674,1,13,6,4,4,0,0,2,6,0,0,0,0,0,0,0,0,0,0,0,0,0,6,0,1
24675,1,13,6,4,4,0,0,2,6,1,2,1,2,3,3,2,4,0,2,0,0,0,6,0,1
24676,1,13,6,4,4,0,0,2,6,0,0,0,0,0,0,0,0,0,0,0,0,0,6,0,1
24677,1,13,7,5,5,0,0,2,7,0,0,0,0,0,0,0,0,0,0,0,0,0,6,0,1
24678,1,13,6,4,4,0,0,2,6,0,0,0,0,0,0,0,0,0,0,0,0,0,6,0,1
24679,1,13,10,6,6,0,0,4,10,0,0,0,0,0,0,0,0,0,0,0,0,0,6,0,1
24680,1,13,1,1,1,0,0,0,1,0,0,0,0,0,0,0,0,0,0,0,0,0,6,0,1
24681,1,13,1,1,1,0,0,0,1,0,0,0,0,0,0,0,0,0,0,0,0,0,6,0,1
24682,1,13,14,10,10,0,0,4,14,1,1,1,1,2,2,0,2,0,1,0,0,0,6,0,1
24683,1,13,46,26,30,3,0,12,49,3,6,3,6,9,9,20,28,1,42,2,0,0,6,0,1
24684,2,26,10,6,6,0,0,4,10,2,4,2,4,6,6,10,15,1,15,0,0,0,10,0,1
24685,3,47,15,10,10,0,0,5,15,2,4,2,4,6,6,10,15,1,15,0,0,0,15,0,1
24686,3,39,15,9,9,0,0,6,15,0,0,0,0,0,0,0,0,0,0,0,0,0,16,0,1
24687,2,36,10,7,7,0,0,3,10,1,2,1,2,3,3,2,4,0,2,0,0,0,11,0,1
24688,3,46,15,9,9,0,0,6,15,1,4,2,4,5,6,8,13,0,6,0,0,0,15,0,1
24689,2,21,10,6,6,0,0,4,10,0,0,0,0,0,0,0,0,0,0,0,0,0,10,0,1
24690,173,7444,139,89,101,2,0,35,141,7,54,34,62,61,96,330,569,4,2287,127,0,2,18,151,1
24691,173,7444,7,5,5,0,0,2,7,1,2,1,2,3,3,2,4,0,2,0,0,2,18,151,1
24692,84,1794,402,202,227,24,74,80,426,12,52,33,61,64,94,339,564,7,3969,220,0,2,1,1,0
24693,92,3984,1020,354,843,12,15,144,1032,8,134,77,144,142,221,970,1580,4,6792,377,0,2,13,0,0
24694,86,2229,773,422,505,30,103,129,803,14,77,46,83,91,129,535,839,7,6334,351,0,2,3,1,0
24695,32,2074,1157,318,931,29,22,177,1186,6,104,63,125,110,188,712,1274,3,4596,255,0,2,34,0,0
24696,32,2078,1157,318,931,29,22,177,1186,6,104,63,125,110,188,712,1274,3,4596,255,0,2,1,0,0
24697,32,2083,1157,318,931,29,22,177,1186,6,104,63,125,110,188,712,1274,3,4596,255,0,2,5,2,0
24698,32,2079,1157,318,931,29,22,177,1186,6,104,63,125,110,188,712,1274,3,4596,255,0,2,1,1,0
24699,86,2229,773,422,505,30,103,129,803,14,77,46,83,91,129,535,839,7,6334,351,0,2,3,1,0
24700,32,2079,1157,318,931,29,22,177,1186,6,104,63,125,110,188,712,1274,3,4596,255,0,2,38,0,0
24701,84,1794,402,202,227,24,74,80,426,12,52,33,61,64,94,339,564,7,3969,220,0,2,1,1,0
24702,92,3984,1020,354,843,12,15,144,1032,8,134,77,144,142,221,970,1580,4,6792,377,0,2,13,0,0
24703,32,938,339,213,244,17,9,65,356,10,42,26,48,52,74,259,421,5,2410,133,0,2,29,3,1
24704,60,2660,1293,570,1093,25,15,163,1318,10,195,123,241,205,364,1516,2795,6,17273,959,0,2,17,0,1
24705,32,948,339,213,244,17,9,65,356,10,42,26,48,52,74,259,421,5,2410,133,0,2,2,0,0
24706,60,2660,1293,570,1093,25,15,163,1318,10,195,123,241,205,364,1516,2795,6,17273,959,0,2,2,2,0
24707,33,960,339,213,244,17,9,65,356,10,42,26,48,52,74,259,421,5,2410,133,0,2,6,2,0
24708,33,960,339,213,244,17,9,65,356,10,42,26,48,52,74,259,421,5,2410,133,0,2,3,3,0
24709,60,2658,1293,570,1093,25,15,163,1318,10,195,123,241,205,364,1516,2795,6,17273,959,0,2,2,2,0
24710,60,2658,1293,570,1093,25,15,163,1318,10,195,123,241,205,364,1516,2795,6,17273,959,0,2,1,0,0
24711,48,992,447,308,343,6,5,95,453,7,96,59,111,103,170,651,1136,4,4600,255,0,2,1,1,0
24712,48,992,322,174,179,16,74,51,338,10,41,26,46,51,72,252,408,5,2291,127,0,2,1,1,0
24713,48,992,447,308,343,6,5,95,453,7,96,59,111,103,170,651,1136,4,4600,255,0,2,1,1,0
24714,48,992,322,174,179,16,74,51,338,10,41,26,46,51,72,252,408,5,2291,127,0,2,1,1,0
24715,33,961,339,213,244,17,9,65,356,10,42,26,48,52,74,259,421,5,2410,133,0,2,1,1,0
24716,34,983,339,213,244,17,9,65,356,10,42,26,48,52,74,259,421,5,2410,133,0,2,24,23,1
24717,61,2743,1293,570,1093,25,15,163,1318,10,195,123,241,205,364,1516,2795,6,17273,959,0,2,21,0,1
24718,61,2743,1293,570,1093,25,15,163,1318,10,195,123,241,205,364,1516,2795,6,17273,959,0,2,1,1,0
24719,61,2731,1293,570,1093,25,15,163,1318,10,195,123,241,205,364,1516,2795,6,17273,959,0,2,0,2,0
24720,34,995,339,213,244,17,9,65,356,10,42,26,48,52,74,259,421,5,2410,133,0,2,3,1,0
24721,61,2731,1293,570,1093,25,15,163,1318,10,195,123,241,205,364,1516,2795,6,17273,959,0,2,1,1,0
24722,61,2731,1293,570,1093,25,15,163,1318,10,195,123,241,205,364,1516,2795,6,17273,959,0,2,1,1,0
24723,84,1794,402,202,227,24,74,80,426,12,52,33,61,64,94,339,564,7,3969,220,0,2,1,1,0
24724,86,2229,773,422,505,30,103,129,803,14,77,46,83,91,129,535,839,7,6334,351,0,2,3,1,0
24725,84,1794,402,202,227,24,74,80,426,12,52,33,61,64,94,339,564,7,3969,220,0,2,1,1,0
24726,48,992,447,308,343,6,5,95,453,7,96,59,111,103,170,651,1136,4,4600,255,0,2,1,1,0
24727,48,992,322,174,179,16,74,51,338,10,41,26,46,51,72,252,408,5,2291,127,0,2,1,1,0
24728,32,2079,1157,318,931,29,22,177,1186,6,104,63,125,110,188,712,1274,3,4596,255,0,2,38,0,0
24729,92,3984,1020,354,843,12,15,144,1032,8,134,77,144,142,221,970,1580,4,6792,377,0,2,13,0,0
24730,84,1794,402,202,227,24,74,80,426,12,52,33,61,64,94,339,564,7,3969,220,0,2,1,1,0
24731,88,2252,773,422,505,30,103,129,803,14,77,46,83,91,129,535,839,7,6334,351,0,2,3,1,0
24732,84,1794,402,202,227,24,74,80,426,12,52,33,61,64,94,339,564,7,3969,220,0,2,2,2,0
24733,48,992,447,308,343,6,5,95,453,7,96,59,111,103,170,651,1136,4,4600,255,0,2,1,1,0
24734,48,992,322,174,179,16,74,51,338,10,41,26,46,51,72,252,408,5,2291,127,0,2,1,1,0
24735,32,2079,1157,318,931,29,22,177,1186,6,104,63,125,110,188,712,1274,3,4596,255,0,2,38,0,0
24736,94,4062,1020,354,843,12,15,144,1032,8,134,77,144,142,221,970,1580,4,6792,377,0,2,13,0,0
24737,88,2252,773,422,505,30,103,129,803,14,77,46,83,91,129,535,839,7,6334,351,0,2,3,1,0
24738,84,1794,402,202,227,24,74,80,426,12,52,33,61,64,94,339,564,7,3969,220,0,2,2,2,0
24739,48,992,447,308,343,6,5,95,453,7,96,59,111,103,170,651,1136,4,4600,255,0,2,1,1,0
24740,48,992,322,174,179,16,74,51,338,10,41,26,46,51,72,252,408,5,2291,127,0,2,1,1,0
24741,32,2079,1157,318,931,29,22,177,1186,6,104,63,125,110,188,712,1274,3,4596,255,0,2,38,0,0
24742,94,4062,1020,354,843,12,15,144,1032,8,134,77,144,142,221,970,1580,4,6792,377,0,2,13,0,0
24743,3,42,14,8,8,0,0,6,14,0,0,0,0,0,0,0,0,0,0,0,0,2,5,2,1
24744,2,40,9,6,6,0,0,3,9,0,0,0,0,0,0,0,0,0,0,0,0,2,3,2,1
24745,2,40,13,9,8,0,0,4,13,0,0,0,0,0,0,0,0,0,0,0,0,2,3,2,1
24746,1,324,382,65,130,157,2,92,539,4,10,5,10,14,15,41,57,2,114,6,0,2,119,100,1
24747,60,1081,282,196,195,3,0,86,285,8,130,71,141,138,212,936,1507,4,6538,363,0,2,72,51,1
24748,4,77,127,75,83,2,11,30,129,4,14,7,14,18,21,61,87,2,175,9,0,2,6,3,1
24749,4,77,652,304,544,16,6,88,668,6,89,51,101,95,152,591,998,3,3399,188,0,2,6,3,1
24750,4,77,2,2,2,0,0,0,2,0,0,0,0,0,0,0,0,0,0,0,0,2,6,3,1
24751,4,77,8,5,5,0,0,3,8,0,0,0,0,0,0,0,0,0,0,0,0,2,6,3,1
24752,4,77,2,2,2,0,0,0,2,0,0,0,0,0,0,0,0,0,0,0,0,2,6,3,1
24753,4,77,14,8,8,0,0,6,14,0,0,0,0,0,0,0,0,0,0,0,0,2,6,3,1
24754,4,77,6,4,4,0,0,2,6,0,0,0,0,0,0,0,0,0,0,0,0,2,6,3,1
24755,4,77,6,4,4,0,0,2,6,1,2,1,2,3,3,2,4,0,2,0,0,2,6,3,1
24756,4,77,6,4,4,0,0,2,6,0,0,0,0,0,0,0,0,0,0,0,0,2,6,3,1
24757,4,77,7,5,5,0,0,2,7,0,0,0,0,0,0,0,0,0,0,0,0,2,6,3,1
24758,4,77,6,4,4,0,0,2,6,0,0,0,0,0,0,0,0,0,0,0,0,2,6,3,1
24759,4,77,10,6,6,0,0,4,10,0,0,0,0,0,0,0,0,0,0,0,0,2,6,3,1
24760,4,77,1,1,1,0,0,0,1,0,0,0,0,0,0,0,0,0,0,0,0,2,6,3,1
24761,4,77,1,1,1,0,0,0,1,0,0,0,0,0,0,0,0,0,0,0,0,2,6,3,1
24762,4,77,14,10,10,0,0,4,14,1,1,1,1,2,2,0,2,0,1,0,0,2,6,3,1
24763,4,77,46,26,30,3,0,12,49,3,6,3,6,9,9,20,28,1,42,2,0,2,6,3,1
24764,1,9,5,3,3,0,0,2,5,0,0,0,0,0,0,0,0,0,0,0,0,2,1,0,1
24765,1,90,13,10,10,0,0,3,13,1,2,1,2,3,3,2,4,0,2,0,0,2,5,5,1
24766,7,114,44,19,17,0,16,11,44,3,14,7,14,17,21,58,85,1,128,7,0,2,3,1,1
24767,3,66,127,75,83,2,11,30,129,4,14,7,14,18,21,61,87,2,175,9,0,2,4,1,1
24768,3,66,652,304,544,16,6,88,668,6,89,51,101,95,152,591,998,3,3399,188,0,2,4,1,1
24769,3,66,2,2,2,0,0,0,2,0,0,0,0,0,0,0,0,0,0,0,0,2,4,1,1
24770,3,66,8,5,5,0,0,3,8,0,0,0,0,0,0,0,0,0,0,0,0,2,4,1,1
24771,3,66,2,2,2,0,0,0,2,0,0,0,0,0,0,0,0,0,0,0,0,2,4,1,1
24772,3,66,14,8,8,0,0,6,14,0,0,0,0,0,0,0,0,0,0,0,0,2,4,1,1
24773,3,66,6,4,4,0,0,2,6,0,0,0,0,0,0,0,0,0,0,0,0,2,4,1,1
24774,3,66,6,4,4,0,0,2,6,1,2,1,2,3,3,2,4,0,2,0,0,2,4,1,1
24775,3,66,6,4,4,0,0,2,6,0,0,0,0,0,0,0,0,0,0,0,0,2,4,1,1
24776,3,66,7,5,5,0,0,2,7,0,0,0,0,0,0,0,0,0,0,0,0,2,4,1,1
24777,3,66,6,4,4,0,0,2,6,0,0,0,0,0,0,0,0,0,0,0,0,2,4,1,1
24778,3,66,10,6,6,0,0,4,10,0,0,0,0,0,0,0,0,0,0,0,0,2,4,1,1
24779,3,66,1,1,1,0,0,0,1,0,0,0,0,0,0,0,0,0,0,0,0,2,4,1,1
24780,3,66,1,1,1,0,0,0,1,0,0,0,0,0,0,0,0,0,0,0,0,2,4,1,1
24781,3,66,14,10,10,0,0,4,14,1,1,1,1,2,2,0,2,0,1,0,0,2,4,1,1
24782,3,66,46,26,30,3,0,12,49,3,6,3,6,9,9,20,28,1,42,2,0,2,4,1,1
24783,7,298,72,33,56,0,4,12,72,1,1,1,1,2,2,0,2,0,1,0,0,2,26,10,1
24784,12,229,127,75,83,2,11,30,129,4,14,7,14,18,21,61,87,2,175,9,0,2,13,6,1
24785,12,229,652,304,544,16,6,88,668,6,89,51,101,95,152,591,998,3,3399,188,0,2,13,6,1
24786,12,229,2,2,2,0,0,0,2,0,0,0,0,0,0,0,0,0,0,0,0,2,13,6,1
24787,12,229,8,5,5,0,0,3,8,0,0,0,0,0,0,0,0,0,0,0,0,2,13,6,1
24788,12,229,2,2,2,0,0,0,2,0,0,0,0,0,0,0,0,0,0,0,0,2,13,6,1
24789,12,229,14,8,8,0,0,6,14,0,0,0,0,0,0,0,0,0,0,0,0,2,13,6,1
24790,12,229,6,4,4,0,0,2,6,0,0,0,0,0,0,0,0,0,0,0,0,2,13,6,1
24791,12,229,6,4,4,0,0,2,6,1,2,1,2,3,3,2,4,0,2,0,0,2,13,6,1
24792,12,229,6,4,4,0,0,2,6,0,0,0,0,0,0,0,0,0,0,0,0,2,13,6,1
24793,12,229,7,5,5,0,0,2,7,0,0,0,0,0,0,0,0,0,0,0,0,2,13,6,1
24794,12,229,6,4,4,0,0,2,6,0,0,0,0,0,0,0,0,0,0,0,0,2,13,6,1
24795,12,229,10,6,6,0,0,4,10,0,0,0,0,0,0,0,0,0,0,0,0,2,13,6,1
24796,12,229,1,1,1,0,0,0,1,0,0,0,0,0,0,0,0,0,0,0,0,2,13,6,1
24797,12,229,1,1,1,0,0,0,1,0,0,0,0,0,0,0,0,0,0,0,0,2,13,6,1
24798,12,229,14,10,10,0,0,4,14,1,1,1,1,2,2,0,2,0,1,0,0,2,13,6,1
24799,12,229,46,26,30,3,0,12,49,3,6,3,6,9,9,20,28,1,42,2,0,2,13,6,1
24800,6,71,127,75,83,2,11,30,129,4,14,7,14,18,21,61,87,2,175,9,0,2,2,3,1
24801,6,71,652,304,544,16,6,88,668,6,89,51,101,95,152,591,998,3,3399,188,0,2,2,3,1
24802,6,71,2,2,2,0,0,0,2,0,0,0,0,0,0,0,0,0,0,0,0,2,2,3,1
24803,6,71,8,5,5,0,0,3,8,0,0,0,0,0,0,0,0,0,0,0,0,2,2,3,1
24804,6,71,2,2,2,0,0,0,2,0,0,0,0,0,0,0,0,0,0,0,0,2,2,3,1
24805,6,71,14,8,8,0,0,6,14,0,0,0,0,0,0,0,0,0,0,0,0,2,2,3,1
24806,6,71,6,4,4,0,0,2,6,0,0,0,0,0,0,0,0,0,0,0,0,2,2,3,1
24807,6,71,6,4,4,0,0,2,6,1,2,1,2,3,3,2,4,0,2,0,0,2,2,3,1
24808,6,71,6,4,4,0,0,2,6,0,0,0,0,0,0,0,0,0,0,0,0,2,2,3,1
24809,6,71,7,5,5,0,0,2,7,0,0,0,0,0,0,0,0,0,0,0,0,2,2,3,1
24810,6,71,6,4,4,0,0,2,6,0,0,0,0,0,0,0,0,0,0,0,0,2,2,3,1
24811,6,71,10,6,6,0,0,4,10,0,0,0,0,0,0,0,0,0,0,0,0,2,2,3,1
24812,6,71,1,1,1,0,0,0,1,0,0,0,0,0,0,0,0,0,0,0,0,2,2,3,1
24813,6,71,1,1,1,0,0,0,1,0,0,0,0,0,0,0,0,0,0,0,0,2,2,3,1
24814,6,71,14,10,10,0,0,4,14,1,1,1,1,2,2,0,2,0,1,0,0,2,2,3,1
24815,6,71,46,26,30,3,0,12,49,3,6,3,6,9,9,20,28,1,42,2,0,2,2,3,1
24816,3,26,14,7,7,2,0,5,16,0,0,0,0,0,0,0,0,0,0,0,0,2,4,1,1
24817,7,103,38,23,23,0,0,15,38,0,0,0,0,0,0,0,0,0,0,0,0,2,8,0,1
24818,17,378,85,59,61,8,0,16,93,5,18,10,18,23,28,86,126,2,316,17,0,2,20,19,1
24819,11,413,42,7,35,4,0,5,46,1,2,1,2,3,3,2,4,0,2,0,0,2,59,66,1
24820,11,413,11,6,10,0,0,1,11,2,4,2,4,6,6,10,15,1,15,0,0,2,59,66,1
24821,11,238,19,8,11,5,0,4,24,2,5,3,6,7,9,13,25,1,30,1,0,3,10,6,1
24822,11,238,102,59,69,5,3,24,107,6,22,15,28,28,43,113,206,3,789,43,0,3,10,6,1
24823,11,238,106,40,36,3,49,17,109,8,17,13,23,25,36,93,167,5,904,50,0,3,10,6,1
24824,213,4619,182,127,129,0,0,53,182,5,39,21,42,44,63,217,343,2,926,51,0,3,128,67,1
24825,213,4619,1165,710,800,67,119,181,1232,18,243,153,282,261,435,2000,3492,10,36473,2026,1,3,128,67,1
24826,83,1808,773,419,590,28,0,166,801,10,204,113,217,214,330,1598,2554,5,13587,754,0,3,37,22,1
24827,83,1808,421,273,302,44,34,57,465,17,81,59,107,98,166,583,1098,11,12329,684,0,3,37,22,1
24828,26,525,2,2,2,0,0,0,2,0,0,0,0,0,0,0,0,0,0,0,0,3,21,16,1
24829,26,525,99,48,90,1,3,5,100,0,0,0,0,0,0,0,0,0,0,0,0,3,21,16,1
24830,26,525,8,5,5,2,0,1,10,0,0,0,0,0,0,0,0,0,0,0,0,3,21,16,1
24831,26,525,1217,716,841,84,126,174,1301,14,185,118,215,199,333,1446,2542,8,20687,1149,0,3,21,16,1
24832,26,525,160,89,115,0,13,31,160,7,15,11,17,22,28,78,124,3,495,27,0,3,21,16,1
24833,26,525,10,10,9,9,0,0,19,0,0,0,0,0,0,0,0,0,0,0,0,3,21,16,1
24834,26,525,173,84,99,8,29,36,181,5,12,7,13,17,20,54,81,2,221,12,0,3,21,16,1
24835,26,525,3,1,1,3,0,0,6,0,0,0,0,0,0,0,0,0,0,0,0,3,21,16,1
24836,164,5065,1660,832,1314,41,38,274,1701,20,312,209,395,332,604,2671,5058,12,64042,3557,1,3,89,62,1
24837,164,5065,1057,646,719,113,100,145,1170,18,215,134,248,233,382,1740,3004,10,31186,1732,1,3,89,62,1
24838,17,344,95,58,50,9,16,20,104,12,33,24,45,45,69,209,378,8,3100,172,0,3,6,9,1
24839,89,1830,477,336,357,30,23,73,507,16,194,134,250,210,384,1538,2962,10,30538,1696,0,3,97,63,1
24840,74,1693,996,429,845,24,10,117,1020,7,76,50,88,83,138,494,879,4,3565,198,0,3,127,91,1
24841,74,1693,456,277,329,12,42,72,468,13,85,50,97,98,147,592,972,7,7212,400,0,3,127,91,1
24842,145,3016,1513,682,1277,25,13,200,1538,11,199,116,219,210,335,1557,2584,6,15641,868,0,3,58,42,1
24843,145,3016,819,519,539,24,98,155,843,15,96,57,106,111,163,690,1107,8,9171,509,0,3,58,42,1
24844,58,1192,207,111,150,11,0,50,218,5,26,19,36,31,55,133,272,3,943,52,0,3,87,59,1
24845,58,1192,410,198,237,31,55,97,441,11,63,38,72,74,110,414,683,6,4293,238,0,3,87,59,1
24846,211,4551,2,2,2,0,0,0,2,0,0,0,0,0,0,0,0,0,0,0,0,3,185,615,1
24847,211,4551,99,48,90,1,3,5,100,0,0,0,0,0,0,0,0,0,0,0,0,3,185,615,1
24848,211,4551,8,5,5,2,0,1,10,0,0,0,0,0,0,0,0,0,0,0,0,3,185,615,1
24849,211,4551,1217,716,841,84,126,174,1301,14,185,118,215,199,333,1446,2542,8,20687,1149,0,3,185,615,1
24850,211,4551,160,89,115,0,13,31,160,7,15,11,17,22,28,78,124,3,495,27,0,3,185,615,1
24851,211,4551,10,10,9,9,0,0,19,0,0,0,0,0,0,0,0,0,0,0,0,3,185,615,1
24852,211,4551,173,84,99,8,29,36,181,5,12,7,13,17,20,54,81,2,221,12,0,3,185,615,1
24853,211,4551,3,1,1,3,0,0,6,0,0,0,0,0,0,0,0,0,0,0,0,3,185,615,1
24854,94,1909,463,295,324,28,62,57,491,12,134,82,154,146,236,989,1696,6,11700,650,0,0,392,0,1
24855,51,727,167,116,138,4,5,22,171,8,48,30,56,56,86,292,499,4,2330,129,0,0,139,0,1
24856,28,810,339,213,244,17,9,65,356,10,42,26,48,52,74,259,421,5,2410,133,0,3,23,11,1
24857,85,2161,1455,414,1257,16,76,112,1471,5,41,23,46,46,69,231,381,2,1069,59,0,3,133,89,1
24858,85,2161,669,365,481,22,61,110,691,15,103,63,122,118,185,747,1273,8,11311,628,0,3,133,89,1
24859,247,5639,4293,999,3693,19,54,507,4312,9,155,88,170,164,258,1156,1898,4,9368,520,0,3,203,107,1
24860,247,5639,1482,859,1002,125,135,219,1607,16,219,134,251,235,385,1766,3032,9,27804,1544,1,3,203,107,1
24861,6,136,44,22,19,0,19,6,44,2,10,6,12,12,18,35,64,1,77,4,0,3,6,4,1
24862,27,959,74,35,59,1,0,14,75,3,14,7,14,17,21,58,85,1,128,7,0,3,78,51,1
24863,27,959,245,125,200,5,7,34,250,7,30,17,34,37,51,166,265,3,1053,58,0,3,78,51,1
24864,51,595,647,139,84,35,284,233,682,0,0,0,0,0,0,0,0,0,0,0,0,3,11,0,1
24865,98,2661,1523,757,1297,19,12,193,1542,12,193,117,230,205,347,1508,2664,7,19053,1058,0,3,138,111,1
24866,98,2661,701,378,504,33,58,109,734,13,110,68,126,123,194,794,1346,7,10027,557,0,3,138,111,1
24867,88,2252,773,422,505,30,103,129,803,14,77,46,83,91,129,535,839,7,6334,351,0,3,173,104,1
24868,140,3246,77,34,69,0,0,8,77,3,24,16,29,27,45,114,213,1,387,21,0,3,154,77,1
24869,140,3246,712,438,573,51,9,84,763,14,102,71,128,116,199,733,1364,8,11988,666,0,3,154,77,1
24870,24,605,2,2,2,0,0,0,2,0,0,0,0,0,0,0,0,0,0,0,0,3,45,28,1
24871,24,605,99,48,90,1,3,5,100,0,0,0,0,0,0,0,0,0,0,0,0,3,45,28,1
24872,24,605,8,5,5,2,0,1,10,0,0,0,0,0,0,0,0,0,0,0,0,3,45,28,1
24873,24,605,1217,716,841,84,126,174,1301,14,185,118,215,199,333,1446,2542,8,20687,1149,0,3,45,28,1
24874,24,605,160,89,115,0,13,31,160,7,15,11,17,22,28,78,124,3,495,27,0,3,45,28,1
24875,24,605,10,10,9,9,0,0,19,0,0,0,0,0,0,0,0,0,0,0,0,3,45,28,1
24876,24,605,173,84,99,8,29,36,181,5,12,7,13,17,20,54,81,2,221,12,0,3,45,28,1
24877,24,605,3,1,1,3,0,0,6,0,0,0,0,0,0,0,0,0,0,0,0,3,45,28,1
24878,30,658,125,97,103,3,0,19,128,9,25,17,27,34,44,144,223,4,1087,60,0,3,23,21,1
24879,22,350,102,57,55,5,16,25,107,5,17,10,18,22,28,81,124,2,330,18,0,3,10,10,1
24880,84,1794,402,202,227,24,74,80,426,12,52,33,61,64,94,339,564,7,3969,220,0,3,70,42,1
24881,48,992,447,308,343,6,5,95,453,7,96,59,111,103,170,651,1136,4,4600,255,0,3,17,18,1
24882,48,992,322,174,179,16,74,51,338,10,41,26,46,51,72,252,408,5,2291,127,0,3,17,18,1
24883,74,1669,53,23,39,0,0,13,53,2,8,4,8,10,12,26,39,1,39,2,0,3,61,28,1
24884,74,1669,515,298,307,33,80,99,548,12,63,44,77,75,121,419,753,7,5527,307,0,3,61,28,1
24885,23,381,424,94,331,4,0,89,428,1,5,5,5,6,10,11,25,0,12,0,0,3,14,14,1
24886,23,381,38,23,23,6,0,8,44,3,11,7,11,14,18,42,68,1,102,5,0,3,14,14,1
24887,20,511,205,80,86,16,53,53,221,7,18,10,19,25,29,94,134,3,497,27,0,3,25,14,1
24888,17,519,184,100,137,2,15,30,186,6,38,20,39,44,59,214,322,3,991,55,0,3,30,21,1
24889,17,519,103,65,74,8,5,16,111,7,17,9,17,24,26,89,119,3,417,23,0,3,30,21,1
24890,2,71,167,116,138,4,5,22,171,8,48,30,56,56,86,292,499,4,2330,129,0,0,13,0,1
24891,231,5436,722,423,573,19,0,135,741,12,172,101,199,184,300,1320,2257,6,15668,870,0,3,140,79,1
24892,231,5436,1508,847,911,44,250,301,1552,14,148,88,169,162,257,1120,1886,7,15077,837,0,3,140,79,1
24893,310,6786,72,33,56,0,4,12,72,1,1,1,1,2,2,0,2,0,1,0,0,3,298,186,1
24894,310,6786,1454,835,1044,76,110,219,1530,17,275,158,296,292,454,2297,3718,9,34017,1889,1,3,298,186,1
24895,78,1601,757,253,292,73,244,162,830,13,61,38,67,74,105,409,651,7,4654,258,0,3,53,33,1
24896,46,954,386,256,301,16,9,68,402,4,59,35,69,63,104,355,621,2,1453,80,0,3,23,16,1
24897,46,954,264,131,164,11,41,46,275,6,38,22,40,44,62,214,338,3,1068,59,0,3,23,16,1
24898,28,702,466,257,367,18,25,50,484,7,126,86,171,133,257,898,1813,4,8612,478,0,0,196,0,1
24899,28,702,507,281,342,29,59,88,536,10,53,29,57,63,86,336,514,5,2764,153,0,0,196,0,1
24900,30,650,215,129,180,6,0,29,221,8,65,43,72,73,115,415,711,4,3153,175,0,3,24,18,1
24901,30,650,97,69,77,3,3,16,100,6,22,13,23,28,36,113,173,3,542,30,0,3,24,18,1
24902,90,1927,1043,504,840,53,9,147,1096,9,180,112,198,189,310,1377,2344,4,11604,644,0,3,77,216,1
24903,90,1927,383,288,292,26,6,62,409,11,65,38,67,76,105,429,656,5,3719,206,0,3,77,216,1
24904,20,411,294,64,250,0,0,43,294,1,20,10,20,21,30,86,131,0,65,3,0,3,30,20,1
24905,20,411,78,46,62,3,0,14,81,3,8,4,8,11,12,28,41,1,62,3,0,3,30,20,1
24906,5,119,110,30,77,3,13,16,113,4,21,15,30,25,45,100,208,2,597,33,0,3,7,3,1
24907,5,119,28,15,21,1,0,6,29,0,0,0,0,0,0,0,0,0,0,0,0,3,7,3,1
24908,70,1382,1178,367,1042,6,15,115,1184,9,94,51,95,103,146,644,976,4,4439,246,0,3,78,69,1
24909,70,1382,177,108,140,8,0,27,185,6,30,16,32,36,48,162,248,3,794,44,0,3,78,69,1
24910,209,4552,1943,715,1694,26,18,214,1969,12,185,120,237,197,357,1436,2721,7,20915,1161,0,3,222,138,1
24911,209,4552,1168,838,957,57,25,144,1225,19,348,224,416,367,640,3018,5452,11,61921,3440,1,3,222,138,1
24912,16,480,442,244,305,14,16,103,456,11,68,45,75,79,120,452,756,6,4588,254,0,3,11,8,1
24913,16,480,182,102,99,11,40,35,193,3,11,6,11,14,17,42,64,1,97,5,0,3,11,8,1
24914,62,1226,1098,241,925,5,10,155,1103,7,46,25,49,53,74,273,423,3,1580,87,0,3,42,28,1
24915,62,1226,282,202,222,14,2,44,296,8,42,24,43,50,67,250,378,4,1548,86,0,3,42,28,1
24916,22,458,601,196,481,2,23,85,603,8,63,36,72,71,108,400,664,4,3036,168,0,3,35,20,1
24917,22,458,156,79,106,5,16,28,161,5,14,8,15,19,23,64,97,2,261,14,0,3,35,20,1
24918,92,3868,1289,550,1043,56,32,155,1345,10,167,93,185,177,278,1266,2075,5,11498,638,0,2,307,281,1
24919,36,1088,182,127,129,0,0,53,182,5,39,21,42,44,63,217,343,2,926,51,0,2,40,34,1
24920,147,6910,1392,870,1177,35,17,170,1427,14,494,280,531,508,811,4473,7289,7,54850,3047,2,2,268,173,1
24921,88,2881,773,419,590,28,0,166,801,10,204,113,217,214,330,1598,2554,5,13587,754,0,2,153,84,1
24922,15,744,75,38,59,1,3,12,76,2,4,2,4,6,6,10,15,1,15,0,0,2,139,77,1
24923,1,15,127,75,83,2,11,30,129,4,14,7,14,18,21,61,87,2,175,9,0,0,4,0,1
24924,1,15,652,304,544,16,6,88,668,6,89,51,101,95,152,591,998,3,3399,188,0,0,4,0,1
24925,1,15,2,2,2,0,0,0,2,0,0,0,0,0,0,0,0,0,0,0,0,0,4,0,1
24926,1,15,8,5,5,0,0,3,8,0,0,0,0,0,0,0,0,0,0,0,0,0,4,0,1
24927,1,15,2,2,2,0,0,0,2,0,0,0,0,0,0,0,0,0,0,0,0,0,4,0,1
24928,1,15,14,8,8,0,0,6,14,0,0,0,0,0,0,0,0,0,0,0,0,0,4,0,1
24929,1,15,6,4,4,0,0,2,6,0,0,0,0,0,0,0,0,0,0,0,0,0,4,0,1
24930,1,15,6,4,4,0,0,2,6,1,2,1,2,3,3,2,4,0,2,0,0,0,4,0,1
24931,1,15,6,4,4,0,0,2,6,0,0,0,0,0,0,0,0,0,0,0,0,0,4,0,1
24932,1,15,7,5,5,0,0,2,7,0,0,0,0,0,0,0,0,0,0,0,0,0,4,0,1
24933,1,15,6,4,4,0,0,2,6,0,0,0,0,0,0,0,0,0,0,0,0,0,4,0,1
24934,1,15,10,6,6,0,0,4,10,0,0,0,0,0,0,0,0,0,0,0,0,0,4,0,1
24935,1,15,1,1,1,0,0,0,1,0,0,0,0,0,0,0,0,0,0,0,0,0,4,0,1
24936,1,15,1,1,1,0,0,0,1,0,0,0,0,0,0,0,0,0,0,0,0,0,4,0,1
24937,1,15,14,10,10,0,0,4,14,1,1,1,1,2,2,0,2,0,1,0,0,0,4,0,1
24938,1,15,46,26,30,3,0,12,49,3,6,3,6,9,9,20,28,1,42,2,0,0,4,0,1
24939,2,51,127,75,83,2,11,30,129,4,14,7,14,18,21,61,87,2,175,9,0,0,14,0,1
24940,2,51,652,304,544,16,6,88,668,6,89,51,101,95,152,591,998,3,3399,188,0,0,14,0,1
24941,2,51,2,2,2,0,0,0,2,0,0,0,0,0,0,0,0,0,0,0,0,0,14,0,1
24942,2,51,8,5,5,0,0,3,8,0,0,0,0,0,0,0,0,0,0,0,0,0,14,0,1
24943,2,51,2,2,2,0,0,0,2,0,0,0,0,0,0,0,0,0,0,0,0,0,14,0,1
24944,2,51,14,8,8,0,0,6,14,0,0,0,0,0,0,0,0,0,0,0,0,0,14,0,1
24945,2,51,6,4,4,0,0,2,6,0,0,0,0,0,0,0,0,0,0,0,0,0,14,0,1
24946,2,51,6,4,4,0,0,2,6,1,2,1,2,3,3,2,4,0,2,0,0,0,14,0,1
24947,2,51,6,4,4,0,0,2,6,0,0,0,0,0,0,0,0,0,0,0,0,0,14,0,1
24948,2,51,7,5,5,0,0,2,7,0,0,0,0,0,0,0,0,0,0,0,0,0,14,0,1
24949,2,51,6,4,4,0,0,2,6,0,0,0,0,0,0,0,0,0,0,0,0,0,14,0,1
24950,2,51,10,6,6,0,0,4,10,0,0,0,0,0,0,0,0,0,0,0,0,0,14,0,1
24951,2,51,1,1,1,0,0,0,1,0,0,0,0,0,0,0,0,0,0,0,0,0,14,0,1
24952,2,51,1,1,1,0,0,0,1,0,0,0,0,0,0,0,0,0,0,0,0,0,14,0,1
24953,2,51,14,10,10,0,0,4,14,1,1,1,1,2,2,0,2,0,1,0,0,0,14,0,1
24954,2,51,46,26,30,3,0,12,49,3,6,3,6,9,9,20,28,1,42,2,0,0,14,0,1
24955,1,6,2,2,2,0,0,0,2,0,0,0,0,0,0,0,0,0,0,0,0,0,2,0,1
24956,8,263,51,25,36,0,0,15,51,3,11,6,12,14,18,42,68,1,112,6,0,0,51,0,1
24957,1,18,3,3,3,0,0,0,3,0,0,0,0,0,0,0,0,0,0,0,0,0,3,0,1
24958,2,26,6,4,4,0,0,2,6,1,4,2,4,5,6,8,13,0,6,0,0,2,2,3,1
24959,15,703,139,89,101,2,0,35,141,7,54,34,62,61,96,330,569,4,2287,127,0,2,66,48,1
24960,1,136,149,67,118,4,0,27,153,1,17,14,28,18,42,69,175,0,144,8,0,2,13,7,1
24961,32,2079,1157,318,931,29,22,177,1186,6,104,63,125,110,188,712,1274,3,4596,255,0,2,414,274,1
24962,56,3685,520,294,400,33,13,81,553,10,261,204,367,271,571,2128,4614,7,32445,1802,1,2,94,93,1
24963,98,4433,1338,495,1086,10,64,173,1348,11,122,82,157,133,239,883,1686,7,11934,663,0,2,472,291,1
24964,174,7788,139,89,101,2,0,35,141,7,54,34,62,61,96,330,569,4,2287,127,0,2,1208,625,1
24965,174,7788,7,5,5,0,0,2,7,1,2,1,2,3,3,2,4,0,2,0,0,2,1208,625,1
24966,33,1004,465,148,393,5,8,60,470,4,31,20,31,35,51,161,261,2,523,29,0,2,94,55,1
24967,33,1004,16,12,9,0,0,6,16,1,2,1,2,3,3,2,4,0,2,0,0,2,94,55,1
24968,139,5895,1782,648,1425,9,47,279,1791,8,171,97,189,179,286,1292,2140,4,9462,525,0,2,485,358,1
24969,25,684,256,139,192,9,7,47,265,4,23,12,24,27,36,112,171,2,357,19,0,2,28,23,1
24970,6,328,180,34,164,0,0,16,180,1,12,6,12,13,18,43,66,0,33,1,0,2,89,64,1
24971,23,578,102,59,69,5,3,24,107,6,22,15,28,28,43,113,206,3,789,43,0,2,31,21,1
24972,111,4174,1450,624,1228,12,26,181,1462,14,306,186,354,320,540,2580,4493,8,36391,2021,1,2,479,386,1
24973,154,4337,1660,832,1314,41,38,274,1701,20,312,209,395,332,604,2671,5058,12,64042,3557,1,2,303,192,1
24974,39,2966,996,429,845,24,10,117,1020,7,76,50,88,83,138,494,879,4,3565,198,0,2,418,318,1
24975,125,5131,1513,682,1277,25,13,200,1538,11,199,116,219,210,335,1557,2584,6,15641,868,0,2,382,294,1
24976,73,3805,1296,573,1062,40,33,157,1336,8,201,118,231,209,349,1561,2689,4,12365,686,0,2,268,193,1
24977,14,341,207,111,150,11,0,50,218,5,26,19,36,31,55,133,272,3,943,52,0,2,21,16,1
24978,84,4438,1457,730,1242,11,6,188,1468,10,292,166,329,302,495,2424,4078,5,22973,1276,1,2,425,271,1
24979,39,2323,652,304,544,16,6,88,668,6,89,51,101,95,152,591,998,3,3399,188,0,2,177,112,1
24980,70,3212,1455,414,1257,16,76,112,1471,5,41,23,46,46,69,231,381,2,1069,59,0,2,529,351,1
24981,2,75,7,6,5,0,0,2,7,1,1,1,2,2,3,0,3,1,3,0,0,2,4,4,1
24982,8,271,74,35,59,1,0,14,75,3,14,7,14,17,21,58,85,1,128,7,0,2,19,24,1
24983,95,4640,1523,757,1297,19,12,193,1542,12,193,117,230,205,347,1508,2664,7,19053,1058,0,2,324,197,1
24984,94,4062,1020,354,843,12,15,144,1032,8,134,77,144,142,221,970,1580,4,6792,377,0,2,478,214,1
24985,38,1676,447,308,343,6,5,95,453,7,96,59,111,103,170,651,1136,4,4600,255,0,2,95,72,1
24986,1,107,53,23,39,0,0,13,53,2,8,4,8,10,12,26,39,1,39,2,0,2,13,10,1
24987,21,658,424,94,331,4,0,89,428,1,5,5,5,6,10,11,25,0,12,0,0,2,83,60,1
24988,38,2302,334,251,279,10,4,40,344,5,127,74,143,132,217,899,1528,2,4303,239,0,2,114,97,1
24989,12,493,184,100,137,2,15,30,186,6,38,20,39,44,59,214,322,3,991,55,0,2,46,34,1
24990,59,2582,1293,570,1093,25,15,163,1318,10,195,123,241,205,364,1516,2795,6,17273,959,0,2,202,124,1
24991,33,1883,384,251,317,7,8,52,391,11,70,44,84,81,128,467,811,6,5355,297,0,2,70,55,1
24992,45,2209,722,423,573,19,0,135,741,12,172,101,199,184,300,1320,2257,6,15668,870,0,2,56,38,1
24993,39,1727,386,256,301,16,9,68,402,4,59,35,69,63,104,355,621,2,1453,80,0,2,88,52,1
24994,16,1214,215,129,180,6,0,29,221,8,65,43,72,73,115,415,711,4,3153,175,0,2,75,60,1
24995,82,3159,1043,504,840,53,9,147,1096,9,180,112,198,189,310,1377,2344,4,11604,644,0,2,259,152,1
24996,14,530,295,56,236,0,4,54,295,2,9,5,10,11,15,30,51,1,57,3,0,2,85,52,1
24997,30,1241,373,158,315,8,0,51,381,5,76,44,79,81,123,486,779,2,2026,112,0,2,87,45,1
24998,77,3213,1178,367,1042,6,15,115,1184,9,94,51,95,103,146,644,976,4,4439,246,0,2,459,375,1
24999,91,4597,1943,715,1694,26,18,214,1969,12,185,120,237,197,357,1436,2721,7,20915,1161,0,2,578,519,1
25000,14,826,442,244,305,14,16,103,456,11,68,45,75,79,120,452,756,6,4588,254,0,2,56,34,1
25001,49,1838,1098,241,925,5,10,155,1103,7,46,25,49,53,74,273,423,3,1580,87,0,2,333,172,1
25002,19,680,601,196,481,2,23,85,603,8,63,36,72,71,108,400,664,4,3036,168,0,2,138,107,1
25003,247,5639,4293,999,3693,19,54,507,4312,9,155,88,170,164,258,1156,1898,4,9368,520,0,2,17,10,0
25004,247,5639,1482,859,1002,125,135,219,1607,16,219,134,251,235,385,1766,3032,9,27804,1544,1,2,17,10,0
25005,247,5639,4293,999,3693,19,54,507,4312,9,155,88,170,164,258,1156,1898,4,9368,520,0,2,44,14,0
25006,247,5639,1482,859,1002,125,135,219,1607,16,219,134,251,235,385,1766,3032,9,27804,1544,1,2,44,14,0
25007,140,3246,77,34,69,0,0,8,77,3,24,16,29,27,45,114,213,1,387,21,0,2,58,9,0
25008,140,3246,712,438,573,51,9,84,763,14,102,71,128,116,199,733,1364,8,11988,666,0,2,58,9,0
25009,74,1669,53,23,39,0,0,13,53,2,8,4,8,10,12,26,39,1,39,2,0,2,1,1,0
25010,74,1669,515,298,307,33,80,99,548,12,63,44,77,75,121,419,753,7,5527,307,0,2,1,1,0
25011,310,6786,72,33,56,0,4,12,72,1,1,1,1,2,2,0,2,0,1,0,0,2,76,1,0
25012,310,6786,1454,835,1044,76,110,219,1530,17,275,158,296,292,454,2297,3718,9,34017,1889,1,2,76,1,0
25013,98,4433,1338,495,1086,10,64,173,1348,11,122,82,157,133,239,883,1686,7,11934,663,0,2,1,1,0
25014,174,7788,139,89,101,2,0,35,141,7,54,34,62,61,96,330,569,4,2287,127,0,2,112,5,0
25015,174,7788,7,5,5,0,0,2,7,1,2,1,2,3,3,2,4,0,2,0,0,2,112,5,0
25016,73,3805,1296,573,1062,40,33,157,1336,8,201,118,231,209,349,1561,2689,4,12365,686,0,2,2,2,0
25017,34,995,339,213,244,17,9,65,356,10,42,26,48,52,74,259,421,5,2410,133,0,2,37,2,0
25018,61,2731,1293,570,1093,25,15,163,1318,10,195,123,241,205,364,1516,2795,6,17273,959,0,2,37,0,0
25019,226,5282,722,423,573,19,0,135,741,12,172,101,199,184,300,1320,2257,6,15668,870,0,2,1,8,1
25020,226,5282,1508,847,911,44,250,301,1552,14,148,88,169,162,257,1120,1886,7,15077,837,0,2,1,8,1
25021,46,2234,722,423,573,19,0,135,741,12,172,101,199,184,300,1320,2257,6,15668,870,0,2,5,0,1
25022,226,5282,722,423,573,19,0,135,741,12,172,101,199,184,300,1320,2257,6,15668,870,0,2,1,8,0
25023,226,5282,1508,847,911,44,250,301,1552,14,148,88,169,162,257,1120,1886,7,15077,837,0,2,1,8,0
25024,46,2234,722,423,573,19,0,135,741,12,172,101,199,184,300,1320,2257,6,15668,870,0,2,5,0,0
25025,84,1801,773,419,590,28,0,166,801,10,204,113,217,214,330,1598,2554,5,13587,754,0,2,3,10,0
25026,84,1801,421,273,302,44,34,57,465,17,81,59,107,98,166,583,1098,11,12329,684,0,2,3,10,0
25027,25,684,256,139,192,9,7,47,265,4,23,12,24,27,36,112,171,2,357,19,0,2,1,2,0
25028,154,4337,1660,832,1314,41,38,274,1701,20,312,209,395,332,604,2671,5058,12,64042,3557,1,2,3,3,0
25029,125,5127,1513,682,1277,25,13,200,1538,11,199,116,219,210,335,1557,2584,6,15641,868,0,2,0,1,0
25030,84,1801,773,419,590,28,0,166,801,10,204,113,217,214,330,1598,2554,5,13587,754,0,2,3,10,0
25031,84,1801,421,273,302,44,34,57,465,17,81,59,107,98,166,583,1098,11,12329,684,0,2,3,10,0
25032,25,684,256,139,192,9,7,47,265,4,23,12,24,27,36,112,171,2,357,19,0,2,1,2,0
25033,154,4337,1660,832,1314,41,38,274,1701,20,312,209,395,332,604,2671,5058,12,64042,3557,1,2,3,3,0
25034,125,5127,1513,682,1277,25,13,200,1538,11,199,116,219,210,335,1557,2584,6,15641,868,0,2,0,1,0
25035,92,2959,773,419,590,28,0,166,801,10,204,113,217,214,330,1598,2554,5,13587,754,0,2,16,0,0
25036,58,1174,207,111,150,11,0,50,218,5,26,19,36,31,55,133,272,3,943,52,0,2,2,2,0
25037,58,1174,410,198,237,31,55,97,441,11,63,38,72,74,110,414,683,6,4293,238,0,2,2,2,0
25038,211,4551,2,2,2,0,0,0,2,0,0,0,0,0,0,0,0,0,0,0,0,2,1,1,0
25039,211,4551,99,48,90,1,3,5,100,0,0,0,0,0,0,0,0,0,0,0,0,2,1,1,0
25040,211,4551,8,5,5,2,0,1,10,0,0,0,0,0,0,0,0,0,0,0,0,2,1,1,0
25041,211,4551,1217,716,841,84,126,174,1301,14,185,118,215,199,333,1446,2542,8,20687,1149,0,2,1,1,0
25042,211,4551,160,89,115,0,13,31,160,7,15,11,17,22,28,78,124,3,495,27,0,2,1,1,0
25043,211,4551,10,10,9,9,0,0,19,0,0,0,0,0,0,0,0,0,0,0,0,2,1,1,0
25044,211,4551,173,84,99,8,29,36,181,5,12,7,13,17,20,54,81,2,221,12,0,2,1,1,0
25045,211,4551,3,1,1,3,0,0,6,0,0,0,0,0,0,0,0,0,0,0,0,2,1,1,0
25046,154,4337,1660,832,1314,41,38,274,1701,20,312,209,395,332,604,2671,5058,12,64042,3557,1,2,1,1,0
25047,46,2233,722,423,573,19,0,135,741,12,172,101,199,184,300,1320,2257,6,15668,870,0,2,1,4,0
25048,58,1174,207,111,150,11,0,50,218,5,26,19,36,31,55,133,272,3,943,52,0,2,2,2,0
25049,58,1174,410,198,237,31,55,97,441,11,63,38,72,74,110,414,683,6,4293,238,0,2,2,2,0
25050,211,4551,2,2,2,0,0,0,2,0,0,0,0,0,0,0,0,0,0,0,0,2,1,1,0
25051,211,4551,99,48,90,1,3,5,100,0,0,0,0,0,0,0,0,0,0,0,0,2,1,1,0
25052,211,4551,8,5,5,2,0,1,10,0,0,0,0,0,0,0,0,0,0,0,0,2,1,1,0
25053,211,4551,1217,716,841,84,126,174,1301,14,185,118,215,199,333,1446,2542,8,20687,1149,0,2,1,1,0
25054,211,4551,160,89,115,0,13,31,160,7,15,11,17,22,28,78,124,3,495,27,0,2,1,1,0
25055,211,4551,10,10,9,9,0,0,19,0,0,0,0,0,0,0,0,0,0,0,0,2,1,1,0
25056,211,4551,173,84,99,8,29,36,181,5,12,7,13,17,20,54,81,2,221,12,0,2,1,1,0
25057,211,4551,3,1,1,3,0,0,6,0,0,0,0,0,0,0,0,0,0,0,0,2,1,1,0
25058,154,4337,1660,832,1314,41,38,274,1701,20,312,209,395,332,604,2671,5058,12,64042,3557,1,2,1,1,0
25059,46,2233,722,423,573,19,0,135,741,12,172,101,199,184,300,1320,2257,6,15668,870,0,2,1,4,0
25060,92,2959,773,419,590,28,0,166,801,10,204,113,217,214,330,1598,2554,5,13587,754,0,2,16,0,0
25061,84,1801,773,419,590,28,0,166,801,10,204,113,217,214,330,1598,2554,5,13587,754,0,2,3,10,0
25062,84,1801,421,273,302,44,34,57,465,17,81,59,107,98,166,583,1098,11,12329,684,0,2,3,10,0
25063,58,1174,207,111,150,11,0,50,218,5,26,19,36,31,55,133,272,3,943,52,0,2,2,2,0
25064,58,1174,410,198,237,31,55,97,441,11,63,38,72,74,110,414,683,6,4293,238,0,2,2,2,0
25065,211,4551,2,2,2,0,0,0,2,0,0,0,0,0,0,0,0,0,0,0,0,2,1,1,0
25066,211,4551,99,48,90,1,3,5,100,0,0,0,0,0,0,0,0,0,0,0,0,2,1,1,0
25067,211,4551,8,5,5,2,0,1,10,0,0,0,0,0,0,0,0,0,0,0,0,2,1,1,0
25068,211,4551,1217,716,841,84,126,174,1301,14,185,118,215,199,333,1446,2542,8,20687,1149,0,2,1,1,0
25069,211,4551,160,89,115,0,13,31,160,7,15,11,17,22,28,78,124,3,495,27,0,2,1,1,0
25070,211,4551,10,10,9,9,0,0,19,0,0,0,0,0,0,0,0,0,0,0,0,2,1,1,0
25071,211,4551,173,84,99,8,29,36,181,5,12,7,13,17,20,54,81,2,221,12,0,2,1,1,0
25072,211,4551,3,1,1,3,0,0,6,0,0,0,0,0,0,0,0,0,0,0,0,2,1,1,0
25073,84,1794,402,202,227,24,74,80,426,12,52,33,61,64,94,339,564,7,3969,220,0,2,1,1,0
25074,226,5282,722,423,573,19,0,135,741,12,172,101,199,184,300,1320,2257,6,15668,870,0,2,1,8,0
25075,226,5282,1508,847,911,44,250,301,1552,14,148,88,169,162,257,1120,1886,7,15077,837,0,2,1,8,0
25076,92,2959,773,419,590,28,0,166,801,10,204,113,217,214,330,1598,2554,5,13587,754,0,2,16,0,0
25077,25,684,256,139,192,9,7,47,265,4,23,12,24,27,36,112,171,2,357,19,0,2,1,2,0
25078,154,4337,1660,832,1314,41,38,274,1701,20,312,209,395,332,604,2671,5058,12,64042,3557,1,2,4,4,0
25079,125,5127,1513,682,1277,25,13,200,1538,11,199,116,219,210,335,1557,2584,6,15641,868,0,2,0,1,0
25080,46,2233,722,423,573,19,0,135,741,12,172,101,199,184,300,1320,2257,6,15668,870,0,2,6,4,0
25081,288,6363,72,33,56,0,4,12,72,1,1,1,1,2,2,0,2,0,1,0,0,2,90,46,0
25082,288,6363,1454,835,1044,76,110,219,1530,17,275,158,296,292,454,2297,3718,9,34017,1889,1,2,90,46,0
25083,86,1828,402,202,227,24,74,80,426,12,52,33,61,64,94,339,564,7,3969,220,0,2,13,1,0
25084,287,6329,72,33,56,0,4,12,72,1,1,1,1,2,2,0,2,0,1,0,0,2,4,13,0
25085,287,6329,1454,835,1044,76,110,219,1530,17,275,158,296,292,454,2297,3718,9,34017,1889,1,2,4,13,0
25086,236,5588,722,423,573,19,0,135,741,12,172,101,199,184,300,1320,2257,6,15668,870,0,2,37,9,0
25087,236,5588,1508,847,911,44,250,301,1552,14,148,88,169,162,257,1120,1886,7,15077,837,0,2,37,9,0
25088,1,26,127,75,83,2,11,30,129,4,14,7,14,18,21,61,87,2,175,9,0,0,7,0,0
25089,1,26,652,304,544,16,6,88,668,6,89,51,101,95,152,591,998,3,3399,188,0,0,7,0,0
25090,1,26,2,2,2,0,0,0,2,0,0,0,0,0,0,0,0,0,0,0,0,0,7,0,0
25091,1,26,8,5,5,0,0,3,8,0,0,0,0,0,0,0,0,0,0,0,0,0,7,0,0
25092,1,26,2,2,2,0,0,0,2,0,0,0,0,0,0,0,0,0,0,0,0,0,7,0,0
25093,1,26,14,8,8,0,0,6,14,0,0,0,0,0,0,0,0,0,0,0,0,0,7,0,0
25094,1,26,6,4,4,0,0,2,6,0,0,0,0,0,0,0,0,0,0,0,0,0,7,0,0
25095,1,26,6,4,4,0,0,2,6,1,2,1,2,3,3,2,4,0,2,0,0,0,7,0,0
25096,1,26,6,4,4,0,0,2,6,0,0,0,0,0,0,0,0,0,0,0,0,0,7,0,0
25097,1,26,7,5,5,0,0,2,7,0,0,0,0,0,0,0,0,0,0,0,0,0,7,0,0
25098,1,26,6,4,4,0,0,2,6,0,0,0,0,0,0,0,0,0,0,0,0,0,7,0,0
25099,1,26,10,6,6,0,0,4,10,0,0,0,0,0,0,0,0,0,0,0,0,0,7,0,0
25100,1,26,1,1,1,0,0,0,1,0,0,0,0,0,0,0,0,0,0,0,0,0,7,0,0
25101,1,26,1,1,1,0,0,0,1,0,0,0,0,0,0,0,0,0,0,0,0,0,7,0,0
25102,1,26,14,10,10,0,0,4,14,1,1,1,1,2,2,0,2,0,1,0,0,0,7,0,0
25103,1,26,46,26,30,3,0,12,49,3,6,3,6,9,9,20,28,1,42,2,0,0,7,0,0
25104,1,7,2,2,2,0,0,0,2,0,0,0,0,0,0,0,0,0,0,0,0,0,2,0,0
25105,1,20,127,75,83,2,11,30,129,4,14,7,14,18,21,61,87,2,175,9,0,0,7,0,0
25106,1,20,652,304,544,16,6,88,668,6,89,51,101,95,152,591,998,3,3399,188,0,0,7,0,0
25107,1,20,2,2,2,0,0,0,2,0,0,0,0,0,0,0,0,0,0,0,0,0,7,0,0
25108,1,20,8,5,5,0,0,3,8,0,0,0,0,0,0,0,0,0,0,0,0,0,7,0,0
25109,1,20,2,2,2,0,0,0,2,0,0,0,0,0,0,0,0,0,0,0,0,0,7,0,0
25110,1,20,14,8,8,0,0,6,14,0,0,0,0,0,0,0,0,0,0,0,0,0,7,0,0
25111,1,20,6,4,4,0,0,2,6,0,0,0,0,0,0,0,0,0,0,0,0,0,7,0,0
25112,1,20,6,4,4,0,0,2,6,1,2,1,2,3,3,2,4,0,2,0,0,0,7,0,0
25113,1,20,6,4,4,0,0,2,6,0,0,0,0,0,0,0,0,0,0,0,0,0,7,0,0
25114,1,20,7,5,5,0,0,2,7,0,0,0,0,0,0,0,0,0,0,0,0,0,7,0,0
25115,1,20,6,4,4,0,0,2,6,0,0,0,0,0,0,0,0,0,0,0,0,0,7,0,0
25116,1,20,10,6,6,0,0,4,10,0,0,0,0,0,0,0,0,0,0,0,0,0,7,0,0
25117,1,20,1,1,1,0,0,0,1,0,0,0,0,0,0,0,0,0,0,0,0,0,7,0,0
25118,1,20,1,1,1,0,0,0,1,0,0,0,0,0,0,0,0,0,0,0,0,0,7,0,0
25119,1,20,14,10,10,0,0,4,14,1,1,1,1,2,2,0,2,0,1,0,0,0,7,0,0
25120,1,20,46,26,30,3,0,12,49,3,6,3,6,9,9,20,28,1,42,2,0,0,7,0,0
25121,1,7,2,2,2,0,0,0,2,0,0,0,0,0,0,0,0,0,0,0,0,0,2,0,0
25122,1,13,127,75,83,2,11,30,129,4,14,7,14,18,21,61,87,2,175,9,0,0,6,0,0
25123,1,13,652,304,544,16,6,88,668,6,89,51,101,95,152,591,998,3,3399,188,0,0,6,0,0
25124,1,13,2,2,2,0,0,0,2,0,0,0,0,0,0,0,0,0,0,0,0,0,6,0,0
25125,1,13,8,5,5,0,0,3,8,0,0,0,0,0,0,0,0,0,0,0,0,0,6,0,0
25126,1,13,2,2,2,0,0,0,2,0,0,0,0,0,0,0,0,0,0,0,0,0,6,0,0
25127,1,13,14,8,8,0,0,6,14,0,0,0,0,0,0,0,0,0,0,0,0,0,6,0,0
25128,1,13,6,4,4,0,0,2,6,0,0,0,0,0,0,0,0,0,0,0,0,0,6,0,0
25129,1,13,6,4,4,0,0,2,6,1,2,1,2,3,3,2,4,0,2,0,0,0,6,0,0
25130,1,13,6,4,4,0,0,2,6,0,0,0,0,0,0,0,0,0,0,0,0,0,6,0,0
25131,1,13,7,5,5,0,0,2,7,0,0,0,0,0,0,0,0,0,0,0,0,0,6,0,0
25132,1,13,6,4,4,0,0,2,6,0,0,0,0,0,0,0,0,0,0,0,0,0,6,0,0
25133,1,13,10,6,6,0,0,4,10,0,0,0,0,0,0,0,0,0,0,0,0,0,6,0,0
25134,1,13,1,1,1,0,0,0,1,0,0,0,0,0,0,0,0,0,0,0,0,0,6,0,0
25135,1,13,1,1,1,0,0,0,1,0,0,0,0,0,0,0,0,0,0,0,0,0,6,0,0
25136,1,13,14,10,10,0,0,4,14,1,1,1,1,2,2,0,2,0,1,0,0,0,6,0,0
25137,1,13,46,26,30,3,0,12,49,3,6,3,6,9,9,20,28,1,42,2,0,0,6,0,0
25138,1,16,127,75,83,2,11,30,129,4,14,7,14,18,21,61,87,2,175,9,0,0,6,0,0
25139,1,16,652,304,544,16,6,88,668,6,89,51,101,95,152,591,998,3,3399,188,0,0,6,0,0
25140,1,16,2,2,2,0,0,0,2,0,0,0,0,0,0,0,0,0,0,0,0,0,6,0,0
25141,1,16,8,5,5,0,0,3,8,0,0,0,0,0,0,0,0,0,0,0,0,0,6,0,0
25142,1,16,2,2,2,0,0,0,2,0,0,0,0,0,0,0,0,0,0,0,0,0,6,0,0
25143,1,16,14,8,8,0,0,6,14,0,0,0,0,0,0,0,0,0,0,0,0,0,6,0,0
25144,1,16,6,4,4,0,0,2,6,0,0,0,0,0,0,0,0,0,0,0,0,0,6,0,0
25145,1,16,6,4,4,0,0,2,6,1,2,1,2,3,3,2,4,0,2,0,0,0,6,0,0
25146,1,16,6,4,4,0,0,2,6,0,0,0,0,0,0,0,0,0,0,0,0,0,6,0,0
25147,1,16,7,5,5,0,0,2,7,0,0,0,0,0,0,0,0,0,0,0,0,0,6,0,0
25148,1,16,6,4,4,0,0,2,6,0,0,0,0,0,0,0,0,0,0,0,0,0,6,0,0
25149,1,16,10,6,6,0,0,4,10,0,0,0,0,0,0,0,0,0,0,0,0,0,6,0,0
25150,1,16,1,1,1,0,0,0,1,0,0,0,0,0,0,0,0,0,0,0,0,0,6,0,0
25151,1,16,1,1,1,0,0,0,1,0,0,0,0,0,0,0,0,0,0,0,0,0,6,0,0
25152,1,16,14,10,10,0,0,4,14,1,1,1,1,2,2,0,2,0,1,0,0,0,6,0,0
25153,1,16,46,26,30,3,0,12,49,3,6,3,6,9,9,20,28,1,42,2,0,0,6,0,0
25154,1,10,2,2,2,0,0,0,2,1,2,1,2,3,3,2,4,0,2,0,0,0,2,0,0
25155,1,13,127,75,83,2,11,30,129,4,14,7,14,18,21,61,87,2,175,9,0,0,6,0,0
25156,1,13,652,304,544,16,6,88,668,6,89,51,101,95,152,591,998,3,3399,188,0,0,6,0,0
25157,1,13,2,2,2,0,0,0,2,0,0,0,0,0,0,0,0,0,0,0,0,0,6,0,0
25158,1,13,8,5,5,0,0,3,8,0,0,0,0,0,0,0,0,0,0,0,0,0,6,0,0
25159,1,13,2,2,2,0,0,0,2,0,0,0,0,0,0,0,0,0,0,0,0,0,6,0,0
25160,1,13,14,8,8,0,0,6,14,0,0,0,0,0,0,0,0,0,0,0,0,0,6,0,0
25161,1,13,6,4,4,0,0,2,6,0,0,0,0,0,0,0,0,0,0,0,0,0,6,0,0
25162,1,13,6,4,4,0,0,2,6,1,2,1,2,3,3,2,4,0,2,0,0,0,6,0,0
25163,1,13,6,4,4,0,0,2,6,0,0,0,0,0,0,0,0,0,0,0,0,0,6,0,0
25164,1,13,7,5,5,0,0,2,7,0,0,0,0,0,0,0,0,0,0,0,0,0,6,0,0
25165,1,13,6,4,4,0,0,2,6,0,0,0,0,0,0,0,0,0,0,0,0,0,6,0,0
25166,1,13,10,6,6,0,0,4,10,0,0,0,0,0,0,0,0,0,0,0,0,0,6,0,0
25167,1,13,1,1,1,0,0,0,1,0,0,0,0,0,0,0,0,0,0,0,0,0,6,0,0
25168,1,13,1,1,1,0,0,0,1,0,0,0,0,0,0,0,0,0,0,0,0,0,6,0,0
25169,1,13,14,10,10,0,0,4,14,1,1,1,1,2,2,0,2,0,1,0,0,0,6,0,0
25170,1,13,46,26,30,3,0,12,49,3,6,3,6,9,9,20,28,1,42,2,0,0,6,0,0
25171,2,26,10,6,6,0,0,4,10,2,4,2,4,6,6,10,15,1,15,0,0,0,10,0,0
25172,3,47,15,10,10,0,0,5,15,2,4,2,4,6,6,10,15,1,15,0,0,0,15,0,0
25173,3,39,15,9,9,0,0,6,15,0,0,0,0,0,0,0,0,0,0,0,0,0,16,0,0
25174,2,36,10,7,7,0,0,3,10,1,2,1,2,3,3,2,4,0,2,0,0,0,11,0,0
25175,3,46,15,9,9,0,0,6,15,1,4,2,4,5,6,8,13,0,6,0,0,0,15,0,0
25176,2,21,10,6,6,0,0,4,10,0,0,0,0,0,0,0,0,0,0,0,0,0,10,0,0
25177,175,7644,139,89,101,2,0,35,141,7,54,34,62,61,96,330,569,4,2287,127,0,2,94,220,0
25178,175,7644,7,5,5,0,0,2,7,1,2,1,2,3,3,2,4,0,2,0,0,2,94,220,0
25179,86,1828,402,202,227,24,74,80,426,12,52,33,61,64,94,339,564,7,3969,220,0,2,13,1,0
25180,287,6329,72,33,56,0,4,12,72,1,1,1,1,2,2,0,2,0,1,0,0,2,86,51,0
25181,287,6329,1454,835,1044,76,110,219,1530,17,275,158,296,292,454,2297,3718,9,34017,1889,1,2,86,51,0
25182,12,509,124,78,88,2,3,26,126,4,13,7,13,17,20,56,81,2,163,9,0,3,38,45,1
25183,86,1822,402,202,227,24,74,80,426,12,52,33,61,64,94,339,564,7,3969,220,0,2,2,2,1
25184,214,4654,182,127,129,0,0,53,182,5,39,21,42,44,63,217,343,2,926,51,0,2,8,1,1
25185,214,4654,1165,710,800,67,119,181,1232,18,243,153,282,261,435,2000,3492,10,36473,2026,1,2,8,1,1
25186,75,1692,53,23,39,0,0,13,53,2,8,4,8,10,12,26,39,1,39,2,0,2,6,0,1
25187,75,1692,515,298,307,33,80,99,548,12,63,44,77,75,121,419,753,7,5527,307,0,2,6,0,1
25188,149,6994,1392,870,1177,35,17,170,1427,14,494,280,531,508,811,4473,7289,7,54850,3047,2,2,12,0,1
25189,12,509,124,78,88,2,3,26,126,4,13,7,13,17,20,56,81,2,163,9,0,3,38,45,0
25190,86,1822,402,202,227,24,74,80,426,12,52,33,61,64,94,339,564,7,3969,220,0,2,2,2,0
25191,12,509,124,78,88,2,3,26,126,4,13,7,13,17,20,56,81,2,163,9,0,3,38,45,0
25192,84,1801,773,419,590,28,0,166,801,10,204,113,217,214,330,1598,2554,5,13587,754,0,2,3,10,0
25193,84,1801,421,273,302,44,34,57,465,17,81,59,107,98,166,583,1098,11,12329,684,0,2,3,10,0
25194,58,1192,207,111,150,11,0,50,218,5,26,19,36,31,55,133,272,3,943,52,0,2,2,2,0
25195,58,1192,410,198,237,31,55,97,441,11,63,38,72,74,110,414,683,6,4293,238,0,2,2,2,0
25196,211,4551,2,2,2,0,0,0,2,0,0,0,0,0,0,0,0,0,0,0,0,2,1,1,0
25197,211,4551,99,48,90,1,3,5,100,0,0,0,0,0,0,0,0,0,0,0,0,2,1,1,0
25198,211,4551,8,5,5,2,0,1,10,0,0,0,0,0,0,0,0,0,0,0,0,2,1,1,0
25199,211,4551,1217,716,841,84,126,174,1301,14,185,118,215,199,333,1446,2542,8,20687,1149,0,2,1,1,0
25200,211,4551,160,89,115,0,13,31,160,7,15,11,17,22,28,78,124,3,495,27,0,2,1,1,0
25201,211,4551,10,10,9,9,0,0,19,0,0,0,0,0,0,0,0,0,0,0,0,2,1,1,0
25202,211,4551,173,84,99,8,29,36,181,5,12,7,13,17,20,54,81,2,221,12,0,2,1,1,0
25203,211,4551,3,1,1,3,0,0,6,0,0,0,0,0,0,0,0,0,0,0,0,2,1,1,0
25204,86,1822,402,202,227,24,74,80,426,12,52,33,61,64,94,339,564,7,3969,220,0,2,15,3,0
25205,236,5564,722,423,573,19,0,135,741,12,172,101,199,184,300,1320,2257,6,15668,870,0,2,1,8,0
25206,236,5564,1508,847,911,44,250,301,1552,14,148,88,169,162,257,1120,1886,7,15077,837,0,2,1,8,0
25207,312,6821,72,33,56,0,4,12,72,1,1,1,1,2,2,0,2,0,1,0,0,2,86,51,0
25208,312,6821,1454,835,1044,76,110,219,1530,17,275,158,296,292,454,2297,3718,9,34017,1889,1,2,86,51,0
25209,92,2959,773,419,590,28,0,166,801,10,204,113,217,214,330,1598,2554,5,13587,754,0,2,16,0,0
25210,25,684,256,139,192,9,7,47,265,4,23,12,24,27,36,112,171,2,357,19,0,2,1,2,0
25211,154,4337,1660,832,1314,41,38,274,1701,20,312,209,395,332,604,2671,5058,12,64042,3557,1,2,4,4,0
25212,125,5127,1513,682,1277,25,13,200,1538,11,199,116,219,210,335,1557,2584,6,15641,868,0,2,0,1,0
25213,46,2233,722,423,573,19,0,135,741,12,172,101,199,184,300,1320,2257,6,15668,870,0,2,6,4,0
25214,214,4654,182,127,129,0,0,53,182,5,39,21,42,44,63,217,343,2,926,51,0,2,8,1,0
25215,214,4654,1165,710,800,67,119,181,1232,18,243,153,282,261,435,2000,3492,10,36473,2026,1,2,8,1,0
25216,75,1692,53,23,39,0,0,13,53,2,8,4,8,10,12,26,39,1,39,2,0,2,6,0,0
25217,75,1692,515,298,307,33,80,99,548,12,63,44,77,75,121,419,753,7,5527,307,0,2,6,0,0
25218,149,6994,1392,870,1177,35,17,170,1427,14,494,280,531,508,811,4473,7289,7,54850,3047,2,2,12,0,0
25219,12,509,124,78,88,2,3,26,126,4,13,7,13,17,20,56,81,2,163,9,0,3,38,45,0
25220,84,1801,773,419,590,28,0,166,801,10,204,113,217,214,330,1598,2554,5,13587,754,0,2,3,10,0
25221,84,1801,421,273,302,44,34,57,465,17,81,59,107,98,166,583,1098,11,12329,684,0,2,3,10,0
25222,58,1192,207,111,150,11,0,50,218,5,26,19,36,31,55,133,272,3,943,52,0,2,2,2,0
25223,58,1192,410,198,237,31,55,97,441,11,63,38,72,74,110,414,683,6,4293,238,0,2,2,2,0
25224,211,4551,2,2,2,0,0,0,2,0,0,0,0,0,0,0,0,0,0,0,0,2,1,1,0
25225,211,4551,99,48,90,1,3,5,100,0,0,0,0,0,0,0,0,0,0,0,0,2,1,1,0
25226,211,4551,8,5,5,2,0,1,10,0,0,0,0,0,0,0,0,0,0,0,0,2,1,1,0
25227,211,4551,1217,716,841,84,126,174,1301,14,185,118,215,199,333,1446,2542,8,20687,1149,0,2,1,1,0
25228,211,4551,160,89,115,0,13,31,160,7,15,11,17,22,28,78,124,3,495,27,0,2,1,1,0
25229,211,4551,10,10,9,9,0,0,19,0,0,0,0,0,0,0,0,0,0,0,0,2,1,1,0
25230,211,4551,173,84,99,8,29,36,181,5,12,7,13,17,20,54,81,2,221,12,0,2,1,1,0
25231,211,4551,3,1,1,3,0,0,6,0,0,0,0,0,0,0,0,0,0,0,0,2,1,1,0
25232,86,1822,402,202,227,24,74,80,426,12,52,33,61,64,94,339,564,7,3969,220,0,2,15,3,0
25233,236,5564,722,423,573,19,0,135,741,12,172,101,199,184,300,1320,2257,6,15668,870,0,2,1,8,0
25234,236,5564,1508,847,911,44,250,301,1552,14,148,88,169,162,257,1120,1886,7,15077,837,0,2,1,8,0
25235,312,6821,72,33,56,0,4,12,72,1,1,1,1,2,2,0,2,0,1,0,0,2,86,51,0
25236,312,6821,1454,835,1044,76,110,219,1530,17,275,158,296,292,454,2297,3718,9,34017,1889,1,2,86,51,0
25237,92,2959,773,419,590,28,0,166,801,10,204,113,217,214,330,1598,2554,5,13587,754,0,2,16,0,0
25238,25,684,256,139,192,9,7,47,265,4,23,12,24,27,36,112,171,2,357,19,0,2,1,2,0
25239,154,4337,1660,832,1314,41,38,274,1701,20,312,209,395,332,604,2671,5058,12,64042,3557,1,2,4,4,0
25240,125,5127,1513,682,1277,25,13,200,1538,11,199,116,219,210,335,1557,2584,6,15641,868,0,2,0,1,0
25241,46,2233,722,423,573,19,0,135,741,12,172,101,199,184,300,1320,2257,6,15668,870,0,2,6,4,0
25242,78,1609,757,253,292,73,244,162,830,13,61,38,67,74,105,409,651,7,4654,258,0,2,4,1,0
25243,247,5655,4293,999,3693,19,54,507,4312,9,155,88,170,164,258,1156,1898,4,9368,520,0,2,15,12,1
25244,247,5655,1482,859,1002,125,135,219,1607,16,219,134,251,235,385,1766,3032,9,27804,1544,1,2,15,12,1
25245,248,5674,4293,999,3693,19,54,507,4312,9,155,88,170,164,258,1156,1898,4,9368,520,0,2,17,9,0
25246,248,5674,1482,859,1002,125,135,219,1607,16,219,134,251,235,385,1766,3032,9,27804,1544,1,2,17,9,0
25247,245,5645,4293,999,3693,19,54,507,4312,9,155,88,170,164,258,1156,1898,4,9368,520,0,2,1,7,0
25248,245,5645,1482,859,1002,125,135,219,1607,16,219,134,251,235,385,1766,3032,9,27804,1544,1,2,1,7,0
25249,245,5645,4293,999,3693,19,54,507,4312,9,155,88,170,164,258,1156,1898,4,9368,520,0,2,33,28,0
25250,245,5645,1482,859,1002,125,135,219,1607,16,219,134,251,235,385,1766,3032,9,27804,1544,1,2,33,28,0
25251,1,319,382,65,130,157,2,92,539,4,10,5,10,14,15,41,57,2,114,6,0,2,1,1,0
25252,1,319,382,65,130,157,2,92,539,4,10,5,10,14,15,41,57,2,114,6,0,2,1,1,0
25253,57,3792,520,294,400,33,13,81,553,10,261,204,367,271,571,2128,4614,7,32445,1802,1,2,14,0,0
25254,78,1602,757,253,292,73,244,162,830,13,61,38,67,74,105,409,651,7,4654,258,0,2,3,4,0
25255,57,3898,520,294,400,33,13,81,553,10,261,204,367,271,571,2128,4614,7,32445,1802,1,2,8,1,0
25256,58,1198,207,111,150,11,0,50,218,5,26,19,36,31,55,133,272,3,943,52,0,2,1,0,1
25257,58,1198,410,198,237,31,55,97,441,11,63,38,72,74,110,414,683,6,4293,238,0,2,1,0,1
25258,255,5847,4293,999,3693,19,54,507,4312,9,155,88,170,164,258,1156,1898,4,9368,520,0,2,51,1,1
25259,255,5847,1482,859,1002,125,135,219,1607,16,219,134,251,235,385,1766,3032,9,27804,1544,1,2,51,1,1
25260,237,5596,722,423,573,19,0,135,741,12,172,101,199,184,300,1320,2257,6,15668,870,0,2,5,0,1
25261,237,5596,1508,847,911,44,250,301,1552,14,148,88,169,162,257,1120,1886,7,15077,837,0,2,5,0,1
25262,17,774,75,38,59,1,3,12,76,2,4,2,4,6,6,10,15,1,15,0,0,2,14,0,1
25263,1,41,7,5,5,0,0,2,7,1,2,1,2,3,3,2,4,0,2,0,0,0,7,0,1
25264,175,7644,139,89,101,2,0,35,141,7,54,34,62,61,96,330,569,4,2287,127,0,2,6,3,1
25265,175,7644,7,5,5,0,0,2,7,1,2,1,2,3,3,2,4,0,2,0,0,2,6,3,1
25266,111,4178,1450,624,1228,12,26,181,1462,14,306,186,354,320,540,2580,4493,8,36391,2021,1,2,6,7,1
25267,39,2321,652,304,544,16,6,88,668,6,89,51,101,95,152,591,998,3,3399,188,0,2,1,3,1
25268,14,717,442,244,305,14,16,103,456,11,68,45,75,79,120,452,756,6,4588,254,0,2,3,28,1
25269,139,5919,1782,648,1425,9,47,279,1791,8,171,97,189,179,286,1292,2140,4,9462,525,0,2,3,0,1
25270,236,5564,722,423,573,19,0,135,741,12,172,101,199,184,300,1320,2257,6,15668,870,0,2,0,5,0
25271,236,5564,1508,847,911,44,250,301,1552,14,148,88,169,162,257,1120,1886,7,15077,837,0,2,0,5,0
25272,14,725,442,244,305,14,16,103,456,11,68,45,75,79,120,452,756,6,4588,254,0,2,2,1,0
25273,79,1591,757,253,292,73,244,162,830,13,61,38,67,74,105,409,651,7,4654,258,0,2,1,3,0
25274,58,1198,207,111,150,11,0,50,218,5,26,19,36,31,55,133,272,3,943,52,0,2,1,0,0
25275,58,1198,410,198,237,31,55,97,441,11,63,38,72,74,110,414,683,6,4293,238,0,2,1,0,0
25276,255,5847,4293,999,3693,19,54,507,4312,9,155,88,170,164,258,1156,1898,4,9368,520,0,2,51,1,0
25277,255,5847,1482,859,1002,125,135,219,1607,16,219,134,251,235,385,1766,3032,9,27804,1544,1,2,51,1,0
25278,17,774,75,38,59,1,3,12,76,2,4,2,4,6,6,10,15,1,15,0,0,2,14,0,0
25279,1,41,7,5,5,0,0,2,7,1,2,1,2,3,3,2,4,0,2,0,0,0,7,0,0
25280,175,7644,139,89,101,2,0,35,141,7,54,34,62,61,96,330,569,4,2287,127,0,2,6,3,0
25281,175,7644,7,5,5,0,0,2,7,1,2,1,2,3,3,2,4,0,2,0,0,2,6,3,0
25282,139,5919,1782,648,1425,9,47,279,1791,8,171,97,189,179,286,1292,2140,4,9462,525,0,2,3,0,0
25283,111,4178,1450,624,1228,12,26,181,1462,14,306,186,354,320,540,2580,4493,8,36391,2021,1,2,6,7,0
25284,39,2321,652,304,544,16,6,88,668,6,89,51,101,95,152,591,998,3,3399,188,0,2,1,3,0
25285,14,725,442,244,305,14,16,103,456,11,68,45,75,79,120,452,756,6,4588,254,0,2,4,28,0
25286,79,1593,757,253,292,73,244,162,830,13,61,38,67,74,105,409,651,7,4654,258,0,2,1,1,0
25287,10,382,42,7,35,4,0,5,46,1,2,1,2,3,3,2,4,0,2,0,0,2,1,1,0
25288,10,382,11,6,10,0,0,1,11,2,4,2,4,6,6,10,15,1,15,0,0,2,1,1,0
25289,10,382,42,7,35,4,0,5,46,1,2,1,2,3,3,2,4,0,2,0,0,2,1,1,0
25290,10,382,11,6,10,0,0,1,11,2,4,2,4,6,6,10,15,1,15,0,0,2,1,1,0
25291,1,319,382,65,130,157,2,92,539,4,10,5,10,14,15,41,57,2,114,6,0,2,1,1,0
25292,11,413,42,7,35,4,0,5,46,1,2,1,2,3,3,2,4,0,2,0,0,2,1,1,0
25293,11,413,11,6,10,0,0,1,11,2,4,2,4,6,6,10,15,1,15,0,0,2,1,1,0
25294,11,413,42,7,35,4,0,5,46,1,2,1,2,3,3,2,4,0,2,0,0,2,1,1,0
25295,11,413,11,6,10,0,0,1,11,2,4,2,4,6,6,10,15,1,15,0,0,2,1,1,0
25296,51,608,647,139,84,35,284,233,682,0,0,0,0,0,0,0,0,0,0,0,0,2,13,2,0
25297,60,4055,520,294,400,33,13,81,553,10,261,204,367,271,571,2128,4614,7,32445,1802,1,2,42,15,0
25298,62,4177,520,294,400,33,13,81,553,10,261,204,367,271,571,2128,4614,7,32445,1802,1,2,14,0,0
25299,1,319,382,65,130,157,2,92,539,4,10,5,10,14,15,41,57,2,114,6,0,2,1,1,0
25300,11,413,42,7,35,4,0,5,46,1,2,1,2,3,3,2,4,0,2,0,0,2,1,1,0
25301,11,413,11,6,10,0,0,1,11,2,4,2,4,6,6,10,15,1,15,0,0,2,1,1,0
25302,51,608,647,139,84,35,284,233,682,0,0,0,0,0,0,0,0,0,0,0,0,2,9,2,1
25303,33,1892,384,251,317,7,8,52,391,11,70,44,84,81,128,467,811,6,5355,297,0,2,1,0,1
25304,51,604,647,139,84,35,284,233,682,0,0,0,0,0,0,0,0,0,0,0,0,2,3,7,0
25305,11,413,42,7,35,4,0,5,46,1,2,1,2,3,3,2,4,0,2,0,0,2,1,1,0
25306,11,413,11,6,10,0,0,1,11,2,4,2,4,6,6,10,15,1,15,0,0,2,1,1,0
25307,51,604,647,139,84,35,284,233,682,0,0,0,0,0,0,0,0,0,0,0,0,2,16,2,0
25308,33,1892,384,251,317,7,8,52,391,11,70,44,84,81,128,467,811,6,5355,297,0,2,1,0,0
25309,79,1593,757,253,292,73,244,162,830,13,61,38,67,74,105,409,651,7,4654,258,0,2,1,1,0
25310,62,4177,520,294,400,33,13,81,553,10,261,204,367,271,571,2128,4614,7,32445,1802,1,2,62,0,0
25311,79,1593,757,253,292,73,244,162,830,13,61,38,67,74,105,409,651,7,4654,258,0,2,1,1,0
25312,62,4177,520,294,400,33,13,81,553,10,261,204,367,271,571,2128,4614,7,32445,1802,1,2,62,0,0
25313,79,1593,757,253,292,73,244,162,830,13,61,38,67,74,105,409,651,7,4654,258,0,2,1,1,0
25314,62,4177,520,294,400,33,13,81,553,10,261,204,367,271,571,2128,4614,7,32445,1802,1,2,62,0,0
25315,81,1607,757,253,292,73,244,162,830,13,61,38,67,74,105,409,651,7,4654,258,0,2,9,5,0
25316,63,4221,520,294,400,33,13,81,553,10,261,204,367,271,571,2128,4614,7,32445,1802,1,2,12,10,0
25317,81,1608,757,253,292,73,244,162,830,13,61,38,67,74,105,409,651,7,4654,258,0,2,9,5,0
25318,92,1762,757,253,292,73,244,162,830,13,61,38,67,74,105,409,651,7,4654,258,0,2,49,19,0
25319,64,4282,520,294,400,33,13,81,553,10,261,204,367,271,571,2128,4614,7,32445,1802,1,2,7,0,0
25320,92,1762,757,253,292,73,244,162,830,13,61,38,67,74,105,409,651,7,4654,258,0,2,34,22,0
25321,64,4283,520,294,400,33,13,81,553,10,261,204,367,271,571,2128,4614,7,32445,1802,1,2,10,7,0
25322,92,1758,757,253,292,73,244,162,830,13,61,38,67,74,105,409,651,7,4654,258,0,2,0,2,0
25323,2,36,127,75,83,2,11,30,129,4,14,7,14,18,21,61,87,2,175,9,0,0,10,0,0
25324,2,36,652,304,544,16,6,88,668,6,89,51,101,95,152,591,998,3,3399,188,0,0,10,0,0
25325,2,36,2,2,2,0,0,0,2,0,0,0,0,0,0,0,0,0,0,0,0,0,10,0,0
25326,2,36,8,5,5,0,0,3,8,0,0,0,0,0,0,0,0,0,0,0,0,0,10,0,0
25327,2,36,2,2,2,0,0,0,2,0,0,0,0,0,0,0,0,0,0,0,0,0,10,0,0
25328,2,36,14,8,8,0,0,6,14,0,0,0,0,0,0,0,0,0,0,0,0,0,10,0,0
25329,2,36,6,4,4,0,0,2,6,0,0,0,0,0,0,0,0,0,0,0,0,0,10,0,0
25330,2,36,6,4,4,0,0,2,6,1,2,1,2,3,3,2,4,0,2,0,0,0,10,0,0
25331,2,36,6,4,4,0,0,2,6,0,0,0,0,0,0,0,0,0,0,0,0,0,10,0,0
25332,2,36,7,5,5,0,0,2,7,0,0,0,0,0,0,0,0,0,0,0,0,0,10,0,0
25333,2,36,6,4,4,0,0,2,6,0,0,0,0,0,0,0,0,0,0,0,0,0,10,0,0
25334,2,36,10,6,6,0,0,4,10,0,0,0,0,0,0,0,0,0,0,0,0,0,10,0,0
25335,2,36,1,1,1,0,0,0,1,0,0,0,0,0,0,0,0,0,0,0,0,0,10,0,0
25336,2,36,1,1,1,0,0,0,1,0,0,0,0,0,0,0,0,0,0,0,0,0,10,0,0
25337,2,36,14,10,10,0,0,4,14,1,1,1,1,2,2,0,2,0,1,0,0,0,10,0,0
25338,2,36,46,26,30,3,0,12,49,3,6,3,6,9,9,20,28,1,42,2,0,0,10,0,0
25339,1,6,2,2,2,0,0,0,2,0,0,0,0,0,0,0,0,0,0,0,0,0,2,0,0
25340,1,6,2,2,2,0,0,0,2,0,0,0,0,0,0,0,0,0,0,0,0,0,2,0,0
25341,1,6,2,2,2,0,0,0,2,0,0,0,0,0,0,0,0,0,0,0,0,0,2,0,0
25342,1,6,2,2,2,0,0,0,2,0,0,0,0,0,0,0,0,0,0,0,0,0,2,0,0
25343,176,7674,139,89,101,2,0,35,141,7,54,34,62,61,96,330,569,4,2287,127,0,2,5,0,0
25344,176,7674,7,5,5,0,0,2,7,1,2,1,2,3,3,2,4,0,2,0,0,2,5,0,0
25345,141,3259,77,34,69,0,0,8,77,3,24,16,29,27,45,114,213,1,387,21,0,2,3,1,1
25346,141,3259,712,438,573,51,9,84,763,14,102,71,128,116,199,733,1364,8,11988,666,0,2,3,1,1
25347,73,3803,1296,573,1062,40,33,157,1336,8,201,118,231,209,349,1561,2689,4,12365,686,0,2,1,1,1
25348,92,1761,757,253,292,73,244,162,830,13,61,38,67,74,105,409,651,7,4654,258,0,2,3,1,0
25349,92,1761,757,253,292,73,244,162,830,13,61,38,67,74,105,409,651,7,4654,258,0,2,2,2,0
25350,75,1704,996,429,845,24,10,117,1020,7,76,50,88,83,138,494,879,4,3565,198,0,2,9,2,0
25351,75,1704,456,277,329,12,42,72,468,13,85,50,97,98,147,592,972,7,7212,400,0,2,9,2,0
25352,40,3026,996,429,845,24,10,117,1020,7,76,50,88,83,138,494,879,4,3565,198,0,2,26,0,0
25353,11,413,42,7,35,4,0,5,46,1,2,1,2,3,3,2,4,0,2,0,0,2,3,3,0
25354,11,413,11,6,10,0,0,1,11,2,4,2,4,6,6,10,15,1,15,0,0,2,3,3,0
25355,93,1841,757,253,292,73,244,162,830,13,61,38,67,74,105,409,651,7,4654,258,0,2,21,20,0
25356,63,4272,520,294,400,33,13,81,553,10,261,204,367,271,571,2128,4614,7,32445,1802,1,2,14,15,0
25357,93,1841,757,253,292,73,244,162,830,13,61,38,67,74,105,409,651,7,4654,258,0,2,2,2,0
25358,75,1704,996,429,845,24,10,117,1020,7,76,50,88,83,138,494,879,4,3565,198,0,2,9,2,0
25359,75,1704,456,277,329,12,42,72,468,13,85,50,97,98,147,592,972,7,7212,400,0,2,9,2,0
25360,40,3026,996,429,845,24,10,117,1020,7,76,50,88,83,138,494,879,4,3565,198,0,2,26,0,0
25361,91,1827,757,253,292,73,244,162,830,13,61,38,67,74,105,409,651,7,4654,258,0,2,4,10,0
25362,91,1827,757,253,292,73,244,162,830,13,61,38,67,74,105,409,651,7,4654,258,0,2,7,7,0
25363,63,4320,520,294,400,33,13,81,553,10,261,204,367,271,571,2128,4614,7,32445,1802,1,2,9,1,0
25364,79,1593,757,253,292,73,244,162,830,13,61,38,67,74,105,409,651,7,4654,258,0,2,1,1,1
25365,11,413,42,7,35,4,0,5,46,1,2,1,2,3,3,2,4,0,2,0,0,2,3,3,0
25366,11,413,11,6,10,0,0,1,11,2,4,2,4,6,6,10,15,1,15,0,0,2,3,3,0
25367,91,1827,757,253,292,73,244,162,830,13,61,38,67,74,105,409,651,7,4654,258,0,2,3,3,0
25368,79,1596,757,253,292,73,244,162,830,13,61,38,67,74,105,409,651,7,4654,258,0,2,3,1,0
25369,63,1255,207,111,150,11,0,50,218,5,26,19,36,31,55,133,272,3,943,52,0,2,15,0,1
25370,63,1255,410,198,237,31,55,97,441,11,63,38,72,74,110,414,683,6,4293,238,0,2,15,0,1
25371,254,5825,4293,999,3693,19,54,507,4312,9,155,88,170,164,258,1156,1898,4,9368,520,0,2,13,14,1
25372,254,5825,1482,859,1002,125,135,219,1607,16,219,134,251,235,385,1766,3032,9,27804,1544,1,2,13,14,1
25373,17,774,75,38,59,1,3,12,76,2,4,2,4,6,6,10,15,1,15,0,0,2,0,1,1
25374,175,7644,139,89,101,2,0,35,141,7,54,34,62,61,96,330,569,4,2287,127,0,2,3,4,1
25375,175,7644,7,5,5,0,0,2,7,1,2,1,2,3,3,2,4,0,2,0,0,2,3,4,1
25376,164,5055,1660,832,1314,41,38,274,1701,20,312,209,395,332,604,2671,5058,12,64042,3557,1,2,12,14,1
25377,164,5055,1057,646,719,113,100,145,1170,18,215,134,248,233,382,1740,3004,10,31186,1732,1,2,12,14,1
25378,155,4396,1660,832,1314,41,38,274,1701,20,312,209,395,332,604,2671,5058,12,64042,3557,1,2,9,0,1
25379,91,1827,757,253,292,73,244,162,830,13,61,38,67,74,105,409,651,7,4654,258,0,2,86,41,0
25380,63,4320,520,294,400,33,13,81,553,10,261,204,367,271,571,2128,4614,7,32445,1802,1,2,29,10,0
25381,91,1830,757,253,292,73,244,162,830,13,61,38,67,74,105,409,651,7,4654,258,0,2,3,1,0
25382,63,1255,207,111,150,11,0,50,218,5,26,19,36,31,55,133,272,3,943,52,0,2,15,0,0
25383,63,1255,410,198,237,31,55,97,441,11,63,38,72,74,110,414,683,6,4293,238,0,2,15,0,0
25384,254,5825,4293,999,3693,19,54,507,4312,9,155,88,170,164,258,1156,1898,4,9368,520,0,2,13,14,0
25385,254,5825,1482,859,1002,125,135,219,1607,16,219,134,251,235,385,1766,3032,9,27804,1544,1,2,13,14,0
25386,17,774,75,38,59,1,3,12,76,2,4,2,4,6,6,10,15,1,15,0,0,2,0,1,0
25387,175,7644,139,89,101,2,0,35,141,7,54,34,62,61,96,330,569,4,2287,127,0,2,3,4,0
25388,175,7644,7,5,5,0,0,2,7,1,2,1,2,3,3,2,4,0,2,0,0,2,3,4,0
25389,164,5055,1660,832,1314,41,38,274,1701,20,312,209,395,332,604,2671,5058,12,64042,3557,1,2,12,14,0
25390,164,5055,1057,646,719,113,100,145,1170,18,215,134,248,233,382,1740,3004,10,31186,1732,1,2,12,14,0
25391,155,4396,1660,832,1314,41,38,274,1701,20,312,209,395,332,604,2671,5058,12,64042,3557,1,2,9,0,0
25392,141,3259,77,34,69,0,0,8,77,3,24,16,29,27,45,114,213,1,387,21,0,2,3,1,0
25393,141,3259,712,438,573,51,9,84,763,14,102,71,128,116,199,733,1364,8,11988,666,0,2,3,1,0
25394,2,36,127,75,83,2,11,30,129,4,14,7,14,18,21,61,87,2,175,9,0,0,10,0,0
25395,2,36,652,304,544,16,6,88,668,6,89,51,101,95,152,591,998,3,3399,188,0,0,10,0,0
25396,2,36,2,2,2,0,0,0,2,0,0,0,0,0,0,0,0,0,0,0,0,0,10,0,0
25397,2,36,8,5,5,0,0,3,8,0,0,0,0,0,0,0,0,0,0,0,0,0,10,0,0
25398,2,36,2,2,2,0,0,0,2,0,0,0,0,0,0,0,0,0,0,0,0,0,10,0,0
25399,2,36,14,8,8,0,0,6,14,0,0,0,0,0,0,0,0,0,0,0,0,0,10,0,0
25400,2,36,6,4,4,0,0,2,6,0,0,0,0,0,0,0,0,0,0,0,0,0,10,0,0
25401,2,36,6,4,4,0,0,2,6,1,2,1,2,3,3,2,4,0,2,0,0,0,10,0,0
25402,2,36,6,4,4,0,0,2,6,0,0,0,0,0,0,0,0,0,0,0,0,0,10,0,0
25403,2,36,7,5,5,0,0,2,7,0,0,0,0,0,0,0,0,0,0,0,0,0,10,0,0
25404,2,36,6,4,4,0,0,2,6,0,0,0,0,0,0,0,0,0,0,0,0,0,10,0,0
25405,2,36,10,6,6,0,0,4,10,0,0,0,0,0,0,0,0,0,0,0,0,0,10,0,0
25406,2,36,1,1,1,0,0,0,1,0,0,0,0,0,0,0,0,0,0,0,0,0,10,0,0
25407,2,36,1,1,1,0,0,0,1,0,0,0,0,0,0,0,0,0,0,0,0,0,10,0,0
25408,2,36,14,10,10,0,0,4,14,1,1,1,1,2,2,0,2,0,1,0,0,0,10,0,0
25409,2,36,46,26,30,3,0,12,49,3,6,3,6,9,9,20,28,1,42,2,0,0,10,0,0
25410,1,6,2,2,2,0,0,0,2,0,0,0,0,0,0,0,0,0,0,0,0,0,2,0,0
25411,1,6,2,2,2,0,0,0,2,0,0,0,0,0,0,0,0,0,0,0,0,0,2,0,0
25412,1,6,2,2,2,0,0,0,2,0,0,0,0,0,0,0,0,0,0,0,0,0,2,0,0
25413,1,6,2,2,2,0,0,0,2,0,0,0,0,0,0,0,0,0,0,0,0,0,2,0,0
25414,176,7674,139,89,101,2,0,35,141,7,54,34,62,61,96,330,569,4,2287,127,0,2,5,0,0
25415,176,7674,7,5,5,0,0,2,7,1,2,1,2,3,3,2,4,0,2,0,0,2,5,0,0
25416,73,3803,1296,573,1062,40,33,157,1336,8,201,118,231,209,349,1561,2689,4,12365,686,0,2,1,1,0
25417,1,8,127,75,83,2,11,30,129,4,14,7,14,18,21,61,87,2,175,9,0,0,2,0,0
25418,1,8,652,304,544,16,6,88,668,6,89,51,101,95,152,591,998,3,3399,188,0,0,2,0,0
25419,1,8,2,2,2,0,0,0,2,0,0,0,0,0,0,0,0,0,0,0,0,0,2,0,0
25420,1,8,8,5,5,0,0,3,8,0,0,0,0,0,0,0,0,0,0,0,0,0,2,0,0
25421,1,8,2,2,2,0,0,0,2,0,0,0,0,0,0,0,0,0,0,0,0,0,2,0,0
25422,1,8,14,8,8,0,0,6,14,0,0,0,0,0,0,0,0,0,0,0,0,0,2,0,0
25423,1,8,6,4,4,0,0,2,6,0,0,0,0,0,0,0,0,0,0,0,0,0,2,0,0
25424,1,8,6,4,4,0,0,2,6,1,2,1,2,3,3,2,4,0,2,0,0,0,2,0,0
25425,1,8,6,4,4,0,0,2,6,0,0,0,0,0,0,0,0,0,0,0,0,0,2,0,0
25426,1,8,7,5,5,0,0,2,7,0,0,0,0,0,0,0,0,0,0,0,0,0,2,0,0
25427,1,8,6,4,4,0,0,2,6,0,0,0,0,0,0,0,0,0,0,0,0,0,2,0,0
25428,1,8,10,6,6,0,0,4,10,0,0,0,0,0,0,0,0,0,0,0,0,0,2,0,0
25429,1,8,1,1,1,0,0,0,1,0,0,0,0,0,0,0,0,0,0,0,0,0,2,0,0
25430,1,8,1,1,1,0,0,0,1,0,0,0,0,0,0,0,0,0,0,0,0,0,2,0,0
25431,1,8,14,10,10,0,0,4,14,1,1,1,1,2,2,0,2,0,1,0,0,0,2,0,0
25432,1,8,46,26,30,3,0,12,49,3,6,3,6,9,9,20,28,1,42,2,0,0,2,0,0
25433,1,6,2,2,2,0,0,0,2,0,0,0,0,0,0,0,0,0,0,0,0,0,2,0,0
25434,99,4460,1338,495,1086,10,64,173,1348,11,122,82,157,133,239,883,1686,7,11934,663,0,2,6,0,0
25435,314,6831,72,33,56,0,4,12,72,1,1,1,1,2,2,0,2,0,1,0,0,2,6,3,1
25436,314,6831,1454,835,1044,76,110,219,1530,17,275,158,296,292,454,2297,3718,9,34017,1889,1,2,6,3,1
25437,64,1275,207,111,150,11,0,50,218,5,26,19,36,31,55,133,272,3,943,52,0,2,7,0,1
25438,64,1275,410,198,237,31,55,97,441,11,63,38,72,74,110,414,683,6,4293,238,0,2,7,0,1
25439,254,5830,4293,999,3693,19,54,507,4312,9,155,88,170,164,258,1156,1898,4,9368,520,0,2,4,3,1
25440,254,5830,1482,859,1002,125,135,219,1607,16,219,134,251,235,385,1766,3032,9,27804,1544,1,2,4,3,1
25441,93,3899,1289,550,1043,56,32,155,1345,10,167,93,185,177,278,1266,2075,5,11498,638,0,2,7,0,1
25442,2,56,16,12,9,0,0,6,16,1,2,1,2,3,3,2,4,0,2,0,0,0,17,0,1
25443,20,439,207,111,150,11,0,50,218,5,26,19,36,31,55,133,272,3,943,52,0,2,32,0,1
25444,212,4563,2,2,2,0,0,0,2,0,0,0,0,0,0,0,0,0,0,0,0,2,5,0,1
25445,212,4563,99,48,90,1,3,5,100,0,0,0,0,0,0,0,0,0,0,0,0,2,5,0,1
25446,212,4563,8,5,5,2,0,1,10,0,0,0,0,0,0,0,0,0,0,0,0,2,5,0,1
25447,212,4563,1217,716,841,84,126,174,1301,14,185,118,215,199,333,1446,2542,8,20687,1149,0,2,5,0,1
25448,212,4563,160,89,115,0,13,31,160,7,15,11,17,22,28,78,124,3,495,27,0,2,5,0,1
25449,212,4563,10,10,9,9,0,0,19,0,0,0,0,0,0,0,0,0,0,0,0,2,5,0,1
25450,212,4563,173,84,99,8,29,36,181,5,12,7,13,17,20,54,81,2,221,12,0,2,5,0,1
25451,212,4563,3,1,1,3,0,0,6,0,0,0,0,0,0,0,0,0,0,0,0,2,5,0,1
25452,1,6,2,2,2,0,0,0,2,0,0,0,0,0,0,0,0,0,0,0,0,0,2,0,1
25453,1,6,2,2,2,0,0,0,2,0,0,0,0,0,0,0,0,0,0,0,0,0,2,0,1
25454,1,6,2,2,2,0,0,0,2,0,0,0,0,0,0,0,0,0,0,0,0,0,2,0,1
25455,1,6,2,2,2,0,0,0,2,0,0,0,0,0,0,0,0,0,0,0,0,0,2,0,1
25456,86,4507,1457,730,1242,11,6,188,1468,10,292,166,329,302,495,2424,4078,5,22973,1276,1,2,18,0,1
25457,212,4563,2,2,2,0,0,0,2,0,0,0,0,0,0,0,0,0,0,0,0,2,5,0,0
25458,212,4563,99,48,90,1,3,5,100,0,0,0,0,0,0,0,0,0,0,0,0,2,5,0,0
25459,212,4563,8,5,5,2,0,1,10,0,0,0,0,0,0,0,0,0,0,0,0,2,5,0,0
25460,212,4563,1217,716,841,84,126,174,1301,14,185,118,215,199,333,1446,2542,8,20687,1149,0,2,5,0,0
25461,212,4563,160,89,115,0,13,31,160,7,15,11,17,22,28,78,124,3,495,27,0,2,5,0,0
25462,212,4563,10,10,9,9,0,0,19,0,0,0,0,0,0,0,0,0,0,0,0,2,5,0,0
25463,212,4563,173,84,99,8,29,36,181,5,12,7,13,17,20,54,81,2,221,12,0,2,5,0,0
25464,212,4563,3,1,1,3,0,0,6,0,0,0,0,0,0,0,0,0,0,0,0,2,5,0,0
25465,1,6,2,2,2,0,0,0,2,0,0,0,0,0,0,0,0,0,0,0,0,0,2,0,0
25466,1,6,2,2,2,0,0,0,2,0,0,0,0,0,0,0,0,0,0,0,0,0,2,0,0
25467,1,6,2,2,2,0,0,0,2,0,0,0,0,0,0,0,0,0,0,0,0,0,2,0,0
25468,1,6,2,2,2,0,0,0,2,0,0,0,0,0,0,0,0,0,0,0,0,0,2,0,0
25469,86,4507,1457,730,1242,11,6,188,1468,10,292,166,329,302,495,2424,4078,5,22973,1276,1,2,18,0,0
25470,314,6831,72,33,56,0,4,12,72,1,1,1,1,2,2,0,2,0,1,0,0,2,6,3,0
25471,314,6831,1454,835,1044,76,110,219,1530,17,275,158,296,292,454,2297,3718,9,34017,1889,1,2,6,3,0
25472,1,8,127,75,83,2,11,30,129,4,14,7,14,18,21,61,87,2,175,9,0,0,2,0,0
25473,1,8,652,304,544,16,6,88,668,6,89,51,101,95,152,591,998,3,3399,188,0,0,2,0,0
25474,1,8,2,2,2,0,0,0,2,0,0,0,0,0,0,0,0,0,0,0,0,0,2,0,0
25475,1,8,8,5,5,0,0,3,8,0,0,0,0,0,0,0,0,0,0,0,0,0,2,0,0
25476,1,8,2,2,2,0,0,0,2,0,0,0,0,0,0,0,0,0,0,0,0,0,2,0,0
25477,1,8,14,8,8,0,0,6,14,0,0,0,0,0,0,0,0,0,0,0,0,0,2,0,0
25478,1,8,6,4,4,0,0,2,6,0,0,0,0,0,0,0,0,0,0,0,0,0,2,0,0
25479,1,8,6,4,4,0,0,2,6,1,2,1,2,3,3,2,4,0,2,0,0,0,2,0,0
25480,1,8,6,4,4,0,0,2,6,0,0,0,0,0,0,0,0,0,0,0,0,0,2,0,0
25481,1,8,7,5,5,0,0,2,7,0,0,0,0,0,0,0,0,0,0,0,0,0,2,0,0
25482,1,8,6,4,4,0,0,2,6,0,0,0,0,0,0,0,0,0,0,0,0,0,2,0,0
25483,1,8,10,6,6,0,0,4,10,0,0,0,0,0,0,0,0,0,0,0,0,0,2,0,0
25484,1,8,1,1,1,0,0,0,1,0,0,0,0,0,0,0,0,0,0,0,0,0,2,0,0
25485,1,8,1,1,1,0,0,0,1,0,0,0,0,0,0,0,0,0,0,0,0,0,2,0,0
25486,1,8,14,10,10,0,0,4,14,1,1,1,1,2,2,0,2,0,1,0,0,0,2,0,0
25487,1,8,46,26,30,3,0,12,49,3,6,3,6,9,9,20,28,1,42,2,0,0,2,0,0
25488,1,6,2,2,2,0,0,0,2,0,0,0,0,0,0,0,0,0,0,0,0,0,2,0,0
25489,99,4460,1338,495,1086,10,64,173,1348,11,122,82,157,133,239,883,1686,7,11934,663,0,2,6,0,0
25490,213,4573,2,2,2,0,0,0,2,0,0,0,0,0,0,0,0,0,0,0,0,2,8,1,1
25491,213,4573,99,48,90,1,3,5,100,0,0,0,0,0,0,0,0,0,0,0,0,2,8,1,1
25492,213,4573,8,5,5,2,0,1,10,0,0,0,0,0,0,0,0,0,0,0,0,2,8,1,1
25493,213,4573,1217,716,841,84,126,174,1301,14,185,118,215,199,333,1446,2542,8,20687,1149,0,2,8,1,1
25494,213,4573,160,89,115,0,13,31,160,7,15,11,17,22,28,78,124,3,495,27,0,2,8,1,1
25495,213,4573,10,10,9,9,0,0,19,0,0,0,0,0,0,0,0,0,0,0,0,2,8,1,1
25496,213,4573,173,84,99,8,29,36,181,5,12,7,13,17,20,54,81,2,221,12,0,2,8,1,1
25497,213,4573,3,1,1,3,0,0,6,0,0,0,0,0,0,0,0,0,0,0,0,2,8,1,1
25498,27,965,74,35,59,1,0,14,75,3,14,7,14,17,21,58,85,1,128,7,0,2,1,0,1
25499,27,965,245,125,200,5,7,34,250,7,30,17,34,37,51,166,265,3,1053,58,0,2,1,0,1
25500,86,4564,1457,730,1242,11,6,188,1468,10,292,166,329,302,495,2424,4078,5,22973,1276,1,2,20,0,1
25501,62,1229,1098,241,925,5,10,155,1103,7,46,25,49,53,74,273,423,3,1580,87,0,2,1,0,0
25502,62,1229,282,202,222,14,2,44,296,8,42,24,43,50,67,250,378,4,1548,86,0,2,1,0,0
25503,50,1879,1098,241,925,5,10,155,1103,7,46,25,49,53,74,273,423,3,1580,87,0,2,21,0,0
25504,50,1879,1098,241,925,5,10,155,1103,7,46,25,49,53,74,273,423,3,1580,87,0,2,1,1,0
25505,213,4573,2,2,2,0,0,0,2,0,0,0,0,0,0,0,0,0,0,0,0,2,8,1,0
25506,213,4573,99,48,90,1,3,5,100,0,0,0,0,0,0,0,0,0,0,0,0,2,8,1,0
25507,213,4573,8,5,5,2,0,1,10,0,0,0,0,0,0,0,0,0,0,0,0,2,8,1,0
25508,213,4573,1217,716,841,84,126,174,1301,14,185,118,215,199,333,1446,2542,8,20687,1149,0,2,8,1,0
25509,213,4573,160,89,115,0,13,31,160,7,15,11,17,22,28,78,124,3,495,27,0,2,8,1,0
25510,213,4573,10,10,9,9,0,0,19,0,0,0,0,0,0,0,0,0,0,0,0,2,8,1,0
25511,213,4573,173,84,99,8,29,36,181,5,12,7,13,17,20,54,81,2,221,12,0,2,8,1,0
25512,213,4573,3,1,1,3,0,0,6,0,0,0,0,0,0,0,0,0,0,0,0,2,8,1,0
25513,27,965,74,35,59,1,0,14,75,3,14,7,14,17,21,58,85,1,128,7,0,2,1,0,0
25514,27,965,245,125,200,5,7,34,250,7,30,17,34,37,51,166,265,3,1053,58,0,2,1,0,0
25515,86,4564,1457,730,1242,11,6,188,1468,10,292,166,329,302,495,2424,4078,5,22973,1276,1,2,20,0,0
25516,62,1229,1098,241,925,5,10,155,1103,7,46,25,49,53,74,273,423,3,1580,87,0,2,1,0,0
25517,62,1229,282,202,222,14,2,44,296,8,42,24,43,50,67,250,378,4,1548,86,0,2,1,0,0
25518,50,1879,1098,241,925,5,10,155,1103,7,46,25,49,53,74,273,423,3,1580,87,0,2,21,0,0
25519,65,1299,207,111,150,11,0,50,218,5,26,19,36,31,55,133,272,3,943,52,0,2,14,2,0
25520,65,1299,410,198,237,31,55,97,441,11,63,38,72,74,110,414,683,6,4293,238,0,2,14,2,0
25521,254,5835,4293,999,3693,19,54,507,4312,9,155,88,170,164,258,1156,1898,4,9368,520,0,2,2,1,0
25522,254,5835,1482,859,1002,125,135,219,1607,16,219,134,251,235,385,1766,3032,9,27804,1544,1,2,2,1,0
25523,19,437,207,111,150,11,0,50,218,5,26,19,36,31,55,133,272,3,943,52,0,2,2,4,0
25524,65,1299,207,111,150,11,0,50,218,5,26,19,36,31,55,133,272,3,943,52,0,2,19,0,0
25525,65,1299,410,198,237,31,55,97,441,11,63,38,72,74,110,414,683,6,4293,238,0,2,19,0,0
25526,254,5835,4293,999,3693,19,54,507,4312,9,155,88,170,164,258,1156,1898,4,9368,520,0,2,5,3,0
25527,254,5835,1482,859,1002,125,135,219,1607,16,219,134,251,235,385,1766,3032,9,27804,1544,1,2,5,3,0
25528,93,3899,1289,550,1043,56,32,155,1345,10,167,93,185,177,278,1266,2075,5,11498,638,0,2,7,0,0
25529,2,56,16,12,9,0,0,6,16,1,2,1,2,3,3,2,4,0,2,0,0,0,17,0,0
25530,19,437,207,111,150,11,0,50,218,5,26,19,36,31,55,133,272,3,943,52,0,2,31,1,0
25531,314,6843,72,33,56,0,4,12,72,1,1,1,1,2,2,0,2,0,1,0,0,2,1,0,0
25532,314,6843,1454,835,1044,76,110,219,1530,17,275,158,296,292,454,2297,3718,9,34017,1889,1,2,1,0,0
25533,141,3263,77,34,69,0,0,8,77,3,24,16,29,27,45,114,213,1,387,21,0,2,3,2,0
25534,141,3263,712,438,573,51,9,84,763,14,102,71,128,116,199,733,1364,8,11988,666,0,2,3,2,0
25535,73,3805,1296,573,1062,40,33,157,1336,8,201,118,231,209,349,1561,2689,4,12365,686,0,2,1,1,0
25536,94,1909,463,295,324,28,62,57,491,12,134,82,154,146,236,989,1696,6,11700,650,0,2,7,7,0
25537,309,6791,72,33,56,0,4,12,72,1,1,1,1,2,2,0,2,0,1,0,0,2,10,15,1
25538,309,6791,1454,835,1044,76,110,219,1530,17,275,158,296,292,454,2297,3718,9,34017,1889,1,2,10,15,1
25539,73,3806,1296,573,1062,40,33,157,1336,8,201,118,231,209,349,1561,2689,4,12365,686,0,2,4,0,0
25540,73,3830,1296,573,1062,40,33,157,1336,8,201,118,231,209,349,1561,2689,4,12365,686,0,2,7,4,0
25541,100,4602,1338,495,1086,10,64,173,1348,11,122,82,157,133,239,883,1686,7,11934,663,0,2,40,0,0
25542,314,6831,72,33,56,0,4,12,72,1,1,1,1,2,2,0,2,0,1,0,0,2,2,1,0
25543,314,6831,1454,835,1044,76,110,219,1530,17,275,158,296,292,454,2297,3718,9,34017,1889,1,2,2,1,0
25544,314,6831,72,33,56,0,4,12,72,1,1,1,1,2,2,0,2,0,1,0,0,2,2,1,0
25545,314,6831,1454,835,1044,76,110,219,1530,17,275,158,296,292,454,2297,3718,9,34017,1889,1,2,2,1,0
25546,94,1909,463,295,324,28,62,57,491,12,134,82,154,146,236,989,1696,6,11700,650,0,2,7,7,0
25547,23,474,601,196,481,2,23,85,603,8,63,36,72,71,108,400,664,4,3036,168,0,2,8,0,1
25548,23,474,156,79,106,5,16,28,161,5,14,8,15,19,23,64,97,2,261,14,0,2,8,0,1
25549,20,707,601,196,481,2,23,85,603,8,63,36,72,71,108,400,664,4,3036,168,0,2,15,0,1
25550,20,707,601,196,481,2,23,85,603,8,63,36,72,71,108,400,664,4,3036,168,0,2,2,2,0
25551,23,474,601,196,481,2,23,85,603,8,63,36,72,71,108,400,664,4,3036,168,0,2,8,0,0
25552,23,474,156,79,106,5,16,28,161,5,14,8,15,19,23,64,97,2,261,14,0,2,8,0,0
25553,20,707,601,196,481,2,23,85,603,8,63,36,72,71,108,400,664,4,3036,168,0,2,15,0,0
25554,309,6791,72,33,56,0,4,12,72,1,1,1,1,2,2,0,2,0,1,0,0,2,10,15,0
25555,309,6791,1454,835,1044,76,110,219,1530,17,275,158,296,292,454,2297,3718,9,34017,1889,1,2,10,15,0
25556,100,4602,1338,495,1086,10,64,173,1348,11,122,82,157,133,239,883,1686,7,11934,663,0,2,40,0,0
25557,215,4676,182,127,129,0,0,53,182,5,39,21,42,44,63,217,343,2,926,51,0,2,3,1,1
25558,215,4676,1165,710,800,67,119,181,1232,18,243,153,282,261,435,2000,3492,10,36473,2026,1,2,3,1,1
25559,152,7085,1392,870,1177,35,17,170,1427,14,494,280,531,508,811,4473,7289,7,54850,3047,2,2,45,0,1
25560,141,3263,77,34,69,0,0,8,77,3,24,16,29,27,45,114,213,1,387,21,0,2,3,2,0
25561,141,3263,712,438,573,51,9,84,763,14,102,71,128,116,199,733,1364,8,11988,666,0,2,3,2,0
25562,73,3830,1296,573,1062,40,33,157,1336,8,201,118,231,209,349,1561,2689,4,12365,686,0,2,9,2,0
25563,215,4676,182,127,129,0,0,53,182,5,39,21,42,44,63,217,343,2,926,51,0,2,3,1,0
25564,215,4676,1165,710,800,67,119,181,1232,18,243,153,282,261,435,2000,3492,10,36473,2026,1,2,3,1,0
25565,152,7085,1392,870,1177,35,17,170,1427,14,494,280,531,508,811,4473,7289,7,54850,3047,2,2,45,0,0
25566,126,5153,1513,682,1277,25,13,200,1538,11,199,116,219,210,335,1557,2584,6,15641,868,0,2,28,0,1
25567,149,3076,1513,682,1277,25,13,200,1538,11,199,116,219,210,335,1557,2584,6,15641,868,0,2,14,2,1
25568,149,3076,819,519,539,24,98,155,843,15,96,57,106,111,163,690,1107,8,9171,509,0,2,14,2,1
25569,88,2266,773,422,505,30,103,129,803,14,77,46,83,91,129,535,839,7,6334,351,0,2,2,0,1
25570,34,2119,1157,318,931,29,22,177,1186,6,104,63,125,110,188,712,1274,3,4596,255,0,2,8,0,0
25571,126,5153,1513,682,1277,25,13,200,1538,11,199,116,219,210,335,1557,2584,6,15641,868,0,2,3,0,0
25572,149,3116,1513,682,1277,25,13,200,1538,11,199,116,219,210,335,1557,2584,6,15641,868,0,2,21,10,1
25573,149,3116,819,519,539,24,98,155,843,15,96,57,106,111,163,690,1107,8,9171,509,0,2,21,10,1
25574,86,2245,773,422,505,30,103,129,803,14,77,46,83,91,129,535,839,7,6334,351,0,2,5,7,1
25575,31,2079,1157,318,931,29,22,177,1186,6,104,63,125,110,188,712,1274,3,4596,255,0,2,7,17,1
25576,254,5829,4293,999,3693,19,54,507,4312,9,155,88,170,164,258,1156,1898,4,9368,520,0,2,2,2,1
25577,254,5829,1482,859,1002,125,135,219,1607,16,219,134,251,235,385,1766,3032,9,27804,1544,1,2,2,2,1
25578,149,3083,1513,682,1277,25,13,200,1538,11,199,116,219,210,335,1557,2584,6,15641,868,0,2,17,17,1
25579,149,3083,819,519,539,24,98,155,843,15,96,57,106,111,163,690,1107,8,9171,509,0,2,17,17,1
25580,150,3111,1513,682,1277,25,13,200,1538,11,199,116,219,210,335,1557,2584,6,15641,868,0,2,8,7,1
25581,150,3111,819,519,539,24,98,155,843,15,96,57,106,111,163,690,1107,8,9171,509,0,2,8,7,1
25582,86,2238,773,422,505,30,103,129,803,14,77,46,83,91,129,535,839,7,6334,351,0,2,1,5,1
25583,150,3111,1513,682,1277,25,13,200,1538,11,199,116,219,210,335,1557,2584,6,15641,868,0,2,1,1,1
25584,150,3111,819,519,539,24,98,155,843,15,96,57,106,111,163,690,1107,8,9171,509,0,2,1,1,1
25585,86,2240,773,422,505,30,103,129,803,14,77,46,83,91,129,535,839,7,6334,351,0,2,5,1,1
25586,150,3126,1513,682,1277,25,13,200,1538,11,199,116,219,210,335,1557,2584,6,15641,868,0,2,3,0,1
25587,150,3126,819,519,539,24,98,155,843,15,96,57,106,111,163,690,1107,8,9171,509,0,2,3,0,1
25588,149,3115,1513,682,1277,25,13,200,1538,11,199,116,219,210,335,1557,2584,6,15641,868,0,2,2,7,1
25589,149,3115,819,519,539,24,98,155,843,15,96,57,106,111,163,690,1107,8,9171,509,0,2,2,7,1
25590,66,1312,207,111,150,11,0,50,218,5,26,19,36,31,55,133,272,3,943,52,0,2,8,0,1
25591,66,1312,410,198,237,31,55,97,441,11,63,38,72,74,110,414,683,6,4293,238,0,2,8,0,1
25592,85,2238,773,422,505,30,103,129,803,14,77,46,83,91,129,535,839,7,6334,351,0,2,3,7,1
25593,149,3116,1513,682,1277,25,13,200,1538,11,199,116,219,210,335,1557,2584,6,15641,868,0,2,7,6,1
25594,149,3116,819,519,539,24,98,155,843,15,96,57,106,111,163,690,1107,8,9171,509,0,2,7,6,1
25595,85,2238,773,422,505,30,103,129,803,14,77,46,83,91,129,535,839,7,6334,351,0,2,1,1,1
25596,31,2079,1157,318,931,29,22,177,1186,6,104,63,125,110,188,712,1274,3,4596,255,0,2,1,1,1
25597,254,5829,4293,999,3693,19,54,507,4312,9,155,88,170,164,258,1156,1898,4,9368,520,0,2,2,2,0
25598,254,5829,1482,859,1002,125,135,219,1607,16,219,134,251,235,385,1766,3032,9,27804,1544,1,2,2,2,0
25599,149,3116,1513,682,1277,25,13,200,1538,11,199,116,219,210,335,1557,2584,6,15641,868,0,2,30,7,0
25600,149,3116,819,519,539,24,98,155,843,15,96,57,106,111,163,690,1107,8,9171,509,0,2,30,7,0
25601,66,1312,207,111,150,11,0,50,218,5,26,19,36,31,55,133,272,3,943,52,0,2,8,0,0
25602,66,1312,410,198,237,31,55,97,441,11,63,38,72,74,110,414,683,6,4293,238,0,2,8,0,0
25603,85,2238,773,422,505,30,103,129,803,14,77,46,83,91,129,535,839,7,6334,351,0,2,8,12,0
25604,31,2079,1157,318,931,29,22,177,1186,6,104,63,125,110,188,712,1274,3,4596,255,0,2,7,9,0
25605,126,5153,1513,682,1277,25,13,200,1538,11,199,116,219,210,335,1557,2584,6,15641,868,0,2,31,0,0
25606,149,3110,1513,682,1277,25,13,200,1538,11,199,116,219,210,335,1557,2584,6,15641,868,0,2,0,1,0
25607,149,3110,819,519,539,24,98,155,843,15,96,57,106,111,163,690,1107,8,9171,509,0,2,0,1,0
25608,127,5180,1513,682,1277,25,13,200,1538,11,199,116,219,210,335,1557,2584,6,15641,868,0,2,20,0,0
25609,149,3215,1513,682,1277,25,13,200,1538,11,199,116,219,210,335,1557,2584,6,15641,868,0,2,28,8,1
25610,149,3215,819,519,539,24,98,155,843,15,96,57,106,111,163,690,1107,8,9171,509,0,2,28,8,1
25611,127,5207,1513,682,1277,25,13,200,1538,11,199,116,219,210,335,1557,2584,6,15641,868,0,2,28,20,1
25612,215,4676,182,127,129,0,0,53,182,5,39,21,42,44,63,217,343,2,926,51,0,2,3,1,0
25613,215,4676,1165,710,800,67,119,181,1232,18,243,153,282,261,435,2000,3492,10,36473,2026,1,2,3,1,0
25614,149,3116,1513,682,1277,25,13,200,1538,11,199,116,219,210,335,1557,2584,6,15641,868,0,2,30,7,0
25615,149,3116,819,519,539,24,98,155,843,15,96,57,106,111,163,690,1107,8,9171,509,0,2,30,7,0
25616,66,1312,207,111,150,11,0,50,218,5,26,19,36,31,55,133,272,3,943,52,0,2,27,0,0
25617,66,1312,410,198,237,31,55,97,441,11,63,38,72,74,110,414,683,6,4293,238,0,2,27,0,0
25618,214,4585,2,2,2,0,0,0,2,0,0,0,0,0,0,0,0,0,0,0,0,2,5,0,0
25619,214,4585,99,48,90,1,3,5,100,0,0,0,0,0,0,0,0,0,0,0,0,2,5,0,0
25620,214,4585,8,5,5,2,0,1,10,0,0,0,0,0,0,0,0,0,0,0,0,2,5,0,0
25621,214,4585,1217,716,841,84,126,174,1301,14,185,118,215,199,333,1446,2542,8,20687,1149,0,2,5,0,0
25622,214,4585,160,89,115,0,13,31,160,7,15,11,17,22,28,78,124,3,495,27,0,2,5,0,0
25623,214,4585,10,10,9,9,0,0,19,0,0,0,0,0,0,0,0,0,0,0,0,2,5,0,0
25624,214,4585,173,84,99,8,29,36,181,5,12,7,13,17,20,54,81,2,221,12,0,2,5,0,0
25625,214,4585,3,1,1,3,0,0,6,0,0,0,0,0,0,0,0,0,0,0,0,2,5,0,0
25626,94,1909,463,295,324,28,62,57,491,12,134,82,154,146,236,989,1696,6,11700,650,0,2,7,7,0
25627,254,5829,4293,999,3693,19,54,507,4312,9,155,88,170,164,258,1156,1898,4,9368,520,0,2,7,5,0
25628,254,5829,1482,859,1002,125,135,219,1607,16,219,134,251,235,385,1766,3032,9,27804,1544,1,2,7,5,0
25629,85,2238,773,422,505,30,103,129,803,14,77,46,83,91,129,535,839,7,6334,351,0,2,8,12,0
25630,141,3263,77,34,69,0,0,8,77,3,24,16,29,27,45,114,213,1,387,21,0,2,3,2,0
25631,141,3263,712,438,573,51,9,84,763,14,102,71,128,116,199,733,1364,8,11988,666,0,2,3,2,0
25632,309,6791,72,33,56,0,4,12,72,1,1,1,1,2,2,0,2,0,1,0,0,2,18,19,0
25633,309,6791,1454,835,1044,76,110,219,1530,17,275,158,296,292,454,2297,3718,9,34017,1889,1,2,18,19,0
25634,62,1229,1098,241,925,5,10,155,1103,7,46,25,49,53,74,273,423,3,1580,87,0,2,1,0,0
25635,62,1229,282,202,222,14,2,44,296,8,42,24,43,50,67,250,378,4,1548,86,0,2,1,0,0
25636,23,474,601,196,481,2,23,85,603,8,63,36,72,71,108,400,664,4,3036,168,0,2,8,0,0
25637,23,474,156,79,106,5,16,28,161,5,14,8,15,19,23,64,97,2,261,14,0,2,8,0,0
25638,93,3899,1289,550,1043,56,32,155,1345,10,167,93,185,177,278,1266,2075,5,11498,638,0,2,7,0,0
25639,152,7085,1392,870,1177,35,17,170,1427,14,494,280,531,508,811,4473,7289,7,54850,3047,2,2,45,0,0
25640,2,56,16,12,9,0,0,6,16,1,2,1,2,3,3,2,4,0,2,0,0,0,17,0,0
25641,1,8,127,75,83,2,11,30,129,4,14,7,14,18,21,61,87,2,175,9,0,0,2,0,0
25642,1,8,652,304,544,16,6,88,668,6,89,51,101,95,152,591,998,3,3399,188,0,0,2,0,0
25643,1,8,2,2,2,0,0,0,2,0,0,0,0,0,0,0,0,0,0,0,0,0,2,0,0
25644,1,8,8,5,5,0,0,3,8,0,0,0,0,0,0,0,0,0,0,0,0,0,2,0,0
25645,1,8,2,2,2,0,0,0,2,0,0,0,0,0,0,0,0,0,0,0,0,0,2,0,0
25646,1,8,14,8,8,0,0,6,14,0,0,0,0,0,0,0,0,0,0,0,0,0,2,0,0
25647,1,8,6,4,4,0,0,2,6,0,0,0,0,0,0,0,0,0,0,0,0,0,2,0,0
25648,1,8,6,4,4,0,0,2,6,1,2,1,2,3,3,2,4,0,2,0,0,0,2,0,0
25649,1,8,6,4,4,0,0,2,6,0,0,0,0,0,0,0,0,0,0,0,0,0,2,0,0
25650,1,8,7,5,5,0,0,2,7,0,0,0,0,0,0,0,0,0,0,0,0,0,2,0,0
25651,1,8,6,4,4,0,0,2,6,0,0,0,0,0,0,0,0,0,0,0,0,0,2,0,0
25652,1,8,10,6,6,0,0,4,10,0,0,0,0,0,0,0,0,0,0,0,0,0,2,0,0
25653,1,8,1,1,1,0,0,0,1,0,0,0,0,0,0,0,0,0,0,0,0,0,2,0,0
25654,1,8,1,1,1,0,0,0,1,0,0,0,0,0,0,0,0,0,0,0,0,0,2,0,0
25655,1,8,14,10,10,0,0,4,14,1,1,1,1,2,2,0,2,0,1,0,0,0,2,0,0
25656,1,8,46,26,30,3,0,12,49,3,6,3,6,9,9,20,28,1,42,2,0,0,2,0,0
25657,1,6,2,2,2,0,0,0,2,0,0,0,0,0,0,0,0,0,0,0,0,0,2,0,0
25658,1,6,2,2,2,0,0,0,2,0,0,0,0,0,0,0,0,0,0,0,0,0,2,0,0
25659,1,6,2,2,2,0,0,0,2,0,0,0,0,0,0,0,0,0,0,0,0,0,2,0,0
25660,1,6,2,2,2,0,0,0,2,0,0,0,0,0,0,0,0,0,0,0,0,0,2,0,0
25661,1,6,2,2,2,0,0,0,2,0,0,0,0,0,0,0,0,0,0,0,0,0,2,0,0
25662,31,2079,1157,318,931,29,22,177,1186,6,104,63,125,110,188,712,1274,3,4596,255,0,2,7,9,0
25663,100,4602,1338,495,1086,10,64,173,1348,11,122,82,157,133,239,883,1686,7,11934,663,0,2,46,0,0
25664,126,5153,1513,682,1277,25,13,200,1538,11,199,116,219,210,335,1557,2584,6,15641,868,0,2,31,0,0
25665,73,3830,1296,573,1062,40,33,157,1336,8,201,118,231,209,349,1561,2689,4,12365,686,0,2,9,2,0
25666,19,437,207,111,150,11,0,50,218,5,26,19,36,31,55,133,272,3,943,52,0,2,31,1,0
25667,88,4633,1457,730,1242,11,6,188,1468,10,292,166,329,302,495,2424,4078,5,22973,1276,1,2,18,0,0
25668,50,1879,1098,241,925,5,10,155,1103,7,46,25,49,53,74,273,423,3,1580,87,0,2,21,0,0
25669,20,707,601,196,481,2,23,85,603,8,63,36,72,71,108,400,664,4,3036,168,0,2,15,0,0
25670,215,4676,182,127,129,0,0,53,182,5,39,21,42,44,63,217,343,2,926,51,0,2,3,1,0
25671,215,4676,1165,710,800,67,119,181,1232,18,243,153,282,261,435,2000,3492,10,36473,2026,1,2,3,1,0
25672,149,3116,1513,682,1277,25,13,200,1538,11,199,116,219,210,335,1557,2584,6,15641,868,0,2,30,7,0
25673,149,3116,819,519,539,24,98,155,843,15,96,57,106,111,163,690,1107,8,9171,509,0,2,30,7,0
25674,66,1312,207,111,150,11,0,50,218,5,26,19,36,31,55,133,272,3,943,52,0,2,27,0,0
25675,66,1312,410,198,237,31,55,97,441,11,63,38,72,74,110,414,683,6,4293,238,0,2,27,0,0
25676,214,4585,2,2,2,0,0,0,2,0,0,0,0,0,0,0,0,0,0,0,0,2,5,0,0
25677,214,4585,99,48,90,1,3,5,100,0,0,0,0,0,0,0,0,0,0,0,0,2,5,0,0
25678,214,4585,8,5,5,2,0,1,10,0,0,0,0,0,0,0,0,0,0,0,0,2,5,0,0
25679,214,4585,1217,716,841,84,126,174,1301,14,185,118,215,199,333,1446,2542,8,20687,1149,0,2,5,0,0
25680,214,4585,160,89,115,0,13,31,160,7,15,11,17,22,28,78,124,3,495,27,0,2,5,0,0
25681,214,4585,10,10,9,9,0,0,19,0,0,0,0,0,0,0,0,0,0,0,0,2,5,0,0
25682,214,4585,173,84,99,8,29,36,181,5,12,7,13,17,20,54,81,2,221,12,0,2,5,0,0
25683,214,4585,3,1,1,3,0,0,6,0,0,0,0,0,0,0,0,0,0,0,0,2,5,0,0
25684,94,1909,463,295,324,28,62,57,491,12,134,82,154,146,236,989,1696,6,11700,650,0,2,7,7,0
25685,254,5829,4293,999,3693,19,54,507,4312,9,155,88,170,164,258,1156,1898,4,9368,520,0,2,7,5,0
25686,254,5829,1482,859,1002,125,135,219,1607,16,219,134,251,235,385,1766,3032,9,27804,1544,1,2,7,5,0
25687,85,2238,773,422,505,30,103,129,803,14,77,46,83,91,129,535,839,7,6334,351,0,2,8,12,0
25688,141,3263,77,34,69,0,0,8,77,3,24,16,29,27,45,114,213,1,387,21,0,2,3,2,0
25689,141,3263,712,438,573,51,9,84,763,14,102,71,128,116,199,733,1364,8,11988,666,0,2,3,2,0
25690,309,6791,72,33,56,0,4,12,72,1,1,1,1,2,2,0,2,0,1,0,0,2,18,19,0
25691,309,6791,1454,835,1044,76,110,219,1530,17,275,158,296,292,454,2297,3718,9,34017,1889,1,2,18,19,0
25692,62,1229,1098,241,925,5,10,155,1103,7,46,25,49,53,74,273,423,3,1580,87,0,2,1,0,0
25693,62,1229,282,202,222,14,2,44,296,8,42,24,43,50,67,250,378,4,1548,86,0,2,1,0,0
25694,23,474,601,196,481,2,23,85,603,8,63,36,72,71,108,400,664,4,3036,168,0,2,8,0,0
25695,23,474,156,79,106,5,16,28,161,5,14,8,15,19,23,64,97,2,261,14,0,2,8,0,0
25696,93,3899,1289,550,1043,56,32,155,1345,10,167,93,185,177,278,1266,2075,5,11498,638,0,2,7,0,0
25697,152,7085,1392,870,1177,35,17,170,1427,14,494,280,531,508,811,4473,7289,7,54850,3047,2,2,45,0,0
25698,2,56,16,12,9,0,0,6,16,1,2,1,2,3,3,2,4,0,2,0,0,0,17,0,0
25699,1,8,127,75,83,2,11,30,129,4,14,7,14,18,21,61,87,2,175,9,0,0,2,0,0
25700,1,8,652,304,544,16,6,88,668,6,89,51,101,95,152,591,998,3,3399,188,0,0,2,0,0
25701,1,8,2,2,2,0,0,0,2,0,0,0,0,0,0,0,0,0,0,0,0,0,2,0,0
25702,1,8,8,5,5,0,0,3,8,0,0,0,0,0,0,0,0,0,0,0,0,0,2,0,0
25703,1,8,2,2,2,0,0,0,2,0,0,0,0,0,0,0,0,0,0,0,0,0,2,0,0
25704,1,8,14,8,8,0,0,6,14,0,0,0,0,0,0,0,0,0,0,0,0,0,2,0,0
25705,1,8,6,4,4,0,0,2,6,0,0,0,0,0,0,0,0,0,0,0,0,0,2,0,0
25706,1,8,6,4,4,0,0,2,6,1,2,1,2,3,3,2,4,0,2,0,0,0,2,0,0
25707,1,8,6,4,4,0,0,2,6,0,0,0,0,0,0,0,0,0,0,0,0,0,2,0,0
25708,1,8,7,5,5,0,0,2,7,0,0,0,0,0,0,0,0,0,0,0,0,0,2,0,0
25709,1,8,6,4,4,0,0,2,6,0,0,0,0,0,0,0,0,0,0,0,0,0,2,0,0
25710,1,8,10,6,6,0,0,4,10,0,0,0,0,0,0,0,0,0,0,0,0,0,2,0,0
25711,1,8,1,1,1,0,0,0,1,0,0,0,0,0,0,0,0,0,0,0,0,0,2,0,0
25712,1,8,1,1,1,0,0,0,1,0,0,0,0,0,0,0,0,0,0,0,0,0,2,0,0
25713,1,8,14,10,10,0,0,4,14,1,1,1,1,2,2,0,2,0,1,0,0,0,2,0,0
25714,1,8,46,26,30,3,0,12,49,3,6,3,6,9,9,20,28,1,42,2,0,0,2,0,0
25715,1,6,2,2,2,0,0,0,2,0,0,0,0,0,0,0,0,0,0,0,0,0,2,0,0
25716,1,6,2,2,2,0,0,0,2,0,0,0,0,0,0,0,0,0,0,0,0,0,2,0,0
25717,1,6,2,2,2,0,0,0,2,0,0,0,0,0,0,0,0,0,0,0,0,0,2,0,0
25718,1,6,2,2,2,0,0,0,2,0,0,0,0,0,0,0,0,0,0,0,0,0,2,0,0
25719,1,6,2,2,2,0,0,0,2,0,0,0,0,0,0,0,0,0,0,0,0,0,2,0,0
25720,31,2079,1157,318,931,29,22,177,1186,6,104,63,125,110,188,712,1274,3,4596,255,0,2,7,9,0
25721,100,4602,1338,495,1086,10,64,173,1348,11,122,82,157,133,239,883,1686,7,11934,663,0,2,46,0,0
25722,126,5153,1513,682,1277,25,13,200,1538,11,199,116,219,210,335,1557,2584,6,15641,868,0,2,31,0,0
25723,73,3830,1296,573,1062,40,33,157,1336,8,201,118,231,209,349,1561,2689,4,12365,686,0,2,9,2,0
25724,19,437,207,111,150,11,0,50,218,5,26,19,36,31,55,133,272,3,943,52,0,2,31,1,0
25725,88,4633,1457,730,1242,11,6,188,1468,10,292,166,329,302,495,2424,4078,5,22973,1276,1,2,18,0,0
25726,50,1879,1098,241,925,5,10,155,1103,7,46,25,49,53,74,273,423,3,1580,87,0,2,21,0,0
25727,20,707,601,196,481,2,23,85,603,8,63,36,72,71,108,400,664,4,3036,168,0,2,15,0,0
25728,155,3182,1513,682,1277,25,13,200,1538,11,199,116,219,210,335,1557,2584,6,15641,868,0,2,77,58,1
25729,155,3182,819,519,539,24,98,155,843,15,96,57,106,111,163,690,1107,8,9171,509,0,2,77,58,1
25730,126,5159,1513,682,1277,25,13,200,1538,11,199,116,219,210,335,1557,2584,6,15641,868,0,2,33,4,0
25731,126,5221,1513,682,1277,25,13,200,1538,11,199,116,219,210,335,1557,2584,6,15641,868,0,2,24,14,0
25732,154,3165,1513,682,1277,25,13,200,1538,11,199,116,219,210,335,1557,2584,6,15641,868,0,2,4,6,0
25733,154,3165,819,519,539,24,98,155,843,15,96,57,106,111,163,690,1107,8,9171,509,0,2,4,6,0
25734,34,1000,339,213,244,17,9,65,356,10,42,26,48,52,74,259,421,5,2410,133,0,2,2,1,0
25735,20,416,294,64,250,0,0,43,294,1,20,10,20,21,30,86,131,0,65,3,0,2,2,1,0
25736,20,416,78,46,62,3,0,14,81,3,8,4,8,11,12,28,41,1,62,3,0,2,2,1,0
25737,31,2071,1157,318,931,29,22,177,1186,6,104,63,125,110,188,712,1274,3,4596,255,0,2,0,4,0
25738,126,5241,1513,682,1277,25,13,200,1538,11,199,116,219,210,335,1557,2584,6,15641,868,0,2,8,4,0
25739,154,3163,1513,682,1277,25,13,200,1538,11,199,116,219,210,335,1557,2584,6,15641,868,0,2,1,2,0
25740,154,3163,819,519,539,24,98,155,843,15,96,57,106,111,163,690,1107,8,9171,509,0,2,1,2,0
25741,31,2065,1157,318,931,29,22,177,1186,6,104,63,125,110,188,712,1274,3,4596,255,0,2,0,1,0
25742,126,5241,1513,682,1277,25,13,200,1538,11,199,116,219,210,335,1557,2584,6,15641,868,0,2,5,3,0
25743,236,5565,722,423,573,19,0,135,741,12,172,101,199,184,300,1320,2257,6,15668,870,0,2,12,8,0
25744,236,5565,1508,847,911,44,250,301,1552,14,148,88,169,162,257,1120,1886,7,15077,837,0,2,12,8,0
25745,236,5605,722,423,573,19,0,135,741,12,172,101,199,184,300,1320,2257,6,15668,870,0,2,14,4,1
25746,236,5605,1508,847,911,44,250,301,1552,14,148,88,169,162,257,1120,1886,7,15077,837,0,2,14,4,1
25747,49,2332,722,423,573,19,0,135,741,12,172,101,199,184,300,1320,2257,6,15668,870,0,2,51,0,1
25748,236,5565,722,423,573,19,0,135,741,12,172,101,199,184,300,1320,2257,6,15668,870,0,2,12,8,0
25749,236,5565,1508,847,911,44,250,301,1552,14,148,88,169,162,257,1120,1886,7,15077,837,0,2,12,8,0
25750,127,5289,1513,682,1277,25,13,200,1538,11,199,116,219,210,335,1557,2584,6,15641,868,0,2,36,16,0
25751,154,3163,1513,682,1277,25,13,200,1538,11,199,116,219,210,335,1557,2584,6,15641,868,0,2,4,4,1
25752,154,3163,819,519,539,24,98,155,843,15,96,57,106,111,163,690,1107,8,9171,509,0,2,4,4,1
25753,34,1000,339,213,244,17,9,65,356,10,42,26,48,52,74,259,421,5,2410,133,0,2,1,1,1
25754,20,416,294,64,250,0,0,43,294,1,20,10,20,21,30,86,131,0,65,3,0,2,1,1,1
25755,20,416,78,46,62,3,0,14,81,3,8,4,8,11,12,28,41,1,62,3,0,2,1,1,1
25756,127,5289,1513,682,1277,25,13,200,1538,11,199,116,219,210,335,1557,2584,6,15641,868,0,2,4,4,1
25757,149,3215,1513,682,1277,25,13,200,1538,11,199,116,219,210,335,1557,2584,6,15641,868,0,2,27,8,0
25758,149,3215,819,519,539,24,98,155,843,15,96,57,106,111,163,690,1107,8,9171,509,0,2,27,8,0
25759,127,5207,1513,682,1277,25,13,200,1538,11,199,116,219,210,335,1557,2584,6,15641,868,0,2,28,0,0
25760,212,4578,1943,715,1694,26,18,214,1969,12,185,120,237,197,357,1436,2721,7,20915,1161,0,2,5,0,0
25761,212,4578,1168,838,957,57,25,144,1225,19,348,224,416,367,640,3018,5452,11,61921,3440,1,2,5,0,0
25762,92,4733,1943,715,1694,26,18,214,1969,12,185,120,237,197,357,1436,2721,7,20915,1161,0,2,40,0,0
25763,236,5605,722,423,573,19,0,135,741,12,172,101,199,184,300,1320,2257,6,15668,870,0,2,14,4,0
25764,236,5605,1508,847,911,44,250,301,1552,14,148,88,169,162,257,1120,1886,7,15077,837,0,2,14,4,0
25765,49,2332,722,423,573,19,0,135,741,12,172,101,199,184,300,1320,2257,6,15668,870,0,2,51,0,0
25766,154,3262,1513,682,1277,25,13,200,1538,11,199,116,219,210,335,1557,2584,6,15641,868,0,2,73,57,0
25767,154,3262,819,519,539,24,98,155,843,15,96,57,106,111,163,690,1107,8,9171,509,0,2,73,57,0
25768,34,1000,339,213,244,17,9,65,356,10,42,26,48,52,74,259,421,5,2410,133,0,2,2,1,0
25769,20,416,294,64,250,0,0,43,294,1,20,10,20,21,30,86,131,0,65,3,0,2,2,1,0
25770,20,416,78,46,62,3,0,14,81,3,8,4,8,11,12,28,41,1,62,3,0,2,2,1,0
25771,31,2065,1157,318,931,29,22,177,1186,6,104,63,125,110,188,712,1274,3,4596,255,0,2,0,5,0
25772,128,5343,1513,682,1277,25,13,200,1538,11,199,116,219,210,335,1557,2584,6,15641,868,0,2,77,12,0
25773,141,3269,77,34,69,0,0,8,77,3,24,16,29,27,45,114,213,1,387,21,0,2,4,3,0
25774,141,3269,712,438,573,51,9,84,763,14,102,71,128,116,199,733,1364,8,11988,666,0,2,4,3,0
25775,94,3940,1289,550,1043,56,32,155,1345,10,167,93,185,177,278,1266,2075,5,11498,638,0,2,10,0,0
25776,212,4578,1943,715,1694,26,18,214,1969,12,185,120,237,197,357,1436,2721,7,20915,1161,0,2,5,0,0
25777,212,4578,1168,838,957,57,25,144,1225,19,348,224,416,367,640,3018,5452,11,61921,3440,1,2,5,0,0
25778,92,4733,1943,715,1694,26,18,214,1969,12,185,120,237,197,357,1436,2721,7,20915,1161,0,2,40,0,0
25779,235,5544,722,423,573,19,0,135,741,12,172,101,199,184,300,1320,2257,6,15668,870,0,2,12,14,0
25780,235,5544,1508,847,911,44,250,301,1552,14,148,88,169,162,257,1120,1886,7,15077,837,0,2,12,14,0
25781,141,3269,77,34,69,0,0,8,77,3,24,16,29,27,45,114,213,1,387,21,0,2,4,3,0
25782,141,3269,712,438,573,51,9,84,763,14,102,71,128,116,199,733,1364,8,11988,666,0,2,4,3,0
25783,94,3940,1289,550,1043,56,32,155,1345,10,167,93,185,177,278,1266,2075,5,11498,638,0,2,10,0,0
25784,47,2258,722,423,573,19,0,135,741,12,172,101,199,184,300,1320,2257,6,15668,870,0,2,6,1,1
25785,47,2258,722,423,573,19,0,135,741,12,172,101,199,184,300,1320,2257,6,15668,870,0,2,1,1,0
25786,96,1940,463,295,324,28,62,57,491,12,134,82,154,146,236,989,1696,6,11700,650,0,2,5,2,1
25787,2,67,16,12,9,0,0,6,16,1,2,1,2,3,3,2,4,0,2,0,0,2,4,1,0
25788,4,77,127,75,83,2,11,30,129,4,14,7,14,18,21,61,87,2,175,9,0,2,1,1,1
25789,4,77,652,304,544,16,6,88,668,6,89,51,101,95,152,591,998,3,3399,188,0,2,1,1,1
25790,4,77,2,2,2,0,0,0,2,0,0,0,0,0,0,0,0,0,0,0,0,2,1,1,1
25791,4,77,8,5,5,0,0,3,8,0,0,0,0,0,0,0,0,0,0,0,0,2,1,1,1
25792,4,77,2,2,2,0,0,0,2,0,0,0,0,0,0,0,0,0,0,0,0,2,1,1,1
25793,4,77,14,8,8,0,0,6,14,0,0,0,0,0,0,0,0,0,0,0,0,2,1,1,1
25794,4,77,6,4,4,0,0,2,6,0,0,0,0,0,0,0,0,0,0,0,0,2,1,1,1
25795,4,77,6,4,4,0,0,2,6,1,2,1,2,3,3,2,4,0,2,0,0,2,1,1,1
25796,4,77,6,4,4,0,0,2,6,0,0,0,0,0,0,0,0,0,0,0,0,2,1,1,1
25797,4,77,7,5,5,0,0,2,7,0,0,0,0,0,0,0,0,0,0,0,0,2,1,1,1
25798,4,77,6,4,4,0,0,2,6,0,0,0,0,0,0,0,0,0,0,0,0,2,1,1,1
25799,4,77,10,6,6,0,0,4,10,0,0,0,0,0,0,0,0,0,0,0,0,2,1,1,1
25800,4,77,1,1,1,0,0,0,1,0,0,0,0,0,0,0,0,0,0,0,0,2,1,1,1
25801,4,77,1,1,1,0,0,0,1,0,0,0,0,0,0,0,0,0,0,0,0,2,1,1,1
25802,4,77,14,10,10,0,0,4,14,1,1,1,1,2,2,0,2,0,1,0,0,2,1,1,1
25803,4,77,46,26,30,3,0,12,49,3,6,3,6,9,9,20,28,1,42,2,0,2,1,1,1
25804,7,296,72,33,56,0,4,12,72,1,1,1,1,2,2,0,2,0,1,0,0,2,26,23,1
25805,94,3942,1289,550,1043,56,32,155,1345,10,167,93,185,177,278,1266,2075,5,11498,638,0,2,3,3,1
25806,152,7086,1392,870,1177,35,17,170,1427,14,494,280,531,508,811,4473,7289,7,54850,3047,2,2,1,1,1
25807,23,579,102,59,69,5,3,24,107,6,22,15,28,28,43,113,206,3,789,43,0,2,1,1,1
25808,155,4397,1660,832,1314,41,38,274,1701,20,312,209,395,332,604,2671,5058,12,64042,3557,1,2,1,1,1
25809,8,271,74,35,59,1,0,14,75,3,14,7,14,17,21,58,85,1,128,7,0,2,3,1,1
25810,38,2302,334,251,279,10,4,40,344,5,127,74,143,132,217,899,1528,2,4303,239,0,2,1,1,1
25811,61,2733,1293,570,1093,25,15,163,1318,10,195,123,241,205,364,1516,2795,6,17273,959,0,2,4,2,1
25812,92,4735,1943,715,1694,26,18,214,1969,12,185,120,237,197,357,1436,2721,7,20915,1161,0,2,2,2,1
25813,215,4676,182,127,129,0,0,53,182,5,39,21,42,44,63,217,343,2,926,51,0,2,3,1,0
25814,215,4676,1165,710,800,67,119,181,1232,18,243,153,282,261,435,2000,3492,10,36473,2026,1,2,3,1,0
25815,154,3262,1513,682,1277,25,13,200,1538,11,199,116,219,210,335,1557,2584,6,15641,868,0,2,108,50,0
25816,154,3262,819,519,539,24,98,155,843,15,96,57,106,111,163,690,1107,8,9171,509,0,2,108,50,0
25817,66,1312,207,111,150,11,0,50,218,5,26,19,36,31,55,133,272,3,943,52,0,2,8,0,0
25818,66,1312,410,198,237,31,55,97,441,11,63,38,72,74,110,414,683,6,4293,238,0,2,8,0,0
25819,94,1909,463,295,324,28,62,57,491,12,134,82,154,146,236,989,1696,6,11700,650,0,2,7,7,0
25820,34,1000,339,213,244,17,9,65,356,10,42,26,48,52,74,259,421,5,2410,133,0,2,2,1,0
25821,254,5829,4293,999,3693,19,54,507,4312,9,155,88,170,164,258,1156,1898,4,9368,520,0,2,2,2,0
25822,254,5829,1482,859,1002,125,135,219,1607,16,219,134,251,235,385,1766,3032,9,27804,1544,1,2,2,2,0
25823,85,2238,773,422,505,30,103,129,803,14,77,46,83,91,129,535,839,7,6334,351,0,2,8,12,0
25824,141,3269,77,34,69,0,0,8,77,3,24,16,29,27,45,114,213,1,387,21,0,2,7,5,0
25825,141,3269,712,438,573,51,9,84,763,14,102,71,128,116,199,733,1364,8,11988,666,0,2,7,5,0
25826,236,5565,722,423,573,19,0,135,741,12,172,101,199,184,300,1320,2257,6,15668,870,0,2,12,8,0
25827,236,5565,1508,847,911,44,250,301,1552,14,148,88,169,162,257,1120,1886,7,15077,837,0,2,12,8,0
25828,309,6803,72,33,56,0,4,12,72,1,1,1,1,2,2,0,2,0,1,0,0,2,12,16,0
25829,309,6803,1454,835,1044,76,110,219,1530,17,275,158,296,292,454,2297,3718,9,34017,1889,1,2,12,16,0
25830,20,416,294,64,250,0,0,43,294,1,20,10,20,21,30,86,131,0,65,3,0,2,2,1,0
25831,20,416,78,46,62,3,0,14,81,3,8,4,8,11,12,28,41,1,62,3,0,2,2,1,0
25832,212,4578,1943,715,1694,26,18,214,1969,12,185,120,237,197,357,1436,2721,7,20915,1161,0,2,5,0,0
25833,212,4578,1168,838,957,57,25,144,1225,19,348,224,416,367,640,3018,5452,11,61921,3440,1,2,5,0,0
25834,23,474,601,196,481,2,23,85,603,8,63,36,72,71,108,400,664,4,3036,168,0,2,8,0,0
25835,23,474,156,79,106,5,16,28,161,5,14,8,15,19,23,64,97,2,261,14,0,2,8,0,0
25836,94,3940,1289,550,1043,56,32,155,1345,10,167,93,185,177,278,1266,2075,5,11498,638,0,2,10,0,0
25837,152,7085,1392,870,1177,35,17,170,1427,14,494,280,531,508,811,4473,7289,7,54850,3047,2,2,45,0,0
25838,31,2065,1157,318,931,29,22,177,1186,6,104,63,125,110,188,712,1274,3,4596,255,0,2,7,14,0
25839,100,4602,1338,495,1086,10,64,173,1348,11,122,82,157,133,239,883,1686,7,11934,663,0,2,40,0,0
25840,128,5343,1513,682,1277,25,13,200,1538,11,199,116,219,210,335,1557,2584,6,15641,868,0,2,128,4,0
25841,73,3830,1296,573,1062,40,33,157,1336,8,201,118,231,209,349,1561,2689,4,12365,686,0,2,9,2,0
25842,92,4733,1943,715,1694,26,18,214,1969,12,185,120,237,197,357,1436,2721,7,20915,1161,0,2,40,0,0
25843,20,707,601,196,481,2,23,85,603,8,63,36,72,71,108,400,664,4,3036,168,0,2,15,0,0
25844,312,6826,72,33,56,0,4,12,72,1,1,1,1,2,2,0,2,0,1,0,0,2,10,5,0
25845,312,6826,1454,835,1044,76,110,219,1530,17,275,158,296,292,454,2297,3718,9,34017,1889,1,2,10,5,0
25846,101,4715,1338,495,1086,10,64,173,1348,11,122,82,157,133,239,883,1686,7,11934,663,0,2,37,0,0
25847,20,507,205,80,86,16,53,53,221,7,18,10,19,25,29,94,134,3,497,27,0,2,1,2,1
25848,309,6789,72,33,56,0,4,12,72,1,1,1,1,2,2,0,2,0,1,0,0,2,1,1,1
25849,309,6789,1454,835,1044,76,110,219,1530,17,275,158,296,292,454,2297,3718,9,34017,1889,1,2,1,1,1
25850,36,1070,182,127,129,0,0,53,182,5,39,21,42,44,63,217,343,2,926,51,0,2,2,3,1
25851,152,7069,1392,870,1177,35,17,170,1427,14,494,280,531,508,811,4473,7289,7,54850,3047,2,2,4,3,1
25852,139,5902,1782,648,1425,9,47,279,1791,8,171,97,189,179,286,1292,2140,4,9462,525,0,2,2,6,1
25853,111,4132,1450,624,1228,12,26,181,1462,14,306,186,354,320,540,2580,4493,8,36391,2021,1,2,6,6,1
25854,155,4385,1660,832,1314,41,38,274,1701,20,312,209,395,332,604,2671,5058,12,64042,3557,1,2,2,4,1
25855,128,5327,1513,682,1277,25,13,200,1538,11,199,116,219,210,335,1557,2584,6,15641,868,0,2,4,3,1
25856,95,4632,1523,757,1297,19,12,193,1542,12,193,117,230,205,347,1508,2664,7,19053,1058,0,2,1,1,1
25857,60,1079,282,196,195,3,0,86,285,8,130,71,141,138,212,936,1507,4,6538,363,0,2,2,2,0
25858,215,4676,182,127,129,0,0,53,182,5,39,21,42,44,63,217,343,2,926,51,0,2,2,1,0
25859,215,4676,1165,710,800,67,119,181,1232,18,243,153,282,261,435,2000,3492,10,36473,2026,1,2,2,1,0
25860,164,5053,1660,832,1314,41,38,274,1701,20,312,209,395,332,604,2671,5058,12,64042,3557,1,2,1,1,0
25861,164,5053,1057,646,719,113,100,145,1170,18,215,134,248,233,382,1740,3004,10,31186,1732,1,2,1,1,0
25862,91,1828,757,253,292,73,244,162,830,13,61,38,67,74,105,409,651,7,4654,258,0,2,3,3,0
25863,46,952,386,256,301,16,9,68,402,4,59,35,69,63,104,355,621,2,1453,80,0,2,3,3,0
25864,46,952,264,131,164,11,41,46,275,6,38,22,40,44,62,214,338,3,1068,59,0,2,3,3,0
25865,92,2955,773,419,590,28,0,166,801,10,204,113,217,214,330,1598,2554,5,13587,754,0,2,3,3,0
25866,155,4385,1660,832,1314,41,38,274,1701,20,312,209,395,332,604,2671,5058,12,64042,3557,1,2,2,1,0
25867,111,4132,1450,624,1228,12,26,181,1462,14,306,186,354,320,540,2580,4493,8,36391,2021,1,2,2,1,0
25868,254,5825,4293,999,3693,19,54,507,4312,9,155,88,170,164,258,1156,1898,4,9368,520,0,2,2,2,0
25869,254,5825,1482,859,1002,125,135,219,1607,16,219,134,251,235,385,1766,3032,9,27804,1544,1,2,2,2,0
25870,90,1921,1043,504,840,53,9,147,1096,9,180,112,198,189,310,1377,2344,4,11604,644,0,2,4,4,0
25871,90,1921,383,288,292,26,6,62,409,11,65,38,67,76,105,429,656,5,3719,206,0,2,4,4,0
25872,152,7067,1392,870,1177,35,17,170,1427,14,494,280,531,508,811,4473,7289,7,54850,3047,2,2,1,1,0
25873,60,1079,282,196,195,3,0,86,285,8,130,71,141,138,212,936,1507,4,6538,363,0,2,2,2,0
25874,215,4676,182,127,129,0,0,53,182,5,39,21,42,44,63,217,343,2,926,51,0,2,2,1,0
25875,215,4676,1165,710,800,67,119,181,1232,18,243,153,282,261,435,2000,3492,10,36473,2026,1,2,2,1,0
25876,164,5053,1660,832,1314,41,38,274,1701,20,312,209,395,332,604,2671,5058,12,64042,3557,1,2,1,1,0
25877,164,5053,1057,646,719,113,100,145,1170,18,215,134,248,233,382,1740,3004,10,31186,1732,1,2,1,1,0
25878,254,5825,4293,999,3693,19,54,507,4312,9,155,88,170,164,258,1156,1898,4,9368,520,0,2,2,2,0
25879,254,5825,1482,859,1002,125,135,219,1607,16,219,134,251,235,385,1766,3032,9,27804,1544,1,2,2,2,0
25880,20,507,205,80,86,16,53,53,221,7,18,10,19,25,29,94,134,3,497,27,0,2,1,2,0
25881,309,6789,72,33,56,0,4,12,72,1,1,1,1,2,2,0,2,0,1,0,0,2,1,1,0
25882,309,6789,1454,835,1044,76,110,219,1530,17,275,158,296,292,454,2297,3718,9,34017,1889,1,2,1,1,0
25883,91,1828,757,253,292,73,244,162,830,13,61,38,67,74,105,409,651,7,4654,258,0,2,3,3,0
25884,46,952,386,256,301,16,9,68,402,4,59,35,69,63,104,355,621,2,1453,80,0,2,3,3,0
25885,46,952,264,131,164,11,41,46,275,6,38,22,40,44,62,214,338,3,1068,59,0,2,3,3,0
25886,90,1921,1043,504,840,53,9,147,1096,9,180,112,198,189,310,1377,2344,4,11604,644,0,2,4,4,0
25887,90,1921,383,288,292,26,6,62,409,11,65,38,67,76,105,429,656,5,3719,206,0,2,4,4,0
25888,36,1070,182,127,129,0,0,53,182,5,39,21,42,44,63,217,343,2,926,51,0,2,2,3,0
25889,152,7067,1392,870,1177,35,17,170,1427,14,494,280,531,508,811,4473,7289,7,54850,3047,2,2,5,4,0
25890,92,2955,773,419,590,28,0,166,801,10,204,113,217,214,330,1598,2554,5,13587,754,0,2,3,3,0
25891,139,5902,1782,648,1425,9,47,279,1791,8,171,97,189,179,286,1292,2140,4,9462,525,0,2,2,6,0
25892,111,4132,1450,624,1228,12,26,181,1462,14,306,186,354,320,540,2580,4493,8,36391,2021,1,2,8,7,0
25893,155,4385,1660,832,1314,41,38,274,1701,20,312,209,395,332,604,2671,5058,12,64042,3557,1,2,4,5,0
25894,128,5327,1513,682,1277,25,13,200,1538,11,199,116,219,210,335,1557,2584,6,15641,868,0,2,4,3,0
25895,95,4632,1523,757,1297,19,12,193,1542,12,193,117,230,205,347,1508,2664,7,19053,1058,0,2,1,1,0
25896,94,3936,1289,550,1043,56,32,155,1345,10,167,93,185,177,278,1266,2075,5,11498,638,0,2,10,10,0
25897,35,1052,182,127,129,0,0,53,182,5,39,21,42,44,63,217,343,2,926,51,0,2,3,6,0
25898,152,7065,1392,870,1177,35,17,170,1427,14,494,280,531,508,811,4473,7289,7,54850,3047,2,2,4,4,0
25899,100,4589,1338,495,1086,10,64,173,1348,11,122,82,157,133,239,883,1686,7,11934,663,0,2,69,68,0
25900,176,7684,139,89,101,2,0,35,141,7,54,34,62,61,96,330,569,4,2287,127,0,2,217,219,0
25901,176,7684,7,5,5,0,0,2,7,1,2,1,2,3,3,2,4,0,2,0,0,2,217,219,0
25902,139,5896,1782,648,1425,9,47,279,1791,8,171,97,189,179,286,1292,2140,4,9462,525,0,2,9,9,0
25903,155,4383,1660,832,1314,41,38,274,1701,20,312,209,395,332,604,2671,5058,12,64042,3557,1,2,7,7,0
25904,40,3016,996,429,845,24,10,117,1020,7,76,50,88,83,138,494,879,4,3565,198,0,2,36,36,0
25905,128,5326,1513,682,1277,25,13,200,1538,11,199,116,219,210,335,1557,2584,6,15641,868,0,2,48,47,0
25906,73,3826,1296,573,1062,40,33,157,1336,8,201,118,231,209,349,1561,2689,4,12365,686,0,2,7,7,0
25907,86,4499,1457,730,1242,11,6,188,1468,10,292,166,329,302,495,2424,4078,5,22973,1276,1,2,18,18,0
25908,39,2317,652,304,544,16,6,88,668,6,89,51,101,95,152,591,998,3,3399,188,0,2,93,96,0
25909,70,3204,1455,414,1257,16,76,112,1471,5,41,23,46,46,69,231,381,2,1069,59,0,2,24,24,0
25910,92,4727,1943,715,1694,26,18,214,1969,12,185,120,237,197,357,1436,2721,7,20915,1161,0,2,12,12,0
25911,94,3936,1289,550,1043,56,32,155,1345,10,167,93,185,177,278,1266,2075,5,11498,638,0,2,10,10,0
25912,35,1052,182,127,129,0,0,53,182,5,39,21,42,44,63,217,343,2,926,51,0,2,3,6,0
25913,152,7065,1392,870,1177,35,17,170,1427,14,494,280,531,508,811,4473,7289,7,54850,3047,2,2,4,4,0
25914,100,4589,1338,495,1086,10,64,173,1348,11,122,82,157,133,239,883,1686,7,11934,663,0,2,69,68,0
25915,176,7684,139,89,101,2,0,35,141,7,54,34,62,61,96,330,569,4,2287,127,0,2,217,219,0
25916,176,7684,7,5,5,0,0,2,7,1,2,1,2,3,3,2,4,0,2,0,0,2,217,219,0
25917,139,5896,1782,648,1425,9,47,279,1791,8,171,97,189,179,286,1292,2140,4,9462,525,0,2,9,9,0
25918,155,4383,1660,832,1314,41,38,274,1701,20,312,209,395,332,604,2671,5058,12,64042,3557,1,2,7,7,0
25919,40,3016,996,429,845,24,10,117,1020,7,76,50,88,83,138,494,879,4,3565,198,0,2,36,36,0
25920,128,5326,1513,682,1277,25,13,200,1538,11,199,116,219,210,335,1557,2584,6,15641,868,0,2,48,47,0
25921,73,3826,1296,573,1062,40,33,157,1336,8,201,118,231,209,349,1561,2689,4,12365,686,0,2,7,7,0
25922,86,4499,1457,730,1242,11,6,188,1468,10,292,166,329,302,495,2424,4078,5,22973,1276,1,2,18,18,0
25923,39,2317,652,304,544,16,6,88,668,6,89,51,101,95,152,591,998,3,3399,188,0,2,93,96,0
25924,70,3204,1455,414,1257,16,76,112,1471,5,41,23,46,46,69,231,381,2,1069,59,0,2,24,24,0
25925,92,4727,1943,715,1694,26,18,214,1969,12,185,120,237,197,357,1436,2721,7,20915,1161,0,2,12,12,0
25926,96,1940,463,295,324,28,62,57,491,12,134,82,154,146,236,989,1696,6,11700,650,0,2,5,2,0
25927,235,5544,722,423,573,19,0,135,741,12,172,101,199,184,300,1320,2257,6,15668,870,0,2,12,14,0
25928,235,5544,1508,847,911,44,250,301,1552,14,148,88,169,162,257,1120,1886,7,15077,837,0,2,12,14,0
25929,47,2258,722,423,573,19,0,135,741,12,172,101,199,184,300,1320,2257,6,15668,870,0,2,6,1,0
25930,2,67,16,12,9,0,0,6,16,1,2,1,2,3,3,2,4,0,2,0,0,2,4,1,0
25931,4,77,127,75,83,2,11,30,129,4,14,7,14,18,21,61,87,2,175,9,0,2,1,1,0
25932,4,77,652,304,544,16,6,88,668,6,89,51,101,95,152,591,998,3,3399,188,0,2,1,1,0
25933,4,77,2,2,2,0,0,0,2,0,0,0,0,0,0,0,0,0,0,0,0,2,1,1,0
25934,4,77,8,5,5,0,0,3,8,0,0,0,0,0,0,0,0,0,0,0,0,2,1,1,0
25935,4,77,2,2,2,0,0,0,2,0,0,0,0,0,0,0,0,0,0,0,0,2,1,1,0
25936,4,77,14,8,8,0,0,6,14,0,0,0,0,0,0,0,0,0,0,0,0,2,1,1,0
25937,4,77,6,4,4,0,0,2,6,0,0,0,0,0,0,0,0,0,0,0,0,2,1,1,0
25938,4,77,6,4,4,0,0,2,6,1,2,1,2,3,3,2,4,0,2,0,0,2,1,1,0
25939,4,77,6,4,4,0,0,2,6,0,0,0,0,0,0,0,0,0,0,0,0,2,1,1,0
25940,4,77,7,5,5,0,0,2,7,0,0,0,0,0,0,0,0,0,0,0,0,2,1,1,0
25941,4,77,6,4,4,0,0,2,6,0,0,0,0,0,0,0,0,0,0,0,0,2,1,1,0
25942,4,77,10,6,6,0,0,4,10,0,0,0,0,0,0,0,0,0,0,0,0,2,1,1,0
25943,4,77,1,1,1,0,0,0,1,0,0,0,0,0,0,0,0,0,0,0,0,2,1,1,0
25944,4,77,1,1,1,0,0,0,1,0,0,0,0,0,0,0,0,0,0,0,0,2,1,1,0
25945,4,77,14,10,10,0,0,4,14,1,1,1,1,2,2,0,2,0,1,0,0,2,1,1,0
25946,4,77,46,26,30,3,0,12,49,3,6,3,6,9,9,20,28,1,42,2,0,2,1,1,0
25947,7,296,72,33,56,0,4,12,72,1,1,1,1,2,2,0,2,0,1,0,0,2,26,23,0
25948,94,3938,1289,550,1043,56,32,155,1345,10,167,93,185,177,278,1266,2075,5,11498,638,0,2,3,3,0
25949,152,7066,1392,870,1177,35,17,170,1427,14,494,280,531,508,811,4473,7289,7,54850,3047,2,2,1,1,0
25950,23,579,102,59,69,5,3,24,107,6,22,15,28,28,43,113,206,3,789,43,0,2,1,1,0
25951,155,4384,1660,832,1314,41,38,274,1701,20,312,209,395,332,604,2671,5058,12,64042,3557,1,2,1,1,0
25952,8,271,74,35,59,1,0,14,75,3,14,7,14,17,21,58,85,1,128,7,0,2,3,1,0
25953,38,2302,334,251,279,10,4,40,344,5,127,74,143,132,217,899,1528,2,4303,239,0,2,1,1,0
25954,61,2733,1293,570,1093,25,15,163,1318,10,195,123,241,205,364,1516,2795,6,17273,959,0,2,4,2,0
25955,92,4729,1943,715,1694,26,18,214,1969,12,185,120,237,197,357,1436,2721,7,20915,1161,0,2,2,2,0
25956,164,5047,1660,832,1314,41,38,274,1701,20,312,209,395,332,604,2671,5058,12,64042,3557,1,2,6,8,1
25957,164,5047,1057,646,719,113,100,145,1170,18,215,134,248,233,382,1740,3004,10,31186,1732,1,2,6,8,1
25958,89,1826,477,336,357,30,23,73,507,16,194,134,250,210,384,1538,2962,10,30538,1696,0,2,2,2,1
25959,128,5324,1513,682,1277,25,13,200,1538,11,199,116,219,210,335,1557,2584,6,15641,868,0,2,3,3,1
25960,312,6826,72,33,56,0,4,12,72,1,1,1,1,2,2,0,2,0,1,0,0,2,6,4,1
25961,312,6826,1454,835,1044,76,110,219,1530,17,275,158,296,292,454,2297,3718,9,34017,1889,1,2,6,4,1
25962,177,7801,139,89,101,2,0,35,141,7,54,34,62,61,96,330,569,4,2287,127,0,2,68,0,1
25963,177,7801,7,5,5,0,0,2,7,1,2,1,2,3,3,2,4,0,2,0,0,2,68,0,1
25964,211,4632,1943,715,1694,26,18,214,1969,12,185,120,237,197,357,1436,2721,7,20915,1161,0,2,18,4,1
25965,211,4632,1168,838,957,57,25,144,1225,19,348,224,416,367,640,3018,5452,11,61921,3440,1,2,18,4,1
25966,94,4715,1943,715,1694,26,18,214,1969,12,185,120,237,197,357,1436,2721,7,20915,1161,0,2,35,0,1
25967,312,6828,72,33,56,0,4,12,72,1,1,1,1,2,2,0,2,0,1,0,0,2,5,2,1
25968,312,6828,1454,835,1044,76,110,219,1530,17,275,158,296,292,454,2297,3718,9,34017,1889,1,2,5,2,1
25969,94,4715,1943,715,1694,26,18,214,1969,12,185,120,237,197,357,1436,2721,7,20915,1161,0,2,5,3,1
25970,164,5047,1660,832,1314,41,38,274,1701,20,312,209,395,332,604,2671,5058,12,64042,3557,1,2,6,8,0
25971,164,5047,1057,646,719,113,100,145,1170,18,215,134,248,233,382,1740,3004,10,31186,1732,1,2,6,8,0
25972,89,1826,477,336,357,30,23,73,507,16,194,134,250,210,384,1538,2962,10,30538,1696,0,2,2,2,0
25973,128,5324,1513,682,1277,25,13,200,1538,11,199,116,219,210,335,1557,2584,6,15641,868,0,2,3,3,0
25974,60,1079,282,196,195,3,0,86,285,8,130,71,141,138,212,936,1507,4,6538,363,0,2,2,2,0
25975,4,77,127,75,83,2,11,30,129,4,14,7,14,18,21,61,87,2,175,9,0,2,1,1,0
25976,4,77,652,304,544,16,6,88,668,6,89,51,101,95,152,591,998,3,3399,188,0,2,1,1,0
25977,4,77,2,2,2,0,0,0,2,0,0,0,0,0,0,0,0,0,0,0,0,2,1,1,0
25978,4,77,8,5,5,0,0,3,8,0,0,0,0,0,0,0,0,0,0,0,0,2,1,1,0
25979,4,77,2,2,2,0,0,0,2,0,0,0,0,0,0,0,0,0,0,0,0,2,1,1,0
25980,4,77,14,8,8,0,0,6,14,0,0,0,0,0,0,0,0,0,0,0,0,2,1,1,0
25981,4,77,6,4,4,0,0,2,6,0,0,0,0,0,0,0,0,0,0,0,0,2,1,1,0
25982,4,77,6,4,4,0,0,2,6,1,2,1,2,3,3,2,4,0,2,0,0,2,1,1,0
25983,4,77,6,4,4,0,0,2,6,0,0,0,0,0,0,0,0,0,0,0,0,2,1,1,0
25984,4,77,7,5,5,0,0,2,7,0,0,0,0,0,0,0,0,0,0,0,0,2,1,1,0
25985,4,77,6,4,4,0,0,2,6,0,0,0,0,0,0,0,0,0,0,0,0,2,1,1,0
25986,4,77,10,6,6,0,0,4,10,0,0,0,0,0,0,0,0,0,0,0,0,2,1,1,0
25987,4,77,1,1,1,0,0,0,1,0,0,0,0,0,0,0,0,0,0,0,0,2,1,1,0
25988,4,77,1,1,1,0,0,0,1,0,0,0,0,0,0,0,0,0,0,0,0,2,1,1,0
25989,4,77,14,10,10,0,0,4,14,1,1,1,1,2,2,0,2,0,1,0,0,2,1,1,0
25990,4,77,46,26,30,3,0,12,49,3,6,3,6,9,9,20,28,1,42,2,0,2,1,1,0
25991,7,296,72,33,56,0,4,12,72,1,1,1,1,2,2,0,2,0,1,0,0,2,26,23,0
25992,215,4676,182,127,129,0,0,53,182,5,39,21,42,44,63,217,343,2,926,51,0,2,2,1,0
25993,215,4676,1165,710,800,67,119,181,1232,18,243,153,282,261,435,2000,3492,10,36473,2026,1,2,2,1,0
25994,164,5047,1660,832,1314,41,38,274,1701,20,312,209,395,332,604,2671,5058,12,64042,3557,1,2,7,9,0
25995,164,5047,1057,646,719,113,100,145,1170,18,215,134,248,233,382,1740,3004,10,31186,1732,1,2,7,9,0
25996,89,1826,477,336,357,30,23,73,507,16,194,134,250,210,384,1538,2962,10,30538,1696,0,2,2,2,0
25997,96,1940,463,295,324,28,62,57,491,12,134,82,154,146,236,989,1696,6,11700,650,0,2,5,2,0
25998,254,5825,4293,999,3693,19,54,507,4312,9,155,88,170,164,258,1156,1898,4,9368,520,0,2,2,2,0
25999,254,5825,1482,859,1002,125,135,219,1607,16,219,134,251,235,385,1766,3032,9,27804,1544,1,2,2,2,0
26000,20,507,205,80,86,16,53,53,221,7,18,10,19,25,29,94,134,3,497,27,0,2,1,2,0
26001,235,5544,722,423,573,19,0,135,741,12,172,101,199,184,300,1320,2257,6,15668,870,0,2,12,14,0
26002,235,5544,1508,847,911,44,250,301,1552,14,148,88,169,162,257,1120,1886,7,15077,837,0,2,12,14,0
26003,312,6826,72,33,56,0,4,12,72,1,1,1,1,2,2,0,2,0,1,0,0,2,1,1,0
26004,312,6826,1454,835,1044,76,110,219,1530,17,275,158,296,292,454,2297,3718,9,34017,1889,1,2,1,1,0
26005,91,1828,757,253,292,73,244,162,830,13,61,38,67,74,105,409,651,7,4654,258,0,2,3,3,0
26006,46,952,386,256,301,16,9,68,402,4,59,35,69,63,104,355,621,2,1453,80,0,2,3,3,0
26007,46,952,264,131,164,11,41,46,275,6,38,22,40,44,62,214,338,3,1068,59,0,2,3,3,0
26008,90,1921,1043,504,840,53,9,147,1096,9,180,112,198,189,310,1377,2344,4,11604,644,0,2,4,4,0
26009,90,1921,383,288,292,26,6,62,409,11,65,38,67,76,105,429,656,5,3719,206,0,2,4,4,0
26010,94,3938,1289,550,1043,56,32,155,1345,10,167,93,185,177,278,1266,2075,5,11498,638,0,2,13,13,0
26011,35,1052,182,127,129,0,0,53,182,5,39,21,42,44,63,217,343,2,926,51,0,2,5,9,0
26012,152,7066,1392,870,1177,35,17,170,1427,14,494,280,531,508,811,4473,7289,7,54850,3047,2,2,10,9,0
26013,92,2955,773,419,590,28,0,166,801,10,204,113,217,214,330,1598,2554,5,13587,754,0,2,3,3,0
26014,2,67,16,12,9,0,0,6,16,1,2,1,2,3,3,2,4,0,2,0,0,2,4,1,0
26015,101,4702,1338,495,1086,10,64,173,1348,11,122,82,157,133,239,883,1686,7,11934,663,0,2,69,68,0
26016,177,7811,139,89,101,2,0,35,141,7,54,34,62,61,96,330,569,4,2287,127,0,2,217,219,0
26017,177,7811,7,5,5,0,0,2,7,1,2,1,2,3,3,2,4,0,2,0,0,2,217,219,0
26018,139,5896,1782,648,1425,9,47,279,1791,8,171,97,189,179,286,1292,2140,4,9462,525,0,2,11,15,0
26019,23,579,102,59,69,5,3,24,107,6,22,15,28,28,43,113,206,3,789,43,0,2,1,1,0
26020,111,4132,1450,624,1228,12,26,181,1462,14,306,186,354,320,540,2580,4493,8,36391,2021,1,2,8,7,0
26021,155,4384,1660,832,1314,41,38,274,1701,20,312,209,395,332,604,2671,5058,12,64042,3557,1,2,12,13,0
26022,40,3016,996,429,845,24,10,117,1020,7,76,50,88,83,138,494,879,4,3565,198,0,2,36,36,0
26023,128,5324,1513,682,1277,25,13,200,1538,11,199,116,219,210,335,1557,2584,6,15641,868,0,2,55,53,0
26024,73,3826,1296,573,1062,40,33,157,1336,8,201,118,231,209,349,1561,2689,4,12365,686,0,2,7,7,0
26025,86,4499,1457,730,1242,11,6,188,1468,10,292,166,329,302,495,2424,4078,5,22973,1276,1,2,18,18,0
26026,39,2317,652,304,544,16,6,88,668,6,89,51,101,95,152,591,998,3,3399,188,0,2,93,96,0
26027,70,3204,1455,414,1257,16,76,112,1471,5,41,23,46,46,69,231,381,2,1069,59,0,2,24,24,0
26028,8,271,74,35,59,1,0,14,75,3,14,7,14,17,21,58,85,1,128,7,0,2,3,1,0
26029,95,4632,1523,757,1297,19,12,193,1542,12,193,117,230,205,347,1508,2664,7,19053,1058,0,2,1,1,0
26030,38,2302,334,251,279,10,4,40,344,5,127,74,143,132,217,899,1528,2,4303,239,0,2,1,1,0
26031,61,2733,1293,570,1093,25,15,163,1318,10,195,123,241,205,364,1516,2795,6,17273,959,0,2,4,2,0
26032,47,2258,722,423,573,19,0,135,741,12,172,101,199,184,300,1320,2257,6,15668,870,0,2,6,1,0
26033,92,4729,1943,715,1694,26,18,214,1969,12,185,120,237,197,357,1436,2721,7,20915,1161,0,2,14,14,0
26034,177,7819,139,89,101,2,0,35,141,7,54,34,62,61,96,330,569,4,2287,127,0,2,4,4,0
26035,177,7819,7,5,5,0,0,2,7,1,2,1,2,3,3,2,4,0,2,0,0,2,4,4,0
26036,177,7819,139,89,101,2,0,35,141,7,54,34,62,61,96,330,569,4,2287,127,0,2,1,0,0
26037,177,7819,7,5,5,0,0,2,7,1,2,1,2,3,3,2,4,0,2,0,0,2,1,0,0
26038,177,7819,139,89,101,2,0,35,141,7,54,34,62,61,96,330,569,4,2287,127,0,2,2,2,0
26039,177,7819,7,5,5,0,0,2,7,1,2,1,2,3,3,2,4,0,2,0,0,2,2,2,0
26040,101,4702,1338,495,1086,10,64,173,1348,11,122,82,157,133,239,883,1686,7,11934,663,0,2,7,7,0
26041,101,4691,1338,495,1086,10,64,173,1348,11,122,82,157,133,239,883,1686,7,11934,663,0,2,7,9,0
26042,254,5822,4293,999,3693,19,54,507,4312,9,155,88,170,164,258,1156,1898,4,9368,520,0,2,1,1,0
26043,254,5822,1482,859,1002,125,135,219,1607,16,219,134,251,235,385,1766,3032,9,27804,1544,1,2,1,1,0
26044,254,5820,4293,999,3693,19,54,507,4312,9,155,88,170,164,258,1156,1898,4,9368,520,0,2,0,1,0
26045,254,5820,1482,859,1002,125,135,219,1607,16,219,134,251,235,385,1766,3032,9,27804,1544,1,2,0,1,0
26046,254,5820,4293,999,3693,19,54,507,4312,9,155,88,170,164,258,1156,1898,4,9368,520,0,2,1,2,0
26047,254,5820,1482,859,1002,125,135,219,1607,16,219,134,251,235,385,1766,3032,9,27804,1544,1,2,1,2,0
26048,312,6826,72,33,56,0,4,12,72,1,1,1,1,2,2,0,2,0,1,0,0,2,15,4,0
26049,312,6826,1454,835,1044,76,110,219,1530,17,275,158,296,292,454,2297,3718,9,34017,1889,1,2,15,4,0
26050,101,4691,1338,495,1086,10,64,173,1348,11,122,82,157,133,239,883,1686,7,11934,663,0,2,35,0,0
26051,177,7819,139,89,101,2,0,35,141,7,54,34,62,61,96,330,569,4,2287,127,0,2,69,0,0
26052,177,7819,7,5,5,0,0,2,7,1,2,1,2,3,3,2,4,0,2,0,0,2,69,0,0
26053,235,5549,722,423,573,19,0,135,741,12,172,101,199,184,300,1320,2257,6,15668,870,0,2,3,1,0
26054,235,5549,1508,847,911,44,250,301,1552,14,148,88,169,162,257,1120,1886,7,15077,837,0,2,3,1,0
26055,315,6881,72,33,56,0,4,12,72,1,1,1,1,2,2,0,2,0,1,0,0,2,13,4,0
26056,315,6881,1454,835,1044,76,110,219,1530,17,275,158,296,292,454,2297,3718,9,34017,1889,1,2,13,4,0
26057,1,6,2,2,2,0,0,0,2,0,0,0,0,0,0,0,0,0,0,0,0,0,2,0,0
26058,1,6,99,48,90,1,3,5,100,0,0,0,0,0,0,0,0,0,0,0,0,0,2,0,0
26059,1,6,8,5,5,2,0,1,10,0,0,0,0,0,0,0,0,0,0,0,0,0,2,0,0
26060,1,6,1217,716,841,84,126,174,1301,14,185,118,215,199,333,1446,2542,8,20687,1149,0,0,2,0,0
26061,1,6,160,89,115,0,13,31,160,7,15,11,17,22,28,78,124,3,495,27,0,0,2,0,0
26062,1,6,10,10,9,9,0,0,19,0,0,0,0,0,0,0,0,0,0,0,0,0,2,0,0
26063,1,6,173,84,99,8,29,36,181,5,12,7,13,17,20,54,81,2,221,12,0,0,2,0,0
26064,1,6,3,1,1,3,0,0,6,0,0,0,0,0,0,0,0,0,0,0,0,0,2,0,0
26065,1,6,2,2,2,0,0,0,2,0,0,0,0,0,0,0,0,0,0,0,0,0,2,0,0
26066,1,6,2,2,2,0,0,0,2,0,0,0,0,0,0,0,0,0,0,0,0,0,2,0,0
26067,1,6,2,2,2,0,0,0,2,0,0,0,0,0,0,0,0,0,0,0,0,0,2,0,0
26068,1,6,2,2,2,0,0,0,2,0,0,0,0,0,0,0,0,0,0,0,0,0,2,0,0
26069,74,3868,1296,573,1062,40,33,157,1336,8,201,118,231,209,349,1561,2689,4,12365,686,0,2,14,0,0
26070,33,1885,384,251,317,7,8,52,391,11,70,44,84,81,128,467,811,6,5355,297,0,2,1,3,0
26071,39,1696,447,308,343,6,5,95,453,7,96,59,111,103,170,651,1136,4,4600,255,0,2,9,5,0
26072,41,2010,722,423,573,19,0,135,741,12,172,101,199,184,300,1320,2257,6,15668,870,0,2,0,51,0
26073,94,4731,1943,715,1694,26,18,214,1969,12,185,120,237,197,357,1436,2721,7,20915,1161,0,2,7,0,1
26074,94,4721,1943,715,1694,26,18,214,1969,12,185,120,237,197,357,1436,2721,7,20915,1161,0,2,0,1,0
26075,235,5549,722,423,573,19,0,135,741,12,172,101,199,184,300,1320,2257,6,15668,870,0,2,3,1,0
26076,235,5549,1508,847,911,44,250,301,1552,14,148,88,169,162,257,1120,1886,7,15077,837,0,2,3,1,0
26077,315,6881,72,33,56,0,4,12,72,1,1,1,1,2,2,0,2,0,1,0,0,2,13,4,0
26078,315,6881,1454,835,1044,76,110,219,1530,17,275,158,296,292,454,2297,3718,9,34017,1889,1,2,13,4,0
26079,1,6,2,2,2,0,0,0,2,0,0,0,0,0,0,0,0,0,0,0,0,0,2,0,0
26080,1,6,99,48,90,1,3,5,100,0,0,0,0,0,0,0,0,0,0,0,0,0,2,0,0
26081,1,6,8,5,5,2,0,1,10,0,0,0,0,0,0,0,0,0,0,0,0,0,2,0,0
26082,1,6,1217,716,841,84,126,174,1301,14,185,118,215,199,333,1446,2542,8,20687,1149,0,0,2,0,0
26083,1,6,160,89,115,0,13,31,160,7,15,11,17,22,28,78,124,3,495,27,0,0,2,0,0
26084,1,6,10,10,9,9,0,0,19,0,0,0,0,0,0,0,0,0,0,0,0,0,2,0,0
26085,1,6,173,84,99,8,29,36,181,5,12,7,13,17,20,54,81,2,221,12,0,0,2,0,0
26086,1,6,3,1,1,3,0,0,6,0,0,0,0,0,0,0,0,0,0,0,0,0,2,0,0
26087,1,6,2,2,2,0,0,0,2,0,0,0,0,0,0,0,0,0,0,0,0,0,2,0,0
26088,1,6,2,2,2,0,0,0,2,0,0,0,0,0,0,0,0,0,0,0,0,0,2,0,0
26089,1,6,2,2,2,0,0,0,2,0,0,0,0,0,0,0,0,0,0,0,0,0,2,0,0
26090,1,6,2,2,2,0,0,0,2,0,0,0,0,0,0,0,0,0,0,0,0,0,2,0,0
26091,74,3868,1296,573,1062,40,33,157,1336,8,201,118,231,209,349,1561,2689,4,12365,686,0,2,14,0,0
26092,39,1696,447,308,343,6,5,95,453,7,96,59,111,103,170,651,1136,4,4600,255,0,2,9,5,0
26093,33,1885,384,251,317,7,8,52,391,11,70,44,84,81,128,467,811,6,5355,297,0,2,1,3,0
26094,41,2010,722,423,573,19,0,135,741,12,172,101,199,184,300,1320,2257,6,15668,870,0,2,0,51,0
26095,60,1079,282,196,195,3,0,86,285,8,130,71,141,138,212,936,1507,4,6538,363,0,2,2,2,0
26096,4,77,127,75,83,2,11,30,129,4,14,7,14,18,21,61,87,2,175,9,0,2,1,1,0
26097,4,77,652,304,544,16,6,88,668,6,89,51,101,95,152,591,998,3,3399,188,0,2,1,1,0
26098,4,77,2,2,2,0,0,0,2,0,0,0,0,0,0,0,0,0,0,0,0,2,1,1,0
26099,4,77,8,5,5,0,0,3,8,0,0,0,0,0,0,0,0,0,0,0,0,2,1,1,0
26100,4,77,2,2,2,0,0,0,2,0,0,0,0,0,0,0,0,0,0,0,0,2,1,1,0
26101,4,77,14,8,8,0,0,6,14,0,0,0,0,0,0,0,0,0,0,0,0,2,1,1,0
26102,4,77,6,4,4,0,0,2,6,0,0,0,0,0,0,0,0,0,0,0,0,2,1,1,0
26103,4,77,6,4,4,0,0,2,6,1,2,1,2,3,3,2,4,0,2,0,0,2,1,1,0
26104,4,77,6,4,4,0,0,2,6,0,0,0,0,0,0,0,0,0,0,0,0,2,1,1,0
26105,4,77,7,5,5,0,0,2,7,0,0,0,0,0,0,0,0,0,0,0,0,2,1,1,0
26106,4,77,6,4,4,0,0,2,6,0,0,0,0,0,0,0,0,0,0,0,0,2,1,1,0
26107,4,77,10,6,6,0,0,4,10,0,0,0,0,0,0,0,0,0,0,0,0,2,1,1,0
26108,4,77,1,1,1,0,0,0,1,0,0,0,0,0,0,0,0,0,0,0,0,2,1,1,0
26109,4,77,1,1,1,0,0,0,1,0,0,0,0,0,0,0,0,0,0,0,0,2,1,1,0
26110,4,77,14,10,10,0,0,4,14,1,1,1,1,2,2,0,2,0,1,0,0,2,1,1,0
26111,4,77,46,26,30,3,0,12,49,3,6,3,6,9,9,20,28,1,42,2,0,2,1,1,0
26112,7,296,72,33,56,0,4,12,72,1,1,1,1,2,2,0,2,0,1,0,0,2,26,23,0
26113,215,4676,182,127,129,0,0,53,182,5,39,21,42,44,63,217,343,2,926,51,0,2,2,1,0
26114,215,4676,1165,710,800,67,119,181,1232,18,243,153,282,261,435,2000,3492,10,36473,2026,1,2,2,1,0
26115,164,5047,1660,832,1314,41,38,274,1701,20,312,209,395,332,604,2671,5058,12,64042,3557,1,2,7,9,0
26116,164,5047,1057,646,719,113,100,145,1170,18,215,134,248,233,382,1740,3004,10,31186,1732,1,2,7,9,0
26117,89,1826,477,336,357,30,23,73,507,16,194,134,250,210,384,1538,2962,10,30538,1696,0,2,2,2,0
26118,154,3262,1513,682,1277,25,13,200,1538,11,199,116,219,210,335,1557,2584,6,15641,868,0,2,100,65,0
26119,154,3262,819,519,539,24,98,155,843,15,96,57,106,111,163,690,1107,8,9171,509,0,2,100,65,0
26120,96,1940,463,295,324,28,62,57,491,12,134,82,154,146,236,989,1696,6,11700,650,0,2,5,2,0
26121,34,1000,339,213,244,17,9,65,356,10,42,26,48,52,74,259,421,5,2410,133,0,2,2,1,0
26122,254,5820,4293,999,3693,19,54,507,4312,9,155,88,170,164,258,1156,1898,4,9368,520,0,2,3,4,0
26123,254,5820,1482,859,1002,125,135,219,1607,16,219,134,251,235,385,1766,3032,9,27804,1544,1,2,3,4,0
26124,141,3269,77,34,69,0,0,8,77,3,24,16,29,27,45,114,213,1,387,21,0,2,4,3,0
26125,141,3269,712,438,573,51,9,84,763,14,102,71,128,116,199,733,1364,8,11988,666,0,2,4,3,0
26126,20,507,205,80,86,16,53,53,221,7,18,10,19,25,29,94,134,3,497,27,0,2,1,2,0
26127,235,5590,722,423,573,19,0,135,741,12,172,101,199,184,300,1320,2257,6,15668,870,0,2,27,23,0
26128,235,5590,1508,847,911,44,250,301,1552,14,148,88,169,162,257,1120,1886,7,15077,837,0,2,27,23,0
26129,315,6881,72,33,56,0,4,12,72,1,1,1,1,2,2,0,2,0,1,0,0,2,29,9,0
26130,315,6881,1454,835,1044,76,110,219,1530,17,275,158,296,292,454,2297,3718,9,34017,1889,1,2,29,9,0
26131,91,1828,757,253,292,73,244,162,830,13,61,38,67,74,105,409,651,7,4654,258,0,2,3,3,0
26132,46,952,386,256,301,16,9,68,402,4,59,35,69,63,104,355,621,2,1453,80,0,2,3,3,0
26133,46,952,264,131,164,11,41,46,275,6,38,22,40,44,62,214,338,3,1068,59,0,2,3,3,0
26134,90,1921,1043,504,840,53,9,147,1096,9,180,112,198,189,310,1377,2344,4,11604,644,0,2,4,4,0
26135,90,1921,383,288,292,26,6,62,409,11,65,38,67,76,105,429,656,5,3719,206,0,2,4,4,0
26136,20,416,294,64,250,0,0,43,294,1,20,10,20,21,30,86,131,0,65,3,0,2,2,1,0
26137,20,416,78,46,62,3,0,14,81,3,8,4,8,11,12,28,41,1,62,3,0,2,2,1,0
26138,212,4578,1943,715,1694,26,18,214,1969,12,185,120,237,197,357,1436,2721,7,20915,1161,0,2,5,0,0
26139,212,4578,1168,838,957,57,25,144,1225,19,348,224,416,367,640,3018,5452,11,61921,3440,1,2,5,0,0
26140,94,3938,1289,550,1043,56,32,155,1345,10,167,93,185,177,278,1266,2075,5,11498,638,0,2,23,13,0
26141,35,1052,182,127,129,0,0,53,182,5,39,21,42,44,63,217,343,2,926,51,0,2,5,9,0
26142,152,7066,1392,870,1177,35,17,170,1427,14,494,280,531,508,811,4473,7289,7,54850,3047,2,2,10,9,0
26143,92,2955,773,419,590,28,0,166,801,10,204,113,217,214,330,1598,2554,5,13587,754,0,2,3,3,0
26144,2,67,16,12,9,0,0,6,16,1,2,1,2,3,3,2,4,0,2,0,0,2,4,1,0
26145,1,6,2,2,2,0,0,0,2,0,0,0,0,0,0,0,0,0,0,0,0,0,2,0,0
26146,1,6,99,48,90,1,3,5,100,0,0,0,0,0,0,0,0,0,0,0,0,0,2,0,0
26147,1,6,8,5,5,2,0,1,10,0,0,0,0,0,0,0,0,0,0,0,0,0,2,0,0
26148,1,6,1217,716,841,84,126,174,1301,14,185,118,215,199,333,1446,2542,8,20687,1149,0,0,2,0,0
26149,1,6,160,89,115,0,13,31,160,7,15,11,17,22,28,78,124,3,495,27,0,0,2,0,0
26150,1,6,10,10,9,9,0,0,19,0,0,0,0,0,0,0,0,0,0,0,0,0,2,0,0
26151,1,6,173,84,99,8,29,36,181,5,12,7,13,17,20,54,81,2,221,12,0,0,2,0,0
26152,1,6,3,1,1,3,0,0,6,0,0,0,0,0,0,0,0,0,0,0,0,0,2,0,0
26153,1,6,2,2,2,0,0,0,2,0,0,0,0,0,0,0,0,0,0,0,0,0,2,0,0
26154,1,6,2,2,2,0,0,0,2,0,0,0,0,0,0,0,0,0,0,0,0,0,2,0,0
26155,1,6,2,2,2,0,0,0,2,0,0,0,0,0,0,0,0,0,0,0,0,0,2,0,0
26156,1,6,2,2,2,0,0,0,2,0,0,0,0,0,0,0,0,0,0,0,0,0,2,0,0
26157,31,2065,1157,318,931,29,22,177,1186,6,104,63,125,110,188,712,1274,3,4596,255,0,2,0,5,0
26158,101,4691,1338,495,1086,10,64,173,1348,11,122,82,157,133,239,883,1686,7,11934,663,0,2,104,68,0
26159,177,7819,139,89,101,2,0,35,141,7,54,34,62,61,96,330,569,4,2287,127,0,2,286,219,0
26160,177,7819,7,5,5,0,0,2,7,1,2,1,2,3,3,2,4,0,2,0,0,2,286,219,0
26161,139,5896,1782,648,1425,9,47,279,1791,8,171,97,189,179,286,1292,2140,4,9462,525,0,2,11,15,0
26162,23,579,102,59,69,5,3,24,107,6,22,15,28,28,43,113,206,3,789,43,0,2,1,1,0
26163,111,4132,1450,624,1228,12,26,181,1462,14,306,186,354,320,540,2580,4493,8,36391,2021,1,2,8,7,0
26164,155,4384,1660,832,1314,41,38,274,1701,20,312,209,395,332,604,2671,5058,12,64042,3557,1,2,12,13,0
26165,40,3016,996,429,845,24,10,117,1020,7,76,50,88,83,138,494,879,4,3565,198,0,2,36,36,0
26166,128,5324,1513,682,1277,25,13,200,1538,11,199,116,219,210,335,1557,2584,6,15641,868,0,2,159,64,0
26167,74,3868,1296,573,1062,40,33,157,1336,8,201,118,231,209,349,1561,2689,4,12365,686,0,2,21,7,0
26168,88,4625,1457,730,1242,11,6,188,1468,10,292,166,329,302,495,2424,4078,5,22973,1276,1,2,18,18,0
26169,39,2317,652,304,544,16,6,88,668,6,89,51,101,95,152,591,998,3,3399,188,0,2,93,96,0
26170,70,3204,1455,414,1257,16,76,112,1471,5,41,23,46,46,69,231,381,2,1069,59,0,2,24,24,0
26171,8,271,74,35,59,1,0,14,75,3,14,7,14,17,21,58,85,1,128,7,0,2,3,1,0
26172,95,4632,1523,757,1297,19,12,193,1542,12,193,117,230,205,347,1508,2664,7,19053,1058,0,2,1,1,0
26173,39,1696,447,308,343,6,5,95,453,7,96,59,111,103,170,651,1136,4,4600,255,0,2,9,5,0
26174,38,2302,334,251,279,10,4,40,344,5,127,74,143,132,217,899,1528,2,4303,239,0,2,1,1,0
26175,61,2733,1293,570,1093,25,15,163,1318,10,195,123,241,205,364,1516,2795,6,17273,959,0,2,4,2,0
26176,33,1885,384,251,317,7,8,52,391,11,70,44,84,81,128,467,811,6,5355,297,0,2,1,3,0
26177,44,2109,722,423,573,19,0,135,741,12,172,101,199,184,300,1320,2257,6,15668,870,0,2,6,52,0
26178,92,4729,1943,715,1694,26,18,214,1969,12,185,120,237,197,357,1436,2721,7,20915,1161,0,2,54,14,0
26179,213,4582,1943,715,1694,26,18,214,1969,12,185,120,237,197,357,1436,2721,7,20915,1161,0,2,3,3,0
26180,213,4582,1168,838,957,57,25,144,1225,19,348,224,416,367,640,3018,5452,11,61921,3440,1,2,3,3,0
26181,96,4914,1943,715,1694,26,18,214,1969,12,185,120,237,197,357,1436,2721,7,20915,1161,0,2,50,3,0
26182,76,1715,996,429,845,24,10,117,1020,7,76,50,88,83,138,494,879,4,3565,198,0,2,1,1,0
26183,76,1715,456,277,329,12,42,72,468,13,85,50,97,98,147,592,972,7,7212,400,0,2,1,1,0
26184,43,3113,996,429,845,24,10,117,1020,7,76,50,88,83,138,494,879,4,3565,198,0,2,13,0,0
26185,60,1079,282,196,195,3,0,86,285,8,130,71,141,138,212,936,1507,4,6538,363,0,2,2,2,0
26186,4,77,127,75,83,2,11,30,129,4,14,7,14,18,21,61,87,2,175,9,0,2,1,1,0
26187,4,77,652,304,544,16,6,88,668,6,89,51,101,95,152,591,998,3,3399,188,0,2,1,1,0
26188,4,77,2,2,2,0,0,0,2,0,0,0,0,0,0,0,0,0,0,0,0,2,1,1,0
26189,4,77,8,5,5,0,0,3,8,0,0,0,0,0,0,0,0,0,0,0,0,2,1,1,0
26190,4,77,2,2,2,0,0,0,2,0,0,0,0,0,0,0,0,0,0,0,0,2,1,1,0
26191,4,77,14,8,8,0,0,6,14,0,0,0,0,0,0,0,0,0,0,0,0,2,1,1,0
26192,4,77,6,4,4,0,0,2,6,0,0,0,0,0,0,0,0,0,0,0,0,2,1,1,0
26193,4,77,6,4,4,0,0,2,6,1,2,1,2,3,3,2,4,0,2,0,0,2,1,1,0
26194,4,77,6,4,4,0,0,2,6,0,0,0,0,0,0,0,0,0,0,0,0,2,1,1,0
26195,4,77,7,5,5,0,0,2,7,0,0,0,0,0,0,0,0,0,0,0,0,2,1,1,0
26196,4,77,6,4,4,0,0,2,6,0,0,0,0,0,0,0,0,0,0,0,0,2,1,1,0
26197,4,77,10,6,6,0,0,4,10,0,0,0,0,0,0,0,0,0,0,0,0,2,1,1,0
26198,4,77,1,1,1,0,0,0,1,0,0,0,0,0,0,0,0,0,0,0,0,2,1,1,0
26199,4,77,1,1,1,0,0,0,1,0,0,0,0,0,0,0,0,0,0,0,0,2,1,1,0
26200,4,77,14,10,10,0,0,4,14,1,1,1,1,2,2,0,2,0,1,0,0,2,1,1,0
26201,4,77,46,26,30,3,0,12,49,3,6,3,6,9,9,20,28,1,42,2,0,2,1,1,0
26202,7,296,72,33,56,0,4,12,72,1,1,1,1,2,2,0,2,0,1,0,0,2,26,23,0
26203,215,4676,182,127,129,0,0,53,182,5,39,21,42,44,63,217,343,2,926,51,0,2,2,1,0
26204,215,4676,1165,710,800,67,119,181,1232,18,243,153,282,261,435,2000,3492,10,36473,2026,1,2,2,1,0
26205,164,5047,1660,832,1314,41,38,274,1701,20,312,209,395,332,604,2671,5058,12,64042,3557,1,2,7,9,0
26206,164,5047,1057,646,719,113,100,145,1170,18,215,134,248,233,382,1740,3004,10,31186,1732,1,2,7,9,0
26207,89,1826,477,336,357,30,23,73,507,16,194,134,250,210,384,1538,2962,10,30538,1696,0,2,2,2,0
26208,154,3262,1513,682,1277,25,13,200,1538,11,199,116,219,210,335,1557,2584,6,15641,868,0,2,100,65,0
26209,154,3262,819,519,539,24,98,155,843,15,96,57,106,111,163,690,1107,8,9171,509,0,2,100,65,0
26210,96,1940,463,295,324,28,62,57,491,12,134,82,154,146,236,989,1696,6,11700,650,0,2,5,2,0
26211,34,1000,339,213,244,17,9,65,356,10,42,26,48,52,74,259,421,5,2410,133,0,2,2,1,0
26212,254,5820,4293,999,3693,19,54,507,4312,9,155,88,170,164,258,1156,1898,4,9368,520,0,2,3,4,0
26213,254,5820,1482,859,1002,125,135,219,1607,16,219,134,251,235,385,1766,3032,9,27804,1544,1,2,3,4,0
26214,141,3269,77,34,69,0,0,8,77,3,24,16,29,27,45,114,213,1,387,21,0,2,4,3,0
26215,141,3269,712,438,573,51,9,84,763,14,102,71,128,116,199,733,1364,8,11988,666,0,2,4,3,0
26216,20,507,205,80,86,16,53,53,221,7,18,10,19,25,29,94,134,3,497,27,0,2,1,2,0
26217,235,5590,722,423,573,19,0,135,741,12,172,101,199,184,300,1320,2257,6,15668,870,0,2,27,23,0
26218,235,5590,1508,847,911,44,250,301,1552,14,148,88,169,162,257,1120,1886,7,15077,837,0,2,27,23,0
26219,315,6881,72,33,56,0,4,12,72,1,1,1,1,2,2,0,2,0,1,0,0,2,29,9,0
26220,315,6881,1454,835,1044,76,110,219,1530,17,275,158,296,292,454,2297,3718,9,34017,1889,1,2,29,9,0
26221,91,1828,757,253,292,73,244,162,830,13,61,38,67,74,105,409,651,7,4654,258,0,2,3,3,0
26222,46,952,386,256,301,16,9,68,402,4,59,35,69,63,104,355,621,2,1453,80,0,2,3,3,0
26223,46,952,264,131,164,11,41,46,275,6,38,22,40,44,62,214,338,3,1068,59,0,2,3,3,0
26224,90,1921,1043,504,840,53,9,147,1096,9,180,112,198,189,310,1377,2344,4,11604,644,0,2,4,4,0
26225,90,1921,383,288,292,26,6,62,409,11,65,38,67,76,105,429,656,5,3719,206,0,2,4,4,0
26226,20,416,294,64,250,0,0,43,294,1,20,10,20,21,30,86,131,0,65,3,0,2,2,1,0
26227,20,416,78,46,62,3,0,14,81,3,8,4,8,11,12,28,41,1,62,3,0,2,2,1,0
26228,212,4578,1943,715,1694,26,18,214,1969,12,185,120,237,197,357,1436,2721,7,20915,1161,0,2,5,0,0
26229,212,4578,1168,838,957,57,25,144,1225,19,348,224,416,367,640,3018,5452,11,61921,3440,1,2,5,0,0
26230,94,3938,1289,550,1043,56,32,155,1345,10,167,93,185,177,278,1266,2075,5,11498,638,0,2,23,13,0
26231,35,1052,182,127,129,0,0,53,182,5,39,21,42,44,63,217,343,2,926,51,0,2,5,9,0
26232,152,7066,1392,870,1177,35,17,170,1427,14,494,280,531,508,811,4473,7289,7,54850,3047,2,2,10,9,0
26233,92,2955,773,419,590,28,0,166,801,10,204,113,217,214,330,1598,2554,5,13587,754,0,2,3,3,0
26234,2,67,16,12,9,0,0,6,16,1,2,1,2,3,3,2,4,0,2,0,0,2,4,1,0
26235,1,6,2,2,2,0,0,0,2,0,0,0,0,0,0,0,0,0,0,0,0,0,2,0,0
26236,1,6,99,48,90,1,3,5,100,0,0,0,0,0,0,0,0,0,0,0,0,0,2,0,0
26237,1,6,8,5,5,2,0,1,10,0,0,0,0,0,0,0,0,0,0,0,0,0,2,0,0
26238,1,6,1217,716,841,84,126,174,1301,14,185,118,215,199,333,1446,2542,8,20687,1149,0,0,2,0,0
26239,1,6,160,89,115,0,13,31,160,7,15,11,17,22,28,78,124,3,495,27,0,0,2,0,0
26240,1,6,10,10,9,9,0,0,19,0,0,0,0,0,0,0,0,0,0,0,0,0,2,0,0
26241,1,6,173,84,99,8,29,36,181,5,12,7,13,17,20,54,81,2,221,12,0,0,2,0,0
26242,1,6,3,1,1,3,0,0,6,0,0,0,0,0,0,0,0,0,0,0,0,0,2,0,0
26243,1,6,2,2,2,0,0,0,2,0,0,0,0,0,0,0,0,0,0,0,0,0,2,0,0
26244,1,6,2,2,2,0,0,0,2,0,0,0,0,0,0,0,0,0,0,0,0,0,2,0,0
26245,1,6,2,2,2,0,0,0,2,0,0,0,0,0,0,0,0,0,0,0,0,0,2,0,0
26246,1,6,2,2,2,0,0,0,2,0,0,0,0,0,0,0,0,0,0,0,0,0,2,0,0
26247,31,2065,1157,318,931,29,22,177,1186,6,104,63,125,110,188,712,1274,3,4596,255,0,2,0,5,0
26248,101,4691,1338,495,1086,10,64,173,1348,11,122,82,157,133,239,883,1686,7,11934,663,0,2,104,68,0
26249,177,7819,139,89,101,2,0,35,141,7,54,34,62,61,96,330,569,4,2287,127,0,2,286,219,0
26250,177,7819,7,5,5,0,0,2,7,1,2,1,2,3,3,2,4,0,2,0,0,2,286,219,0
26251,139,5896,1782,648,1425,9,47,279,1791,8,171,97,189,179,286,1292,2140,4,9462,525,0,2,11,15,0
26252,23,579,102,59,69,5,3,24,107,6,22,15,28,28,43,113,206,3,789,43,0,2,1,1,0
26253,111,4132,1450,624,1228,12,26,181,1462,14,306,186,354,320,540,2580,4493,8,36391,2021,1,2,8,7,0
26254,155,4384,1660,832,1314,41,38,274,1701,20,312,209,395,332,604,2671,5058,12,64042,3557,1,2,12,13,0
26255,40,3016,996,429,845,24,10,117,1020,7,76,50,88,83,138,494,879,4,3565,198,0,2,36,36,0
26256,128,5324,1513,682,1277,25,13,200,1538,11,199,116,219,210,335,1557,2584,6,15641,868,0,2,159,64,0
26257,74,3868,1296,573,1062,40,33,157,1336,8,201,118,231,209,349,1561,2689,4,12365,686,0,2,21,7,0
26258,88,4625,1457,730,1242,11,6,188,1468,10,292,166,329,302,495,2424,4078,5,22973,1276,1,2,18,18,0
26259,39,2317,652,304,544,16,6,88,668,6,89,51,101,95,152,591,998,3,3399,188,0,2,93,96,0
26260,70,3204,1455,414,1257,16,76,112,1471,5,41,23,46,46,69,231,381,2,1069,59,0,2,24,24,0
26261,8,271,74,35,59,1,0,14,75,3,14,7,14,17,21,58,85,1,128,7,0,2,3,1,0
26262,95,4632,1523,757,1297,19,12,193,1542,12,193,117,230,205,347,1508,2664,7,19053,1058,0,2,1,1,0
26263,39,1696,447,308,343,6,5,95,453,7,96,59,111,103,170,651,1136,4,4600,255,0,2,9,5,0
26264,38,2302,334,251,279,10,4,40,344,5,127,74,143,132,217,899,1528,2,4303,239,0,2,1,1,0
26265,61,2733,1293,570,1093,25,15,163,1318,10,195,123,241,205,364,1516,2795,6,17273,959,0,2,4,2,0
26266,33,1885,384,251,317,7,8,52,391,11,70,44,84,81,128,467,811,6,5355,297,0,2,1,3,0
26267,44,2109,722,423,573,19,0,135,741,12,172,101,199,184,300,1320,2257,6,15668,870,0,2,6,52,0
26268,92,4729,1943,715,1694,26,18,214,1969,12,185,120,237,197,357,1436,2721,7,20915,1161,0,2,54,14,0
26269,35,1068,182,127,129,0,0,53,182,5,39,21,42,44,63,217,343,2,926,51,0,2,15,14,0
26270,91,2944,773,419,590,28,0,166,801,10,204,113,217,214,330,1598,2554,5,13587,754,0,2,5,8,0
26271,76,1715,996,429,845,24,10,117,1020,7,76,50,88,83,138,494,879,4,3565,198,0,2,1,1,0
26272,76,1715,456,277,329,12,42,72,468,13,85,50,97,98,147,592,972,7,7212,400,0,2,1,1,0
26273,43,3113,996,429,845,24,10,117,1020,7,76,50,88,83,138,494,879,4,3565,198,0,2,13,0,0
26274,213,4683,1943,715,1694,26,18,214,1969,12,185,120,237,197,357,1436,2721,7,20915,1161,0,2,15,6,0
26275,213,4683,1168,838,957,57,25,144,1225,19,348,224,416,367,640,3018,5452,11,61921,3440,1,2,15,6,0
26276,94,4721,1943,715,1694,26,18,214,1969,12,185,120,237,197,357,1436,2721,7,20915,1161,0,2,3,3,0
26277,35,1068,182,127,129,0,0,53,182,5,39,21,42,44,63,217,343,2,926,51,0,2,15,14,0
26278,91,2944,773,419,590,28,0,166,801,10,204,113,217,214,330,1598,2554,5,13587,754,0,2,5,8,0
26279,85,2166,1455,414,1257,16,76,112,1471,5,41,23,46,46,69,231,381,2,1069,59,0,2,2,1,0
26280,85,2166,669,365,481,22,61,110,691,15,103,63,122,118,185,747,1273,8,11311,628,0,2,2,1,0
26281,213,4582,1943,715,1694,26,18,214,1969,12,185,120,237,197,357,1436,2721,7,20915,1161,0,2,3,3,0
26282,213,4582,1168,838,957,57,25,144,1225,19,348,224,416,367,640,3018,5452,11,61921,3440,1,2,3,3,0
26283,96,4914,1943,715,1694,26,18,214,1969,12,185,120,237,197,357,1436,2721,7,20915,1161,0,2,50,3,0
26284,177,7829,139,89,101,2,0,35,141,7,54,34,62,61,96,330,569,4,2287,127,0,2,1,0,0
26285,177,7829,7,5,5,0,0,2,7,1,2,1,2,3,3,2,4,0,2,0,0,2,1,0,0
26286,166,5073,1660,832,1314,41,38,274,1701,20,312,209,395,332,604,2671,5058,12,64042,3557,1,2,10,1,0
26287,166,5073,1057,646,719,113,100,145,1170,18,215,134,248,233,382,1740,3004,10,31186,1732,1,2,10,1,0
26288,157,4508,1660,832,1314,41,38,274,1701,20,312,209,395,332,604,2671,5058,12,64042,3557,1,2,29,0,0
26289,212,4659,1943,715,1694,26,18,214,1969,12,185,120,237,197,357,1436,2721,7,20915,1161,0,2,5,16,0
26290,212,4659,1168,838,957,57,25,144,1225,19,348,224,416,367,640,3018,5452,11,61921,3440,1,2,5,16,0
26291,94,4721,1943,715,1694,26,18,214,1969,12,185,120,237,197,357,1436,2721,7,20915,1161,0,2,7,7,0
26292,215,4685,1943,715,1694,26,18,214,1969,12,185,120,237,197,357,1436,2721,7,20915,1161,0,2,20,8,0
26293,215,4685,1168,838,957,57,25,144,1225,19,348,224,416,367,640,3018,5452,11,61921,3440,1,2,20,8,0
26294,95,4853,1943,715,1694,26,18,214,1969,12,185,120,237,197,357,1436,2721,7,20915,1161,0,2,43,0,0
26295,85,2166,1455,414,1257,16,76,112,1471,5,41,23,46,46,69,231,381,2,1069,59,0,2,2,1,0
26296,85,2166,669,365,481,22,61,110,691,15,103,63,122,118,185,747,1273,8,11311,628,0,2,2,1,0
26297,177,7829,139,89,101,2,0,35,141,7,54,34,62,61,96,330,569,4,2287,127,0,2,1,0,0
26298,177,7829,7,5,5,0,0,2,7,1,2,1,2,3,3,2,4,0,2,0,0,2,1,0,0
26299,166,5073,1660,832,1314,41,38,274,1701,20,312,209,395,332,604,2671,5058,12,64042,3557,1,2,10,1,0
26300,166,5073,1057,646,719,113,100,145,1170,18,215,134,248,233,382,1740,3004,10,31186,1732,1,2,10,1,0
26301,157,4508,1660,832,1314,41,38,274,1701,20,312,209,395,332,604,2671,5058,12,64042,3557,1,2,29,0,0
26302,11,413,42,7,35,4,0,5,46,1,2,1,2,3,3,2,4,0,2,0,0,2,1,1,0
26303,11,413,11,6,10,0,0,1,11,2,4,2,4,6,6,10,15,1,15,0,0,2,1,1,0
26304,315,6882,72,33,56,0,4,12,72,1,1,1,1,2,2,0,2,0,1,0,0,2,4,3,0
26305,315,6882,1454,835,1044,76,110,219,1530,17,275,158,296,292,454,2297,3718,9,34017,1889,1,2,4,3,0
26306,70,1382,1178,367,1042,6,15,115,1184,9,94,51,95,103,146,644,976,4,4439,246,0,2,2,2,0
26307,70,1382,177,108,140,8,0,27,185,6,30,16,32,36,48,162,248,3,794,44,0,2,2,2,0
26308,213,4582,1943,715,1694,26,18,214,1969,12,185,120,237,197,357,1436,2721,7,20915,1161,0,2,1,1,0
26309,213,4582,1168,838,957,57,25,144,1225,19,348,224,416,367,640,3018,5452,11,61921,3440,1,2,1,1,0
26310,23,474,601,196,481,2,23,85,603,8,63,36,72,71,108,400,664,4,3036,168,0,2,1,1,0
26311,23,474,156,79,106,5,16,28,161,5,14,8,15,19,23,64,97,2,261,14,0,2,1,1,0
26312,17,774,75,38,59,1,3,12,76,2,4,2,4,6,6,10,15,1,15,0,0,2,1,1,0
26313,11,413,42,7,35,4,0,5,46,1,2,1,2,3,3,2,4,0,2,0,0,2,1,1,0
26314,11,413,11,6,10,0,0,1,11,2,4,2,4,6,6,10,15,1,15,0,0,2,1,1,0
26315,315,6882,72,33,56,0,4,12,72,1,1,1,1,2,2,0,2,0,1,0,0,2,4,3,0
26316,315,6882,1454,835,1044,76,110,219,1530,17,275,158,296,292,454,2297,3718,9,34017,1889,1,2,4,3,0
26317,70,1382,1178,367,1042,6,15,115,1184,9,94,51,95,103,146,644,976,4,4439,246,0,2,2,2,0
26318,70,1382,177,108,140,8,0,27,185,6,30,16,32,36,48,162,248,3,794,44,0,2,2,2,0
26319,213,4582,1943,715,1694,26,18,214,1969,12,185,120,237,197,357,1436,2721,7,20915,1161,0,2,1,1,0
26320,213,4582,1168,838,957,57,25,144,1225,19,348,224,416,367,640,3018,5452,11,61921,3440,1,2,1,1,0
26321,23,474,601,196,481,2,23,85,603,8,63,36,72,71,108,400,664,4,3036,168,0,2,1,1,0
26322,23,474,156,79,106,5,16,28,161,5,14,8,15,19,23,64,97,2,261,14,0,2,1,1,0
26323,17,774,75,38,59,1,3,12,76,2,4,2,4,6,6,10,15,1,15,0,0,2,1,1,0
26324,75,1694,996,429,845,24,10,117,1020,7,76,50,88,83,138,494,879,4,3565,198,0,2,6,9,0
26325,75,1694,456,277,329,12,42,72,468,13,85,50,97,98,147,592,972,7,7212,400,0,2,6,9,0
26326,42,3095,996,429,845,24,10,117,1020,7,76,50,88,83,138,494,879,4,3565,198,0,2,12,7,0
26327,75,1694,996,429,845,24,10,117,1020,7,76,50,88,83,138,494,879,4,3565,198,0,2,6,9,0
26328,75,1694,456,277,329,12,42,72,468,13,85,50,97,98,147,592,972,7,7212,400,0,2,6,9,0
26329,42,3095,996,429,845,24,10,117,1020,7,76,50,88,83,138,494,879,4,3565,198,0,2,12,7,0
26330,11,413,42,7,35,4,0,5,46,1,2,1,2,3,3,2,4,0,2,0,0,2,1,1,0
26331,11,413,11,6,10,0,0,1,11,2,4,2,4,6,6,10,15,1,15,0,0,2,1,1,0
26332,166,5073,1660,832,1314,41,38,274,1701,20,312,209,395,332,604,2671,5058,12,64042,3557,1,2,10,1,0
26333,166,5073,1057,646,719,113,100,145,1170,18,215,134,248,233,382,1740,3004,10,31186,1732,1,2,10,1,0
26334,76,1705,996,429,845,24,10,117,1020,7,76,50,88,83,138,494,879,4,3565,198,0,2,1,1,0
26335,76,1705,456,277,329,12,42,72,468,13,85,50,97,98,147,592,972,7,7212,400,0,2,1,1,0
26336,85,2166,1455,414,1257,16,76,112,1471,5,41,23,46,46,69,231,381,2,1069,59,0,2,2,1,0
26337,85,2166,669,365,481,22,61,110,691,15,103,63,122,118,185,747,1273,8,11311,628,0,2,2,1,0
26338,315,6882,72,33,56,0,4,12,72,1,1,1,1,2,2,0,2,0,1,0,0,2,4,3,0
26339,315,6882,1454,835,1044,76,110,219,1530,17,275,158,296,292,454,2297,3718,9,34017,1889,1,2,4,3,0
26340,70,1382,1178,367,1042,6,15,115,1184,9,94,51,95,103,146,644,976,4,4439,246,0,2,2,2,0
26341,70,1382,177,108,140,8,0,27,185,6,30,16,32,36,48,162,248,3,794,44,0,2,2,2,0
26342,216,4689,1943,715,1694,26,18,214,1969,12,185,120,237,197,357,1436,2721,7,20915,1161,0,2,4,4,0
26343,216,4689,1168,838,957,57,25,144,1225,19,348,224,416,367,640,3018,5452,11,61921,3440,1,2,4,4,0
26344,23,474,601,196,481,2,23,85,603,8,63,36,72,71,108,400,664,4,3036,168,0,2,1,1,0
26345,23,474,156,79,106,5,16,28,161,5,14,8,15,19,23,64,97,2,261,14,0,2,1,1,0
26346,35,1068,182,127,129,0,0,53,182,5,39,21,42,44,63,217,343,2,926,51,0,2,15,14,0
26347,91,2944,773,419,590,28,0,166,801,10,204,113,217,214,330,1598,2554,5,13587,754,0,2,5,8,0
26348,17,774,75,38,59,1,3,12,76,2,4,2,4,6,6,10,15,1,15,0,0,2,1,1,0
26349,177,7829,139,89,101,2,0,35,141,7,54,34,62,61,96,330,569,4,2287,127,0,2,1,0,0
26350,177,7829,7,5,5,0,0,2,7,1,2,1,2,3,3,2,4,0,2,0,0,2,1,0,0
26351,157,4508,1660,832,1314,41,38,274,1701,20,312,209,395,332,604,2671,5058,12,64042,3557,1,2,29,0,0
26352,45,3192,996,429,845,24,10,117,1020,7,76,50,88,83,138,494,879,4,3565,198,0,2,13,0,0
26353,99,5038,1943,715,1694,26,18,214,1969,12,185,120,237,197,357,1436,2721,7,20915,1161,0,2,50,3,0
26354,11,413,42,7,35,4,0,5,46,1,2,1,2,3,3,2,4,0,2,0,0,2,1,1,0
26355,11,413,11,6,10,0,0,1,11,2,4,2,4,6,6,10,15,1,15,0,0,2,1,1,0
26356,213,4576,1943,715,1694,26,18,214,1969,12,185,120,237,197,357,1436,2721,7,20915,1161,0,2,3,5,0
26357,213,4576,1168,838,957,57,25,144,1225,19,348,224,416,367,640,3018,5452,11,61921,3440,1,2,3,5,0
26358,11,413,42,7,35,4,0,5,46,1,2,1,2,3,3,2,4,0,2,0,0,2,1,1,0
26359,11,413,11,6,10,0,0,1,11,2,4,2,4,6,6,10,15,1,15,0,0,2,1,1,0
26360,215,4604,1943,715,1694,26,18,214,1969,12,185,120,237,197,357,1436,2721,7,20915,1161,0,2,12,5,0
26361,215,4604,1168,838,957,57,25,144,1225,19,348,224,416,367,640,3018,5452,11,61921,3440,1,2,12,5,0
26362,11,413,42,7,35,4,0,5,46,1,2,1,2,3,3,2,4,0,2,0,0,2,1,1,0
26363,11,413,11,6,10,0,0,1,11,2,4,2,4,6,6,10,15,1,15,0,0,2,1,1,0
26364,215,4602,1943,715,1694,26,18,214,1969,12,185,120,237,197,357,1436,2721,7,20915,1161,0,2,10,9,0
26365,215,4602,1168,838,957,57,25,144,1225,19,348,224,416,367,640,3018,5452,11,61921,3440,1,2,10,9,0
26366,43,3130,996,429,845,24,10,117,1020,7,76,50,88,83,138,494,879,4,3565,198,0,2,7,14,0
26367,11,413,42,7,35,4,0,5,46,1,2,1,2,3,3,2,4,0,2,0,0,2,1,1,0
26368,11,413,11,6,10,0,0,1,11,2,4,2,4,6,6,10,15,1,15,0,0,2,1,1,0
26369,166,5073,1660,832,1314,41,38,274,1701,20,312,209,395,332,604,2671,5058,12,64042,3557,1,2,10,1,0
26370,166,5073,1057,646,719,113,100,145,1170,18,215,134,248,233,382,1740,3004,10,31186,1732,1,2,10,1,0
26371,76,1705,996,429,845,24,10,117,1020,7,76,50,88,83,138,494,879,4,3565,198,0,2,1,1,0
26372,76,1705,456,277,329,12,42,72,468,13,85,50,97,98,147,592,972,7,7212,400,0,2,1,1,0
26373,85,2166,1455,414,1257,16,76,112,1471,5,41,23,46,46,69,231,381,2,1069,59,0,2,2,1,0
26374,85,2166,669,365,481,22,61,110,691,15,103,63,122,118,185,747,1273,8,11311,628,0,2,2,1,0
26375,315,6882,72,33,56,0,4,12,72,1,1,1,1,2,2,0,2,0,1,0,0,2,4,3,0
26376,315,6882,1454,835,1044,76,110,219,1530,17,275,158,296,292,454,2297,3718,9,34017,1889,1,2,4,3,0
26377,70,1382,1178,367,1042,6,15,115,1184,9,94,51,95,103,146,644,976,4,4439,246,0,2,2,2,0
26378,70,1382,177,108,140,8,0,27,185,6,30,16,32,36,48,162,248,3,794,44,0,2,2,2,0
26379,216,4689,1943,715,1694,26,18,214,1969,12,185,120,237,197,357,1436,2721,7,20915,1161,0,2,4,4,0
26380,216,4689,1168,838,957,57,25,144,1225,19,348,224,416,367,640,3018,5452,11,61921,3440,1,2,4,4,0
26381,23,474,601,196,481,2,23,85,603,8,63,36,72,71,108,400,664,4,3036,168,0,2,1,1,0
26382,23,474,156,79,106,5,16,28,161,5,14,8,15,19,23,64,97,2,261,14,0,2,1,1,0
26383,35,1068,182,127,129,0,0,53,182,5,39,21,42,44,63,217,343,2,926,51,0,2,15,14,0
26384,91,2944,773,419,590,28,0,166,801,10,204,113,217,214,330,1598,2554,5,13587,754,0,2,5,8,0
26385,17,774,75,38,59,1,3,12,76,2,4,2,4,6,6,10,15,1,15,0,0,2,1,1,0
26386,177,7829,139,89,101,2,0,35,141,7,54,34,62,61,96,330,569,4,2287,127,0,2,1,0,0
26387,177,7829,7,5,5,0,0,2,7,1,2,1,2,3,3,2,4,0,2,0,0,2,1,0,0
26388,157,4508,1660,832,1314,41,38,274,1701,20,312,209,395,332,604,2671,5058,12,64042,3557,1,2,29,0,0
26389,43,3130,996,429,845,24,10,117,1020,7,76,50,88,83,138,494,879,4,3565,198,0,2,7,1,0
26390,99,5038,1943,715,1694,26,18,214,1969,12,185,120,237,197,357,1436,2721,7,20915,1161,0,2,50,3,0
26391,175,5294,1660,832,1314,41,38,274,1701,20,312,209,395,332,604,2671,5058,12,64042,3557,1,2,55,15,0
26392,175,5294,1057,646,719,113,100,145,1170,18,215,134,248,233,382,1740,3004,10,31186,1732,1,2,55,15,0
26393,141,3272,77,34,69,0,0,8,77,3,24,16,29,27,45,114,213,1,387,21,0,2,3,2,0
26394,141,3272,712,438,573,51,9,84,763,14,102,71,128,116,199,733,1364,8,11988,666,0,2,3,2,0
26395,1,319,382,65,130,157,2,92,539,4,10,5,10,14,15,41,57,2,114,6,0,2,1,1,0
26396,11,413,42,7,35,4,0,5,46,1,2,1,2,3,3,2,4,0,2,0,0,2,1,1,0
26397,11,413,11,6,10,0,0,1,11,2,4,2,4,6,6,10,15,1,15,0,0,2,1,1,0
26398,215,4602,1943,715,1694,26,18,214,1969,12,185,120,237,197,357,1436,2721,7,20915,1161,0,2,14,8,0
26399,215,4602,1168,838,957,57,25,144,1225,19,348,224,416,367,640,3018,5452,11,61921,3440,1,2,14,8,0
26400,1,319,382,65,130,157,2,92,539,4,10,5,10,14,15,41,57,2,114,6,0,2,1,1,0
26401,179,5366,1660,832,1314,41,38,274,1701,20,312,209,395,332,604,2671,5058,12,64042,3557,1,2,24,7,0
26402,179,5366,1057,646,719,113,100,145,1170,18,215,134,248,233,382,1740,3004,10,31186,1732,1,2,24,7,0
26403,141,3279,77,34,69,0,0,8,77,3,24,16,29,27,45,114,213,1,387,21,0,2,1,1,0
26404,141,3279,712,438,573,51,9,84,763,14,102,71,128,116,199,733,1364,8,11988,666,0,2,1,1,0
26405,162,4813,1660,832,1314,41,38,274,1701,20,312,209,395,332,604,2671,5058,12,64042,3557,1,2,93,14,0
26406,212,4569,2,2,2,0,0,0,2,0,0,0,0,0,0,0,0,0,0,0,0,2,3,1,0
26407,212,4569,99,48,90,1,3,5,100,0,0,0,0,0,0,0,0,0,0,0,0,2,3,1,0
26408,212,4569,8,5,5,2,0,1,10,0,0,0,0,0,0,0,0,0,0,0,0,2,3,1,0
26409,212,4569,1217,716,841,84,126,174,1301,14,185,118,215,199,333,1446,2542,8,20687,1149,0,2,3,1,0
26410,212,4569,160,89,115,0,13,31,160,7,15,11,17,22,28,78,124,3,495,27,0,2,3,1,0
26411,212,4569,10,10,9,9,0,0,19,0,0,0,0,0,0,0,0,0,0,0,0,2,3,1,0
26412,212,4569,173,84,99,8,29,36,181,5,12,7,13,17,20,54,81,2,221,12,0,2,3,1,0
26413,212,4569,3,1,1,3,0,0,6,0,0,0,0,0,0,0,0,0,0,0,0,2,3,1,0
26414,212,4569,2,2,2,0,0,0,2,0,0,0,0,0,0,0,0,0,0,0,0,2,3,1,0
26415,212,4569,99,48,90,1,3,5,100,0,0,0,0,0,0,0,0,0,0,0,0,2,3,1,0
26416,212,4569,8,5,5,2,0,1,10,0,0,0,0,0,0,0,0,0,0,0,0,2,3,1,0
26417,212,4569,1217,716,841,84,126,174,1301,14,185,118,215,199,333,1446,2542,8,20687,1149,0,2,3,1,0
26418,212,4569,160,89,115,0,13,31,160,7,15,11,17,22,28,78,124,3,495,27,0,2,3,1,0
26419,212,4569,10,10,9,9,0,0,19,0,0,0,0,0,0,0,0,0,0,0,0,2,3,1,0
26420,212,4569,173,84,99,8,29,36,181,5,12,7,13,17,20,54,81,2,221,12,0,2,3,1,0
26421,212,4569,3,1,1,3,0,0,6,0,0,0,0,0,0,0,0,0,0,0,0,2,3,1,0
26422,20,507,205,80,86,16,53,53,221,7,18,10,19,25,29,94,134,3,497,27,0,2,24,8,0
26423,20,507,205,80,86,16,53,53,221,7,18,10,19,25,29,94,134,3,497,27,0,2,24,8,0
26424,97,1999,463,295,324,28,62,57,491,12,134,82,154,146,236,989,1696,6,11700,650,0,2,15,0,0
26425,95,3958,1289,550,1043,56,32,155,1345,10,167,93,185,177,278,1266,2075,5,11498,638,0,2,5,0,0
26426,179,5366,1660,832,1314,41,38,274,1701,20,312,209,395,332,604,2671,5058,12,64042,3557,1,2,1,1,0
26427,179,5366,1057,646,719,113,100,145,1170,18,215,134,248,233,382,1740,3004,10,31186,1732,1,2,1,1,0
26428,235,5582,722,423,573,19,0,135,741,12,172,101,199,184,300,1320,2257,6,15668,870,0,2,0,1,0
26429,235,5582,1508,847,911,44,250,301,1552,14,148,88,169,162,257,1120,1886,7,15077,837,0,2,0,1,0
26430,52,622,647,139,84,35,284,233,682,0,0,0,0,0,0,0,0,0,0,0,0,2,19,0,0
26431,24,513,601,196,481,2,23,85,603,8,63,36,72,71,108,400,664,4,3036,168,0,2,31,31,0
26432,24,513,156,79,106,5,16,28,161,5,14,8,15,19,23,64,97,2,261,14,0,2,31,31,0
26433,22,807,601,196,481,2,23,85,603,8,63,36,72,71,108,400,664,4,3036,168,0,2,19,0,0
26434,52,622,647,139,84,35,284,233,682,0,0,0,0,0,0,0,0,0,0,0,0,2,3,3,0
26435,76,1707,53,23,39,0,0,13,53,2,8,4,8,10,12,26,39,1,39,2,0,2,13,3,0
26436,76,1707,515,298,307,33,80,99,548,12,63,44,77,75,121,419,753,7,5527,307,0,2,13,3,0
26437,216,4748,1943,715,1694,26,18,214,1969,12,185,120,237,197,357,1436,2721,7,20915,1161,0,2,26,16,0
26438,216,4748,1168,838,957,57,25,144,1225,19,348,224,416,367,640,3018,5452,11,61921,3440,1,2,26,16,0
26439,24,500,601,196,481,2,23,85,603,8,63,36,72,71,108,400,664,4,3036,168,0,2,15,11,0
26440,24,500,156,79,106,5,16,28,161,5,14,8,15,19,23,64,97,2,261,14,0,2,15,11,0
26441,22,807,601,196,481,2,23,85,603,8,63,36,72,71,108,400,664,4,3036,168,0,2,2,2,0
26442,314,6858,72,33,56,0,4,12,72,1,1,1,1,2,2,0,2,0,1,0,0,2,0,5,0
26443,314,6858,1454,835,1044,76,110,219,1530,17,275,158,296,292,454,2297,3718,9,34017,1889,1,2,0,5,0
26444,217,4757,1943,715,1694,26,18,214,1969,12,185,120,237,197,357,1436,2721,7,20915,1161,0,2,4,2,1
26445,217,4757,1168,838,957,57,25,144,1225,19,348,224,416,367,640,3018,5452,11,61921,3440,1,2,4,2,1
26446,26,557,601,196,481,2,23,85,603,8,63,36,72,71,108,400,664,4,3036,168,0,2,21,11,1
26447,26,557,156,79,106,5,16,28,161,5,14,8,15,19,23,64,97,2,261,14,0,2,21,11,1
26448,23,855,601,196,481,2,23,85,603,8,63,36,72,71,108,400,664,4,3036,168,0,2,25,0,1
26449,79,1795,53,23,39,0,0,13,53,2,8,4,8,10,12,26,39,1,39,2,0,2,17,4,0
26450,79,1795,515,298,307,33,80,99,548,12,63,44,77,75,121,419,753,7,5527,307,0,2,17,4,0
26451,314,6864,72,33,56,0,4,12,72,1,1,1,1,2,2,0,2,0,1,0,0,2,13,7,0
26452,314,6864,1454,835,1044,76,110,219,1530,17,275,158,296,292,454,2297,3718,9,34017,1889,1,2,13,7,0
26453,217,4758,1943,715,1694,26,18,214,1969,12,185,120,237,197,357,1436,2721,7,20915,1161,0,2,3,4,0
26454,217,4758,1168,838,957,57,25,144,1225,19,348,224,416,367,640,3018,5452,11,61921,3440,1,2,3,4,0
26455,94,4062,1020,354,843,12,15,144,1032,8,134,77,144,142,221,970,1580,4,6792,377,0,2,1,1,0
26456,86,1832,402,202,227,24,74,80,426,12,52,33,61,64,94,339,564,7,3969,220,0,2,7,4,1
26457,79,1799,53,23,39,0,0,13,53,2,8,4,8,10,12,26,39,1,39,2,0,2,1,1,1
26458,79,1799,515,298,307,33,80,99,548,12,63,44,77,75,121,419,753,7,5527,307,0,2,1,1,1
26459,314,6871,72,33,56,0,4,12,72,1,1,1,1,2,2,0,2,0,1,0,0,2,5,1,1
26460,314,6871,1454,835,1044,76,110,219,1530,17,275,158,296,292,454,2297,3718,9,34017,1889,1,2,5,1,1
26461,128,5332,1513,682,1277,25,13,200,1538,11,199,116,219,210,335,1557,2584,6,15641,868,0,2,4,3,1
26462,214,4605,2,2,2,0,0,0,2,0,0,0,0,0,0,0,0,0,0,0,0,2,8,1,0
26463,214,4605,99,48,90,1,3,5,100,0,0,0,0,0,0,0,0,0,0,0,0,2,8,1,0
26464,214,4605,8,5,5,2,0,1,10,0,0,0,0,0,0,0,0,0,0,0,0,2,8,1,0
26465,214,4605,1217,716,841,84,126,174,1301,14,185,118,215,199,333,1446,2542,8,20687,1149,0,2,8,1,0
26466,214,4605,160,89,115,0,13,31,160,7,15,11,17,22,28,78,124,3,495,27,0,2,8,1,0
26467,214,4605,10,10,9,9,0,0,19,0,0,0,0,0,0,0,0,0,0,0,0,2,8,1,0
26468,214,4605,173,84,99,8,29,36,181,5,12,7,13,17,20,54,81,2,221,12,0,2,8,1,0
26469,214,4605,3,1,1,3,0,0,6,0,0,0,0,0,0,0,0,0,0,0,0,2,8,1,0
26470,87,1837,402,202,227,24,74,80,426,12,52,33,61,64,94,339,564,7,3969,220,0,2,1,1,0
26471,315,6924,72,33,56,0,4,12,72,1,1,1,1,2,2,0,2,0,1,0,0,2,20,18,0
26472,315,6924,1454,835,1044,76,110,219,1530,17,275,158,296,292,454,2297,3718,9,34017,1889,1,2,20,18,0
26473,27,596,601,196,481,2,23,85,603,8,63,36,72,71,108,400,664,4,3036,168,0,2,8,1,0
26474,27,596,156,79,106,5,16,28,161,5,14,8,15,19,23,64,97,2,261,14,0,2,8,1,0
26475,20,864,75,38,59,1,3,12,76,2,4,2,4,6,6,10,15,1,15,0,0,2,32,8,0
26476,136,5760,1782,648,1425,9,47,279,1791,8,171,97,189,179,286,1292,2140,4,9462,525,0,2,4,40,0
26477,99,5044,1943,715,1694,26,18,214,1969,12,185,120,237,197,357,1436,2721,7,20915,1161,0,2,5,4,0
26478,165,5078,1660,832,1314,41,38,274,1701,20,312,209,395,332,604,2671,5058,12,64042,3557,1,2,14,7,1
26479,165,5078,1057,646,719,113,100,145,1170,18,215,134,248,233,382,1740,3004,10,31186,1732,1,2,14,7,1
26480,76,1699,996,429,845,24,10,117,1020,7,76,50,88,83,138,494,879,4,3565,198,0,2,7,3,1
26481,76,1699,456,277,329,12,42,72,468,13,85,50,97,98,147,592,972,7,7212,400,0,2,7,3,1
26482,217,4679,2,2,2,0,0,0,2,0,0,0,0,0,0,0,0,0,0,0,0,2,23,3,1
26483,217,4679,99,48,90,1,3,5,100,0,0,0,0,0,0,0,0,0,0,0,0,2,23,3,1
26484,217,4679,8,5,5,2,0,1,10,0,0,0,0,0,0,0,0,0,0,0,0,2,23,3,1
26485,217,4679,1217,716,841,84,126,174,1301,14,185,118,215,199,333,1446,2542,8,20687,1149,0,2,23,3,1
26486,217,4679,160,89,115,0,13,31,160,7,15,11,17,22,28,78,124,3,495,27,0,2,23,3,1
26487,217,4679,10,10,9,9,0,0,19,0,0,0,0,0,0,0,0,0,0,0,0,2,23,3,1
26488,217,4679,173,84,99,8,29,36,181,5,12,7,13,17,20,54,81,2,221,12,0,2,23,3,1
26489,217,4679,3,1,1,3,0,0,6,0,0,0,0,0,0,0,0,0,0,0,0,2,23,3,1
26490,49,729,167,116,138,4,5,22,171,8,48,30,56,56,86,292,499,4,2330,129,0,2,18,9,1
26491,254,5836,4293,999,3693,19,54,507,4312,9,155,88,170,164,258,1156,1898,4,9368,520,0,2,6,2,1
26492,254,5836,1482,859,1002,125,135,219,1607,16,219,134,251,235,385,1766,3032,9,27804,1544,1,2,6,2,1
26493,98,2668,1523,757,1297,19,12,193,1542,12,193,117,230,205,347,1508,2664,7,19053,1058,0,2,5,2,1
26494,98,2668,701,378,504,33,58,109,734,13,110,68,126,123,194,794,1346,7,10027,557,0,2,5,2,1
26495,80,1826,53,23,39,0,0,13,53,2,8,4,8,10,12,26,39,1,39,2,0,2,30,4,1
26496,80,1826,515,298,307,33,80,99,548,12,63,44,77,75,121,419,753,7,5527,307,0,2,30,4,1
26497,315,6944,72,33,56,0,4,12,72,1,1,1,1,2,2,0,2,0,1,0,0,2,14,6,1
26498,315,6944,1454,835,1044,76,110,219,1530,17,275,158,296,292,454,2297,3718,9,34017,1889,1,2,14,6,1
26499,30,658,215,129,180,6,0,29,221,8,65,43,72,73,115,415,711,4,3153,175,0,2,3,1,1
26500,30,658,97,69,77,3,3,16,100,6,22,13,23,28,36,113,173,3,542,30,0,2,3,1,1
26501,94,3940,1289,550,1043,56,32,155,1345,10,167,93,185,177,278,1266,2075,5,11498,638,0,2,1,1,1
26502,20,968,75,38,59,1,3,12,76,2,4,2,4,6,6,10,15,1,15,0,0,2,22,6,1
26503,101,4718,1338,495,1086,10,64,173,1348,11,122,82,157,133,239,883,1686,7,11934,663,0,2,11,3,1
26504,136,5760,1782,648,1425,9,47,279,1791,8,171,97,189,179,286,1292,2140,4,9462,525,0,2,2,2,1
26505,111,4139,1450,624,1228,12,26,181,1462,14,306,186,354,320,540,2580,4493,8,36391,2021,1,2,2,1,1
26506,156,4476,1660,832,1314,41,38,274,1701,20,312,209,395,332,604,2671,5058,12,64042,3557,1,2,4,8,1
26507,43,3139,996,429,845,24,10,117,1020,7,76,50,88,83,138,494,879,4,3565,198,0,2,1,0,1
26508,90,4662,1457,730,1242,11,6,188,1468,10,292,166,329,302,495,2424,4078,5,22973,1276,1,2,22,15,1
26509,95,4642,1523,757,1297,19,12,193,1542,12,193,117,230,205,347,1508,2664,7,19053,1058,0,2,5,1,1
26510,16,1224,215,129,180,6,0,29,221,8,65,43,72,73,115,415,711,4,3153,175,0,2,3,0,1
26511,23,855,601,196,481,2,23,85,603,8,63,36,72,71,108,400,664,4,3036,168,0,2,1,1,1
26512,217,4679,2,2,2,0,0,0,2,0,0,0,0,0,0,0,0,0,0,0,0,2,2,2,0
26513,217,4679,99,48,90,1,3,5,100,0,0,0,0,0,0,0,0,0,0,0,0,2,2,2,0
26514,217,4679,8,5,5,2,0,1,10,0,0,0,0,0,0,0,0,0,0,0,0,2,2,2,0
26515,217,4679,1217,716,841,84,126,174,1301,14,185,118,215,199,333,1446,2542,8,20687,1149,0,2,2,2,0
26516,217,4679,160,89,115,0,13,31,160,7,15,11,17,22,28,78,124,3,495,27,0,2,2,2,0
26517,217,4679,10,10,9,9,0,0,19,0,0,0,0,0,0,0,0,0,0,0,0,2,2,2,0
26518,217,4679,173,84,99,8,29,36,181,5,12,7,13,17,20,54,81,2,221,12,0,2,2,2,0
26519,217,4679,3,1,1,3,0,0,6,0,0,0,0,0,0,0,0,0,0,0,0,2,2,2,0
26520,315,6939,72,33,56,0,4,12,72,1,1,1,1,2,2,0,2,0,1,0,0,2,3,7,0
26521,315,6939,1454,835,1044,76,110,219,1530,17,275,158,296,292,454,2297,3718,9,34017,1889,1,2,3,7,0
26522,156,4472,1660,832,1314,41,38,274,1701,20,312,209,395,332,604,2671,5058,12,64042,3557,1,2,1,2,0
26523,94,4062,1020,354,843,12,15,144,1032,8,134,77,144,142,221,970,1580,4,6792,377,0,2,1,1,0
26524,30,634,601,196,481,2,23,85,603,8,63,36,72,71,108,400,664,4,3036,168,0,2,8,0,0
26525,30,634,156,79,106,5,16,28,161,5,14,8,15,19,23,64,97,2,261,14,0,2,8,0,0
26526,102,4744,1338,495,1086,10,64,173,1348,11,122,82,157,133,239,883,1686,7,11934,663,0,2,20,23,0
26527,29,1088,601,196,481,2,23,85,603,8,63,36,72,71,108,400,664,4,3036,168,0,2,73,0,0
26528,33,1200,601,196,481,2,23,85,603,8,63,36,72,71,108,400,664,4,3036,168,0,2,40,0,0
26529,217,4692,2,2,2,0,0,0,2,0,0,0,0,0,0,0,0,0,0,0,0,2,6,4,1
26530,217,4692,99,48,90,1,3,5,100,0,0,0,0,0,0,0,0,0,0,0,0,2,6,4,1
26531,217,4692,8,5,5,2,0,1,10,0,0,0,0,0,0,0,0,0,0,0,0,2,6,4,1
26532,217,4692,1217,716,841,84,126,174,1301,14,185,118,215,199,333,1446,2542,8,20687,1149,0,2,6,4,1
26533,217,4692,160,89,115,0,13,31,160,7,15,11,17,22,28,78,124,3,495,27,0,2,6,4,1
26534,217,4692,10,10,9,9,0,0,19,0,0,0,0,0,0,0,0,0,0,0,0,2,6,4,1
26535,217,4692,173,84,99,8,29,36,181,5,12,7,13,17,20,54,81,2,221,12,0,2,6,4,1
26536,217,4692,3,1,1,3,0,0,6,0,0,0,0,0,0,0,0,0,0,0,0,2,6,4,1
26537,51,767,167,116,138,4,5,22,171,8,48,30,56,56,86,292,499,4,2330,129,0,2,20,19,1
26538,52,622,647,139,84,35,284,233,682,0,0,0,0,0,0,0,0,0,0,0,0,2,14,2,1
26539,30,663,215,129,180,6,0,29,221,8,65,43,72,73,115,415,711,4,3153,175,0,2,2,2,1
26540,30,663,97,69,77,3,3,16,100,6,22,13,23,28,36,113,173,3,542,30,0,2,2,2,1
26541,31,704,601,196,481,2,23,85,603,8,63,36,72,71,108,400,664,4,3036,168,0,2,17,0,1
26542,31,704,156,79,106,5,16,28,161,5,14,8,15,19,23,64,97,2,261,14,0,2,17,0,1
26543,20,911,75,38,59,1,3,12,76,2,4,2,4,6,6,10,15,1,15,0,0,2,3,15,1
26544,165,5086,1660,832,1314,41,38,274,1701,20,312,209,395,332,604,2671,5058,12,64042,3557,1,2,4,3,1
26545,165,5086,1057,646,719,113,100,145,1170,18,215,134,248,233,382,1740,3004,10,31186,1732,1,2,4,3,1
26546,98,2666,1523,757,1297,19,12,193,1542,12,193,117,230,205,347,1508,2664,7,19053,1058,0,2,2,3,1
26547,98,2666,701,378,504,33,58,109,734,13,110,68,126,123,194,794,1346,7,10027,557,0,2,2,3,1
26548,235,5586,722,423,573,19,0,135,741,12,172,101,199,184,300,1320,2257,6,15668,870,0,2,1,1,1
26549,235,5586,1508,847,911,44,250,301,1552,14,148,88,169,162,257,1120,1886,7,15077,837,0,2,1,1,1
26550,220,4815,1943,715,1694,26,18,214,1969,12,185,120,237,197,357,1436,2721,7,20915,1161,0,2,21,6,1
26551,220,4815,1168,838,957,57,25,144,1225,19,348,224,416,367,640,3018,5452,11,61921,3440,1,2,21,6,1
26552,156,4471,1660,832,1314,41,38,274,1701,20,312,209,395,332,604,2671,5058,12,64042,3557,1,2,10,5,1
26553,95,4639,1523,757,1297,19,12,193,1542,12,193,117,230,205,347,1508,2664,7,19053,1058,0,2,1,4,1
26554,33,1183,601,196,481,2,23,85,603,8,63,36,72,71,108,400,664,4,3036,168,0,2,2,5,1
26555,235,5588,722,423,573,19,0,135,741,12,172,101,199,184,300,1320,2257,6,15668,870,0,2,4,2,0
26556,235,5588,1508,847,911,44,250,301,1552,14,148,88,169,162,257,1120,1886,7,15077,837,0,2,4,2,0
26557,1,54,37,13,25,0,6,6,37,1,2,1,2,3,3,2,4,0,2,0,0,2,17,0,0
26558,1,54,133,47,40,1,43,49,134,0,0,0,0,0,0,0,0,0,0,0,0,2,17,0,0
26559,235,5588,722,423,573,19,0,135,741,12,172,101,199,184,300,1320,2257,6,15668,870,0,2,1,1,0
26560,235,5588,1508,847,911,44,250,301,1552,14,148,88,169,162,257,1120,1886,7,15077,837,0,2,1,1,0
26561,1,54,37,13,25,0,6,6,37,1,2,1,2,3,3,2,4,0,2,0,0,2,1,1,0
26562,1,54,133,47,40,1,43,49,134,0,0,0,0,0,0,0,0,0,0,0,0,2,1,1,0
26563,315,6939,72,33,56,0,4,12,72,1,1,1,1,2,2,0,2,0,1,0,0,2,0,5,0
26564,315,6939,1454,835,1044,76,110,219,1530,17,275,158,296,292,454,2297,3718,9,34017,1889,1,2,0,5,0
26565,31,704,601,196,481,2,23,85,603,8,63,36,72,71,108,400,664,4,3036,168,0,2,1,0,0
26566,31,704,156,79,106,5,16,28,161,5,14,8,15,19,23,64,97,2,261,14,0,2,1,0,0
26567,80,1826,53,23,39,0,0,13,53,2,8,4,8,10,12,26,39,1,39,2,0,2,1,0,0
26568,80,1826,515,298,307,33,80,99,548,12,63,44,77,75,121,419,753,7,5527,307,0,2,1,0,0
26569,97,1999,463,295,324,28,62,57,491,12,134,82,154,146,236,989,1696,6,11700,650,0,2,15,0,0
26570,95,3958,1289,550,1043,56,32,155,1345,10,167,93,185,177,278,1266,2075,5,11498,638,0,2,5,0,0
26571,165,5085,1660,832,1314,41,38,274,1701,20,312,209,395,332,604,2671,5058,12,64042,3557,1,2,1,1,0
26572,165,5085,1057,646,719,113,100,145,1170,18,215,134,248,233,382,1740,3004,10,31186,1732,1,2,1,1,0
26573,166,5096,1660,832,1314,41,38,274,1701,20,312,209,395,332,604,2671,5058,12,64042,3557,1,2,1,1,0
26574,166,5096,1057,646,719,113,100,145,1170,18,215,134,248,233,382,1740,3004,10,31186,1732,1,2,1,1,0
26575,111,4170,1450,624,1228,12,26,181,1462,14,306,186,354,320,540,2580,4493,8,36391,2021,1,2,12,3,0
26576,76,1699,996,429,845,24,10,117,1020,7,76,50,88,83,138,494,879,4,3565,198,0,2,1,1,0
26577,76,1699,456,277,329,12,42,72,468,13,85,50,97,98,147,592,972,7,7212,400,0,2,1,1,0
26578,217,4683,2,2,2,0,0,0,2,0,0,0,0,0,0,0,0,0,0,0,0,2,4,5,1
26579,217,4683,99,48,90,1,3,5,100,0,0,0,0,0,0,0,0,0,0,0,0,2,4,5,1
26580,217,4683,8,5,5,2,0,1,10,0,0,0,0,0,0,0,0,0,0,0,0,2,4,5,1
26581,217,4683,1217,716,841,84,126,174,1301,14,185,118,215,199,333,1446,2542,8,20687,1149,0,2,4,5,1
26582,217,4683,160,89,115,0,13,31,160,7,15,11,17,22,28,78,124,3,495,27,0,2,4,5,1
26583,217,4683,10,10,9,9,0,0,19,0,0,0,0,0,0,0,0,0,0,0,0,2,4,5,1
26584,217,4683,173,84,99,8,29,36,181,5,12,7,13,17,20,54,81,2,221,12,0,2,4,5,1
26585,217,4683,3,1,1,3,0,0,6,0,0,0,0,0,0,0,0,0,0,0,0,2,4,5,1
26586,254,5836,4293,999,3693,19,54,507,4312,9,155,88,170,164,258,1156,1898,4,9368,520,0,2,2,1,1
26587,254,5836,1482,859,1002,125,135,219,1607,16,219,134,251,235,385,1766,3032,9,27804,1544,1,2,2,1,1
26588,98,2660,1523,757,1297,19,12,193,1542,12,193,117,230,205,347,1508,2664,7,19053,1058,0,2,2,3,1
26589,98,2660,701,378,504,33,58,109,734,13,110,68,126,123,194,794,1346,7,10027,557,0,2,2,3,1
26590,87,1836,402,202,227,24,74,80,426,12,52,33,61,64,94,339,564,7,3969,220,0,2,7,5,1
26591,80,1834,53,23,39,0,0,13,53,2,8,4,8,10,12,26,39,1,39,2,0,2,14,12,1
26592,80,1834,515,298,307,33,80,99,548,12,63,44,77,75,121,419,753,7,5527,307,0,2,14,12,1
26593,235,5585,722,423,573,19,0,135,741,12,172,101,199,184,300,1320,2257,6,15668,870,0,2,3,5,1
26594,235,5585,1508,847,911,44,250,301,1552,14,148,88,169,162,257,1120,1886,7,15077,837,0,2,3,5,1
26595,314,6932,72,33,56,0,4,12,72,1,1,1,1,2,2,0,2,0,1,0,0,2,15,18,1
26596,314,6932,1454,835,1044,76,110,219,1530,17,275,158,296,292,454,2297,3718,9,34017,1889,1,2,15,18,1
26597,1,62,37,13,25,0,6,6,37,1,2,1,2,3,3,2,4,0,2,0,0,2,3,0,1
26598,1,62,133,47,40,1,43,49,134,0,0,0,0,0,0,0,0,0,0,0,0,2,3,0,1
26599,31,716,601,196,481,2,23,85,603,8,63,36,72,71,108,400,664,4,3036,168,0,2,3,3,1
26600,31,716,156,79,106,5,16,28,161,5,14,8,15,19,23,64,97,2,261,14,0,2,3,3,1
26601,94,3938,1289,550,1043,56,32,155,1345,10,167,93,185,177,278,1266,2075,5,11498,638,0,2,1,1,1
26602,20,918,75,38,59,1,3,12,76,2,4,2,4,6,6,10,15,1,15,0,0,2,2,1,1
26603,136,5782,1782,648,1425,9,47,279,1791,8,171,97,189,179,286,1292,2140,4,9462,525,0,2,4,4,1
26604,95,4080,1020,354,843,12,15,144,1032,8,134,77,144,142,221,970,1580,4,6792,377,0,2,5,1,1
26605,2,145,53,23,39,0,0,13,53,2,8,4,8,10,12,26,39,1,39,2,0,2,11,0,1
26606,31,712,601,196,481,2,23,85,603,8,63,36,72,71,108,400,664,4,3036,168,0,2,1,1,0
26607,31,712,156,79,106,5,16,28,161,5,14,8,15,19,23,64,97,2,261,14,0,2,1,1,0
26608,43,3157,996,429,845,24,10,117,1020,7,76,50,88,83,138,494,879,4,3565,198,0,2,2,0,1
26609,166,5096,1660,832,1314,41,38,274,1701,20,312,209,395,332,604,2671,5058,12,64042,3557,1,2,1,1,0
26610,166,5096,1057,646,719,113,100,145,1170,18,215,134,248,233,382,1740,3004,10,31186,1732,1,2,1,1,0
26611,43,3157,996,429,845,24,10,117,1020,7,76,50,88,83,138,494,879,4,3565,198,0,2,3,1,0
26612,98,2660,1523,757,1297,19,12,193,1542,12,193,117,230,205,347,1508,2664,7,19053,1058,0,2,2,4,1
26613,98,2660,701,378,504,33,58,109,734,13,110,68,126,123,194,794,1346,7,10027,557,0,2,2,4,1
26614,87,1836,402,202,227,24,74,80,426,12,52,33,61,64,94,339,564,7,3969,220,0,2,1,1,1
26615,82,1862,53,23,39,0,0,13,53,2,8,4,8,10,12,26,39,1,39,2,0,2,40,5,1
26616,82,1862,515,298,307,33,80,99,548,12,63,44,77,75,121,419,753,7,5527,307,0,2,40,5,1
26617,235,5585,722,423,573,19,0,135,741,12,172,101,199,184,300,1320,2257,6,15668,870,0,2,1,1,1
26618,235,5585,1508,847,911,44,250,301,1552,14,148,88,169,162,257,1120,1886,7,15077,837,0,2,1,1,1
26619,314,6932,72,33,56,0,4,12,72,1,1,1,1,2,2,0,2,0,1,0,0,2,5,5,1
26620,314,6932,1454,835,1044,76,110,219,1530,17,275,158,296,292,454,2297,3718,9,34017,1889,1,2,5,5,1
26621,90,4662,1457,730,1242,11,6,188,1468,10,292,166,329,302,495,2424,4078,5,22973,1276,1,2,1,1,1
26622,95,4080,1020,354,843,12,15,144,1032,8,134,77,144,142,221,970,1580,4,6792,377,0,2,1,1,1
26623,2,145,53,23,39,0,0,13,53,2,8,4,8,10,12,26,39,1,39,2,0,2,1,1,1
26624,52,622,647,139,84,35,284,233,682,0,0,0,0,0,0,0,0,0,0,0,0,2,5,2,0
26625,33,814,601,196,481,2,23,85,603,8,63,36,72,71,108,400,664,4,3036,168,0,2,28,6,0
26626,33,814,156,79,106,5,16,28,161,5,14,8,15,19,23,64,97,2,261,14,0,2,28,6,0
26627,34,1230,601,196,481,2,23,85,603,8,63,36,72,71,108,400,664,4,3036,168,0,2,32,4,0
26628,76,1714,996,429,845,24,10,117,1020,7,76,50,88,83,138,494,879,4,3565,198,0,2,5,4,0
26629,76,1714,456,277,329,12,42,72,468,13,85,50,97,98,147,592,972,7,7212,400,0,2,5,4,0
26630,166,5101,1660,832,1314,41,38,274,1701,20,312,209,395,332,604,2671,5058,12,64042,3557,1,2,2,2,1
26631,166,5101,1057,646,719,113,100,145,1170,18,215,134,248,233,382,1740,3004,10,31186,1732,1,2,2,2,1
26632,217,4685,2,2,2,0,0,0,2,0,0,0,0,0,0,0,0,0,0,0,0,2,5,4,1
26633,217,4685,99,48,90,1,3,5,100,0,0,0,0,0,0,0,0,0,0,0,0,2,5,4,1
26634,217,4685,8,5,5,2,0,1,10,0,0,0,0,0,0,0,0,0,0,0,0,2,5,4,1
26635,217,4685,1217,716,841,84,126,174,1301,14,185,118,215,199,333,1446,2542,8,20687,1149,0,2,5,4,1
26636,217,4685,160,89,115,0,13,31,160,7,15,11,17,22,28,78,124,3,495,27,0,2,5,4,1
26637,217,4685,10,10,9,9,0,0,19,0,0,0,0,0,0,0,0,0,0,0,0,2,5,4,1
26638,217,4685,173,84,99,8,29,36,181,5,12,7,13,17,20,54,81,2,221,12,0,2,5,4,1
26639,217,4685,3,1,1,3,0,0,6,0,0,0,0,0,0,0,0,0,0,0,0,2,5,4,1
26640,254,5841,4293,999,3693,19,54,507,4312,9,155,88,170,164,258,1156,1898,4,9368,520,0,2,4,2,1
26641,254,5841,1482,859,1002,125,135,219,1607,16,219,134,251,235,385,1766,3032,9,27804,1544,1,2,4,2,1
26642,314,6935,72,33,56,0,4,12,72,1,1,1,1,2,2,0,2,0,1,0,0,2,4,2,1
26643,314,6935,1454,835,1044,76,110,219,1530,17,275,158,296,292,454,2297,3718,9,34017,1889,1,2,4,2,1
26644,20,927,75,38,59,1,3,12,76,2,4,2,4,6,6,10,15,1,15,0,0,2,3,3,1
26645,86,1893,53,23,39,0,0,13,53,2,8,4,8,10,12,26,39,1,39,2,0,2,10,2,0
26646,86,1893,515,298,307,33,80,99,548,12,63,44,77,75,121,419,753,7,5527,307,0,2,10,2,0
26647,92,4702,1457,730,1242,11,6,188,1468,10,292,166,329,302,495,2424,4078,5,22973,1276,1,2,8,3,0
26648,313,6932,72,33,56,0,4,12,72,1,1,1,1,2,2,0,2,0,1,0,0,2,1,2,0
26649,313,6932,1454,835,1044,76,110,219,1530,17,275,158,296,292,454,2297,3718,9,34017,1889,1,2,1,2,0
26650,313,6930,72,33,56,0,4,12,72,1,1,1,1,2,2,0,2,0,1,0,0,2,3,3,0
26651,313,6930,1454,835,1044,76,110,219,1530,17,275,158,296,292,454,2297,3718,9,34017,1889,1,2,3,3,0
26652,136,5790,1782,648,1425,9,47,279,1791,8,171,97,189,179,286,1292,2140,4,9462,525,0,2,2,2,0
26653,52,622,647,139,84,35,284,233,682,0,0,0,0,0,0,0,0,0,0,0,0,2,2,5,0
26654,31,726,601,196,481,2,23,85,603,8,63,36,72,71,108,400,664,4,3036,168,0,2,2,18,0
26655,31,726,156,79,106,5,16,28,161,5,14,8,15,19,23,64,97,2,261,14,0,2,2,18,0
26656,34,1230,601,196,481,2,23,85,603,8,63,36,72,71,108,400,664,4,3036,168,0,2,3,3,0
26657,39,1718,386,256,301,16,9,68,402,4,59,35,69,63,104,355,621,2,1453,80,0,2,3,3,0
26658,136,5794,1782,648,1425,9,47,279,1791,8,171,97,189,179,286,1292,2140,4,9462,525,0,2,1,1,0
26659,86,1893,53,23,39,0,0,13,53,2,8,4,8,10,12,26,39,1,39,2,0,2,10,6,0
26660,86,1893,515,298,307,33,80,99,548,12,63,44,77,75,121,419,753,7,5527,307,0,2,10,6,0
26661,95,4101,1020,354,843,12,15,144,1032,8,134,77,144,142,221,970,1580,4,6792,377,0,2,7,2,0
26662,179,5366,1660,832,1314,41,38,274,1701,20,312,209,395,332,604,2671,5058,12,64042,3557,1,2,64,7,0
26663,179,5366,1057,646,719,113,100,145,1170,18,215,134,248,233,382,1740,3004,10,31186,1732,1,2,64,7,0
26664,141,3279,77,34,69,0,0,8,77,3,24,16,29,27,45,114,213,1,387,21,0,2,4,3,0
26665,141,3279,712,438,573,51,9,84,763,14,102,71,128,116,199,733,1364,8,11988,666,0,2,4,3,0
26666,162,4813,1660,832,1314,41,38,274,1701,20,312,209,395,332,604,2671,5058,12,64042,3557,1,2,93,14,0
26667,31,726,601,196,481,2,23,85,603,8,63,36,72,71,108,400,664,4,3036,168,0,2,1,1,0
26668,31,726,156,79,106,5,16,28,161,5,14,8,15,19,23,64,97,2,261,14,0,2,1,1,0
26669,35,1271,601,196,481,2,23,85,603,8,63,36,72,71,108,400,664,4,3036,168,0,2,16,0,0
26670,166,5101,1660,832,1314,41,38,274,1701,20,312,209,395,332,604,2671,5058,12,64042,3557,1,2,16,8,0
26671,166,5101,1057,646,719,113,100,145,1170,18,215,134,248,233,382,1740,3004,10,31186,1732,1,2,16,8,0
26672,76,1714,996,429,845,24,10,117,1020,7,76,50,88,83,138,494,879,4,3565,198,0,2,8,3,0
26673,76,1714,456,277,329,12,42,72,468,13,85,50,97,98,147,592,972,7,7212,400,0,2,8,3,0
26674,217,4685,2,2,2,0,0,0,2,0,0,0,0,0,0,0,0,0,0,0,0,2,33,4,0
26675,217,4685,99,48,90,1,3,5,100,0,0,0,0,0,0,0,0,0,0,0,0,2,33,4,0
26676,217,4685,8,5,5,2,0,1,10,0,0,0,0,0,0,0,0,0,0,0,0,2,33,4,0
26677,217,4685,1217,716,841,84,126,174,1301,14,185,118,215,199,333,1446,2542,8,20687,1149,0,2,33,4,0
26678,217,4685,160,89,115,0,13,31,160,7,15,11,17,22,28,78,124,3,495,27,0,2,33,4,0
26679,217,4685,10,10,9,9,0,0,19,0,0,0,0,0,0,0,0,0,0,0,0,2,33,4,0
26680,217,4685,173,84,99,8,29,36,181,5,12,7,13,17,20,54,81,2,221,12,0,2,33,4,0
26681,217,4685,3,1,1,3,0,0,6,0,0,0,0,0,0,0,0,0,0,0,0,2,33,4,0
26682,51,767,167,116,138,4,5,22,171,8,48,30,56,56,86,292,499,4,2330,129,0,2,24,14,0
26683,254,5841,4293,999,3693,19,54,507,4312,9,155,88,170,164,258,1156,1898,4,9368,520,0,2,10,3,0
26684,254,5841,1482,859,1002,125,135,219,1607,16,219,134,251,235,385,1766,3032,9,27804,1544,1,2,10,3,0
26685,52,622,647,139,84,35,284,233,682,0,0,0,0,0,0,0,0,0,0,0,0,2,32,1,0
26686,98,2660,1523,757,1297,19,12,193,1542,12,193,117,230,205,347,1508,2664,7,19053,1058,0,2,5,6,0
26687,98,2660,701,378,504,33,58,109,734,13,110,68,126,123,194,794,1346,7,10027,557,0,2,5,6,0
26688,87,1836,402,202,227,24,74,80,426,12,52,33,61,64,94,339,564,7,3969,220,0,2,10,5,0
26689,86,1893,53,23,39,0,0,13,53,2,8,4,8,10,12,26,39,1,39,2,0,2,105,6,0
26690,86,1893,515,298,307,33,80,99,548,12,63,44,77,75,121,419,753,7,5527,307,0,2,105,6,0
26691,235,5585,722,423,573,19,0,135,741,12,172,101,199,184,300,1320,2257,6,15668,870,0,2,3,4,0
26692,235,5585,1508,847,911,44,250,301,1552,14,148,88,169,162,257,1120,1886,7,15077,837,0,2,3,4,0
26693,313,6930,72,33,56,0,4,12,72,1,1,1,1,2,2,0,2,0,1,0,0,2,40,36,0
26694,313,6930,1454,835,1044,76,110,219,1530,17,275,158,296,292,454,2297,3718,9,34017,1889,1,2,40,36,0
26695,30,663,215,129,180,6,0,29,221,8,65,43,72,73,115,415,711,4,3153,175,0,2,3,1,0
26696,30,663,97,69,77,3,3,16,100,6,22,13,23,28,36,113,173,3,542,30,0,2,3,1,0
26697,220,4815,1943,715,1694,26,18,214,1969,12,185,120,237,197,357,1436,2721,7,20915,1161,0,2,45,19,0
26698,220,4815,1168,838,957,57,25,144,1225,19,348,224,416,367,640,3018,5452,11,61921,3440,1,2,45,19,0
26699,1,62,37,13,25,0,6,6,37,1,2,1,2,3,3,2,4,0,2,0,0,0,42,0,0
26700,1,62,133,47,40,1,43,49,134,0,0,0,0,0,0,0,0,0,0,0,0,0,42,0,0
26701,31,726,601,196,481,2,23,85,603,8,63,36,72,71,108,400,664,4,3036,168,0,2,94,41,0
26702,31,726,156,79,106,5,16,28,161,5,14,8,15,19,23,64,97,2,261,14,0,2,94,41,0
26703,20,927,75,38,59,1,3,12,76,2,4,2,4,6,6,10,15,1,15,0,0,2,46,17,0
26704,102,4744,1338,495,1086,10,64,173,1348,11,122,82,157,133,239,883,1686,7,11934,663,0,2,31,26,0
26705,136,5794,1782,648,1425,9,47,279,1791,8,171,97,189,179,286,1292,2140,4,9462,525,0,2,8,44,0
26706,111,4170,1450,624,1228,12,26,181,1462,14,306,186,354,320,540,2580,4493,8,36391,2021,1,2,13,3,0
26707,156,4471,1660,832,1314,41,38,274,1701,20,312,209,395,332,604,2671,5058,12,64042,3557,1,2,10,10,0
26708,43,3157,996,429,845,24,10,117,1020,7,76,50,88,83,138,494,879,4,3565,198,0,2,5,0,0
26709,128,5332,1513,682,1277,25,13,200,1538,11,199,116,219,210,335,1557,2584,6,15641,868,0,2,4,3,0
26710,92,4702,1457,730,1242,11,6,188,1468,10,292,166,329,302,495,2424,4078,5,22973,1276,1,2,30,18,0
26711,95,4639,1523,757,1297,19,12,193,1542,12,193,117,230,205,347,1508,2664,7,19053,1058,0,2,2,1,0
26712,95,4101,1020,354,843,12,15,144,1032,8,134,77,144,142,221,970,1580,4,6792,377,0,2,12,3,0
26713,2,145,53,23,39,0,0,13,53,2,8,4,8,10,12,26,39,1,39,2,0,2,11,0,0
26714,39,1718,386,256,301,16,9,68,402,4,59,35,69,63,104,355,621,2,1453,80,0,2,3,3,0
26715,16,1224,215,129,180,6,0,29,221,8,65,43,72,73,115,415,711,4,3153,175,0,2,3,0,0
26716,99,5044,1943,715,1694,26,18,214,1969,12,185,120,237,197,357,1436,2721,7,20915,1161,0,2,5,4,0
26717,35,1271,601,196,481,2,23,85,603,8,63,36,72,71,108,400,664,4,3036,168,0,2,203,5,0
26718,1,319,382,65,130,157,2,92,539,4,10,5,10,14,15,41,57,2,114,6,0,2,1,1,0
26719,11,413,42,7,35,4,0,5,46,1,2,1,2,3,3,2,4,0,2,0,0,2,1,1,0
26720,11,413,11,6,10,0,0,1,11,2,4,2,4,6,6,10,15,1,15,0,0,2,1,1,0
26721,179,5394,1660,832,1314,41,38,274,1701,20,312,209,395,332,604,2671,5058,12,64042,3557,1,2,64,7,0
26722,179,5394,1057,646,719,113,100,145,1170,18,215,134,248,233,382,1740,3004,10,31186,1732,1,2,64,7,0
26723,217,4691,2,2,2,0,0,0,2,0,0,0,0,0,0,0,0,0,0,0,0,2,3,1,0
26724,217,4691,99,48,90,1,3,5,100,0,0,0,0,0,0,0,0,0,0,0,0,2,3,1,0
26725,217,4691,8,5,5,2,0,1,10,0,0,0,0,0,0,0,0,0,0,0,0,2,3,1,0
26726,217,4691,1217,716,841,84,126,174,1301,14,185,118,215,199,333,1446,2542,8,20687,1149,0,2,3,1,0
26727,217,4691,160,89,115,0,13,31,160,7,15,11,17,22,28,78,124,3,495,27,0,2,3,1,0
26728,217,4691,10,10,9,9,0,0,19,0,0,0,0,0,0,0,0,0,0,0,0,2,3,1,0
26729,217,4691,173,84,99,8,29,36,181,5,12,7,13,17,20,54,81,2,221,12,0,2,3,1,0
26730,217,4691,3,1,1,3,0,0,6,0,0,0,0,0,0,0,0,0,0,0,0,2,3,1,0
26731,141,3279,77,34,69,0,0,8,77,3,24,16,29,27,45,114,213,1,387,21,0,2,4,3,0
26732,141,3279,712,438,573,51,9,84,763,14,102,71,128,116,199,733,1364,8,11988,666,0,2,4,3,0
26733,20,507,205,80,86,16,53,53,221,7,18,10,19,25,29,94,134,3,497,27,0,2,24,8,0
26734,222,4835,1943,715,1694,26,18,214,1969,12,185,120,237,197,357,1436,2721,7,20915,1161,0,2,14,8,0
26735,222,4835,1168,838,957,57,25,144,1225,19,348,224,416,367,640,3018,5452,11,61921,3440,1,2,14,8,0
26736,161,4776,1660,832,1314,41,38,274,1701,20,312,209,395,332,604,2671,5058,12,64042,3557,1,2,93,14,0
26737,1,319,382,65,130,157,2,92,539,4,10,5,10,14,15,41,57,2,114,6,0,2,1,1,0
26738,11,413,42,7,35,4,0,5,46,1,2,1,2,3,3,2,4,0,2,0,0,2,1,1,0
26739,11,413,11,6,10,0,0,1,11,2,4,2,4,6,6,10,15,1,15,0,0,2,1,1,0
26740,179,5394,1660,832,1314,41,38,274,1701,20,312,209,395,332,604,2671,5058,12,64042,3557,1,2,64,7,0
26741,179,5394,1057,646,719,113,100,145,1170,18,215,134,248,233,382,1740,3004,10,31186,1732,1,2,64,7,0
26742,217,4691,2,2,2,0,0,0,2,0,0,0,0,0,0,0,0,0,0,0,0,2,3,1,0
26743,217,4691,99,48,90,1,3,5,100,0,0,0,0,0,0,0,0,0,0,0,0,2,3,1,0
26744,217,4691,8,5,5,2,0,1,10,0,0,0,0,0,0,0,0,0,0,0,0,2,3,1,0
26745,217,4691,1217,716,841,84,126,174,1301,14,185,118,215,199,333,1446,2542,8,20687,1149,0,2,3,1,0
26746,217,4691,160,89,115,0,13,31,160,7,15,11,17,22,28,78,124,3,495,27,0,2,3,1,0
26747,217,4691,10,10,9,9,0,0,19,0,0,0,0,0,0,0,0,0,0,0,0,2,3,1,0
26748,217,4691,173,84,99,8,29,36,181,5,12,7,13,17,20,54,81,2,221,12,0,2,3,1,0
26749,217,4691,3,1,1,3,0,0,6,0,0,0,0,0,0,0,0,0,0,0,0,2,3,1,0
26750,141,3279,77,34,69,0,0,8,77,3,24,16,29,27,45,114,213,1,387,21,0,2,4,3,0
26751,141,3279,712,438,573,51,9,84,763,14,102,71,128,116,199,733,1364,8,11988,666,0,2,4,3,0
26752,20,507,205,80,86,16,53,53,221,7,18,10,19,25,29,94,134,3,497,27,0,2,24,8,0
26753,222,4835,1943,715,1694,26,18,214,1969,12,185,120,237,197,357,1436,2721,7,20915,1161,0,2,14,8,0
26754,222,4835,1168,838,957,57,25,144,1225,19,348,224,416,367,640,3018,5452,11,61921,3440,1,2,14,8,0
26755,161,4776,1660,832,1314,41,38,274,1701,20,312,209,395,332,604,2671,5058,12,64042,3557,1,2,93,14,0
26756,179,5394,1660,832,1314,41,38,274,1701,20,312,209,395,332,604,2671,5058,12,64042,3557,1,2,16,8,0
26757,179,5394,1057,646,719,113,100,145,1170,18,215,134,248,233,382,1740,3004,10,31186,1732,1,2,16,8,0
26758,76,1714,996,429,845,24,10,117,1020,7,76,50,88,83,138,494,879,4,3565,198,0,2,14,12,0
26759,76,1714,456,277,329,12,42,72,468,13,85,50,97,98,147,592,972,7,7212,400,0,2,14,12,0
26760,217,4691,2,2,2,0,0,0,2,0,0,0,0,0,0,0,0,0,0,0,0,2,41,5,0
26761,217,4691,99,48,90,1,3,5,100,0,0,0,0,0,0,0,0,0,0,0,0,2,41,5,0
26762,217,4691,8,5,5,2,0,1,10,0,0,0,0,0,0,0,0,0,0,0,0,2,41,5,0
26763,217,4691,1217,716,841,84,126,174,1301,14,185,118,215,199,333,1446,2542,8,20687,1149,0,2,41,5,0
26764,217,4691,160,89,115,0,13,31,160,7,15,11,17,22,28,78,124,3,495,27,0,2,41,5,0
26765,217,4691,10,10,9,9,0,0,19,0,0,0,0,0,0,0,0,0,0,0,0,2,41,5,0
26766,217,4691,173,84,99,8,29,36,181,5,12,7,13,17,20,54,81,2,221,12,0,2,41,5,0
26767,217,4691,3,1,1,3,0,0,6,0,0,0,0,0,0,0,0,0,0,0,0,2,41,5,0
26768,97,1999,463,295,324,28,62,57,491,12,134,82,154,146,236,989,1696,6,11700,650,0,2,15,0,0
26769,51,767,167,116,138,4,5,22,171,8,48,30,56,56,86,292,499,4,2330,129,0,2,24,14,0
26770,254,5841,4293,999,3693,19,54,507,4312,9,155,88,170,164,258,1156,1898,4,9368,520,0,2,10,3,0
26771,254,5841,1482,859,1002,125,135,219,1607,16,219,134,251,235,385,1766,3032,9,27804,1544,1,2,10,3,0
26772,27,965,74,35,59,1,0,14,75,3,14,7,14,17,21,58,85,1,128,7,0,2,1,0,0
26773,27,965,245,125,200,5,7,34,250,7,30,17,34,37,51,166,265,3,1053,58,0,2,1,0,0
26774,52,622,647,139,84,35,284,233,682,0,0,0,0,0,0,0,0,0,0,0,0,2,32,1,0
26775,98,2660,1523,757,1297,19,12,193,1542,12,193,117,230,205,347,1508,2664,7,19053,1058,0,2,5,6,0
26776,98,2660,701,378,504,33,58,109,734,13,110,68,126,123,194,794,1346,7,10027,557,0,2,5,6,0
26777,87,1836,402,202,227,24,74,80,426,12,52,33,61,64,94,339,564,7,3969,220,0,2,10,5,0
26778,86,1893,53,23,39,0,0,13,53,2,8,4,8,10,12,26,39,1,39,2,0,2,105,6,0
26779,86,1893,515,298,307,33,80,99,548,12,63,44,77,75,121,419,753,7,5527,307,0,2,105,6,0
26780,235,5585,722,423,573,19,0,135,741,12,172,101,199,184,300,1320,2257,6,15668,870,0,2,17,8,0
26781,235,5585,1508,847,911,44,250,301,1552,14,148,88,169,162,257,1120,1886,7,15077,837,0,2,17,8,0
26782,313,6930,72,33,56,0,4,12,72,1,1,1,1,2,2,0,2,0,1,0,0,2,40,36,0
26783,313,6930,1454,835,1044,76,110,219,1530,17,275,158,296,292,454,2297,3718,9,34017,1889,1,2,40,36,0
26784,30,663,215,129,180,6,0,29,221,8,65,43,72,73,115,415,711,4,3153,175,0,2,3,1,0
26785,30,663,97,69,77,3,3,16,100,6,22,13,23,28,36,113,173,3,542,30,0,2,3,1,0
26786,222,4835,1943,715,1694,26,18,214,1969,12,185,120,237,197,357,1436,2721,7,20915,1161,0,2,65,27,0
26787,222,4835,1168,838,957,57,25,144,1225,19,348,224,416,367,640,3018,5452,11,61921,3440,1,2,65,27,0
26788,1,62,37,13,25,0,6,6,37,1,2,1,2,3,3,2,4,0,2,0,0,0,42,0,0
26789,1,62,133,47,40,1,43,49,134,0,0,0,0,0,0,0,0,0,0,0,0,0,42,0,0
26790,31,726,601,196,481,2,23,85,603,8,63,36,72,71,108,400,664,4,3036,168,0,2,94,41,0
26791,31,726,156,79,106,5,16,28,161,5,14,8,15,19,23,64,97,2,261,14,0,2,94,41,0
26792,95,3958,1289,550,1043,56,32,155,1345,10,167,93,185,177,278,1266,2075,5,11498,638,0,2,5,0,0
26793,20,927,75,38,59,1,3,12,76,2,4,2,4,6,6,10,15,1,15,0,0,2,46,17,0
26794,102,4744,1338,495,1086,10,64,173,1348,11,122,82,157,133,239,883,1686,7,11934,663,0,2,31,26,0
26795,136,5794,1782,648,1425,9,47,279,1791,8,171,97,189,179,286,1292,2140,4,9462,525,0,2,8,44,0
26796,111,4170,1450,624,1228,12,26,181,1462,14,306,186,354,320,540,2580,4493,8,36391,2021,1,2,13,3,0
26797,161,4776,1660,832,1314,41,38,274,1701,20,312,209,395,332,604,2671,5058,12,64042,3557,1,2,10,10,0
26798,43,3157,996,429,845,24,10,117,1020,7,76,50,88,83,138,494,879,4,3565,198,0,2,23,20,0
26799,128,5332,1513,682,1277,25,13,200,1538,11,199,116,219,210,335,1557,2584,6,15641,868,0,2,4,3,0
26800,92,4702,1457,730,1242,11,6,188,1468,10,292,166,329,302,495,2424,4078,5,22973,1276,1,2,50,18,0
26801,95,4639,1523,757,1297,19,12,193,1542,12,193,117,230,205,347,1508,2664,7,19053,1058,0,2,2,1,0
26802,95,4101,1020,354,843,12,15,144,1032,8,134,77,144,142,221,970,1580,4,6792,377,0,2,12,3,0
26803,2,145,53,23,39,0,0,13,53,2,8,4,8,10,12,26,39,1,39,2,0,2,11,0,0
26804,44,2109,722,423,573,19,0,135,741,12,172,101,199,184,300,1320,2257,6,15668,870,0,2,51,0,0
26805,39,1718,386,256,301,16,9,68,402,4,59,35,69,63,104,355,621,2,1453,80,0,2,3,3,0
26806,16,1224,215,129,180,6,0,29,221,8,65,43,72,73,115,415,711,4,3153,175,0,2,3,0,0
26807,99,5044,1943,715,1694,26,18,214,1969,12,185,120,237,197,357,1436,2721,7,20915,1161,0,2,48,4,0
26808,35,1271,601,196,481,2,23,85,603,8,63,36,72,71,108,400,664,4,3036,168,0,2,203,5,0
26809,139,5872,1782,648,1425,9,47,279,1791,8,171,97,189,179,286,1292,2140,4,9462,525,0,2,0,3,0
26810,179,5394,1660,832,1314,41,38,274,1701,20,312,209,395,332,604,2671,5058,12,64042,3557,1,2,16,8,0
26811,179,5394,1057,646,719,113,100,145,1170,18,215,134,248,233,382,1740,3004,10,31186,1732,1,2,16,8,0
26812,76,1714,996,429,845,24,10,117,1020,7,76,50,88,83,138,494,879,4,3565,198,0,2,14,12,0
26813,76,1714,456,277,329,12,42,72,468,13,85,50,97,98,147,592,972,7,7212,400,0,2,14,12,0
26814,217,4691,2,2,2,0,0,0,2,0,0,0,0,0,0,0,0,0,0,0,0,2,41,5,0
26815,217,4691,99,48,90,1,3,5,100,0,0,0,0,0,0,0,0,0,0,0,0,2,41,5,0
26816,217,4691,8,5,5,2,0,1,10,0,0,0,0,0,0,0,0,0,0,0,0,2,41,5,0
26817,217,4691,1217,716,841,84,126,174,1301,14,185,118,215,199,333,1446,2542,8,20687,1149,0,2,41,5,0
26818,217,4691,160,89,115,0,13,31,160,7,15,11,17,22,28,78,124,3,495,27,0,2,41,5,0
26819,217,4691,10,10,9,9,0,0,19,0,0,0,0,0,0,0,0,0,0,0,0,2,41,5,0
26820,217,4691,173,84,99,8,29,36,181,5,12,7,13,17,20,54,81,2,221,12,0,2,41,5,0
26821,217,4691,3,1,1,3,0,0,6,0,0,0,0,0,0,0,0,0,0,0,0,2,41,5,0
26822,97,1999,463,295,324,28,62,57,491,12,134,82,154,146,236,989,1696,6,11700,650,0,2,15,0,0
26823,51,767,167,116,138,4,5,22,171,8,48,30,56,56,86,292,499,4,2330,129,0,2,24,14,0
26824,254,5841,4293,999,3693,19,54,507,4312,9,155,88,170,164,258,1156,1898,4,9368,520,0,2,10,3,0
26825,254,5841,1482,859,1002,125,135,219,1607,16,219,134,251,235,385,1766,3032,9,27804,1544,1,2,10,3,0
26826,27,965,74,35,59,1,0,14,75,3,14,7,14,17,21,58,85,1,128,7,0,2,1,0,0
26827,27,965,245,125,200,5,7,34,250,7,30,17,34,37,51,166,265,3,1053,58,0,2,1,0,0
26828,52,622,647,139,84,35,284,233,682,0,0,0,0,0,0,0,0,0,0,0,0,2,32,1,0
26829,98,2660,1523,757,1297,19,12,193,1542,12,193,117,230,205,347,1508,2664,7,19053,1058,0,2,5,6,0
26830,98,2660,701,378,504,33,58,109,734,13,110,68,126,123,194,794,1346,7,10027,557,0,2,5,6,0
26831,87,1836,402,202,227,24,74,80,426,12,52,33,61,64,94,339,564,7,3969,220,0,2,10,5,0
26832,86,1893,53,23,39,0,0,13,53,2,8,4,8,10,12,26,39,1,39,2,0,2,105,6,0
26833,86,1893,515,298,307,33,80,99,548,12,63,44,77,75,121,419,753,7,5527,307,0,2,105,6,0
26834,235,5585,722,423,573,19,0,135,741,12,172,101,199,184,300,1320,2257,6,15668,870,0,2,17,8,0
26835,235,5585,1508,847,911,44,250,301,1552,14,148,88,169,162,257,1120,1886,7,15077,837,0,2,17,8,0
26836,313,6930,72,33,56,0,4,12,72,1,1,1,1,2,2,0,2,0,1,0,0,2,40,36,0
26837,313,6930,1454,835,1044,76,110,219,1530,17,275,158,296,292,454,2297,3718,9,34017,1889,1,2,40,36,0
26838,30,663,215,129,180,6,0,29,221,8,65,43,72,73,115,415,711,4,3153,175,0,2,3,1,0
26839,30,663,97,69,77,3,3,16,100,6,22,13,23,28,36,113,173,3,542,30,0,2,3,1,0
26840,222,4835,1943,715,1694,26,18,214,1969,12,185,120,237,197,357,1436,2721,7,20915,1161,0,2,65,27,0
26841,222,4835,1168,838,957,57,25,144,1225,19,348,224,416,367,640,3018,5452,11,61921,3440,1,2,65,27,0
26842,1,62,37,13,25,0,6,6,37,1,2,1,2,3,3,2,4,0,2,0,0,0,42,0,0
26843,1,62,133,47,40,1,43,49,134,0,0,0,0,0,0,0,0,0,0,0,0,0,42,0,0
26844,31,726,601,196,481,2,23,85,603,8,63,36,72,71,108,400,664,4,3036,168,0,2,94,41,0
26845,31,726,156,79,106,5,16,28,161,5,14,8,15,19,23,64,97,2,261,14,0,2,94,41,0
26846,95,3958,1289,550,1043,56,32,155,1345,10,167,93,185,177,278,1266,2075,5,11498,638,0,2,5,0,0
26847,20,927,75,38,59,1,3,12,76,2,4,2,4,6,6,10,15,1,15,0,0,2,46,17,0
26848,102,4744,1338,495,1086,10,64,173,1348,11,122,82,157,133,239,883,1686,7,11934,663,0,2,31,26,0
26849,136,5794,1782,648,1425,9,47,279,1791,8,171,97,189,179,286,1292,2140,4,9462,525,0,2,8,44,0
26850,111,4170,1450,624,1228,12,26,181,1462,14,306,186,354,320,540,2580,4493,8,36391,2021,1,2,13,3,0
26851,161,4776,1660,832,1314,41,38,274,1701,20,312,209,395,332,604,2671,5058,12,64042,3557,1,2,10,10,0
26852,43,3157,996,429,845,24,10,117,1020,7,76,50,88,83,138,494,879,4,3565,198,0,2,23,20,0
26853,128,5332,1513,682,1277,25,13,200,1538,11,199,116,219,210,335,1557,2584,6,15641,868,0,2,4,3,0
26854,92,4702,1457,730,1242,11,6,188,1468,10,292,166,329,302,495,2424,4078,5,22973,1276,1,2,50,18,0
26855,95,4639,1523,757,1297,19,12,193,1542,12,193,117,230,205,347,1508,2664,7,19053,1058,0,2,2,1,0
26856,95,4101,1020,354,843,12,15,144,1032,8,134,77,144,142,221,970,1580,4,6792,377,0,2,12,3,0
26857,2,145,53,23,39,0,0,13,53,2,8,4,8,10,12,26,39,1,39,2,0,2,11,0,0
26858,44,2109,722,423,573,19,0,135,741,12,172,101,199,184,300,1320,2257,6,15668,870,0,2,51,0,0
26859,39,1718,386,256,301,16,9,68,402,4,59,35,69,63,104,355,621,2,1453,80,0,2,3,3,0
26860,16,1224,215,129,180,6,0,29,221,8,65,43,72,73,115,415,711,4,3153,175,0,2,3,0,0
26861,99,5044,1943,715,1694,26,18,214,1969,12,185,120,237,197,357,1436,2721,7,20915,1161,0,2,48,4,0
26862,35,1271,601,196,481,2,23,85,603,8,63,36,72,71,108,400,664,4,3036,168,0,2,203,5,0
26863,136,5770,1782,648,1425,9,47,279,1791,8,171,97,189,179,286,1292,2140,4,9462,525,0,2,0,3,0
26864,136,5770,1782,648,1425,9,47,279,1791,8,171,97,189,179,286,1292,2140,4,9462,525,0,2,0,3,0
26865,31,729,601,196,481,2,23,85,603,8,63,36,72,71,108,400,664,4,3036,168,0,2,7,5,0
26866,31,729,156,79,106,5,16,28,161,5,14,8,15,19,23,64,97,2,261,14,0,2,7,5,0
26867,39,1392,601,196,481,2,23,85,603,8,63,36,72,71,108,400,664,4,3036,168,0,2,44,0,0
26868,35,1079,182,127,129,0,0,53,182,5,39,21,42,44,63,217,343,2,926,51,0,2,8,2,1
26869,35,1079,182,127,129,0,0,53,182,5,39,21,42,44,63,217,343,2,926,51,0,2,8,2,0
26870,313,6898,72,33,56,0,4,12,72,1,1,1,1,2,2,0,2,0,1,0,0,2,4,5,1
26871,313,6898,1454,835,1044,76,110,219,1530,17,275,158,296,292,454,2297,3718,9,34017,1889,1,2,4,5,1
26872,62,1231,1098,241,925,5,10,155,1103,7,46,25,49,53,74,273,423,3,1580,87,0,2,2,1,1
26873,62,1231,282,202,222,14,2,44,296,8,42,24,43,50,67,250,378,4,1548,86,0,2,2,1,1
26874,136,5770,1782,648,1425,9,47,279,1791,8,171,97,189,179,286,1292,2140,4,9462,525,0,2,2,6,1
26875,31,729,601,196,481,2,23,85,603,8,63,36,72,71,108,400,664,4,3036,168,0,2,7,5,0
26876,31,729,156,79,106,5,16,28,161,5,14,8,15,19,23,64,97,2,261,14,0,2,7,5,0
26877,39,1392,601,196,481,2,23,85,603,8,63,36,72,71,108,400,664,4,3036,168,0,2,44,0,0
26878,86,1927,53,23,39,0,0,13,53,2,8,4,8,10,12,26,39,1,39,2,0,2,8,5,0
26879,86,1927,515,298,307,33,80,99,548,12,63,44,77,75,121,419,753,7,5527,307,0,2,8,5,0
26880,313,6928,72,33,56,0,4,12,72,1,1,1,1,2,2,0,2,0,1,0,0,2,1,1,0
26881,313,6928,1454,835,1044,76,110,219,1530,17,275,158,296,292,454,2297,3718,9,34017,1889,1,2,1,1,0
26882,21,960,75,38,59,1,3,12,76,2,4,2,4,6,6,10,15,1,15,0,0,2,17,0,0
26883,254,5860,4293,999,3693,19,54,507,4312,9,155,88,170,164,258,1156,1898,4,9368,520,0,2,5,0,0
26884,254,5860,1482,859,1002,125,135,219,1607,16,219,134,251,235,385,1766,3032,9,27804,1544,1,2,5,0,0
26885,22,992,75,38,59,1,3,12,76,2,4,2,4,6,6,10,15,1,15,0,0,2,21,0,0
26886,177,7847,139,89,101,2,0,35,141,7,54,34,62,61,96,330,569,4,2287,127,0,2,2,0,0
26887,177,7847,7,5,5,0,0,2,7,1,2,1,2,3,3,2,4,0,2,0,0,2,2,0,0
26888,86,1955,53,23,39,0,0,13,53,2,8,4,8,10,12,26,39,1,39,2,0,2,7,4,0
26889,86,1955,515,298,307,33,80,99,548,12,63,44,77,75,121,419,753,7,5527,307,0,2,7,4,0
26890,23,1030,75,38,59,1,3,12,76,2,4,2,4,6,6,10,15,1,15,0,0,2,30,0,0
26891,313,6940,72,33,56,0,4,12,72,1,1,1,1,2,2,0,2,0,1,0,0,2,4,1,1
26892,313,6940,1454,835,1044,76,110,219,1530,17,275,158,296,292,454,2297,3718,9,34017,1889,1,2,4,1,1
26893,102,4762,1338,495,1086,10,64,173,1348,11,122,82,157,133,239,883,1686,7,11934,663,0,2,6,0,1
26894,313,6898,72,33,56,0,4,12,72,1,1,1,1,2,2,0,2,0,1,0,0,2,4,5,0
26895,313,6898,1454,835,1044,76,110,219,1530,17,275,158,296,292,454,2297,3718,9,34017,1889,1,2,4,5,0
26896,62,1231,1098,241,925,5,10,155,1103,7,46,25,49,53,74,273,423,3,1580,87,0,2,2,1,0
26897,62,1231,282,202,222,14,2,44,296,8,42,24,43,50,67,250,378,4,1548,86,0,2,2,1,0
26898,136,5770,1782,648,1425,9,47,279,1791,8,171,97,189,179,286,1292,2140,4,9462,525,0,2,2,6,0
26899,254,5857,4293,999,3693,19,54,507,4312,9,155,88,170,164,258,1156,1898,4,9368,520,0,2,3,5,0
26900,254,5857,1482,859,1002,125,135,219,1607,16,219,134,251,235,385,1766,3032,9,27804,1544,1,2,3,5,0
26901,86,1965,53,23,39,0,0,13,53,2,8,4,8,10,12,26,39,1,39,2,0,2,10,9,0
26902,86,1965,515,298,307,33,80,99,548,12,63,44,77,75,121,419,753,7,5527,307,0,2,10,9,0
26903,51,757,167,116,138,4,5,22,171,8,48,30,56,56,86,292,499,4,2330,129,0,2,3,6,1
26904,1,210,42,7,23,2,8,9,44,0,0,0,0,0,0,0,0,0,0,0,0,2,40,12,1
26905,254,5844,4293,999,3693,19,54,507,4312,9,155,88,170,164,258,1156,1898,4,9368,520,0,2,6,7,1
26906,254,5844,1482,859,1002,125,135,219,1607,16,219,134,251,235,385,1766,3032,9,27804,1544,1,2,6,7,1
26907,86,1952,53,23,39,0,0,13,53,2,8,4,8,10,12,26,39,1,39,2,0,2,2,10,1
26908,86,1952,515,298,307,33,80,99,548,12,63,44,77,75,121,419,753,7,5527,307,0,2,2,10,1
26909,30,654,215,129,180,6,0,29,221,8,65,43,72,73,115,415,711,4,3153,175,0,2,1,2,1
26910,30,654,97,69,77,3,3,16,100,6,22,13,23,28,36,113,173,3,542,30,0,2,1,2,1
26911,76,1736,996,429,845,24,10,117,1020,7,76,50,88,83,138,494,879,4,3565,198,0,2,6,3,0
26912,76,1736,456,277,329,12,42,72,468,13,85,50,97,98,147,592,972,7,7212,400,0,2,6,3,0
26913,44,3214,996,429,845,24,10,117,1020,7,76,50,88,83,138,494,879,4,3565,198,0,2,11,0,0
26914,177,7850,139,89,101,2,0,35,141,7,54,34,62,61,96,330,569,4,2287,127,0,2,18,14,1
26915,177,7850,7,5,5,0,0,2,7,1,2,1,2,3,3,2,4,0,2,0,0,2,18,14,1
26916,2,114,37,13,25,0,6,6,37,1,2,1,2,3,3,2,4,0,2,0,0,2,18,0,1
26917,2,114,133,47,40,1,43,49,134,0,0,0,0,0,0,0,0,0,0,0,0,2,18,0,1
26918,313,6905,72,33,56,0,4,12,72,1,1,1,1,2,2,0,2,0,1,0,0,2,10,5,0
26919,313,6905,1454,835,1044,76,110,219,1530,17,275,158,296,292,454,2297,3718,9,34017,1889,1,2,10,5,0
26920,139,6150,1782,648,1425,9,47,279,1791,8,171,97,189,179,286,1292,2140,4,9462,525,0,2,79,0,0
26921,51,757,167,116,138,4,5,22,171,8,48,30,56,56,86,292,499,4,2330,129,0,2,3,6,0
26922,254,5844,4293,999,3693,19,54,507,4312,9,155,88,170,164,258,1156,1898,4,9368,520,0,2,9,7,0
26923,254,5844,1482,859,1002,125,135,219,1607,16,219,134,251,235,385,1766,3032,9,27804,1544,1,2,9,7,0
26924,86,1952,53,23,39,0,0,13,53,2,8,4,8,10,12,26,39,1,39,2,0,2,8,9,0
26925,86,1952,515,298,307,33,80,99,548,12,63,44,77,75,121,419,753,7,5527,307,0,2,8,9,0
26926,313,6940,72,33,56,0,4,12,72,1,1,1,1,2,2,0,2,0,1,0,0,2,4,1,0
26927,313,6940,1454,835,1044,76,110,219,1530,17,275,158,296,292,454,2297,3718,9,34017,1889,1,2,4,1,0
26928,30,654,215,129,180,6,0,29,221,8,65,43,72,73,115,415,711,4,3153,175,0,2,1,2,0
26929,30,654,97,69,77,3,3,16,100,6,22,13,23,28,36,113,173,3,542,30,0,2,1,2,0
26930,2,114,37,13,25,0,6,6,37,1,2,1,2,3,3,2,4,0,2,0,0,2,18,0,0
26931,2,114,133,47,40,1,43,49,134,0,0,0,0,0,0,0,0,0,0,0,0,2,18,0,0
26932,23,1030,75,38,59,1,3,12,76,2,4,2,4,6,6,10,15,1,15,0,0,2,68,0,0
26933,102,4762,1338,495,1086,10,64,173,1348,11,122,82,157,133,239,883,1686,7,11934,663,0,2,6,0,0
26934,177,7847,139,89,101,2,0,35,141,7,54,34,62,61,96,330,569,4,2287,127,0,2,2,0,0
26935,177,7847,7,5,5,0,0,2,7,1,2,1,2,3,3,2,4,0,2,0,0,2,2,0,0
26936,76,1736,996,429,845,24,10,117,1020,7,76,50,88,83,138,494,879,4,3565,198,0,2,6,3,0
26937,76,1736,456,277,329,12,42,72,468,13,85,50,97,98,147,592,972,7,7212,400,0,2,6,3,0
26938,177,7850,139,89,101,2,0,35,141,7,54,34,62,61,96,330,569,4,2287,127,0,2,18,14,0
26939,177,7850,7,5,5,0,0,2,7,1,2,1,2,3,3,2,4,0,2,0,0,2,18,14,0
26940,44,3214,996,429,845,24,10,117,1020,7,76,50,88,83,138,494,879,4,3565,198,0,2,11,0,0
26941,24,607,2,2,2,0,0,0,2,0,0,0,0,0,0,0,0,0,0,0,0,2,2,2,0
26942,24,607,99,48,90,1,3,5,100,0,0,0,0,0,0,0,0,0,0,0,0,2,2,2,0
26943,24,607,8,5,5,2,0,1,10,0,0,0,0,0,0,0,0,0,0,0,0,2,2,2,0
26944,24,607,1217,716,841,84,126,174,1301,14,185,118,215,199,333,1446,2542,8,20687,1149,0,2,2,2,0
26945,24,607,160,89,115,0,13,31,160,7,15,11,17,22,28,78,124,3,495,27,0,2,2,2,0
26946,24,607,10,10,9,9,0,0,19,0,0,0,0,0,0,0,0,0,0,0,0,2,2,2,0
26947,24,607,173,84,99,8,29,36,181,5,12,7,13,17,20,54,81,2,221,12,0,2,2,2,0
26948,24,607,3,1,1,3,0,0,6,0,0,0,0,0,0,0,0,0,0,0,0,2,2,2,0
26949,88,1873,402,202,227,24,74,80,426,12,52,33,61,64,94,339,564,7,3969,220,0,2,8,0,0
26950,96,4196,1020,354,843,12,15,144,1032,8,134,77,144,142,221,970,1580,4,6792,377,0,2,37,2,0
26951,180,5401,1660,832,1314,41,38,274,1701,20,312,209,395,332,604,2671,5058,12,64042,3557,1,2,5,1,0
26952,180,5401,1057,646,719,113,100,145,1170,18,215,134,248,233,382,1740,3004,10,31186,1732,1,2,5,1,0
26953,162,4835,1660,832,1314,41,38,274,1701,20,312,209,395,332,604,2671,5058,12,64042,3557,1,2,24,0,0
26954,178,5362,1660,832,1314,41,38,274,1701,20,312,209,395,332,604,2671,5058,12,64042,3557,1,2,4,15,0
26955,178,5362,1057,646,719,113,100,145,1170,18,215,134,248,233,382,1740,3004,10,31186,1732,1,2,4,15,0
26956,67,1349,207,111,150,11,0,50,218,5,26,19,36,31,55,133,272,3,943,52,0,2,11,3,0
26957,67,1349,410,198,237,31,55,97,441,11,63,38,72,74,110,414,683,6,4293,238,0,2,11,3,0
26958,7,164,167,116,138,4,5,22,171,8,48,30,56,56,86,292,499,4,2330,129,0,2,37,2,0
26959,24,607,2,2,2,0,0,0,2,0,0,0,0,0,0,0,0,0,0,0,0,2,2,2,0
26960,24,607,99,48,90,1,3,5,100,0,0,0,0,0,0,0,0,0,0,0,0,2,2,2,0
26961,24,607,8,5,5,2,0,1,10,0,0,0,0,0,0,0,0,0,0,0,0,2,2,2,0
26962,24,607,1217,716,841,84,126,174,1301,14,185,118,215,199,333,1446,2542,8,20687,1149,0,2,2,2,0
26963,24,607,160,89,115,0,13,31,160,7,15,11,17,22,28,78,124,3,495,27,0,2,2,2,0
26964,24,607,10,10,9,9,0,0,19,0,0,0,0,0,0,0,0,0,0,0,0,2,2,2,0
26965,24,607,173,84,99,8,29,36,181,5,12,7,13,17,20,54,81,2,221,12,0,2,2,2,0
26966,24,607,3,1,1,3,0,0,6,0,0,0,0,0,0,0,0,0,0,0,0,2,2,2,0
26967,88,1873,402,202,227,24,74,80,426,12,52,33,61,64,94,339,564,7,3969,220,0,2,8,0,0
26968,96,4196,1020,354,843,12,15,144,1032,8,134,77,144,142,221,970,1580,4,6792,377,0,2,37,2,0
26969,88,2299,773,422,505,30,103,129,803,14,77,46,83,91,129,535,839,7,6334,351,0,2,26,15,0
26970,32,2102,1157,318,931,29,22,177,1186,6,104,63,125,110,188,712,1274,3,4596,255,0,2,20,0,0
26971,33,2202,1157,318,931,29,22,177,1186,6,104,63,125,110,188,712,1274,3,4596,255,0,2,38,0,0
26972,7,164,167,116,138,4,5,22,171,8,48,30,56,56,86,292,499,4,2330,129,0,2,4,0,0
26973,7,164,167,116,138,4,5,22,171,8,48,30,56,56,86,292,499,4,2330,129,0,2,1,1,0
26974,88,2299,773,422,505,30,103,129,803,14,77,46,83,91,129,535,839,7,6334,351,0,2,1,1,0
26975,85,2238,773,422,505,30,103,129,803,14,77,46,83,91,129,535,839,7,6334,351,0,2,1,1,0
26976,62,2790,1293,570,1093,25,15,163,1318,10,195,123,241,205,364,1516,2795,6,17273,959,0,2,18,0,0
26977,178,5362,1660,832,1314,41,38,274,1701,20,312,209,395,332,604,2671,5058,12,64042,3557,1,2,5,12,0
26978,178,5362,1057,646,719,113,100,145,1170,18,215,134,248,233,382,1740,3004,10,31186,1732,1,2,5,12,0
26979,67,1349,207,111,150,11,0,50,218,5,26,19,36,31,55,133,272,3,943,52,0,2,11,3,0
26980,67,1349,410,198,237,31,55,97,441,11,63,38,72,74,110,414,683,6,4293,238,0,2,11,3,0
26981,7,164,167,116,138,4,5,22,171,8,48,30,56,56,86,292,499,4,2330,129,0,2,41,2,0
26982,162,4835,1660,832,1314,41,38,274,1701,20,312,209,395,332,604,2671,5058,12,64042,3557,1,2,24,0,0
26983,88,2299,773,422,505,30,103,129,803,14,77,46,83,91,129,535,839,7,6334,351,0,2,26,15,0
26984,33,2202,1157,318,931,29,22,177,1186,6,104,63,125,110,188,712,1274,3,4596,255,0,2,58,0,0
26985,313,6905,72,33,56,0,4,12,72,1,1,1,1,2,2,0,2,0,1,0,0,2,10,5,0
26986,313,6905,1454,835,1044,76,110,219,1530,17,275,158,296,292,454,2297,3718,9,34017,1889,1,2,10,5,0
26987,139,6150,1782,648,1425,9,47,279,1791,8,171,97,189,179,286,1292,2140,4,9462,525,0,2,79,0,0
26988,85,2238,773,422,505,30,103,129,803,14,77,46,83,91,129,535,839,7,6334,351,0,2,1,1,0
26989,62,2790,1293,570,1093,25,15,163,1318,10,195,123,241,205,364,1516,2795,6,17273,959,0,2,18,0,0
26990,180,5384,1660,832,1314,41,38,274,1701,20,312,209,395,332,604,2671,5058,12,64042,3557,1,2,9,4,1
26991,180,5384,1057,646,719,113,100,145,1170,18,215,134,248,233,382,1740,3004,10,31186,1732,1,2,9,4,1
26992,165,4899,1660,832,1314,41,38,274,1701,20,312,209,395,332,604,2671,5058,12,64042,3557,1,2,17,1,1
26993,180,5384,1660,832,1314,41,38,274,1701,20,312,209,395,332,604,2671,5058,12,64042,3557,1,2,9,4,0
26994,180,5384,1057,646,719,113,100,145,1170,18,215,134,248,233,382,1740,3004,10,31186,1732,1,2,9,4,0
26995,165,4899,1660,832,1314,41,38,274,1701,20,312,209,395,332,604,2671,5058,12,64042,3557,1,2,17,1,0
26996,141,3284,77,34,69,0,0,8,77,3,24,16,29,27,45,114,213,1,387,21,0,2,4,3,0
26997,141,3284,712,438,573,51,9,84,763,14,102,71,128,116,199,733,1364,8,11988,666,0,2,4,3,0
26998,1,6,2,2,2,0,0,0,2,0,0,0,0,0,0,0,0,0,0,0,0,0,2,0,0
26999,1,6,2,2,2,0,0,0,2,0,0,0,0,0,0,0,0,0,0,0,0,0,2,0,0
27000,1,6,2,2,2,0,0,0,2,0,0,0,0,0,0,0,0,0,0,0,0,0,2,0,0
27001,1,6,2,2,2,0,0,0,2,0,0,0,0,0,0,0,0,0,0,0,0,0,2,0,0
27002,103,4779,1338,495,1086,10,64,173,1348,11,122,82,157,133,239,883,1686,7,11934,663,0,2,7,0,0
27003,141,3284,77,34,69,0,0,8,77,3,24,16,29,27,45,114,213,1,387,21,0,2,4,3,0
27004,141,3284,712,438,573,51,9,84,763,14,102,71,128,116,199,733,1364,8,11988,666,0,2,4,3,0
27005,1,6,2,2,2,0,0,0,2,0,0,0,0,0,0,0,0,0,0,0,0,0,2,0,0
27006,1,6,2,2,2,0,0,0,2,0,0,0,0,0,0,0,0,0,0,0,0,0,2,0,0
27007,1,6,2,2,2,0,0,0,2,0,0,0,0,0,0,0,0,0,0,0,0,0,2,0,0
27008,1,6,2,2,2,0,0,0,2,0,0,0,0,0,0,0,0,0,0,0,0,0,2,0,0
27009,103,4779,1338,495,1086,10,64,173,1348,11,122,82,157,133,239,883,1686,7,11934,663,0,2,7,0,0
27010,48,992,447,308,343,6,5,95,453,7,96,59,111,103,170,651,1136,4,4600,255,0,2,2,2,0
27011,48,992,322,174,179,16,74,51,338,10,41,26,46,51,72,252,408,5,2291,127,0,2,2,2,0
27012,48,992,447,308,343,6,5,95,453,7,96,59,111,103,170,651,1136,4,4600,255,0,2,2,2,0
27013,48,992,322,174,179,16,74,51,338,10,41,26,46,51,72,252,408,5,2291,127,0,2,2,2,0
27014,29,716,601,196,481,2,23,85,603,8,63,36,72,71,108,400,664,4,3036,168,0,2,5,7,0
27015,29,716,156,79,106,5,16,28,161,5,14,8,15,19,23,64,97,2,261,14,0,2,5,7,0
27016,40,1425,601,196,481,2,23,85,603,8,63,36,72,71,108,400,664,4,3036,168,0,2,22,4,0
27017,180,5384,1660,832,1314,41,38,274,1701,20,312,209,395,332,604,2671,5058,12,64042,3557,1,2,14,16,0
27018,180,5384,1057,646,719,113,100,145,1170,18,215,134,248,233,382,1740,3004,10,31186,1732,1,2,14,16,0
27019,76,1736,996,429,845,24,10,117,1020,7,76,50,88,83,138,494,879,4,3565,198,0,2,6,3,0
27020,76,1736,456,277,329,12,42,72,468,13,85,50,97,98,147,592,972,7,7212,400,0,2,6,3,0
27021,67,1349,207,111,150,11,0,50,218,5,26,19,36,31,55,133,272,3,943,52,0,2,11,3,0
27022,67,1349,410,198,237,31,55,97,441,11,63,38,72,74,110,414,683,6,4293,238,0,2,11,3,0
27023,88,2299,773,422,505,30,103,129,803,14,77,46,83,91,129,535,839,7,6334,351,0,2,1,1,0
27024,141,3284,77,34,69,0,0,8,77,3,24,16,29,27,45,114,213,1,387,21,0,2,4,3,0
27025,141,3284,712,438,573,51,9,84,763,14,102,71,128,116,199,733,1364,8,11988,666,0,2,4,3,0
27026,48,992,447,308,343,6,5,95,453,7,96,59,111,103,170,651,1136,4,4600,255,0,2,2,2,0
27027,48,992,322,174,179,16,74,51,338,10,41,26,46,51,72,252,408,5,2291,127,0,2,2,2,0
27028,7,164,167,116,138,4,5,22,171,8,48,30,56,56,86,292,499,4,2330,129,0,2,41,2,0
27029,313,6915,72,33,56,0,4,12,72,1,1,1,1,2,2,0,2,0,1,0,0,2,14,10,0
27030,313,6915,1454,835,1044,76,110,219,1530,17,275,158,296,292,454,2297,3718,9,34017,1889,1,2,14,10,0
27031,62,1231,1098,241,925,5,10,155,1103,7,46,25,49,53,74,273,423,3,1580,87,0,2,2,1,0
27032,62,1231,282,202,222,14,2,44,296,8,42,24,43,50,67,250,378,4,1548,86,0,2,2,1,0
27033,35,1079,182,127,129,0,0,53,182,5,39,21,42,44,63,217,343,2,926,51,0,2,8,2,0
27034,1,6,2,2,2,0,0,0,2,0,0,0,0,0,0,0,0,0,0,0,0,0,2,0,0
27035,1,6,2,2,2,0,0,0,2,0,0,0,0,0,0,0,0,0,0,0,0,0,2,0,0
27036,1,6,2,2,2,0,0,0,2,0,0,0,0,0,0,0,0,0,0,0,0,0,2,0,0
27037,1,6,2,2,2,0,0,0,2,0,0,0,0,0,0,0,0,0,0,0,0,0,2,0,0
27038,103,4797,1338,495,1086,10,64,173,1348,11,122,82,157,133,239,883,1686,7,11934,663,0,2,7,0,0
27039,177,7868,139,89,101,2,0,35,141,7,54,34,62,61,96,330,569,4,2287,127,0,2,18,14,0
27040,177,7868,7,5,5,0,0,2,7,1,2,1,2,3,3,2,4,0,2,0,0,2,18,14,0
27041,139,6150,1782,648,1425,9,47,279,1791,8,171,97,189,179,286,1292,2140,4,9462,525,0,2,81,6,0
27042,165,4899,1660,832,1314,41,38,274,1701,20,312,209,395,332,604,2671,5058,12,64042,3557,1,2,41,1,0
27043,44,3214,996,429,845,24,10,117,1020,7,76,50,88,83,138,494,879,4,3565,198,0,2,11,0,0
27044,62,2790,1293,570,1093,25,15,163,1318,10,195,123,241,205,364,1516,2795,6,17273,959,0,2,18,0,0
27045,29,716,601,196,481,2,23,85,603,8,63,36,72,71,108,400,664,4,3036,168,0,2,5,7,0
27046,29,716,156,79,106,5,16,28,161,5,14,8,15,19,23,64,97,2,261,14,0,2,5,7,0
27047,40,1425,601,196,481,2,23,85,603,8,63,36,72,71,108,400,664,4,3036,168,0,2,22,4,0
27048,180,5384,1660,832,1314,41,38,274,1701,20,312,209,395,332,604,2671,5058,12,64042,3557,1,2,14,16,0
27049,180,5384,1057,646,719,113,100,145,1170,18,215,134,248,233,382,1740,3004,10,31186,1732,1,2,14,16,0
27050,76,1736,996,429,845,24,10,117,1020,7,76,50,88,83,138,494,879,4,3565,198,0,2,6,3,0
27051,76,1736,456,277,329,12,42,72,468,13,85,50,97,98,147,592,972,7,7212,400,0,2,6,3,0
27052,67,1349,207,111,150,11,0,50,218,5,26,19,36,31,55,133,272,3,943,52,0,2,11,3,0
27053,67,1349,410,198,237,31,55,97,441,11,63,38,72,74,110,414,683,6,4293,238,0,2,11,3,0
27054,88,2299,773,422,505,30,103,129,803,14,77,46,83,91,129,535,839,7,6334,351,0,2,1,1,0
27055,141,3284,77,34,69,0,0,8,77,3,24,16,29,27,45,114,213,1,387,21,0,2,4,3,0
27056,141,3284,712,438,573,51,9,84,763,14,102,71,128,116,199,733,1364,8,11988,666,0,2,4,3,0
27057,48,992,447,308,343,6,5,95,453,7,96,59,111,103,170,651,1136,4,4600,255,0,2,2,2,0
27058,48,992,322,174,179,16,74,51,338,10,41,26,46,51,72,252,408,5,2291,127,0,2,2,2,0
27059,7,164,167,116,138,4,5,22,171,8,48,30,56,56,86,292,499,4,2330,129,0,2,41,2,0
27060,313,6915,72,33,56,0,4,12,72,1,1,1,1,2,2,0,2,0,1,0,0,2,14,10,0
27061,313,6915,1454,835,1044,76,110,219,1530,17,275,158,296,292,454,2297,3718,9,34017,1889,1,2,14,10,0
27062,62,1231,1098,241,925,5,10,155,1103,7,46,25,49,53,74,273,423,3,1580,87,0,2,2,1,0
27063,62,1231,282,202,222,14,2,44,296,8,42,24,43,50,67,250,378,4,1548,86,0,2,2,1,0
27064,35,1079,182,127,129,0,0,53,182,5,39,21,42,44,63,217,343,2,926,51,0,2,8,2,0
27065,1,6,2,2,2,0,0,0,2,0,0,0,0,0,0,0,0,0,0,0,0,0,2,0,0
27066,1,6,2,2,2,0,0,0,2,0,0,0,0,0,0,0,0,0,0,0,0,0,2,0,0
27067,1,6,2,2,2,0,0,0,2,0,0,0,0,0,0,0,0,0,0,0,0,0,2,0,0
27068,1,6,2,2,2,0,0,0,2,0,0,0,0,0,0,0,0,0,0,0,0,0,2,0,0
27069,103,4797,1338,495,1086,10,64,173,1348,11,122,82,157,133,239,883,1686,7,11934,663,0,2,7,0,0
27070,177,7868,139,89,101,2,0,35,141,7,54,34,62,61,96,330,569,4,2287,127,0,2,18,14,0
27071,177,7868,7,5,5,0,0,2,7,1,2,1,2,3,3,2,4,0,2,0,0,2,18,14,0
27072,139,6150,1782,648,1425,9,47,279,1791,8,171,97,189,179,286,1292,2140,4,9462,525,0,2,81,6,0
27073,165,4899,1660,832,1314,41,38,274,1701,20,312,209,395,332,604,2671,5058,12,64042,3557,1,2,41,1,0
27074,44,3214,996,429,845,24,10,117,1020,7,76,50,88,83,138,494,879,4,3565,198,0,2,11,0,0
27075,62,2790,1293,570,1093,25,15,163,1318,10,195,123,241,205,364,1516,2795,6,17273,959,0,2,18,0,0
27076,180,5387,1660,832,1314,41,38,274,1701,20,312,209,395,332,604,2671,5058,12,64042,3557,1,2,10,10,0
27077,180,5387,1057,646,719,113,100,145,1170,18,215,134,248,233,382,1740,3004,10,31186,1732,1,2,10,10,0
27078,166,4970,1660,832,1314,41,38,274,1701,20,312,209,395,332,604,2671,5058,12,64042,3557,1,2,42,0,0
27079,180,5387,1660,832,1314,41,38,274,1701,20,312,209,395,332,604,2671,5058,12,64042,3557,1,2,10,10,0
27080,180,5387,1057,646,719,113,100,145,1170,18,215,134,248,233,382,1740,3004,10,31186,1732,1,2,10,10,0
27081,166,4970,1660,832,1314,41,38,274,1701,20,312,209,395,332,604,2671,5058,12,64042,3557,1,2,42,0,0
27082,31,946,339,213,244,17,9,65,356,10,42,26,48,52,74,259,421,5,2410,133,0,2,0,16,1
27083,62,2798,1293,570,1093,25,15,163,1318,10,195,123,241,205,364,1516,2795,6,17273,959,0,2,7,1,1
27084,52,622,647,139,84,35,284,233,682,0,0,0,0,0,0,0,0,0,0,0,0,2,3,0,0
27085,223,4840,1943,715,1694,26,18,214,1969,12,185,120,237,197,357,1436,2721,7,20915,1161,0,2,4,3,0
27086,223,4840,1168,838,957,57,25,144,1225,19,348,224,416,367,640,3018,5452,11,61921,3440,1,2,4,3,0
27087,28,725,466,257,367,18,25,50,484,7,126,86,171,133,257,898,1813,4,8612,478,0,2,6,1,0
27088,28,725,507,281,342,29,59,88,536,10,53,29,57,63,86,336,514,5,2764,153,0,2,6,1,0
27089,28,707,466,257,367,18,25,50,484,7,126,86,171,133,257,898,1813,4,8612,478,0,2,1,6,0
27090,28,707,507,281,342,29,59,88,536,10,53,29,57,63,86,336,514,5,2764,153,0,2,1,6,0
27091,99,5070,1943,715,1694,26,18,214,1969,12,185,120,237,197,357,1436,2721,7,20915,1161,0,2,11,3,0
27092,20,893,75,38,59,1,3,12,76,2,4,2,4,6,6,10,15,1,15,0,0,2,4,13,0
27093,218,4705,2,2,2,0,0,0,2,0,0,0,0,0,0,0,0,0,0,0,0,2,6,1,0
27094,218,4705,99,48,90,1,3,5,100,0,0,0,0,0,0,0,0,0,0,0,0,2,6,1,0
27095,218,4705,8,5,5,2,0,1,10,0,0,0,0,0,0,0,0,0,0,0,0,2,6,1,0
27096,218,4705,1217,716,841,84,126,174,1301,14,185,118,215,199,333,1446,2542,8,20687,1149,0,2,6,1,0
27097,218,4705,160,89,115,0,13,31,160,7,15,11,17,22,28,78,124,3,495,27,0,2,6,1,0
27098,218,4705,10,10,9,9,0,0,19,0,0,0,0,0,0,0,0,0,0,0,0,2,6,1,0
27099,218,4705,173,84,99,8,29,36,181,5,12,7,13,17,20,54,81,2,221,12,0,2,6,1,0
27100,218,4705,3,1,1,3,0,0,6,0,0,0,0,0,0,0,0,0,0,0,0,2,6,1,0
27101,21,1042,75,38,59,1,3,12,76,2,4,2,4,6,6,10,15,1,15,0,0,2,29,1,0
27102,39,2322,652,304,544,16,6,88,668,6,89,51,101,95,152,591,998,3,3399,188,0,2,1,0,0
27103,223,4840,1943,715,1694,26,18,214,1969,12,185,120,237,197,357,1436,2721,7,20915,1161,0,2,4,3,0
27104,223,4840,1168,838,957,57,25,144,1225,19,348,224,416,367,640,3018,5452,11,61921,3440,1,2,4,3,0
27105,99,5070,1943,715,1694,26,18,214,1969,12,185,120,237,197,357,1436,2721,7,20915,1161,0,2,11,3,0
27106,28,707,466,257,367,18,25,50,484,7,126,86,171,133,257,898,1813,4,8612,478,0,2,2,2,0
27107,28,707,507,281,342,29,59,88,536,10,53,29,57,63,86,336,514,5,2764,153,0,2,2,2,0
27108,52,622,647,139,84,35,284,233,682,0,0,0,0,0,0,0,0,0,0,0,0,2,3,0,0
27109,218,4705,2,2,2,0,0,0,2,0,0,0,0,0,0,0,0,0,0,0,0,2,6,1,0
27110,218,4705,99,48,90,1,3,5,100,0,0,0,0,0,0,0,0,0,0,0,0,2,6,1,0
27111,218,4705,8,5,5,2,0,1,10,0,0,0,0,0,0,0,0,0,0,0,0,2,6,1,0
27112,218,4705,1217,716,841,84,126,174,1301,14,185,118,215,199,333,1446,2542,8,20687,1149,0,2,6,1,0
27113,218,4705,160,89,115,0,13,31,160,7,15,11,17,22,28,78,124,3,495,27,0,2,6,1,0
27114,218,4705,10,10,9,9,0,0,19,0,0,0,0,0,0,0,0,0,0,0,0,2,6,1,0
27115,218,4705,173,84,99,8,29,36,181,5,12,7,13,17,20,54,81,2,221,12,0,2,6,1,0
27116,218,4705,3,1,1,3,0,0,6,0,0,0,0,0,0,0,0,0,0,0,0,2,6,1,0
27117,21,1042,75,38,59,1,3,12,76,2,4,2,4,6,6,10,15,1,15,0,0,2,33,14,0
27118,39,2322,652,304,544,16,6,88,668,6,89,51,101,95,152,591,998,3,3399,188,0,2,1,0,0
27119,23,367,102,57,55,5,16,25,107,5,17,10,18,22,28,81,124,2,330,18,0,2,4,1,0
27120,92,4051,1020,354,843,12,15,144,1032,8,134,77,144,142,221,970,1580,4,6792,377,0,2,12,0,0
27121,23,367,102,57,55,5,16,25,107,5,17,10,18,22,28,81,124,2,330,18,0,2,4,1,0
27122,96,4133,1020,354,843,12,15,144,1032,8,134,77,144,142,221,970,1580,4,6792,377,0,2,12,0,0
27123,51,1046,447,308,343,6,5,95,453,7,96,59,111,103,170,651,1136,4,4600,255,0,2,14,0,0
27124,51,1046,322,174,179,16,74,51,338,10,41,26,46,51,72,252,408,5,2291,127,0,2,14,0,0
27125,41,1806,447,308,343,6,5,95,453,7,96,59,111,103,170,651,1136,4,4600,255,0,2,26,0,0
27126,91,2946,773,419,590,28,0,166,801,10,204,113,217,214,330,1598,2554,5,13587,754,0,2,1,1,0
27127,46,955,386,256,301,16,9,68,402,4,59,35,69,63,104,355,621,2,1453,80,0,2,2,0,0
27128,46,955,264,131,164,11,41,46,275,6,38,22,40,44,62,214,338,3,1068,59,0,2,2,0,0
27129,52,1071,447,308,343,6,5,95,453,7,96,59,111,103,170,651,1136,4,4600,255,0,2,9,1,1
27130,52,1071,322,174,179,16,74,51,338,10,41,26,46,51,72,252,408,5,2291,127,0,2,9,1,1
27131,95,3964,1289,550,1043,56,32,155,1345,10,167,93,185,177,278,1266,2075,5,11498,638,0,2,2,2,1
27132,44,3226,996,429,845,24,10,117,1020,7,76,50,88,83,138,494,879,4,3565,198,0,2,7,7,1
27133,95,4642,1523,757,1297,19,12,193,1542,12,193,117,230,205,347,1508,2664,7,19053,1058,0,2,1,1,1
27134,42,1899,447,308,343,6,5,95,453,7,96,59,111,103,170,651,1136,4,4600,255,0,2,20,7,1
27135,52,1071,447,308,343,6,5,95,453,7,96,59,111,103,170,651,1136,4,4600,255,0,2,23,1,0
27136,52,1071,322,174,179,16,74,51,338,10,41,26,46,51,72,252,408,5,2291,127,0,2,23,1,0
27137,46,955,386,256,301,16,9,68,402,4,59,35,69,63,104,355,621,2,1453,80,0,2,2,0,0
27138,46,955,264,131,164,11,41,46,275,6,38,22,40,44,62,214,338,3,1068,59,0,2,2,0,0
27139,95,3964,1289,550,1043,56,32,155,1345,10,167,93,185,177,278,1266,2075,5,11498,638,0,2,2,2,0
27140,91,2946,773,419,590,28,0,166,801,10,204,113,217,214,330,1598,2554,5,13587,754,0,2,1,1,0
27141,44,3226,996,429,845,24,10,117,1020,7,76,50,88,83,138,494,879,4,3565,198,0,2,7,7,0
27142,95,4642,1523,757,1297,19,12,193,1542,12,193,117,230,205,347,1508,2664,7,19053,1058,0,2,1,1,0
27143,42,1899,447,308,343,6,5,95,453,7,96,59,111,103,170,651,1136,4,4600,255,0,2,42,3,0
27144,180,5387,1660,832,1314,41,38,274,1701,20,312,209,395,332,604,2671,5058,12,64042,3557,1,2,10,10,0
27145,180,5387,1057,646,719,113,100,145,1170,18,215,134,248,233,382,1740,3004,10,31186,1732,1,2,10,10,0
27146,218,4705,2,2,2,0,0,0,2,0,0,0,0,0,0,0,0,0,0,0,0,2,6,1,0
27147,218,4705,99,48,90,1,3,5,100,0,0,0,0,0,0,0,0,0,0,0,0,2,6,1,0
27148,218,4705,8,5,5,2,0,1,10,0,0,0,0,0,0,0,0,0,0,0,0,2,6,1,0
27149,218,4705,1217,716,841,84,126,174,1301,14,185,118,215,199,333,1446,2542,8,20687,1149,0,2,6,1,0
27150,218,4705,160,89,115,0,13,31,160,7,15,11,17,22,28,78,124,3,495,27,0,2,6,1,0
27151,218,4705,10,10,9,9,0,0,19,0,0,0,0,0,0,0,0,0,0,0,0,2,6,1,0
27152,218,4705,173,84,99,8,29,36,181,5,12,7,13,17,20,54,81,2,221,12,0,2,6,1,0
27153,218,4705,3,1,1,3,0,0,6,0,0,0,0,0,0,0,0,0,0,0,0,2,6,1,0
27154,52,622,647,139,84,35,284,233,682,0,0,0,0,0,0,0,0,0,0,0,0,2,3,0,0
27155,23,367,102,57,55,5,16,25,107,5,17,10,18,22,28,81,124,2,330,18,0,2,4,1,0
27156,52,1071,447,308,343,6,5,95,453,7,96,59,111,103,170,651,1136,4,4600,255,0,2,23,1,0
27157,52,1071,322,174,179,16,74,51,338,10,41,26,46,51,72,252,408,5,2291,127,0,2,23,1,0
27158,46,955,386,256,301,16,9,68,402,4,59,35,69,63,104,355,621,2,1453,80,0,2,2,0,0
27159,46,955,264,131,164,11,41,46,275,6,38,22,40,44,62,214,338,3,1068,59,0,2,2,0,0
27160,28,707,466,257,367,18,25,50,484,7,126,86,171,133,257,898,1813,4,8612,478,0,2,2,2,0
27161,28,707,507,281,342,29,59,88,536,10,53,29,57,63,86,336,514,5,2764,153,0,2,2,2,0
27162,223,4840,1943,715,1694,26,18,214,1969,12,185,120,237,197,357,1436,2721,7,20915,1161,0,2,4,3,0
27163,223,4840,1168,838,957,57,25,144,1225,19,348,224,416,367,640,3018,5452,11,61921,3440,1,2,4,3,0
27164,95,3964,1289,550,1043,56,32,155,1345,10,167,93,185,177,278,1266,2075,5,11498,638,0,2,2,2,0
27165,91,2946,773,419,590,28,0,166,801,10,204,113,217,214,330,1598,2554,5,13587,754,0,2,1,1,0
27166,24,1145,75,38,59,1,3,12,76,2,4,2,4,6,6,10,15,1,15,0,0,2,33,14,0
27167,166,4970,1660,832,1314,41,38,274,1701,20,312,209,395,332,604,2671,5058,12,64042,3557,1,2,42,0,0
27168,44,3226,996,429,845,24,10,117,1020,7,76,50,88,83,138,494,879,4,3565,198,0,2,7,7,0
27169,39,2322,652,304,544,16,6,88,668,6,89,51,101,95,152,591,998,3,3399,188,0,2,1,0,0
27170,95,4642,1523,757,1297,19,12,193,1542,12,193,117,230,205,347,1508,2664,7,19053,1058,0,2,1,1,0
27171,97,4228,1020,354,843,12,15,144,1032,8,134,77,144,142,221,970,1580,4,6792,377,0,2,12,0,0
27172,42,1899,447,308,343,6,5,95,453,7,96,59,111,103,170,651,1136,4,4600,255,0,2,42,3,0
27173,99,5070,1943,715,1694,26,18,214,1969,12,185,120,237,197,357,1436,2721,7,20915,1161,0,2,11,3,0
27174,68,1571,773,419,590,28,0,166,801,10,204,113,217,214,330,1598,2554,5,13587,754,0,2,2,46,0
27175,68,1571,421,273,302,44,34,57,465,17,81,59,107,98,166,583,1098,11,12329,684,0,2,2,46,0
27176,91,2922,773,419,590,28,0,166,801,10,204,113,217,214,330,1598,2554,5,13587,754,0,2,9,15,0
27177,180,5387,1660,832,1314,41,38,274,1701,20,312,209,395,332,604,2671,5058,12,64042,3557,1,2,10,10,0
27178,180,5387,1057,646,719,113,100,145,1170,18,215,134,248,233,382,1740,3004,10,31186,1732,1,2,10,10,0
27179,218,4705,2,2,2,0,0,0,2,0,0,0,0,0,0,0,0,0,0,0,0,2,6,1,0
27180,218,4705,99,48,90,1,3,5,100,0,0,0,0,0,0,0,0,0,0,0,0,2,6,1,0
27181,218,4705,8,5,5,2,0,1,10,0,0,0,0,0,0,0,0,0,0,0,0,2,6,1,0
27182,218,4705,1217,716,841,84,126,174,1301,14,185,118,215,199,333,1446,2542,8,20687,1149,0,2,6,1,0
27183,218,4705,160,89,115,0,13,31,160,7,15,11,17,22,28,78,124,3,495,27,0,2,6,1,0
27184,218,4705,10,10,9,9,0,0,19,0,0,0,0,0,0,0,0,0,0,0,0,2,6,1,0
27185,218,4705,173,84,99,8,29,36,181,5,12,7,13,17,20,54,81,2,221,12,0,2,6,1,0
27186,218,4705,3,1,1,3,0,0,6,0,0,0,0,0,0,0,0,0,0,0,0,2,6,1,0
27187,52,622,647,139,84,35,284,233,682,0,0,0,0,0,0,0,0,0,0,0,0,2,3,0,0
27188,23,367,102,57,55,5,16,25,107,5,17,10,18,22,28,81,124,2,330,18,0,2,4,1,0
27189,52,1071,447,308,343,6,5,95,453,7,96,59,111,103,170,651,1136,4,4600,255,0,2,23,1,0
27190,52,1071,322,174,179,16,74,51,338,10,41,26,46,51,72,252,408,5,2291,127,0,2,23,1,0
27191,46,955,386,256,301,16,9,68,402,4,59,35,69,63,104,355,621,2,1453,80,0,2,2,0,0
27192,46,955,264,131,164,11,41,46,275,6,38,22,40,44,62,214,338,3,1068,59,0,2,2,0,0
27193,28,707,466,257,367,18,25,50,484,7,126,86,171,133,257,898,1813,4,8612,478,0,2,2,2,0
27194,28,707,507,281,342,29,59,88,536,10,53,29,57,63,86,336,514,5,2764,153,0,2,2,2,0
27195,223,4840,1943,715,1694,26,18,214,1969,12,185,120,237,197,357,1436,2721,7,20915,1161,0,2,4,3,0
27196,223,4840,1168,838,957,57,25,144,1225,19,348,224,416,367,640,3018,5452,11,61921,3440,1,2,4,3,0
27197,95,3964,1289,550,1043,56,32,155,1345,10,167,93,185,177,278,1266,2075,5,11498,638,0,2,2,2,0
27198,91,2946,773,419,590,28,0,166,801,10,204,113,217,214,330,1598,2554,5,13587,754,0,2,1,1,0
27199,24,1145,75,38,59,1,3,12,76,2,4,2,4,6,6,10,15,1,15,0,0,2,33,14,0
27200,166,4970,1660,832,1314,41,38,274,1701,20,312,209,395,332,604,2671,5058,12,64042,3557,1,2,42,0,0
27201,44,3226,996,429,845,24,10,117,1020,7,76,50,88,83,138,494,879,4,3565,198,0,2,7,7,0
27202,39,2322,652,304,544,16,6,88,668,6,89,51,101,95,152,591,998,3,3399,188,0,2,1,0,0
27203,95,4642,1523,757,1297,19,12,193,1542,12,193,117,230,205,347,1508,2664,7,19053,1058,0,2,1,1,0
27204,97,4228,1020,354,843,12,15,144,1032,8,134,77,144,142,221,970,1580,4,6792,377,0,2,12,0,0
27205,42,1899,447,308,343,6,5,95,453,7,96,59,111,103,170,651,1136,4,4600,255,0,2,42,3,0
27206,99,5070,1943,715,1694,26,18,214,1969,12,185,120,237,197,357,1436,2721,7,20915,1161,0,2,11,3,0
27207,90,2885,773,419,590,28,0,166,801,10,204,113,217,214,330,1598,2554,5,13587,754,0,2,2,10,0
27208,68,1561,773,419,590,28,0,166,801,10,204,113,217,214,330,1598,2554,5,13587,754,0,2,4,11,0
27209,68,1561,421,273,302,44,34,57,465,17,81,59,107,98,166,583,1098,11,12329,684,0,2,4,11,0
27210,254,5861,4293,999,3693,19,54,507,4312,9,155,88,170,164,258,1156,1898,4,9368,520,0,2,4,2,0
27211,254,5861,1482,859,1002,125,135,219,1607,16,219,134,251,235,385,1766,3032,9,27804,1544,1,2,4,2,0
27212,4,61,20,12,12,0,0,8,20,1,2,1,2,3,3,2,4,0,2,0,0,0,20,0,0
27213,178,7880,139,89,101,2,0,35,141,7,54,34,62,61,96,330,569,4,2287,127,0,2,6,0,0
27214,178,7880,7,5,5,0,0,2,7,1,2,1,2,3,3,2,4,0,2,0,0,2,6,0,0
27215,256,5900,4293,999,3693,19,54,507,4312,9,155,88,170,164,258,1156,1898,4,9368,520,0,2,18,3,0
27216,256,5900,1482,859,1002,125,135,219,1607,16,219,134,251,235,385,1766,3032,9,27804,1544,1,2,18,3,0
27217,2,51,14,9,9,0,0,5,14,0,0,0,0,0,0,0,0,0,0,0,0,0,13,0,0
27218,177,7850,139,89,101,2,0,35,141,7,54,34,62,61,96,330,569,4,2287,127,0,2,8,4,0
27219,177,7850,7,5,5,0,0,2,7,1,2,1,2,3,3,2,4,0,2,0,0,2,8,4,0
27220,51,1913,1098,241,925,5,10,155,1103,7,46,25,49,53,74,273,423,3,1580,87,0,2,12,0,0
27221,68,1561,773,419,590,28,0,166,801,10,204,113,217,214,330,1598,2554,5,13587,754,0,2,6,57,0
27222,68,1561,421,273,302,44,34,57,465,17,81,59,107,98,166,583,1098,11,12329,684,0,2,6,57,0
27223,90,2885,773,419,590,28,0,166,801,10,204,113,217,214,330,1598,2554,5,13587,754,0,2,9,23,0
27224,11,415,42,7,35,4,0,5,46,1,2,1,2,3,3,2,4,0,2,0,0,2,1,0,1
27225,11,415,11,6,10,0,0,1,11,2,4,2,4,6,6,10,15,1,15,0,0,2,1,0,1
27226,242,5716,722,423,573,19,0,135,741,12,172,101,199,184,300,1320,2257,6,15668,870,0,2,33,3,1
27227,242,5716,1508,847,911,44,250,301,1552,14,148,88,169,162,257,1120,1886,7,15077,837,0,2,33,3,1
27228,46,2172,722,423,573,19,0,135,741,12,172,101,199,184,300,1320,2257,6,15668,870,0,2,18,0,1
27229,242,5718,722,423,573,19,0,135,741,12,172,101,199,184,300,1320,2257,6,15668,870,0,2,1,1,0
27230,242,5718,1508,847,911,44,250,301,1552,14,148,88,169,162,257,1120,1886,7,15077,837,0,2,1,1,0
27231,254,5861,4293,999,3693,19,54,507,4312,9,155,88,170,164,258,1156,1898,4,9368,520,0,2,4,2,0
27232,254,5861,1482,859,1002,125,135,219,1607,16,219,134,251,235,385,1766,3032,9,27804,1544,1,2,4,2,0
27233,4,61,20,12,12,0,0,8,20,1,2,1,2,3,3,2,4,0,2,0,0,0,20,0,0
27234,178,7880,139,89,101,2,0,35,141,7,54,34,62,61,96,330,569,4,2287,127,0,2,6,0,0
27235,178,7880,7,5,5,0,0,2,7,1,2,1,2,3,3,2,4,0,2,0,0,2,6,0,0
27236,242,5718,722,423,573,19,0,135,741,12,172,101,199,184,300,1320,2257,6,15668,870,0,2,1,1,0
27237,242,5718,1508,847,911,44,250,301,1552,14,148,88,169,162,257,1120,1886,7,15077,837,0,2,1,1,0
27238,46,2170,722,423,573,19,0,135,741,12,172,101,199,184,300,1320,2257,6,15668,870,0,2,1,2,0
27239,11,413,42,7,35,4,0,5,46,1,2,1,2,3,3,2,4,0,2,0,0,2,0,1,0
27240,11,413,11,6,10,0,0,1,11,2,4,2,4,6,6,10,15,1,15,0,0,2,0,1,0
27241,242,5716,722,423,573,19,0,135,741,12,172,101,199,184,300,1320,2257,6,15668,870,0,2,2,3,0
27242,242,5716,1508,847,911,44,250,301,1552,14,148,88,169,162,257,1120,1886,7,15077,837,0,2,2,3,0
27243,242,5735,722,423,573,19,0,135,741,12,172,101,199,184,300,1320,2257,6,15668,870,0,2,8,2,0
27244,242,5735,1508,847,911,44,250,301,1552,14,148,88,169,162,257,1120,1886,7,15077,837,0,2,8,2,0
27245,243,5749,722,423,573,19,0,135,741,12,172,101,199,184,300,1320,2257,6,15668,870,0,2,11,6,0
27246,243,5749,1508,847,911,44,250,301,1552,14,148,88,169,162,257,1120,1886,7,15077,837,0,2,11,6,0
27247,243,5757,722,423,573,19,0,135,741,12,172,101,199,184,300,1320,2257,6,15668,870,0,2,3,1,1
27248,243,5757,1508,847,911,44,250,301,1552,14,148,88,169,162,257,1120,1886,7,15077,837,0,2,3,1,1
27249,47,2227,722,423,573,19,0,135,741,12,172,101,199,184,300,1320,2257,6,15668,870,0,2,13,0,1
27250,47,2225,722,423,573,19,0,135,741,12,172,101,199,184,300,1320,2257,6,15668,870,0,2,1,1,0
27251,242,5792,722,423,573,19,0,135,741,12,172,101,199,184,300,1320,2257,6,15668,870,0,2,21,14,0
27252,242,5792,1508,847,911,44,250,301,1552,14,148,88,169,162,257,1120,1886,7,15077,837,0,2,21,14,0
27253,241,5777,722,423,573,19,0,135,741,12,172,101,199,184,300,1320,2257,6,15668,870,0,2,1,6,0
27254,241,5777,1508,847,911,44,250,301,1552,14,148,88,169,162,257,1120,1886,7,15077,837,0,2,1,6,0
27255,243,5819,722,423,573,19,0,135,741,12,172,101,199,184,300,1320,2257,6,15668,870,0,2,12,2,1
27256,243,5819,1508,847,911,44,250,301,1552,14,148,88,169,162,257,1120,1886,7,15077,837,0,2,12,2,1
27257,243,5819,722,423,573,19,0,135,741,12,172,101,199,184,300,1320,2257,6,15668,870,0,2,0,1,0
27258,243,5819,1508,847,911,44,250,301,1552,14,148,88,169,162,257,1120,1886,7,15077,837,0,2,0,1,0
27259,244,5784,722,423,573,19,0,135,741,12,172,101,199,184,300,1320,2257,6,15668,870,0,2,14,21,0
27260,244,5784,1508,847,911,44,250,301,1552,14,148,88,169,162,257,1120,1886,7,15077,837,0,2,14,21,0
27261,244,5775,722,423,573,19,0,135,741,12,172,101,199,184,300,1320,2257,6,15668,870,0,2,1,4,1
27262,244,5775,1508,847,911,44,250,301,1552,14,148,88,169,162,257,1120,1886,7,15077,837,0,2,1,4,1
27263,47,2225,722,423,573,19,0,135,741,12,172,101,199,184,300,1320,2257,6,15668,870,0,2,1,1,0
27264,244,5775,722,423,573,19,0,135,741,12,172,101,199,184,300,1320,2257,6,15668,870,0,2,8,0,0
27265,244,5775,1508,847,911,44,250,301,1552,14,148,88,169,162,257,1120,1886,7,15077,837,0,2,8,0,0
27266,244,5770,722,423,573,19,0,135,741,12,172,101,199,184,300,1320,2257,6,15668,870,0,2,1,2,0
27267,244,5770,1508,847,911,44,250,301,1552,14,148,88,169,162,257,1120,1886,7,15077,837,0,2,1,2,0
27268,256,5920,4293,999,3693,19,54,507,4312,9,155,88,170,164,258,1156,1898,4,9368,520,0,2,18,3,0
27269,256,5920,1482,859,1002,125,135,219,1607,16,219,134,251,235,385,1766,3032,9,27804,1544,1,2,18,3,0
27270,2,51,14,9,9,0,0,5,14,0,0,0,0,0,0,0,0,0,0,0,0,0,13,0,0
27271,178,7880,139,89,101,2,0,35,141,7,54,34,62,61,96,330,569,4,2287,127,0,2,8,4,0
27272,178,7880,7,5,5,0,0,2,7,1,2,1,2,3,3,2,4,0,2,0,0,2,8,4,0
27273,51,1913,1098,241,925,5,10,155,1103,7,46,25,49,53,74,273,423,3,1580,87,0,2,12,0,0
27274,244,5779,722,423,573,19,0,135,741,12,172,101,199,184,300,1320,2257,6,15668,870,0,2,6,0,0
27275,244,5779,1508,847,911,44,250,301,1552,14,148,88,169,162,257,1120,1886,7,15077,837,0,2,6,0,0
27276,47,2225,722,423,573,19,0,135,741,12,172,101,199,184,300,1320,2257,6,15668,870,0,2,1,1,0
27277,244,5779,722,423,573,19,0,135,741,12,172,101,199,184,300,1320,2257,6,15668,870,0,2,59,3,0
27278,244,5779,1508,847,911,44,250,301,1552,14,148,88,169,162,257,1120,1886,7,15077,837,0,2,59,3,0
27279,47,2225,722,423,573,19,0,135,741,12,172,101,199,184,300,1320,2257,6,15668,870,0,2,30,0,0
27280,92,1945,1043,504,840,53,9,147,1096,9,180,112,198,189,310,1377,2344,4,11604,644,0,2,3,0,0
27281,92,1945,383,288,292,26,6,62,409,11,65,38,67,76,105,429,656,5,3719,206,0,2,3,0,0
27282,101,4044,1289,550,1043,56,32,155,1345,10,167,93,185,177,278,1266,2075,5,11498,638,0,2,23,9,0
27283,3,42,14,8,8,0,0,6,14,0,0,0,0,0,0,0,0,0,0,0,0,2,0,1,1
27284,60,1079,282,196,195,3,0,86,285,8,130,71,141,138,212,936,1507,4,6538,363,0,2,3,3,1
27285,1,9,5,3,3,0,0,2,5,0,0,0,0,0,0,0,0,0,0,0,0,2,0,1,1
27286,1,90,13,10,10,0,0,3,13,1,2,1,2,3,3,2,4,0,2,0,0,2,0,1,1
27287,3,66,127,75,83,2,11,30,129,4,14,7,14,18,21,61,87,2,175,9,0,2,0,1,1
27288,3,66,652,304,544,16,6,88,668,6,89,51,101,95,152,591,998,3,3399,188,0,2,0,1,1
27289,3,66,2,2,2,0,0,0,2,0,0,0,0,0,0,0,0,0,0,0,0,2,0,1,1
27290,3,66,8,5,5,0,0,3,8,0,0,0,0,0,0,0,0,0,0,0,0,2,0,1,1
27291,3,66,2,2,2,0,0,0,2,0,0,0,0,0,0,0,0,0,0,0,0,2,0,1,1
27292,3,66,14,8,8,0,0,6,14,0,0,0,0,0,0,0,0,0,0,0,0,2,0,1,1
27293,3,66,6,4,4,0,0,2,6,0,0,0,0,0,0,0,0,0,0,0,0,2,0,1,1
27294,3,66,6,4,4,0,0,2,6,1,2,1,2,3,3,2,4,0,2,0,0,2,0,1,1
27295,3,66,6,4,4,0,0,2,6,0,0,0,0,0,0,0,0,0,0,0,0,2,0,1,1
27296,3,66,7,5,5,0,0,2,7,0,0,0,0,0,0,0,0,0,0,0,0,2,0,1,1
27297,3,66,6,4,4,0,0,2,6,0,0,0,0,0,0,0,0,0,0,0,0,2,0,1,1
27298,3,66,10,6,6,0,0,4,10,0,0,0,0,0,0,0,0,0,0,0,0,2,0,1,1
27299,3,66,1,1,1,0,0,0,1,0,0,0,0,0,0,0,0,0,0,0,0,2,0,1,1
27300,3,66,1,1,1,0,0,0,1,0,0,0,0,0,0,0,0,0,0,0,0,2,0,1,1
27301,3,66,14,10,10,0,0,4,14,1,1,1,1,2,2,0,2,0,1,0,0,2,0,1,1
27302,3,66,46,26,30,3,0,12,49,3,6,3,6,9,9,20,28,1,42,2,0,2,0,1,1
27303,11,238,19,8,11,5,0,4,24,2,5,3,6,7,9,13,25,1,30,1,0,2,0,1,1
27304,11,238,102,59,69,5,3,24,107,6,22,15,28,28,43,113,206,3,789,43,0,2,0,1,1
27305,11,238,106,40,36,3,49,17,109,8,17,13,23,25,36,93,167,5,904,50,0,2,0,1,1
27306,218,4706,2,2,2,0,0,0,2,0,0,0,0,0,0,0,0,0,0,0,0,2,1,1,1
27307,218,4706,99,48,90,1,3,5,100,0,0,0,0,0,0,0,0,0,0,0,0,2,1,1,1
27308,218,4706,8,5,5,2,0,1,10,0,0,0,0,0,0,0,0,0,0,0,0,2,1,1,1
27309,218,4706,1217,716,841,84,126,174,1301,14,185,118,215,199,333,1446,2542,8,20687,1149,0,2,1,1,1
27310,218,4706,160,89,115,0,13,31,160,7,15,11,17,22,28,78,124,3,495,27,0,2,1,1,1
27311,218,4706,10,10,9,9,0,0,19,0,0,0,0,0,0,0,0,0,0,0,0,2,1,1,1
27312,218,4706,173,84,99,8,29,36,181,5,12,7,13,17,20,54,81,2,221,12,0,2,1,1,1
27313,218,4706,3,1,1,3,0,0,6,0,0,0,0,0,0,0,0,0,0,0,0,2,1,1,1
27314,98,2660,1523,757,1297,19,12,193,1542,12,193,117,230,205,347,1508,2664,7,19053,1058,0,2,1,1,1
27315,98,2660,701,378,504,33,58,109,734,13,110,68,126,123,194,794,1346,7,10027,557,0,2,1,1,1
27316,85,2240,773,422,505,30,103,129,803,14,77,46,83,91,129,535,839,7,6334,351,0,2,3,1,1
27317,30,660,125,97,103,3,0,19,128,9,25,17,27,34,44,144,223,4,1087,60,0,2,4,1,1
27318,1,20,127,75,83,2,11,30,129,4,14,7,14,18,21,61,87,2,175,9,0,2,0,1,1
27319,1,20,652,304,544,16,6,88,668,6,89,51,101,95,152,591,998,3,3399,188,0,2,0,1,1
27320,1,20,2,2,2,0,0,0,2,0,0,0,0,0,0,0,0,0,0,0,0,2,0,1,1
27321,1,20,8,5,5,0,0,3,8,0,0,0,0,0,0,0,0,0,0,0,0,2,0,1,1
27322,1,20,2,2,2,0,0,0,2,0,0,0,0,0,0,0,0,0,0,0,0,2,0,1,1
27323,1,20,14,8,8,0,0,6,14,0,0,0,0,0,0,0,0,0,0,0,0,2,0,1,1
27324,1,20,6,4,4,0,0,2,6,0,0,0,0,0,0,0,0,0,0,0,0,2,0,1,1
27325,1,20,6,4,4,0,0,2,6,1,2,1,2,3,3,2,4,0,2,0,0,2,0,1,1
27326,1,20,6,4,4,0,0,2,6,0,0,0,0,0,0,0,0,0,0,0,0,2,0,1,1
27327,1,20,7,5,5,0,0,2,7,0,0,0,0,0,0,0,0,0,0,0,0,2,0,1,1
27328,1,20,6,4,4,0,0,2,6,0,0,0,0,0,0,0,0,0,0,0,0,2,0,1,1
27329,1,20,10,6,6,0,0,4,10,0,0,0,0,0,0,0,0,0,0,0,0,2,0,1,1
27330,1,20,1,1,1,0,0,0,1,0,0,0,0,0,0,0,0,0,0,0,0,2,0,1,1
27331,1,20,1,1,1,0,0,0,1,0,0,0,0,0,0,0,0,0,0,0,0,2,0,1,1
27332,1,20,14,10,10,0,0,4,14,1,1,1,1,2,2,0,2,0,1,0,0,2,0,1,1
27333,1,20,46,26,30,3,0,12,49,3,6,3,6,9,9,20,28,1,42,2,0,2,0,1,1
27334,3,39,15,9,9,0,0,6,15,0,0,0,0,0,0,0,0,0,0,0,0,2,0,1,1
27335,2,36,10,7,7,0,0,3,10,1,2,1,2,3,3,2,4,0,2,0,0,2,0,1,1
27336,8,263,51,25,36,0,0,15,51,3,11,6,12,14,18,42,68,1,112,6,0,2,0,1,1
27337,63,4331,520,294,400,33,13,81,553,10,261,204,367,271,571,2128,4614,7,32445,1802,1,2,9,9,1
27338,44,2109,722,423,573,19,0,135,741,12,172,101,199,184,300,1320,2257,6,15668,870,0,2,1,1,1
27339,85,2238,773,422,505,30,103,129,803,14,77,46,83,91,129,535,839,7,6334,351,0,2,2,3,1
27340,151,7095,1392,870,1177,35,17,170,1427,14,494,280,531,508,811,4473,7289,7,54850,3047,2,2,26,26,1
27341,15,703,139,89,101,2,0,35,141,7,54,34,62,61,96,330,569,4,2287,127,0,2,1,1,1
27342,151,7095,1392,870,1177,35,17,170,1427,14,494,280,531,508,811,4473,7289,7,54850,3047,2,2,2,2,0
27343,151,7095,1392,870,1177,35,17,170,1427,14,494,280,531,508,811,4473,7289,7,54850,3047,2,2,1,1,0
27344,151,7095,1392,870,1177,35,17,170,1427,14,494,280,531,508,811,4473,7289,7,54850,3047,2,2,26,26,0
27345,15,703,139,89,101,2,0,35,141,7,54,34,62,61,96,330,569,4,2287,127,0,2,1,1,0
27346,47,2228,722,423,573,19,0,135,741,12,172,101,199,184,300,1320,2257,6,15668,870,0,2,4,2,0
27347,3,42,14,8,8,0,0,6,14,0,0,0,0,0,0,0,0,0,0,0,0,2,0,1,0
27348,60,1079,282,196,195,3,0,86,285,8,130,71,141,138,212,936,1507,4,6538,363,0,2,3,3,0
27349,1,9,5,3,3,0,0,2,5,0,0,0,0,0,0,0,0,0,0,0,0,2,0,1,0
27350,1,90,13,10,10,0,0,3,13,1,2,1,2,3,3,2,4,0,2,0,0,2,0,1,0
27351,3,66,127,75,83,2,11,30,129,4,14,7,14,18,21,61,87,2,175,9,0,2,0,1,0
27352,3,66,652,304,544,16,6,88,668,6,89,51,101,95,152,591,998,3,3399,188,0,2,0,1,0
27353,3,66,2,2,2,0,0,0,2,0,0,0,0,0,0,0,0,0,0,0,0,2,0,1,0
27354,3,66,8,5,5,0,0,3,8,0,0,0,0,0,0,0,0,0,0,0,0,2,0,1,0
27355,3,66,2,2,2,0,0,0,2,0,0,0,0,0,0,0,0,0,0,0,0,2,0,1,0
27356,3,66,14,8,8,0,0,6,14,0,0,0,0,0,0,0,0,0,0,0,0,2,0,1,0
27357,3,66,6,4,4,0,0,2,6,0,0,0,0,0,0,0,0,0,0,0,0,2,0,1,0
27358,3,66,6,4,4,0,0,2,6,1,2,1,2,3,3,2,4,0,2,0,0,2,0,1,0
27359,3,66,6,4,4,0,0,2,6,0,0,0,0,0,0,0,0,0,0,0,0,2,0,1,0
27360,3,66,7,5,5,0,0,2,7,0,0,0,0,0,0,0,0,0,0,0,0,2,0,1,0
27361,3,66,6,4,4,0,0,2,6,0,0,0,0,0,0,0,0,0,0,0,0,2,0,1,0
27362,3,66,10,6,6,0,0,4,10,0,0,0,0,0,0,0,0,0,0,0,0,2,0,1,0
27363,3,66,1,1,1,0,0,0,1,0,0,0,0,0,0,0,0,0,0,0,0,2,0,1,0
27364,3,66,1,1,1,0,0,0,1,0,0,0,0,0,0,0,0,0,0,0,0,2,0,1,0
27365,3,66,14,10,10,0,0,4,14,1,1,1,1,2,2,0,2,0,1,0,0,2,0,1,0
27366,3,66,46,26,30,3,0,12,49,3,6,3,6,9,9,20,28,1,42,2,0,2,0,1,0
27367,11,238,19,8,11,5,0,4,24,2,5,3,6,7,9,13,25,1,30,1,0,2,0,1,0
27368,11,238,102,59,69,5,3,24,107,6,22,15,28,28,43,113,206,3,789,43,0,2,0,1,0
27369,11,238,106,40,36,3,49,17,109,8,17,13,23,25,36,93,167,5,904,50,0,2,0,1,0
27370,218,4706,2,2,2,0,0,0,2,0,0,0,0,0,0,0,0,0,0,0,0,2,1,1,0
27371,218,4706,99,48,90,1,3,5,100,0,0,0,0,0,0,0,0,0,0,0,0,2,1,1,0
27372,218,4706,8,5,5,2,0,1,10,0,0,0,0,0,0,0,0,0,0,0,0,2,1,1,0
27373,218,4706,1217,716,841,84,126,174,1301,14,185,118,215,199,333,1446,2542,8,20687,1149,0,2,1,1,0
27374,218,4706,160,89,115,0,13,31,160,7,15,11,17,22,28,78,124,3,495,27,0,2,1,1,0
27375,218,4706,10,10,9,9,0,0,19,0,0,0,0,0,0,0,0,0,0,0,0,2,1,1,0
27376,218,4706,173,84,99,8,29,36,181,5,12,7,13,17,20,54,81,2,221,12,0,2,1,1,0
27377,218,4706,3,1,1,3,0,0,6,0,0,0,0,0,0,0,0,0,0,0,0,2,1,1,0
27378,98,2660,1523,757,1297,19,12,193,1542,12,193,117,230,205,347,1508,2664,7,19053,1058,0,2,1,1,0
27379,98,2660,701,378,504,33,58,109,734,13,110,68,126,123,194,794,1346,7,10027,557,0,2,1,1,0
27380,85,2238,773,422,505,30,103,129,803,14,77,46,83,91,129,535,839,7,6334,351,0,2,2,1,0
27381,30,660,125,97,103,3,0,19,128,9,25,17,27,34,44,144,223,4,1087,60,0,2,4,1,0
27382,1,20,127,75,83,2,11,30,129,4,14,7,14,18,21,61,87,2,175,9,0,2,0,1,0
27383,1,20,652,304,544,16,6,88,668,6,89,51,101,95,152,591,998,3,3399,188,0,2,0,1,0
27384,1,20,2,2,2,0,0,0,2,0,0,0,0,0,0,0,0,0,0,0,0,2,0,1,0
27385,1,20,8,5,5,0,0,3,8,0,0,0,0,0,0,0,0,0,0,0,0,2,0,1,0
27386,1,20,2,2,2,0,0,0,2,0,0,0,0,0,0,0,0,0,0,0,0,2,0,1,0
27387,1,20,14,8,8,0,0,6,14,0,0,0,0,0,0,0,0,0,0,0,0,2,0,1,0
27388,1,20,6,4,4,0,0,2,6,0,0,0,0,0,0,0,0,0,0,0,0,2,0,1,0
27389,1,20,6,4,4,0,0,2,6,1,2,1,2,3,3,2,4,0,2,0,0,2,0,1,0
27390,1,20,6,4,4,0,0,2,6,0,0,0,0,0,0,0,0,0,0,0,0,2,0,1,0
27391,1,20,7,5,5,0,0,2,7,0,0,0,0,0,0,0,0,0,0,0,0,2,0,1,0
27392,1,20,6,4,4,0,0,2,6,0,0,0,0,0,0,0,0,0,0,0,0,2,0,1,0
27393,1,20,10,6,6,0,0,4,10,0,0,0,0,0,0,0,0,0,0,0,0,2,0,1,0
27394,1,20,1,1,1,0,0,0,1,0,0,0,0,0,0,0,0,0,0,0,0,2,0,1,0
27395,1,20,1,1,1,0,0,0,1,0,0,0,0,0,0,0,0,0,0,0,0,2,0,1,0
27396,1,20,14,10,10,0,0,4,14,1,1,1,1,2,2,0,2,0,1,0,0,2,0,1,0
27397,1,20,46,26,30,3,0,12,49,3,6,3,6,9,9,20,28,1,42,2,0,2,0,1,0
27398,3,39,15,9,9,0,0,6,15,0,0,0,0,0,0,0,0,0,0,0,0,2,0,1,0
27399,2,36,10,7,7,0,0,3,10,1,2,1,2,3,3,2,4,0,2,0,0,2,0,1,0
27400,8,263,51,25,36,0,0,15,51,3,11,6,12,14,18,42,68,1,112,6,0,2,0,1,0
27401,63,4331,520,294,400,33,13,81,553,10,261,204,367,271,571,2128,4614,7,32445,1802,1,2,9,9,0
27402,44,2109,722,423,573,19,0,135,741,12,172,101,199,184,300,1320,2257,6,15668,870,0,2,1,1,0
27403,47,2228,722,423,573,19,0,135,741,12,172,101,199,184,300,1320,2257,6,15668,870,0,2,4,2,0
27404,218,4705,2,2,2,0,0,0,2,0,0,0,0,0,0,0,0,0,0,0,0,2,1,1,0
27405,218,4705,99,48,90,1,3,5,100,0,0,0,0,0,0,0,0,0,0,0,0,2,1,1,0
27406,218,4705,8,5,5,2,0,1,10,0,0,0,0,0,0,0,0,0,0,0,0,2,1,1,0
27407,218,4705,1217,716,841,84,126,174,1301,14,185,118,215,199,333,1446,2542,8,20687,1149,0,2,1,1,0
27408,218,4705,160,89,115,0,13,31,160,7,15,11,17,22,28,78,124,3,495,27,0,2,1,1,0
27409,218,4705,10,10,9,9,0,0,19,0,0,0,0,0,0,0,0,0,0,0,0,2,1,1,0
27410,218,4705,173,84,99,8,29,36,181,5,12,7,13,17,20,54,81,2,221,12,0,2,1,1,0
27411,218,4705,3,1,1,3,0,0,6,0,0,0,0,0,0,0,0,0,0,0,0,2,1,1,0
27412,218,4705,2,2,2,0,0,0,2,0,0,0,0,0,0,0,0,0,0,0,0,2,1,1,0
27413,218,4705,99,48,90,1,3,5,100,0,0,0,0,0,0,0,0,0,0,0,0,2,1,1,0
27414,218,4705,8,5,5,2,0,1,10,0,0,0,0,0,0,0,0,0,0,0,0,2,1,1,0
27415,218,4705,1217,716,841,84,126,174,1301,14,185,118,215,199,333,1446,2542,8,20687,1149,0,2,1,1,0
27416,218,4705,160,89,115,0,13,31,160,7,15,11,17,22,28,78,124,3,495,27,0,2,1,1,0
27417,218,4705,10,10,9,9,0,0,19,0,0,0,0,0,0,0,0,0,0,0,0,2,1,1,0
27418,218,4705,173,84,99,8,29,36,181,5,12,7,13,17,20,54,81,2,221,12,0,2,1,1,0
27419,218,4705,3,1,1,3,0,0,6,0,0,0,0,0,0,0,0,0,0,0,0,2,1,1,0
27420,3,42,14,8,8,0,0,6,14,0,0,0,0,0,0,0,0,0,0,0,0,2,0,1,0
27421,60,1079,282,196,195,3,0,86,285,8,130,71,141,138,212,936,1507,4,6538,363,0,2,3,3,0
27422,1,9,5,3,3,0,0,2,5,0,0,0,0,0,0,0,0,0,0,0,0,2,0,1,0
27423,1,90,13,10,10,0,0,3,13,1,2,1,2,3,3,2,4,0,2,0,0,2,0,1,0
27424,3,66,127,75,83,2,11,30,129,4,14,7,14,18,21,61,87,2,175,9,0,2,0,1,0
27425,3,66,652,304,544,16,6,88,668,6,89,51,101,95,152,591,998,3,3399,188,0,2,0,1,0
27426,3,66,2,2,2,0,0,0,2,0,0,0,0,0,0,0,0,0,0,0,0,2,0,1,0
27427,3,66,8,5,5,0,0,3,8,0,0,0,0,0,0,0,0,0,0,0,0,2,0,1,0
27428,3,66,2,2,2,0,0,0,2,0,0,0,0,0,0,0,0,0,0,0,0,2,0,1,0
27429,3,66,14,8,8,0,0,6,14,0,0,0,0,0,0,0,0,0,0,0,0,2,0,1,0
27430,3,66,6,4,4,0,0,2,6,0,0,0,0,0,0,0,0,0,0,0,0,2,0,1,0
27431,3,66,6,4,4,0,0,2,6,1,2,1,2,3,3,2,4,0,2,0,0,2,0,1,0
27432,3,66,6,4,4,0,0,2,6,0,0,0,0,0,0,0,0,0,0,0,0,2,0,1,0
27433,3,66,7,5,5,0,0,2,7,0,0,0,0,0,0,0,0,0,0,0,0,2,0,1,0
27434,3,66,6,4,4,0,0,2,6,0,0,0,0,0,0,0,0,0,0,0,0,2,0,1,0
27435,3,66,10,6,6,0,0,4,10,0,0,0,0,0,0,0,0,0,0,0,0,2,0,1,0
27436,3,66,1,1,1,0,0,0,1,0,0,0,0,0,0,0,0,0,0,0,0,2,0,1,0
27437,3,66,1,1,1,0,0,0,1,0,0,0,0,0,0,0,0,0,0,0,0,2,0,1,0
27438,3,66,14,10,10,0,0,4,14,1,1,1,1,2,2,0,2,0,1,0,0,2,0,1,0
27439,3,66,46,26,30,3,0,12,49,3,6,3,6,9,9,20,28,1,42,2,0,2,0,1,0
27440,11,238,19,8,11,5,0,4,24,2,5,3,6,7,9,13,25,1,30,1,0,2,0,1,0
27441,11,238,102,59,69,5,3,24,107,6,22,15,28,28,43,113,206,3,789,43,0,2,0,1,0
27442,11,238,106,40,36,3,49,17,109,8,17,13,23,25,36,93,167,5,904,50,0,2,0,1,0
27443,68,1561,773,419,590,28,0,166,801,10,204,113,217,214,330,1598,2554,5,13587,754,0,2,6,57,0
27444,68,1561,421,273,302,44,34,57,465,17,81,59,107,98,166,583,1098,11,12329,684,0,2,6,57,0
27445,256,5923,4293,999,3693,19,54,507,4312,9,155,88,170,164,258,1156,1898,4,9368,520,0,2,22,5,0
27446,256,5923,1482,859,1002,125,135,219,1607,16,219,134,251,235,385,1766,3032,9,27804,1544,1,2,22,5,0
27447,98,2660,1523,757,1297,19,12,193,1542,12,193,117,230,205,347,1508,2664,7,19053,1058,0,2,1,1,0
27448,98,2660,701,378,504,33,58,109,734,13,110,68,126,123,194,794,1346,7,10027,557,0,2,1,1,0
27449,88,2299,773,422,505,30,103,129,803,14,77,46,83,91,129,535,839,7,6334,351,0,2,2,1,0
27450,30,660,125,97,103,3,0,19,128,9,25,17,27,34,44,144,223,4,1087,60,0,2,4,1,0
27451,151,7095,1392,870,1177,35,17,170,1427,14,494,280,531,508,811,4473,7289,7,54850,3047,2,2,26,26,0
27452,90,2885,773,419,590,28,0,166,801,10,204,113,217,214,330,1598,2554,5,13587,754,0,2,9,23,0
27453,1,20,127,75,83,2,11,30,129,4,14,7,14,18,21,61,87,2,175,9,0,2,0,1,0
27454,1,20,652,304,544,16,6,88,668,6,89,51,101,95,152,591,998,3,3399,188,0,2,0,1,0
27455,1,20,2,2,2,0,0,0,2,0,0,0,0,0,0,0,0,0,0,0,0,2,0,1,0
27456,1,20,8,5,5,0,0,3,8,0,0,0,0,0,0,0,0,0,0,0,0,2,0,1,0
27457,1,20,2,2,2,0,0,0,2,0,0,0,0,0,0,0,0,0,0,0,0,2,0,1,0
27458,1,20,14,8,8,0,0,6,14,0,0,0,0,0,0,0,0,0,0,0,0,2,0,1,0
27459,1,20,6,4,4,0,0,2,6,0,0,0,0,0,0,0,0,0,0,0,0,2,0,1,0
27460,1,20,6,4,4,0,0,2,6,1,2,1,2,3,3,2,4,0,2,0,0,2,0,1,0
27461,1,20,6,4,4,0,0,2,6,0,0,0,0,0,0,0,0,0,0,0,0,2,0,1,0
27462,1,20,7,5,5,0,0,2,7,0,0,0,0,0,0,0,0,0,0,0,0,2,0,1,0
27463,1,20,6,4,4,0,0,2,6,0,0,0,0,0,0,0,0,0,0,0,0,2,0,1,0
27464,1,20,10,6,6,0,0,4,10,0,0,0,0,0,0,0,0,0,0,0,0,2,0,1,0
27465,1,20,1,1,1,0,0,0,1,0,0,0,0,0,0,0,0,0,0,0,0,2,0,1,0
27466,1,20,1,1,1,0,0,0,1,0,0,0,0,0,0,0,0,0,0,0,0,2,0,1,0
27467,1,20,14,10,10,0,0,4,14,1,1,1,1,2,2,0,2,0,1,0,0,2,0,1,0
27468,1,20,46,26,30,3,0,12,49,3,6,3,6,9,9,20,28,1,42,2,0,2,0,1,0
27469,3,39,15,9,9,0,0,6,15,0,0,0,0,0,0,0,0,0,0,0,0,2,0,1,0
27470,2,36,10,7,7,0,0,3,10,1,2,1,2,3,3,2,4,0,2,0,0,2,0,1,0
27471,4,61,20,12,12,0,0,8,20,1,2,1,2,3,3,2,4,0,2,0,0,0,20,0,0
27472,8,263,51,25,36,0,0,15,51,3,11,6,12,14,18,42,68,1,112,6,0,2,0,1,0
27473,2,51,14,9,9,0,0,5,14,0,0,0,0,0,0,0,0,0,0,0,0,0,13,0,0
27474,15,703,139,89,101,2,0,35,141,7,54,34,62,61,96,330,569,4,2287,127,0,2,1,1,0
27475,63,4331,520,294,400,33,13,81,553,10,261,204,367,271,571,2128,4614,7,32445,1802,1,2,9,9,0
27476,178,7898,139,89,101,2,0,35,141,7,54,34,62,61,96,330,569,4,2287,127,0,2,14,4,0
27477,178,7898,7,5,5,0,0,2,7,1,2,1,2,3,3,2,4,0,2,0,0,2,14,4,0
27478,47,2228,722,423,573,19,0,135,741,12,172,101,199,184,300,1320,2257,6,15668,870,0,2,1,1,0
27479,51,1913,1098,241,925,5,10,155,1103,7,46,25,49,53,74,273,423,3,1580,87,0,2,12,0,0
27480,3,42,14,8,8,0,0,6,14,0,0,0,0,0,0,0,0,0,0,0,0,2,0,1,0
27481,60,1079,282,196,195,3,0,86,285,8,130,71,141,138,212,936,1507,4,6538,363,0,2,3,3,0
27482,1,9,5,3,3,0,0,2,5,0,0,0,0,0,0,0,0,0,0,0,0,2,0,1,0
27483,1,90,13,10,10,0,0,3,13,1,2,1,2,3,3,2,4,0,2,0,0,2,0,1,0
27484,3,66,127,75,83,2,11,30,129,4,14,7,14,18,21,61,87,2,175,9,0,2,0,1,0
27485,3,66,652,304,544,16,6,88,668,6,89,51,101,95,152,591,998,3,3399,188,0,2,0,1,0
27486,3,66,2,2,2,0,0,0,2,0,0,0,0,0,0,0,0,0,0,0,0,2,0,1,0
27487,3,66,8,5,5,0,0,3,8,0,0,0,0,0,0,0,0,0,0,0,0,2,0,1,0
27488,3,66,2,2,2,0,0,0,2,0,0,0,0,0,0,0,0,0,0,0,0,2,0,1,0
27489,3,66,14,8,8,0,0,6,14,0,0,0,0,0,0,0,0,0,0,0,0,2,0,1,0
27490,3,66,6,4,4,0,0,2,6,0,0,0,0,0,0,0,0,0,0,0,0,2,0,1,0
27491,3,66,6,4,4,0,0,2,6,1,2,1,2,3,3,2,4,0,2,0,0,2,0,1,0
27492,3,66,6,4,4,0,0,2,6,0,0,0,0,0,0,0,0,0,0,0,0,2,0,1,0
27493,3,66,7,5,5,0,0,2,7,0,0,0,0,0,0,0,0,0,0,0,0,2,0,1,0
27494,3,66,6,4,4,0,0,2,6,0,0,0,0,0,0,0,0,0,0,0,0,2,0,1,0
27495,3,66,10,6,6,0,0,4,10,0,0,0,0,0,0,0,0,0,0,0,0,2,0,1,0
27496,3,66,1,1,1,0,0,0,1,0,0,0,0,0,0,0,0,0,0,0,0,2,0,1,0
27497,3,66,1,1,1,0,0,0,1,0,0,0,0,0,0,0,0,0,0,0,0,2,0,1,0
27498,3,66,14,10,10,0,0,4,14,1,1,1,1,2,2,0,2,0,1,0,0,2,0,1,0
27499,3,66,46,26,30,3,0,12,49,3,6,3,6,9,9,20,28,1,42,2,0,2,0,1,0
27500,11,238,19,8,11,5,0,4,24,2,5,3,6,7,9,13,25,1,30,1,0,2,0,1,0
27501,11,238,102,59,69,5,3,24,107,6,22,15,28,28,43,113,206,3,789,43,0,2,0,1,0
27502,11,238,106,40,36,3,49,17,109,8,17,13,23,25,36,93,167,5,904,50,0,2,0,1,0
27503,68,1561,773,419,590,28,0,166,801,10,204,113,217,214,330,1598,2554,5,13587,754,0,2,6,57,0
27504,68,1561,421,273,302,44,34,57,465,17,81,59,107,98,166,583,1098,11,12329,684,0,2,6,57,0
27505,256,5923,4293,999,3693,19,54,507,4312,9,155,88,170,164,258,1156,1898,4,9368,520,0,2,22,5,0
27506,256,5923,1482,859,1002,125,135,219,1607,16,219,134,251,235,385,1766,3032,9,27804,1544,1,2,22,5,0
27507,98,2660,1523,757,1297,19,12,193,1542,12,193,117,230,205,347,1508,2664,7,19053,1058,0,2,1,1,0
27508,98,2660,701,378,504,33,58,109,734,13,110,68,126,123,194,794,1346,7,10027,557,0,2,1,1,0
27509,88,2299,773,422,505,30,103,129,803,14,77,46,83,91,129,535,839,7,6334,351,0,2,2,1,0
27510,30,660,125,97,103,3,0,19,128,9,25,17,27,34,44,144,223,4,1087,60,0,2,4,1,0
27511,151,7095,1392,870,1177,35,17,170,1427,14,494,280,531,508,811,4473,7289,7,54850,3047,2,2,26,26,0
27512,90,2885,773,419,590,28,0,166,801,10,204,113,217,214,330,1598,2554,5,13587,754,0,2,9,23,0
27513,1,20,127,75,83,2,11,30,129,4,14,7,14,18,21,61,87,2,175,9,0,2,0,1,0
27514,1,20,652,304,544,16,6,88,668,6,89,51,101,95,152,591,998,3,3399,188,0,2,0,1,0
27515,1,20,2,2,2,0,0,0,2,0,0,0,0,0,0,0,0,0,0,0,0,2,0,1,0
27516,1,20,8,5,5,0,0,3,8,0,0,0,0,0,0,0,0,0,0,0,0,2,0,1,0
27517,1,20,2,2,2,0,0,0,2,0,0,0,0,0,0,0,0,0,0,0,0,2,0,1,0
27518,1,20,14,8,8,0,0,6,14,0,0,0,0,0,0,0,0,0,0,0,0,2,0,1,0
27519,1,20,6,4,4,0,0,2,6,0,0,0,0,0,0,0,0,0,0,0,0,2,0,1,0
27520,1,20,6,4,4,0,0,2,6,1,2,1,2,3,3,2,4,0,2,0,0,2,0,1,0
27521,1,20,6,4,4,0,0,2,6,0,0,0,0,0,0,0,0,0,0,0,0,2,0,1,0
27522,1,20,7,5,5,0,0,2,7,0,0,0,0,0,0,0,0,0,0,0,0,2,0,1,0
27523,1,20,6,4,4,0,0,2,6,0,0,0,0,0,0,0,0,0,0,0,0,2,0,1,0
27524,1,20,10,6,6,0,0,4,10,0,0,0,0,0,0,0,0,0,0,0,0,2,0,1,0
27525,1,20,1,1,1,0,0,0,1,0,0,0,0,0,0,0,0,0,0,0,0,2,0,1,0
27526,1,20,1,1,1,0,0,0,1,0,0,0,0,0,0,0,0,0,0,0,0,2,0,1,0
27527,1,20,14,10,10,0,0,4,14,1,1,1,1,2,2,0,2,0,1,0,0,2,0,1,0
27528,1,20,46,26,30,3,0,12,49,3,6,3,6,9,9,20,28,1,42,2,0,2,0,1,0
27529,3,39,15,9,9,0,0,6,15,0,0,0,0,0,0,0,0,0,0,0,0,2,0,1,0
27530,2,36,10,7,7,0,0,3,10,1,2,1,2,3,3,2,4,0,2,0,0,2,0,1,0
27531,4,61,20,12,12,0,0,8,20,1,2,1,2,3,3,2,4,0,2,0,0,0,20,0,0
27532,8,263,51,25,36,0,0,15,51,3,11,6,12,14,18,42,68,1,112,6,0,2,0,1,0
27533,2,51,14,9,9,0,0,5,14,0,0,0,0,0,0,0,0,0,0,0,0,0,13,0,0
27534,15,703,139,89,101,2,0,35,141,7,54,34,62,61,96,330,569,4,2287,127,0,2,1,1,0
27535,63,4331,520,294,400,33,13,81,553,10,261,204,367,271,571,2128,4614,7,32445,1802,1,2,9,9,0
27536,178,7898,139,89,101,2,0,35,141,7,54,34,62,61,96,330,569,4,2287,127,0,2,14,4,0
27537,178,7898,7,5,5,0,0,2,7,1,2,1,2,3,3,2,4,0,2,0,0,2,14,4,0
27538,47,2228,722,423,573,19,0,135,741,12,172,101,199,184,300,1320,2257,6,15668,870,0,2,1,1,0
27539,51,1913,1098,241,925,5,10,155,1103,7,46,25,49,53,74,273,423,3,1580,87,0,2,12,0,0
27540,38,779,386,256,301,16,9,68,402,4,59,35,69,63,104,355,621,2,1453,80,0,2,5,39,1
27541,38,779,264,131,164,11,41,46,275,6,38,22,40,44,62,214,338,3,1068,59,0,2,5,39,1
27542,40,1789,386,256,301,16,9,68,402,4,59,35,69,63,104,355,621,2,1453,80,0,2,14,7,1
27543,254,5844,4293,999,3693,19,54,507,4312,9,155,88,170,164,258,1156,1898,4,9368,520,0,2,1,1,0
27544,254,5844,1482,859,1002,125,135,219,1607,16,219,134,251,235,385,1766,3032,9,27804,1544,1,2,1,1,0
27545,41,830,386,256,301,16,9,68,402,4,59,35,69,63,104,355,621,2,1453,80,0,2,13,0,1
27546,41,830,264,131,164,11,41,46,275,6,38,22,40,44,62,214,338,3,1068,59,0,2,13,0,1
27547,42,1848,386,256,301,16,9,68,402,4,59,35,69,63,104,355,621,2,1453,80,0,2,10,0,1
27548,244,5785,722,423,573,19,0,135,741,12,172,101,199,184,300,1320,2257,6,15668,870,0,2,2,0,0
27549,244,5785,1508,847,911,44,250,301,1552,14,148,88,169,162,257,1120,1886,7,15077,837,0,2,2,0,0
27550,60,1078,282,196,195,3,0,86,285,8,130,71,141,138,212,936,1507,4,6538,363,0,2,1,1,0
27551,89,1825,477,336,357,30,23,73,507,16,194,134,250,210,384,1538,2962,10,30538,1696,0,2,1,1,0
27552,76,1735,996,429,845,24,10,117,1020,7,76,50,88,83,138,494,879,4,3565,198,0,2,1,1,0
27553,76,1735,456,277,329,12,42,72,468,13,85,50,97,98,147,592,972,7,7212,400,0,2,1,1,0
27554,154,3261,1513,682,1277,25,13,200,1538,11,199,116,219,210,335,1557,2584,6,15641,868,0,2,1,1,0
27555,154,3261,819,519,539,24,98,155,843,15,96,57,106,111,163,690,1107,8,9171,509,0,2,1,1,0
27556,67,1348,207,111,150,11,0,50,218,5,26,19,36,31,55,133,272,3,943,52,0,2,1,1,0
27557,67,1348,410,198,237,31,55,97,441,11,63,38,72,74,110,414,683,6,4293,238,0,2,1,1,0
27558,27,964,74,35,59,1,0,14,75,3,14,7,14,17,21,58,85,1,128,7,0,2,1,1,0
27559,27,964,245,125,200,5,7,34,250,7,30,17,34,37,51,166,265,3,1053,58,0,2,1,1,0
27560,313,6904,72,33,56,0,4,12,72,1,1,1,1,2,2,0,2,0,1,0,0,2,1,1,0
27561,313,6904,1454,835,1044,76,110,219,1530,17,275,158,296,292,454,2297,3718,9,34017,1889,1,2,1,1,0
27562,46,954,386,256,301,16,9,68,402,4,59,35,69,63,104,355,621,2,1453,80,0,2,1,1,0
27563,46,954,264,131,164,11,41,46,275,6,38,22,40,44,62,214,338,3,1068,59,0,2,1,1,0
27564,223,4839,1943,715,1694,26,18,214,1969,12,185,120,237,197,357,1436,2721,7,20915,1161,0,2,1,1,0
27565,223,4839,1168,838,957,57,25,144,1225,19,348,224,416,367,640,3018,5452,11,61921,3440,1,2,1,1,0
27566,95,3960,1289,550,1043,56,32,155,1345,10,167,93,185,177,278,1266,2075,5,11498,638,0,2,3,3,0
27567,1,134,149,67,118,4,0,27,153,1,17,14,28,18,42,69,175,0,144,8,0,2,2,2,0
27568,95,4641,1523,757,1297,19,12,193,1542,12,193,117,230,205,347,1508,2664,7,19053,1058,0,2,1,1,0
27569,62,2789,1293,570,1093,25,15,163,1318,10,195,123,241,205,364,1516,2795,6,17273,959,0,2,1,1,0
27570,256,5923,4293,999,3693,19,54,507,4312,9,155,88,170,164,258,1156,1898,4,9368,520,0,2,1,1,0
27571,256,5923,1482,859,1002,125,135,219,1607,16,219,134,251,235,385,1766,3032,9,27804,1544,1,2,1,1,0
27572,62,2790,1293,570,1093,25,15,163,1318,10,195,123,241,205,364,1516,2795,6,17273,959,0,2,19,19,0
27573,62,2808,1293,570,1093,25,15,163,1318,10,195,123,241,205,364,1516,2795,6,17273,959,0,2,3,0,0
27574,244,5785,722,423,573,19,0,135,741,12,172,101,199,184,300,1320,2257,6,15668,870,0,2,2,0,0
27575,244,5785,1508,847,911,44,250,301,1552,14,148,88,169,162,257,1120,1886,7,15077,837,0,2,2,0,0
27576,218,4703,2,2,2,0,0,0,2,0,0,0,0,0,0,0,0,0,0,0,0,2,19,17,1
27577,218,4703,99,48,90,1,3,5,100,0,0,0,0,0,0,0,0,0,0,0,0,2,19,17,1
27578,218,4703,8,5,5,2,0,1,10,0,0,0,0,0,0,0,0,0,0,0,0,2,19,17,1
27579,218,4703,1217,716,841,84,126,174,1301,14,185,118,215,199,333,1446,2542,8,20687,1149,0,2,19,17,1
27580,218,4703,160,89,115,0,13,31,160,7,15,11,17,22,28,78,124,3,495,27,0,2,19,17,1
27581,218,4703,10,10,9,9,0,0,19,0,0,0,0,0,0,0,0,0,0,0,0,2,19,17,1
27582,218,4703,173,84,99,8,29,36,181,5,12,7,13,17,20,54,81,2,221,12,0,2,19,17,1
27583,218,4703,3,1,1,3,0,0,6,0,0,0,0,0,0,0,0,0,0,0,0,2,19,17,1
27584,88,1878,402,202,227,24,74,80,426,12,52,33,61,64,94,339,564,7,3969,220,0,2,1,1,0
27585,256,5936,4293,999,3693,19,54,507,4312,9,155,88,170,164,258,1156,1898,4,9368,520,0,2,9,6,1
27586,256,5936,1482,859,1002,125,135,219,1607,16,219,134,251,235,385,1766,3032,9,27804,1544,1,2,9,6,1
27587,24,600,2,2,2,0,0,0,2,0,0,0,0,0,0,0,0,0,0,0,0,2,0,5,1
27588,24,600,99,48,90,1,3,5,100,0,0,0,0,0,0,0,0,0,0,0,0,2,0,5,1
27589,24,600,8,5,5,2,0,1,10,0,0,0,0,0,0,0,0,0,0,0,0,2,0,5,1
27590,24,600,1217,716,841,84,126,174,1301,14,185,118,215,199,333,1446,2542,8,20687,1149,0,2,0,5,1
27591,24,600,160,89,115,0,13,31,160,7,15,11,17,22,28,78,124,3,495,27,0,2,0,5,1
27592,24,600,10,10,9,9,0,0,19,0,0,0,0,0,0,0,0,0,0,0,0,2,0,5,1
27593,24,600,173,84,99,8,29,36,181,5,12,7,13,17,20,54,81,2,221,12,0,2,0,5,1
27594,24,600,3,1,1,3,0,0,6,0,0,0,0,0,0,0,0,0,0,0,0,2,0,5,1
27595,88,1887,402,202,227,24,74,80,426,12,52,33,61,64,94,339,564,7,3969,220,0,2,2,1,1
27596,88,1985,53,23,39,0,0,13,53,2,8,4,8,10,12,26,39,1,39,2,0,2,4,0,1
27597,88,1985,515,298,307,33,80,99,548,12,63,44,77,75,121,419,753,7,5527,307,0,2,4,0,1
27598,310,6900,72,33,56,0,4,12,72,1,1,1,1,2,2,0,2,0,1,0,0,2,27,23,1
27599,310,6900,1454,835,1044,76,110,219,1530,17,275,158,296,292,454,2297,3718,9,34017,1889,1,2,27,23,1
27600,178,7961,139,89,101,2,0,35,141,7,54,34,62,61,96,330,569,4,2287,127,0,2,39,42,1
27601,178,7961,7,5,5,0,0,2,7,1,2,1,2,3,3,2,4,0,2,0,0,2,39,42,1
27602,138,6146,1782,648,1425,9,47,279,1791,8,171,97,189,179,286,1292,2140,4,9462,525,0,2,19,19,1
27603,97,4228,1020,354,843,12,15,144,1032,8,134,77,144,142,221,970,1580,4,6792,377,0,2,2,2,1
27604,83,3201,1043,504,840,53,9,147,1096,9,180,112,198,189,310,1377,2344,4,11604,644,0,2,17,1,1
27605,41,830,386,256,301,16,9,68,402,4,59,35,69,63,104,355,621,2,1453,80,0,2,4,4,1
27606,41,830,264,131,164,11,41,46,275,6,38,22,40,44,62,214,338,3,1068,59,0,2,4,4,1
27607,60,1078,282,196,195,3,0,86,285,8,130,71,141,138,212,936,1507,4,6538,363,0,2,3,3,0
27608,223,4839,1943,715,1694,26,18,214,1969,12,185,120,237,197,357,1436,2721,7,20915,1161,0,2,1,3,0
27609,223,4839,1168,838,957,57,25,144,1225,19,348,224,416,367,640,3018,5452,11,61921,3440,1,2,1,3,0
27610,62,2789,1293,570,1093,25,15,163,1318,10,195,123,241,205,364,1516,2795,6,17273,959,0,2,1,3,0
27611,141,3287,77,34,69,0,0,8,77,3,24,16,29,27,45,114,213,1,387,21,0,2,4,1,0
27612,141,3287,712,438,573,51,9,84,763,14,102,71,128,116,199,733,1364,8,11988,666,0,2,4,1,0
27613,26,755,442,244,305,14,16,103,456,11,68,45,75,79,120,452,756,6,4588,254,0,2,101,44,0
27614,26,755,182,102,99,11,40,35,193,3,11,6,11,14,17,42,64,1,97,5,0,2,101,44,0
27615,14,732,442,244,305,14,16,103,456,11,68,45,75,79,120,452,756,6,4588,254,0,2,2,2,0
27616,26,761,442,244,305,14,16,103,456,11,68,45,75,79,120,452,756,6,4588,254,0,2,4,2,0
27617,26,761,182,102,99,11,40,35,193,3,11,6,11,14,17,42,64,1,97,5,0,2,4,2,0
27618,38,1045,442,244,305,14,16,103,456,11,68,45,75,79,120,452,756,6,4588,254,0,2,74,18,1
27619,38,1045,182,102,99,11,40,35,193,3,11,6,11,14,17,42,64,1,97,5,0,2,74,18,1
27620,38,1039,442,244,305,14,16,103,456,11,68,45,75,79,120,452,756,6,4588,254,0,2,6,6,1
27621,38,1039,182,102,99,11,40,35,193,3,11,6,11,14,17,42,64,1,97,5,0,2,6,6,1
27622,14,732,442,244,305,14,16,103,456,11,68,45,75,79,120,452,756,6,4588,254,0,2,1,1,0
27623,50,1304,442,244,305,14,16,103,456,11,68,45,75,79,120,452,756,6,4588,254,0,2,84,29,1
27624,50,1304,182,102,99,11,40,35,193,3,11,6,11,14,17,42,64,1,97,5,0,2,84,29,1
27625,19,987,442,244,305,14,16,103,456,11,68,45,75,79,120,452,756,6,4588,254,0,2,57,0,1
27626,50,1308,442,244,305,14,16,103,456,11,68,45,75,79,120,452,756,6,4588,254,0,2,5,5,0
27627,50,1308,182,102,99,11,40,35,193,3,11,6,11,14,17,42,64,1,97,5,0,2,5,5,0
27628,56,1403,442,244,305,14,16,103,456,11,68,45,75,79,120,452,756,6,4588,254,0,2,35,17,1
27629,56,1403,182,102,99,11,40,35,193,3,11,6,11,14,17,42,64,1,97,5,0,2,35,17,1
27630,20,1078,442,244,305,14,16,103,456,11,68,45,75,79,120,452,756,6,4588,254,0,2,12,0,1
27631,56,1403,442,244,305,14,16,103,456,11,68,45,75,79,120,452,756,6,4588,254,0,2,9,9,1
27632,56,1403,182,102,99,11,40,35,193,3,11,6,11,14,17,42,64,1,97,5,0,2,9,9,1
27633,56,1416,442,244,305,14,16,103,456,11,68,45,75,79,120,452,756,6,4588,254,0,2,9,5,0
27634,56,1416,182,102,99,11,40,35,193,3,11,6,11,14,17,42,64,1,97,5,0,2,9,5,0
27635,20,1083,442,244,305,14,16,103,456,11,68,45,75,79,120,452,756,6,4588,254,0,2,11,3,0
27636,56,1420,442,244,305,14,16,103,456,11,68,45,75,79,120,452,756,6,4588,254,0,2,1,1,0
27637,56,1420,182,102,99,11,40,35,193,3,11,6,11,14,17,42,64,1,97,5,0,2,1,1,0
27638,180,5391,1660,832,1314,41,38,274,1701,20,312,209,395,332,604,2671,5058,12,64042,3557,1,2,2,1,1
27639,180,5391,1057,646,719,113,100,145,1170,18,215,134,248,233,382,1740,3004,10,31186,1732,1,2,2,1,1
27640,76,1739,996,429,845,24,10,117,1020,7,76,50,88,83,138,494,879,4,3565,198,0,2,2,1,1
27641,76,1739,456,277,329,12,42,72,468,13,85,50,97,98,147,592,972,7,7212,400,0,2,2,1,1
27642,67,1325,207,111,150,11,0,50,218,5,26,19,36,31,55,133,272,3,943,52,0,2,0,7,1
27643,67,1325,410,198,237,31,55,97,441,11,63,38,72,74,110,414,683,6,4293,238,0,2,0,7,1
27644,37,833,91,45,69,0,3,18,91,3,9,6,10,12,16,33,57,1,95,5,0,0,183,0,1
27645,37,833,367,234,237,17,34,68,384,16,55,34,61,71,95,381,584,8,5183,287,0,0,183,0,1
27646,7,164,167,116,138,4,5,22,171,8,48,30,56,56,86,292,499,4,2330,129,0,2,1,1,1
27647,244,5785,722,423,573,19,0,135,741,12,172,101,199,184,300,1320,2257,6,15668,870,0,2,4,3,1
27648,244,5785,1508,847,911,44,250,301,1552,14,148,88,169,162,257,1120,1886,7,15077,837,0,2,4,3,1
27649,19,622,442,244,305,14,16,103,456,11,68,45,75,79,120,452,756,6,4588,254,0,2,1,173,1
27650,19,622,182,102,99,11,40,35,193,3,11,6,11,14,17,42,64,1,97,5,0,2,1,173,1
27651,20,1083,442,244,305,14,16,103,456,11,68,45,75,79,120,452,756,6,4588,254,0,2,9,9,1
27652,178,7898,139,89,101,2,0,35,141,7,54,34,62,61,96,330,569,4,2287,127,0,2,1,1,0
27653,178,7898,7,5,5,0,0,2,7,1,2,1,2,3,3,2,4,0,2,0,0,2,1,1,0
27654,180,5391,1660,832,1314,41,38,274,1701,20,312,209,395,332,604,2671,5058,12,64042,3557,1,2,1,1,0
27655,180,5391,1057,646,719,113,100,145,1170,18,215,134,248,233,382,1740,3004,10,31186,1732,1,2,1,1,0
27656,76,1735,996,429,845,24,10,117,1020,7,76,50,88,83,138,494,879,4,3565,198,0,2,2,3,0
27657,76,1735,456,277,329,12,42,72,468,13,85,50,97,98,147,592,972,7,7212,400,0,2,2,3,0
27658,44,988,91,45,69,0,3,18,91,3,9,6,10,12,16,33,57,1,95,5,0,2,49,0,0
27659,44,988,367,234,237,17,34,68,384,16,55,34,61,71,95,381,584,8,5183,287,0,2,49,0,0
27660,76,1734,996,429,845,24,10,117,1020,7,76,50,88,83,138,494,879,4,3565,198,0,2,2,3,1
27661,76,1734,456,277,329,12,42,72,468,13,85,50,97,98,147,592,972,7,7212,400,0,2,2,3,1
27662,49,1088,91,45,69,0,3,18,91,3,9,6,10,12,16,33,57,1,95,5,0,2,46,2,1
27663,49,1088,367,234,237,17,34,68,384,16,55,34,61,71,95,381,584,8,5183,287,0,2,46,2,1
27664,18,608,442,244,305,14,16,103,456,11,68,45,75,79,120,452,756,6,4588,254,0,2,7,5,1
27665,18,608,182,102,99,11,40,35,193,3,11,6,11,14,17,42,64,1,97,5,0,2,7,5,1
27666,21,1150,442,244,305,14,16,103,456,11,68,45,75,79,120,452,756,6,4588,254,0,2,16,0,1
27667,49,1103,91,45,69,0,3,18,91,3,9,6,10,12,16,33,57,1,95,5,0,2,13,8,0
27668,49,1103,367,234,237,17,34,68,384,16,55,34,61,71,95,381,584,8,5183,287,0,2,13,8,0
27669,18,611,442,244,305,14,16,103,456,11,68,45,75,79,120,452,756,6,4588,254,0,2,25,8,0
27670,18,611,182,102,99,11,40,35,193,3,11,6,11,14,17,42,64,1,97,5,0,2,25,8,0
27671,244,5821,722,423,573,19,0,135,741,12,172,101,199,184,300,1320,2257,6,15668,870,0,2,3,0,1
27672,244,5821,1508,847,911,44,250,301,1552,14,148,88,169,162,257,1120,1886,7,15077,837,0,2,3,0,1
27673,19,625,442,244,305,14,16,103,456,11,68,45,75,79,120,452,756,6,4588,254,0,2,3,1,1
27674,19,625,182,102,99,11,40,35,193,3,11,6,11,14,17,42,64,1,97,5,0,2,3,1,1
27675,21,1128,442,244,305,14,16,103,456,11,68,45,75,79,120,452,756,6,4588,254,0,2,0,2,1
27676,244,5824,722,423,573,19,0,135,741,12,172,101,199,184,300,1320,2257,6,15668,870,0,2,1,1,0
27677,244,5824,1508,847,911,44,250,301,1552,14,148,88,169,162,257,1120,1886,7,15077,837,0,2,1,1,0
27678,19,627,442,244,305,14,16,103,456,11,68,45,75,79,120,452,756,6,4588,254,0,2,2,1,0
27679,19,627,182,102,99,11,40,35,193,3,11,6,11,14,17,42,64,1,97,5,0,2,2,1,0
27680,19,628,442,244,305,14,16,103,456,11,68,45,75,79,120,452,756,6,4588,254,0,2,1,0,0
27681,19,628,182,102,99,11,40,35,193,3,11,6,11,14,17,42,64,1,97,5,0,2,1,0,0
27682,19,669,442,244,305,14,16,103,456,11,68,45,75,79,120,452,756,6,4588,254,0,2,26,14,1
27683,19,669,182,102,99,11,40,35,193,3,11,6,11,14,17,42,64,1,97,5,0,2,26,14,1
27684,62,2808,1293,570,1093,25,15,163,1318,10,195,123,241,205,364,1516,2795,6,17273,959,0,2,22,19,0
27685,218,4703,2,2,2,0,0,0,2,0,0,0,0,0,0,0,0,0,0,0,0,2,19,17,0
27686,218,4703,99,48,90,1,3,5,100,0,0,0,0,0,0,0,0,0,0,0,0,2,19,17,0
27687,218,4703,8,5,5,2,0,1,10,0,0,0,0,0,0,0,0,0,0,0,0,2,19,17,0
27688,218,4703,1217,716,841,84,126,174,1301,14,185,118,215,199,333,1446,2542,8,20687,1149,0,2,19,17,0
27689,218,4703,160,89,115,0,13,31,160,7,15,11,17,22,28,78,124,3,495,27,0,2,19,17,0
27690,218,4703,10,10,9,9,0,0,19,0,0,0,0,0,0,0,0,0,0,0,0,2,19,17,0
27691,218,4703,173,84,99,8,29,36,181,5,12,7,13,17,20,54,81,2,221,12,0,2,19,17,0
27692,218,4703,3,1,1,3,0,0,6,0,0,0,0,0,0,0,0,0,0,0,0,2,19,17,0
27693,41,830,386,256,301,16,9,68,402,4,59,35,69,63,104,355,621,2,1453,80,0,2,18,39,0
27694,41,830,264,131,164,11,41,46,275,6,38,22,40,44,62,214,338,3,1068,59,0,2,18,39,0
27695,42,1848,386,256,301,16,9,68,402,4,59,35,69,63,104,355,621,2,1453,80,0,2,24,7,0
27696,19,669,442,244,305,14,16,103,456,11,68,45,75,79,120,452,756,6,4588,254,0,2,6,6,1
27697,19,669,182,102,99,11,40,35,193,3,11,6,11,14,17,42,64,1,97,5,0,2,6,6,1
27698,60,1078,282,196,195,3,0,86,285,8,130,71,141,138,212,936,1507,4,6538,363,0,2,3,3,0
27699,89,1825,477,336,357,30,23,73,507,16,194,134,250,210,384,1538,2962,10,30538,1696,0,2,1,1,0
27700,76,1735,996,429,845,24,10,117,1020,7,76,50,88,83,138,494,879,4,3565,198,0,2,1,1,0
27701,76,1735,456,277,329,12,42,72,468,13,85,50,97,98,147,592,972,7,7212,400,0,2,1,1,0
27702,154,3261,1513,682,1277,25,13,200,1538,11,199,116,219,210,335,1557,2584,6,15641,868,0,2,1,1,0
27703,154,3261,819,519,539,24,98,155,843,15,96,57,106,111,163,690,1107,8,9171,509,0,2,1,1,0
27704,67,1348,207,111,150,11,0,50,218,5,26,19,36,31,55,133,272,3,943,52,0,2,1,1,0
27705,67,1348,410,198,237,31,55,97,441,11,63,38,72,74,110,414,683,6,4293,238,0,2,1,1,0
27706,27,964,74,35,59,1,0,14,75,3,14,7,14,17,21,58,85,1,128,7,0,2,1,1,0
27707,27,964,245,125,200,5,7,34,250,7,30,17,34,37,51,166,265,3,1053,58,0,2,1,1,0
27708,313,6904,72,33,56,0,4,12,72,1,1,1,1,2,2,0,2,0,1,0,0,2,1,1,0
27709,313,6904,1454,835,1044,76,110,219,1530,17,275,158,296,292,454,2297,3718,9,34017,1889,1,2,1,1,0
27710,46,954,386,256,301,16,9,68,402,4,59,35,69,63,104,355,621,2,1453,80,0,2,1,1,0
27711,46,954,264,131,164,11,41,46,275,6,38,22,40,44,62,214,338,3,1068,59,0,2,1,1,0
27712,223,4839,1943,715,1694,26,18,214,1969,12,185,120,237,197,357,1436,2721,7,20915,1161,0,2,1,3,0
27713,223,4839,1168,838,957,57,25,144,1225,19,348,224,416,367,640,3018,5452,11,61921,3440,1,2,1,3,0
27714,95,3960,1289,550,1043,56,32,155,1345,10,167,93,185,177,278,1266,2075,5,11498,638,0,2,3,3,0
27715,1,134,149,67,118,4,0,27,153,1,17,14,28,18,42,69,175,0,144,8,0,2,2,2,0
27716,95,4641,1523,757,1297,19,12,193,1542,12,193,117,230,205,347,1508,2664,7,19053,1058,0,2,1,1,0
27717,62,2807,1293,570,1093,25,15,163,1318,10,195,123,241,205,364,1516,2795,6,17273,959,0,2,1,3,0
27718,256,5936,4293,999,3693,19,54,507,4312,9,155,88,170,164,258,1156,1898,4,9368,520,0,2,9,6,0
27719,256,5936,1482,859,1002,125,135,219,1607,16,219,134,251,235,385,1766,3032,9,27804,1544,1,2,9,6,0
27720,24,600,2,2,2,0,0,0,2,0,0,0,0,0,0,0,0,0,0,0,0,2,0,5,0
27721,24,600,99,48,90,1,3,5,100,0,0,0,0,0,0,0,0,0,0,0,0,2,0,5,0
27722,24,600,8,5,5,2,0,1,10,0,0,0,0,0,0,0,0,0,0,0,0,2,0,5,0
27723,24,600,1217,716,841,84,126,174,1301,14,185,118,215,199,333,1446,2542,8,20687,1149,0,2,0,5,0
27724,24,600,160,89,115,0,13,31,160,7,15,11,17,22,28,78,124,3,495,27,0,2,0,5,0
27725,24,600,10,10,9,9,0,0,19,0,0,0,0,0,0,0,0,0,0,0,0,2,0,5,0
27726,24,600,173,84,99,8,29,36,181,5,12,7,13,17,20,54,81,2,221,12,0,2,0,5,0
27727,24,600,3,1,1,3,0,0,6,0,0,0,0,0,0,0,0,0,0,0,0,2,0,5,0
27728,88,1887,402,202,227,24,74,80,426,12,52,33,61,64,94,339,564,7,3969,220,0,2,3,2,0
27729,88,1985,53,23,39,0,0,13,53,2,8,4,8,10,12,26,39,1,39,2,0,2,4,0,0
27730,88,1985,515,298,307,33,80,99,548,12,63,44,77,75,121,419,753,7,5527,307,0,2,4,0,0
27731,310,6900,72,33,56,0,4,12,72,1,1,1,1,2,2,0,2,0,1,0,0,2,27,23,0
27732,310,6900,1454,835,1044,76,110,219,1530,17,275,158,296,292,454,2297,3718,9,34017,1889,1,2,27,23,0
27733,178,7961,139,89,101,2,0,35,141,7,54,34,62,61,96,330,569,4,2287,127,0,2,39,42,0
27734,178,7961,7,5,5,0,0,2,7,1,2,1,2,3,3,2,4,0,2,0,0,2,39,42,0
27735,138,6146,1782,648,1425,9,47,279,1791,8,171,97,189,179,286,1292,2140,4,9462,525,0,2,19,19,0
27736,97,4228,1020,354,843,12,15,144,1032,8,134,77,144,142,221,970,1580,4,6792,377,0,2,2,2,0
27737,83,3201,1043,504,840,53,9,147,1096,9,180,112,198,189,310,1377,2344,4,11604,644,0,2,17,1,0
27738,180,5391,1660,832,1314,41,38,274,1701,20,312,209,395,332,604,2671,5058,12,64042,3557,1,2,3,2,0
27739,180,5391,1057,646,719,113,100,145,1170,18,215,134,248,233,382,1740,3004,10,31186,1732,1,2,3,2,0
27740,76,1734,996,429,845,24,10,117,1020,7,76,50,88,83,138,494,879,4,3565,198,0,2,4,5,0
27741,76,1734,456,277,329,12,42,72,468,13,85,50,97,98,147,592,972,7,7212,400,0,2,4,5,0
27742,67,1325,207,111,150,11,0,50,218,5,26,19,36,31,55,133,272,3,943,52,0,2,0,7,0
27743,67,1325,410,198,237,31,55,97,441,11,63,38,72,74,110,414,683,6,4293,238,0,2,0,7,0
27744,141,3287,77,34,69,0,0,8,77,3,24,16,29,27,45,114,213,1,387,21,0,2,4,1,0
27745,141,3287,712,438,573,51,9,84,763,14,102,71,128,116,199,733,1364,8,11988,666,0,2,4,1,0
27746,49,1103,91,45,69,0,3,18,91,3,9,6,10,12,16,33,57,1,95,5,0,0,281,0,0
27747,49,1103,367,234,237,17,34,68,384,16,55,34,61,71,95,381,584,8,5183,287,0,0,281,0,0
27748,244,5824,722,423,573,19,0,135,741,12,172,101,199,184,300,1320,2257,6,15668,870,0,2,7,3,0
27749,244,5824,1508,847,911,44,250,301,1552,14,148,88,169,162,257,1120,1886,7,15077,837,0,2,7,3,0
27750,19,669,442,244,305,14,16,103,456,11,68,45,75,79,120,452,756,6,4588,254,0,2,113,58,0
27751,19,669,182,102,99,11,40,35,193,3,11,6,11,14,17,42,64,1,97,5,0,2,113,58,0
27752,178,7961,139,89,101,2,0,35,141,7,54,34,62,61,96,330,569,4,2287,127,0,2,1,1,0
27753,178,7961,7,5,5,0,0,2,7,1,2,1,2,3,3,2,4,0,2,0,0,2,1,1,0
27754,21,1128,442,244,305,14,16,103,456,11,68,45,75,79,120,452,756,6,4588,254,0,2,94,3,0
27755,217,4704,182,127,129,0,0,53,182,5,39,21,42,44,63,217,343,2,926,51,0,2,35,7,1
27756,217,4704,1165,710,800,67,119,181,1232,18,243,153,282,261,435,2000,3492,10,36473,2026,1,2,35,7,1
27757,152,7140,1392,870,1177,35,17,170,1427,14,494,280,531,508,811,4473,7289,7,54850,3047,2,2,15,5,1
27758,219,4763,2,2,2,0,0,0,2,0,0,0,0,0,0,0,0,0,0,0,0,2,16,2,0
27759,219,4763,99,48,90,1,3,5,100,0,0,0,0,0,0,0,0,0,0,0,0,2,16,2,0
27760,219,4763,8,5,5,2,0,1,10,0,0,0,0,0,0,0,0,0,0,0,0,2,16,2,0
27761,219,4763,1217,716,841,84,126,174,1301,14,185,118,215,199,333,1446,2542,8,20687,1149,0,2,16,2,0
27762,219,4763,160,89,115,0,13,31,160,7,15,11,17,22,28,78,124,3,495,27,0,2,16,2,0
27763,219,4763,10,10,9,9,0,0,19,0,0,0,0,0,0,0,0,0,0,0,0,2,16,2,0
27764,219,4763,173,84,99,8,29,36,181,5,12,7,13,17,20,54,81,2,221,12,0,2,16,2,0
27765,219,4763,3,1,1,3,0,0,6,0,0,0,0,0,0,0,0,0,0,0,0,2,16,2,0
27766,97,4034,1289,550,1043,56,32,155,1345,10,167,93,185,177,278,1266,2075,5,11498,638,0,2,25,5,0
27767,222,4841,182,127,129,0,0,53,182,5,39,21,42,44,63,217,343,2,926,51,0,2,35,0,0
27768,222,4841,1165,710,800,67,119,181,1232,18,243,153,282,261,435,2000,3492,10,36473,2026,1,2,35,0,0
27769,219,4759,2,2,2,0,0,0,2,0,0,0,0,0,0,0,0,0,0,0,0,2,1,4,0
27770,219,4759,99,48,90,1,3,5,100,0,0,0,0,0,0,0,0,0,0,0,0,2,1,4,0
27771,219,4759,8,5,5,2,0,1,10,0,0,0,0,0,0,0,0,0,0,0,0,2,1,4,0
27772,219,4759,1217,716,841,84,126,174,1301,14,185,118,215,199,333,1446,2542,8,20687,1149,0,2,1,4,0
27773,219,4759,160,89,115,0,13,31,160,7,15,11,17,22,28,78,124,3,495,27,0,2,1,4,0
27774,219,4759,10,10,9,9,0,0,19,0,0,0,0,0,0,0,0,0,0,0,0,2,1,4,0
27775,219,4759,173,84,99,8,29,36,181,5,12,7,13,17,20,54,81,2,221,12,0,2,1,4,0
27776,219,4759,3,1,1,3,0,0,6,0,0,0,0,0,0,0,0,0,0,0,0,2,1,4,0
27777,305,6771,72,33,56,0,4,12,72,1,1,1,1,2,2,0,2,0,1,0,0,2,1,32,0
27778,305,6771,1454,835,1044,76,110,219,1530,17,275,158,296,292,454,2297,3718,9,34017,1889,1,2,1,32,0
27779,218,4716,2,2,2,0,0,0,2,0,0,0,0,0,0,0,0,0,0,0,0,2,0,10,0
27780,218,4716,99,48,90,1,3,5,100,0,0,0,0,0,0,0,0,0,0,0,0,2,0,10,0
27781,218,4716,8,5,5,2,0,1,10,0,0,0,0,0,0,0,0,0,0,0,0,2,0,10,0
27782,218,4716,1217,716,841,84,126,174,1301,14,185,118,215,199,333,1446,2542,8,20687,1149,0,2,0,10,0
27783,218,4716,160,89,115,0,13,31,160,7,15,11,17,22,28,78,124,3,495,27,0,2,0,10,0
27784,218,4716,10,10,9,9,0,0,19,0,0,0,0,0,0,0,0,0,0,0,0,2,0,10,0
27785,218,4716,173,84,99,8,29,36,181,5,12,7,13,17,20,54,81,2,221,12,0,2,0,10,0
27786,218,4716,3,1,1,3,0,0,6,0,0,0,0,0,0,0,0,0,0,0,0,2,0,10,0
27787,60,1078,282,196,195,3,0,86,285,8,130,71,141,138,212,936,1507,4,6538,363,0,2,3,3,0
27788,89,1825,477,336,357,30,23,73,507,16,194,134,250,210,384,1538,2962,10,30538,1696,0,2,1,1,0
27789,76,1733,996,429,845,24,10,117,1020,7,76,50,88,83,138,494,879,4,3565,198,0,2,1,1,0
27790,76,1733,456,277,329,12,42,72,468,13,85,50,97,98,147,592,972,7,7212,400,0,2,1,1,0
27791,154,3261,1513,682,1277,25,13,200,1538,11,199,116,219,210,335,1557,2584,6,15641,868,0,2,1,1,0
27792,154,3261,819,519,539,24,98,155,843,15,96,57,106,111,163,690,1107,8,9171,509,0,2,1,1,0
27793,67,1324,207,111,150,11,0,50,218,5,26,19,36,31,55,133,272,3,943,52,0,2,1,1,0
27794,67,1324,410,198,237,31,55,97,441,11,63,38,72,74,110,414,683,6,4293,238,0,2,1,1,0
27795,27,964,74,35,59,1,0,14,75,3,14,7,14,17,21,58,85,1,128,7,0,2,1,1,0
27796,27,964,245,125,200,5,7,34,250,7,30,17,34,37,51,166,265,3,1053,58,0,2,1,1,0
27797,310,6899,72,33,56,0,4,12,72,1,1,1,1,2,2,0,2,0,1,0,0,2,1,1,0
27798,310,6899,1454,835,1044,76,110,219,1530,17,275,158,296,292,454,2297,3718,9,34017,1889,1,2,1,1,0
27799,41,829,386,256,301,16,9,68,402,4,59,35,69,63,104,355,621,2,1453,80,0,2,1,1,0
27800,41,829,264,131,164,11,41,46,275,6,38,22,40,44,62,214,338,3,1068,59,0,2,1,1,0
27801,223,4839,1943,715,1694,26,18,214,1969,12,185,120,237,197,357,1436,2721,7,20915,1161,0,2,1,3,0
27802,223,4839,1168,838,957,57,25,144,1225,19,348,224,416,367,640,3018,5452,11,61921,3440,1,2,1,3,0
27803,95,3960,1289,550,1043,56,32,155,1345,10,167,93,185,177,278,1266,2075,5,11498,638,0,2,3,3,0
27804,1,134,149,67,118,4,0,27,153,1,17,14,28,18,42,69,175,0,144,8,0,2,2,2,0
27805,95,4641,1523,757,1297,19,12,193,1542,12,193,117,230,205,347,1508,2664,7,19053,1058,0,2,1,1,0
27806,62,2807,1293,570,1093,25,15,163,1318,10,195,123,241,205,364,1516,2795,6,17273,959,0,2,23,22,0
27807,222,4841,182,127,129,0,0,53,182,5,39,21,42,44,63,217,343,2,926,51,0,2,70,7,0
27808,222,4841,1165,710,800,67,119,181,1232,18,243,153,282,261,435,2000,3492,10,36473,2026,1,2,70,7,0
27809,218,4716,2,2,2,0,0,0,2,0,0,0,0,0,0,0,0,0,0,0,0,2,13,12,0
27810,218,4716,99,48,90,1,3,5,100,0,0,0,0,0,0,0,0,0,0,0,0,2,13,12,0
27811,218,4716,8,5,5,2,0,1,10,0,0,0,0,0,0,0,0,0,0,0,0,2,13,12,0
27812,218,4716,1217,716,841,84,126,174,1301,14,185,118,215,199,333,1446,2542,8,20687,1149,0,2,13,12,0
27813,218,4716,160,89,115,0,13,31,160,7,15,11,17,22,28,78,124,3,495,27,0,2,13,12,0
27814,218,4716,10,10,9,9,0,0,19,0,0,0,0,0,0,0,0,0,0,0,0,2,13,12,0
27815,218,4716,173,84,99,8,29,36,181,5,12,7,13,17,20,54,81,2,221,12,0,2,13,12,0
27816,218,4716,3,1,1,3,0,0,6,0,0,0,0,0,0,0,0,0,0,0,0,2,13,12,0
27817,305,6771,72,33,56,0,4,12,72,1,1,1,1,2,2,0,2,0,1,0,0,2,1,32,0
27818,305,6771,1454,835,1044,76,110,219,1530,17,275,158,296,292,454,2297,3718,9,34017,1889,1,2,1,32,0
27819,97,4034,1289,550,1043,56,32,155,1345,10,167,93,185,177,278,1266,2075,5,11498,638,0,2,25,5,0
27820,152,7140,1392,870,1177,35,17,170,1427,14,494,280,531,508,811,4473,7289,7,54850,3047,2,2,15,5,0
27821,95,3960,1289,550,1043,56,32,155,1345,10,167,93,185,177,278,1266,2075,5,11498,638,0,2,2,2,0
27822,90,3892,1289,550,1043,56,32,155,1345,10,167,93,185,177,278,1266,2075,5,11498,638,0,2,15,25,0
27823,60,1078,282,196,195,3,0,86,285,8,130,71,141,138,212,936,1507,4,6538,363,0,2,3,3,0
27824,89,1825,477,336,357,30,23,73,507,16,194,134,250,210,384,1538,2962,10,30538,1696,0,2,1,1,0
27825,76,1733,996,429,845,24,10,117,1020,7,76,50,88,83,138,494,879,4,3565,198,0,2,1,1,0
27826,76,1733,456,277,329,12,42,72,468,13,85,50,97,98,147,592,972,7,7212,400,0,2,1,1,0
27827,154,3261,1513,682,1277,25,13,200,1538,11,199,116,219,210,335,1557,2584,6,15641,868,0,2,1,1,0
27828,154,3261,819,519,539,24,98,155,843,15,96,57,106,111,163,690,1107,8,9171,509,0,2,1,1,0
27829,67,1324,207,111,150,11,0,50,218,5,26,19,36,31,55,133,272,3,943,52,0,2,1,1,0
27830,67,1324,410,198,237,31,55,97,441,11,63,38,72,74,110,414,683,6,4293,238,0,2,1,1,0
27831,27,964,74,35,59,1,0,14,75,3,14,7,14,17,21,58,85,1,128,7,0,2,1,1,0
27832,27,964,245,125,200,5,7,34,250,7,30,17,34,37,51,166,265,3,1053,58,0,2,1,1,0
27833,305,6770,72,33,56,0,4,12,72,1,1,1,1,2,2,0,2,0,1,0,0,2,1,1,0
27834,305,6770,1454,835,1044,76,110,219,1530,17,275,158,296,292,454,2297,3718,9,34017,1889,1,2,1,1,0
27835,41,829,386,256,301,16,9,68,402,4,59,35,69,63,104,355,621,2,1453,80,0,2,1,1,0
27836,41,829,264,131,164,11,41,46,275,6,38,22,40,44,62,214,338,3,1068,59,0,2,1,1,0
27837,223,4839,1943,715,1694,26,18,214,1969,12,185,120,237,197,357,1436,2721,7,20915,1161,0,2,1,3,0
27838,223,4839,1168,838,957,57,25,144,1225,19,348,224,416,367,640,3018,5452,11,61921,3440,1,2,1,3,0
27839,97,4030,1289,550,1043,56,32,155,1345,10,167,93,185,177,278,1266,2075,5,11498,638,0,2,3,3,0
27840,1,134,149,67,118,4,0,27,153,1,17,14,28,18,42,69,175,0,144,8,0,2,2,2,0
27841,95,4641,1523,757,1297,19,12,193,1542,12,193,117,230,205,347,1508,2664,7,19053,1058,0,2,1,1,0
27842,62,2807,1293,570,1093,25,15,163,1318,10,195,123,241,205,364,1516,2795,6,17273,959,0,2,23,22,0
27843,256,5918,4293,999,3693,19,54,507,4312,9,155,88,170,164,258,1156,1898,4,9368,520,0,2,2,3,0
27844,256,5918,1482,859,1002,125,135,219,1607,16,219,134,251,235,385,1766,3032,9,27804,1544,1,2,2,3,0
27845,141,3282,77,34,69,0,0,8,77,3,24,16,29,27,45,114,213,1,387,21,0,2,2,5,0
27846,141,3282,712,438,573,51,9,84,763,14,102,71,128,116,199,733,1364,8,11988,666,0,2,2,5,0
27847,235,5587,722,423,573,19,0,135,741,12,172,101,199,184,300,1320,2257,6,15668,870,0,2,2,2,1
27848,235,5587,1508,847,911,44,250,301,1552,14,148,88,169,162,257,1120,1886,7,15077,837,0,2,2,2,1
27849,90,3892,1289,550,1043,56,32,155,1345,10,167,93,185,177,278,1266,2075,5,11498,638,0,2,17,27,0
27850,256,5918,4293,999,3693,19,54,507,4312,9,155,88,170,164,258,1156,1898,4,9368,520,0,2,2,3,0
27851,256,5918,1482,859,1002,125,135,219,1607,16,219,134,251,235,385,1766,3032,9,27804,1544,1,2,2,3,0
27852,141,3282,77,34,69,0,0,8,77,3,24,16,29,27,45,114,213,1,387,21,0,2,2,5,0
27853,141,3282,712,438,573,51,9,84,763,14,102,71,128,116,199,733,1364,8,11988,666,0,2,2,5,0
27854,235,5587,722,423,573,19,0,135,741,12,172,101,199,184,300,1320,2257,6,15668,870,0,2,2,2,0
27855,235,5587,1508,847,911,44,250,301,1552,14,148,88,169,162,257,1120,1886,7,15077,837,0,2,2,2,0
27856,92,1951,1043,504,840,53,9,147,1096,9,180,112,198,189,310,1377,2344,4,11604,644,0,2,1,0,0
27857,92,1951,383,288,292,26,6,62,409,11,65,38,67,76,105,429,656,5,3719,206,0,2,1,0,0
27858,92,1951,1043,504,840,53,9,147,1096,9,180,112,198,189,310,1377,2344,4,11604,644,0,2,1,1,0
27859,92,1951,383,288,292,26,6,62,409,11,65,38,67,76,105,429,656,5,3719,206,0,2,1,1,0
27860,62,2807,1293,570,1093,25,15,163,1318,10,195,123,241,205,364,1516,2795,6,17273,959,0,2,7,7,0
27861,92,1957,1043,504,840,53,9,147,1096,9,180,112,198,189,310,1377,2344,4,11604,644,0,2,2,1,1
27862,92,1957,383,288,292,26,6,62,409,11,65,38,67,76,105,429,656,5,3719,206,0,2,2,1,1
27863,101,4065,1289,550,1043,56,32,155,1345,10,167,93,185,177,278,1266,2075,5,11498,638,0,2,4,0,1
27864,33,970,339,213,244,17,9,65,356,10,42,26,48,52,74,259,421,5,2410,133,0,2,0,3,0
27865,64,2837,1293,570,1093,25,15,163,1318,10,195,123,241,205,364,1516,2795,6,17273,959,0,2,5,1,0
27866,256,5940,4293,999,3693,19,54,507,4312,9,155,88,170,164,258,1156,1898,4,9368,520,0,2,1,1,1
27867,256,5940,1482,859,1002,125,135,219,1607,16,219,134,251,235,385,1766,3032,9,27804,1544,1,2,1,1,1
27868,141,3291,77,34,69,0,0,8,77,3,24,16,29,27,45,114,213,1,387,21,0,2,1,1,1
27869,141,3291,712,438,573,51,9,84,763,14,102,71,128,116,199,733,1364,8,11988,666,0,2,1,1,1
27870,98,4059,1289,550,1043,56,32,155,1345,10,167,93,185,177,278,1266,2075,5,11498,638,0,2,17,7,1
27871,40,2477,652,304,544,16,6,88,668,6,89,51,101,95,152,591,998,3,3399,188,0,2,47,1,1
27872,35,1016,339,213,244,17,9,65,356,10,42,26,48,52,74,259,421,5,2410,133,0,2,6,2,1
27873,62,2819,1293,570,1093,25,15,163,1318,10,195,123,241,205,364,1516,2795,6,17273,959,0,2,12,3,1
27874,64,2839,1293,570,1093,25,15,163,1318,10,195,123,241,205,364,1516,2795,6,17273,959,0,2,10,2,0
27875,92,1957,1043,504,840,53,9,147,1096,9,180,112,198,189,310,1377,2344,4,11604,644,0,2,5,0,0
27876,92,1957,383,288,292,26,6,62,409,11,65,38,67,76,105,429,656,5,3719,206,0,2,5,0,0
27877,96,3993,1289,550,1043,56,32,155,1345,10,167,93,185,177,278,1266,2075,5,11498,638,0,2,27,9,0
27878,33,970,339,213,244,17,9,65,356,10,42,26,48,52,74,259,421,5,2410,133,0,2,0,3,0
27879,64,2839,1293,570,1093,25,15,163,1318,10,195,123,241,205,364,1516,2795,6,17273,959,0,2,20,8,0
27880,34,986,339,213,244,17,9,65,356,10,42,26,48,52,74,259,421,5,2410,133,0,2,6,2,0
27881,64,2851,1293,570,1093,25,15,163,1318,10,195,123,241,205,364,1516,2795,6,17273,959,0,2,12,3,0
27882,256,5940,4293,999,3693,19,54,507,4312,9,155,88,170,164,258,1156,1898,4,9368,520,0,2,1,1,0
27883,256,5940,1482,859,1002,125,135,219,1607,16,219,134,251,235,385,1766,3032,9,27804,1544,1,2,1,1,0
27884,141,3291,77,34,69,0,0,8,77,3,24,16,29,27,45,114,213,1,387,21,0,2,1,1,0
27885,141,3291,712,438,573,51,9,84,763,14,102,71,128,116,199,733,1364,8,11988,666,0,2,1,1,0
27886,98,4059,1289,550,1043,56,32,155,1345,10,167,93,185,177,278,1266,2075,5,11498,638,0,2,17,7,0
27887,40,2477,652,304,544,16,6,88,668,6,89,51,101,95,152,591,998,3,3399,188,0,2,47,1,0
27888,96,3982,1289,550,1043,56,32,155,1345,10,167,93,185,177,278,1266,2075,5,11498,638,0,2,0,1,0
27889,21,521,205,80,86,16,53,53,221,7,18,10,19,25,29,94,134,3,497,27,0,2,5,2,0
27890,85,3247,1043,504,840,53,9,147,1096,9,180,112,198,189,310,1377,2344,4,11604,644,0,2,9,0,0
27891,179,7896,139,89,101,2,0,35,141,7,54,34,62,61,96,330,569,4,2287,127,0,2,6,0,0
27892,179,7896,7,5,5,0,0,2,7,1,2,1,2,3,3,2,4,0,2,0,0,2,6,0,0
27893,50,1112,91,45,69,0,3,18,91,3,9,6,10,12,16,33,57,1,95,5,0,2,2,0,1
27894,50,1112,367,234,237,17,34,68,384,16,55,34,61,71,95,381,584,8,5183,287,0,2,2,0,1
27895,23,1181,442,244,305,14,16,103,456,11,68,45,75,79,120,452,756,6,4588,254,0,2,9,1,1
27896,20,522,205,80,86,16,53,53,221,7,18,10,19,25,29,94,134,3,497,27,0,2,3,5,0
27897,141,3301,77,34,69,0,0,8,77,3,24,16,29,27,45,114,213,1,387,21,0,2,4,2,1
27898,141,3301,712,438,573,51,9,84,763,14,102,71,128,116,199,733,1364,8,11988,666,0,2,4,2,1
27899,84,3226,1043,504,840,53,9,147,1096,9,180,112,198,189,310,1377,2344,4,11604,644,0,2,10,7,1
27900,2,173,42,7,35,4,0,5,46,1,2,1,2,3,3,2,4,0,2,0,0,2,4,77,1
27901,2,173,11,6,10,0,0,1,11,2,4,2,4,6,6,10,15,1,15,0,0,2,4,77,1
27902,20,522,205,80,86,16,53,53,221,7,18,10,19,25,29,94,134,3,497,27,0,2,5,1,0
27903,27,1218,442,244,305,14,16,103,456,11,68,45,75,79,120,452,756,6,4588,254,0,2,17,7,0
27904,96,3982,1289,550,1043,56,32,155,1345,10,167,93,185,177,278,1266,2075,5,11498,638,0,2,0,1,0
27905,179,7896,139,89,101,2,0,35,141,7,54,34,62,61,96,330,569,4,2287,127,0,2,6,0,0
27906,179,7896,7,5,5,0,0,2,7,1,2,1,2,3,3,2,4,0,2,0,0,2,6,0,0
27907,20,522,205,80,86,16,53,53,221,7,18,10,19,25,29,94,134,3,497,27,0,2,1,1,0
27908,142,3311,77,34,69,0,0,8,77,3,24,16,29,27,45,114,213,1,387,21,0,2,2,1,0
27909,142,3311,712,438,573,51,9,84,763,14,102,71,128,116,199,733,1364,8,11988,666,0,2,2,1,0
27910,20,522,205,80,86,16,53,53,221,7,18,10,19,25,29,94,134,3,497,27,0,2,2,1,0
27911,20,522,205,80,86,16,53,53,221,7,18,10,19,25,29,94,134,3,497,27,0,2,1,1,0
27912,180,5393,1660,832,1314,41,38,274,1701,20,312,209,395,332,604,2671,5058,12,64042,3557,1,2,1,1,0
27913,180,5393,1057,646,719,113,100,145,1170,18,215,134,248,233,382,1740,3004,10,31186,1732,1,2,1,1,0
27914,50,1112,91,45,69,0,3,18,91,3,9,6,10,12,16,33,57,1,95,5,0,2,2,0,0
27915,50,1112,367,234,237,17,34,68,384,16,55,34,61,71,95,381,584,8,5183,287,0,2,2,0,0
27916,27,1218,442,244,305,14,16,103,456,11,68,45,75,79,120,452,756,6,4588,254,0,2,25,7,0
27917,1,86,42,7,35,4,0,5,46,1,2,1,2,3,3,2,4,0,2,0,0,2,23,42,1
27918,1,86,11,6,10,0,0,1,11,2,4,2,4,6,6,10,15,1,15,0,0,2,23,42,1
27919,142,3311,77,34,69,0,0,8,77,3,24,16,29,27,45,114,213,1,387,21,0,2,5,2,0
27920,142,3311,712,438,573,51,9,84,763,14,102,71,128,116,199,733,1364,8,11988,666,0,2,5,2,0
27921,20,522,205,80,86,16,53,53,221,7,18,10,19,25,29,94,134,3,497,27,0,2,10,4,0
27922,84,3226,1043,504,840,53,9,147,1096,9,180,112,198,189,310,1377,2344,4,11604,644,0,2,12,0,0
27923,1,86,42,7,35,4,0,5,46,1,2,1,2,3,3,2,4,0,2,0,0,2,19,111,0
27924,1,86,11,6,10,0,0,1,11,2,4,2,4,6,6,10,15,1,15,0,0,2,19,111,0
27925,180,5393,1660,832,1314,41,38,274,1701,20,312,209,395,332,604,2671,5058,12,64042,3557,1,2,1,1,0
27926,180,5393,1057,646,719,113,100,145,1170,18,215,134,248,233,382,1740,3004,10,31186,1732,1,2,1,1,0
27927,180,5397,1660,832,1314,41,38,274,1701,20,312,209,395,332,604,2671,5058,12,64042,3557,1,2,1,1,0
27928,180,5397,1057,646,719,113,100,145,1170,18,215,134,248,233,382,1740,3004,10,31186,1732,1,2,1,1,0
27929,34,986,339,213,244,17,9,65,356,10,42,26,48,52,74,259,421,5,2410,133,0,2,6,5,0
27930,256,5938,4293,999,3693,19,54,507,4312,9,155,88,170,164,258,1156,1898,4,9368,520,0,2,2,3,0
27931,256,5938,1482,859,1002,125,135,219,1607,16,219,134,251,235,385,1766,3032,9,27804,1544,1,2,2,3,0
27932,142,3309,77,34,69,0,0,8,77,3,24,16,29,27,45,114,213,1,387,21,0,2,2,5,0
27933,142,3309,712,438,573,51,9,84,763,14,102,71,128,116,199,733,1364,8,11988,666,0,2,2,5,0
27934,244,5826,722,423,573,19,0,135,741,12,172,101,199,184,300,1320,2257,6,15668,870,0,2,2,2,0
27935,244,5826,1508,847,911,44,250,301,1552,14,148,88,169,162,257,1120,1886,7,15077,837,0,2,2,2,0
27936,92,1957,1043,504,840,53,9,147,1096,9,180,112,198,189,310,1377,2344,4,11604,644,0,2,5,0,0
27937,92,1957,383,288,292,26,6,62,409,11,65,38,67,76,105,429,656,5,3719,206,0,2,5,0,0
27938,99,4081,1289,550,1043,56,32,155,1345,10,167,93,185,177,278,1266,2075,5,11498,638,0,2,43,36,0
27939,179,7977,139,89,101,2,0,35,141,7,54,34,62,61,96,330,569,4,2287,127,0,2,6,0,0
27940,179,7977,7,5,5,0,0,2,7,1,2,1,2,3,3,2,4,0,2,0,0,2,6,0,0
27941,64,2851,1293,570,1093,25,15,163,1318,10,195,123,241,205,364,1516,2795,6,17273,959,0,2,32,11,0
27942,224,4845,1943,715,1694,26,18,214,1969,12,185,120,237,197,357,1436,2721,7,20915,1161,0,2,3,1,0
27943,224,4845,1168,838,957,57,25,144,1225,19,348,224,416,367,640,3018,5452,11,61921,3440,1,2,3,1,0
27944,98,4059,1289,550,1043,56,32,155,1345,10,167,93,185,177,278,1266,2075,5,11498,638,0,2,2,2,0
27945,99,5070,1943,715,1694,26,18,214,1969,12,185,120,237,197,357,1436,2721,7,20915,1161,0,2,2,2,0
27946,218,4718,2,2,2,0,0,0,2,0,0,0,0,0,0,0,0,0,0,0,0,2,1,0,0
27947,218,4718,99,48,90,1,3,5,100,0,0,0,0,0,0,0,0,0,0,0,0,2,1,0,0
27948,218,4718,8,5,5,2,0,1,10,0,0,0,0,0,0,0,0,0,0,0,0,2,1,0,0
27949,218,4718,1217,716,841,84,126,174,1301,14,185,118,215,199,333,1446,2542,8,20687,1149,0,2,1,0,0
27950,218,4718,160,89,115,0,13,31,160,7,15,11,17,22,28,78,124,3,495,27,0,2,1,0,0
27951,218,4718,10,10,9,9,0,0,19,0,0,0,0,0,0,0,0,0,0,0,0,2,1,0,0
27952,218,4718,173,84,99,8,29,36,181,5,12,7,13,17,20,54,81,2,221,12,0,2,1,0,0
27953,218,4718,3,1,1,3,0,0,6,0,0,0,0,0,0,0,0,0,0,0,0,2,1,0,0
27954,25,412,219,78,157,11,5,46,230,3,24,20,34,27,54,114,256,2,545,30,0,2,7,8,0
27955,25,412,108,64,79,9,0,20,117,5,15,11,19,20,30,70,129,3,410,22,0,2,7,8,0
27956,10,454,219,78,157,11,5,46,230,3,24,20,34,27,54,114,256,2,545,30,0,2,6,6,0
27957,25,418,219,78,157,11,5,46,230,3,24,20,34,27,54,114,256,2,545,30,0,2,28,15,0
27958,25,418,108,64,79,9,0,20,117,5,15,11,19,20,30,70,129,3,410,22,0,2,28,15,0
27959,10,454,219,78,157,11,5,46,230,3,24,20,34,27,54,114,256,2,545,30,0,2,53,40,0
27960,9,441,219,78,157,11,5,46,230,3,24,20,34,27,54,114,256,2,545,30,0,2,1,4,0
27961,25,418,219,78,157,11,5,46,230,3,24,20,34,27,54,114,256,2,545,30,0,2,1,1,0
27962,25,418,108,64,79,9,0,20,117,5,15,11,19,20,30,70,129,3,410,22,0,2,1,1,0
27963,180,5397,1660,832,1314,41,38,274,1701,20,312,209,395,332,604,2671,5058,12,64042,3557,1,2,1,1,0
27964,180,5397,1057,646,719,113,100,145,1170,18,215,134,248,233,382,1740,3004,10,31186,1732,1,2,1,1,0
27965,34,986,339,213,244,17,9,65,356,10,42,26,48,52,74,259,421,5,2410,133,0,2,6,5,0
27966,256,5938,4293,999,3693,19,54,507,4312,9,155,88,170,164,258,1156,1898,4,9368,520,0,2,2,3,0
27967,256,5938,1482,859,1002,125,135,219,1607,16,219,134,251,235,385,1766,3032,9,27804,1544,1,2,2,3,0
27968,142,3309,77,34,69,0,0,8,77,3,24,16,29,27,45,114,213,1,387,21,0,2,2,5,0
27969,142,3309,712,438,573,51,9,84,763,14,102,71,128,116,199,733,1364,8,11988,666,0,2,2,5,0
27970,244,5826,722,423,573,19,0,135,741,12,172,101,199,184,300,1320,2257,6,15668,870,0,2,2,2,0
27971,244,5826,1508,847,911,44,250,301,1552,14,148,88,169,162,257,1120,1886,7,15077,837,0,2,2,2,0
27972,92,1957,1043,504,840,53,9,147,1096,9,180,112,198,189,310,1377,2344,4,11604,644,0,2,5,0,0
27973,92,1957,383,288,292,26,6,62,409,11,65,38,67,76,105,429,656,5,3719,206,0,2,5,0,0
27974,99,4081,1289,550,1043,56,32,155,1345,10,167,93,185,177,278,1266,2075,5,11498,638,0,2,43,36,0
27975,179,7977,139,89,101,2,0,35,141,7,54,34,62,61,96,330,569,4,2287,127,0,2,6,0,0
27976,179,7977,7,5,5,0,0,2,7,1,2,1,2,3,3,2,4,0,2,0,0,2,6,0,0
27977,64,2851,1293,570,1093,25,15,163,1318,10,195,123,241,205,364,1516,2795,6,17273,959,0,2,32,11,0
27978,44,3226,996,429,845,24,10,117,1020,7,76,50,88,83,138,494,879,4,3565,198,0,2,2,1,1
27979,98,2666,1523,757,1297,19,12,193,1542,12,193,117,230,205,347,1508,2664,7,19053,1058,0,2,5,3,0
27980,98,2666,701,378,504,33,58,109,734,13,110,68,126,123,194,794,1346,7,10027,557,0,2,5,3,0
27981,96,4691,1523,757,1297,19,12,193,1542,12,193,117,230,205,347,1508,2664,7,19053,1058,0,2,16,0,0
27982,224,4845,1943,715,1694,26,18,214,1969,12,185,120,237,197,357,1436,2721,7,20915,1161,0,2,3,1,0
27983,224,4845,1168,838,957,57,25,144,1225,19,348,224,416,367,640,3018,5452,11,61921,3440,1,2,3,1,0
27984,99,4081,1289,550,1043,56,32,155,1345,10,167,93,185,177,278,1266,2075,5,11498,638,0,2,2,2,0
27985,99,5070,1943,715,1694,26,18,214,1969,12,185,120,237,197,357,1436,2721,7,20915,1161,0,2,2,2,0
27986,98,2666,1523,757,1297,19,12,193,1542,12,193,117,230,205,347,1508,2664,7,19053,1058,0,2,5,3,0
27987,98,2666,701,378,504,33,58,109,734,13,110,68,126,123,194,794,1346,7,10027,557,0,2,5,3,0
27988,96,4691,1523,757,1297,19,12,193,1542,12,193,117,230,205,347,1508,2664,7,19053,1058,0,2,16,0,0
27989,1,86,42,7,35,4,0,5,46,1,2,1,2,3,3,2,4,0,2,0,0,2,19,111,0
27990,1,86,11,6,10,0,0,1,11,2,4,2,4,6,6,10,15,1,15,0,0,2,19,111,0
27991,222,4841,182,127,129,0,0,53,182,5,39,21,42,44,63,217,343,2,926,51,0,2,70,7,0
27992,222,4841,1165,710,800,67,119,181,1232,18,243,153,282,261,435,2000,3492,10,36473,2026,1,2,70,7,0
27993,180,5397,1660,832,1314,41,38,274,1701,20,312,209,395,332,604,2671,5058,12,64042,3557,1,2,3,2,0
27994,180,5397,1057,646,719,113,100,145,1170,18,215,134,248,233,382,1740,3004,10,31186,1732,1,2,3,2,0
27995,76,1733,996,429,845,24,10,117,1020,7,76,50,88,83,138,494,879,4,3565,198,0,2,4,5,0
27996,76,1733,456,277,329,12,42,72,468,13,85,50,97,98,147,592,972,7,7212,400,0,2,4,5,0
27997,67,1324,207,111,150,11,0,50,218,5,26,19,36,31,55,133,272,3,943,52,0,2,0,7,0
27998,67,1324,410,198,237,31,55,97,441,11,63,38,72,74,110,414,683,6,4293,238,0,2,0,7,0
27999,218,4716,2,2,2,0,0,0,2,0,0,0,0,0,0,0,0,0,0,0,0,2,32,29,0
28000,218,4716,99,48,90,1,3,5,100,0,0,0,0,0,0,0,0,0,0,0,0,2,32,29,0
28001,218,4716,8,5,5,2,0,1,10,0,0,0,0,0,0,0,0,0,0,0,0,2,32,29,0
28002,218,4716,1217,716,841,84,126,174,1301,14,185,118,215,199,333,1446,2542,8,20687,1149,0,2,32,29,0
28003,218,4716,160,89,115,0,13,31,160,7,15,11,17,22,28,78,124,3,495,27,0,2,32,29,0
28004,218,4716,10,10,9,9,0,0,19,0,0,0,0,0,0,0,0,0,0,0,0,2,32,29,0
28005,218,4716,173,84,99,8,29,36,181,5,12,7,13,17,20,54,81,2,221,12,0,2,32,29,0
28006,218,4716,3,1,1,3,0,0,6,0,0,0,0,0,0,0,0,0,0,0,0,2,32,29,0
28007,51,757,167,116,138,4,5,22,171,8,48,30,56,56,86,292,499,4,2330,129,0,2,3,6,0
28008,256,5938,4293,999,3693,19,54,507,4312,9,155,88,170,164,258,1156,1898,4,9368,520,0,2,20,15,0
28009,256,5938,1482,859,1002,125,135,219,1607,16,219,134,251,235,385,1766,3032,9,27804,1544,1,2,20,15,0
28010,88,2299,773,422,505,30,103,129,803,14,77,46,83,91,129,535,839,7,6334,351,0,2,26,15,0
28011,142,3309,77,34,69,0,0,8,77,3,24,16,29,27,45,114,213,1,387,21,0,2,10,4,0
28012,142,3309,712,438,573,51,9,84,763,14,102,71,128,116,199,733,1364,8,11988,666,0,2,10,4,0
28013,24,600,2,2,2,0,0,0,2,0,0,0,0,0,0,0,0,0,0,0,0,2,2,7,0
28014,24,600,99,48,90,1,3,5,100,0,0,0,0,0,0,0,0,0,0,0,0,2,2,7,0
28015,24,600,8,5,5,2,0,1,10,0,0,0,0,0,0,0,0,0,0,0,0,2,2,7,0
28016,24,600,1217,716,841,84,126,174,1301,14,185,118,215,199,333,1446,2542,8,20687,1149,0,2,2,7,0
28017,24,600,160,89,115,0,13,31,160,7,15,11,17,22,28,78,124,3,495,27,0,2,2,7,0
28018,24,600,10,10,9,9,0,0,19,0,0,0,0,0,0,0,0,0,0,0,0,2,2,7,0
28019,24,600,173,84,99,8,29,36,181,5,12,7,13,17,20,54,81,2,221,12,0,2,2,7,0
28020,24,600,3,1,1,3,0,0,6,0,0,0,0,0,0,0,0,0,0,0,0,2,2,7,0
28021,88,1887,402,202,227,24,74,80,426,12,52,33,61,64,94,339,564,7,3969,220,0,2,11,2,0
28022,88,1985,53,23,39,0,0,13,53,2,8,4,8,10,12,26,39,1,39,2,0,2,12,9,0
28023,88,1985,515,298,307,33,80,99,548,12,63,44,77,75,121,419,753,7,5527,307,0,2,12,9,0
28024,20,522,205,80,86,16,53,53,221,7,18,10,19,25,29,94,134,3,497,27,0,2,10,4,0
28025,50,1112,91,45,69,0,3,18,91,3,9,6,10,12,16,33,57,1,95,5,0,0,283,0,0
28026,50,1112,367,234,237,17,34,68,384,16,55,34,61,71,95,381,584,8,5183,287,0,0,283,0,0
28027,244,5826,722,423,573,19,0,135,741,12,172,101,199,184,300,1320,2257,6,15668,870,0,2,68,6,0
28028,244,5826,1508,847,911,44,250,301,1552,14,148,88,169,162,257,1120,1886,7,15077,837,0,2,68,6,0
28029,305,6770,72,33,56,0,4,12,72,1,1,1,1,2,2,0,2,0,1,0,0,2,32,56,0
28030,305,6770,1454,835,1044,76,110,219,1530,17,275,158,296,292,454,2297,3718,9,34017,1889,1,2,32,56,0
28031,41,829,386,256,301,16,9,68,402,4,59,35,69,63,104,355,621,2,1453,80,0,2,18,39,0
28032,41,829,264,131,164,11,41,46,275,6,38,22,40,44,62,214,338,3,1068,59,0,2,18,39,0
28033,30,654,215,129,180,6,0,29,221,8,65,43,72,73,115,415,711,4,3153,175,0,2,1,2,0
28034,30,654,97,69,77,3,3,16,100,6,22,13,23,28,36,113,173,3,542,30,0,2,1,2,0
28035,224,4845,1943,715,1694,26,18,214,1969,12,185,120,237,197,357,1436,2721,7,20915,1161,0,2,3,1,0
28036,224,4845,1168,838,957,57,25,144,1225,19,348,224,416,367,640,3018,5452,11,61921,3440,1,2,3,1,0
28037,19,669,442,244,305,14,16,103,456,11,68,45,75,79,120,452,756,6,4588,254,0,2,113,58,0
28038,19,669,182,102,99,11,40,35,193,3,11,6,11,14,17,42,64,1,97,5,0,2,113,58,0
28039,2,114,37,13,25,0,6,6,37,1,2,1,2,3,3,2,4,0,2,0,0,2,18,0,0
28040,2,114,133,47,40,1,43,49,134,0,0,0,0,0,0,0,0,0,0,0,0,2,18,0,0
28041,29,716,601,196,481,2,23,85,603,8,63,36,72,71,108,400,664,4,3036,168,0,2,10,10,0
28042,29,716,156,79,106,5,16,28,161,5,14,8,15,19,23,64,97,2,261,14,0,2,10,10,0
28043,99,4081,1289,550,1043,56,32,155,1345,10,167,93,185,177,278,1266,2075,5,11498,638,0,2,42,12,0
28044,152,7140,1392,870,1177,35,17,170,1427,14,494,280,531,508,811,4473,7289,7,54850,3047,2,2,15,5,0
28045,24,1145,75,38,59,1,3,12,76,2,4,2,4,6,6,10,15,1,15,0,0,2,68,0,0
28046,33,2202,1157,318,931,29,22,177,1186,6,104,63,125,110,188,712,1274,3,4596,255,0,2,58,0,0
28047,103,4797,1338,495,1086,10,64,173,1348,11,122,82,157,133,239,883,1686,7,11934,663,0,2,6,0,0
28048,179,7977,139,89,101,2,0,35,141,7,54,34,62,61,96,330,569,4,2287,127,0,2,42,43,0
28049,179,7977,7,5,5,0,0,2,7,1,2,1,2,3,3,2,4,0,2,0,0,2,42,43,0
28050,138,6146,1782,648,1425,9,47,279,1791,8,171,97,189,179,286,1292,2140,4,9462,525,0,2,19,19,0
28051,40,2477,652,304,544,16,6,88,668,6,89,51,101,95,152,591,998,3,3399,188,0,2,47,1,0
28052,97,4228,1020,354,843,12,15,144,1032,8,134,77,144,142,221,970,1580,4,6792,377,0,2,39,4,0
28053,47,2228,722,423,573,19,0,135,741,12,172,101,199,184,300,1320,2257,6,15668,870,0,2,32,0,0
28054,42,1848,386,256,301,16,9,68,402,4,59,35,69,63,104,355,621,2,1453,80,0,2,24,7,0
28055,84,3226,1043,504,840,53,9,147,1096,9,180,112,198,189,310,1377,2344,4,11604,644,0,2,29,1,0
28056,99,5070,1943,715,1694,26,18,214,1969,12,185,120,237,197,357,1436,2721,7,20915,1161,0,2,2,2,0
28057,27,1218,442,244,305,14,16,103,456,11,68,45,75,79,120,452,756,6,4588,254,0,2,118,9,0
28058,40,1425,601,196,481,2,23,85,603,8,63,36,72,71,108,400,664,4,3036,168,0,2,66,4,0
28059,1,86,42,7,35,4,0,5,46,1,2,1,2,3,3,2,4,0,2,0,0,2,19,111,0
28060,1,86,11,6,10,0,0,1,11,2,4,2,4,6,6,10,15,1,15,0,0,2,19,111,0
28061,222,4841,182,127,129,0,0,53,182,5,39,21,42,44,63,217,343,2,926,51,0,2,70,7,0
28062,222,4841,1165,710,800,67,119,181,1232,18,243,153,282,261,435,2000,3492,10,36473,2026,1,2,70,7,0
28063,180,5397,1660,832,1314,41,38,274,1701,20,312,209,395,332,604,2671,5058,12,64042,3557,1,2,3,2,0
28064,180,5397,1057,646,719,113,100,145,1170,18,215,134,248,233,382,1740,3004,10,31186,1732,1,2,3,2,0
28065,76,1733,996,429,845,24,10,117,1020,7,76,50,88,83,138,494,879,4,3565,198,0,2,4,5,0
28066,76,1733,456,277,329,12,42,72,468,13,85,50,97,98,147,592,972,7,7212,400,0,2,4,5,0
28067,67,1324,207,111,150,11,0,50,218,5,26,19,36,31,55,133,272,3,943,52,0,2,0,7,0
28068,67,1324,410,198,237,31,55,97,441,11,63,38,72,74,110,414,683,6,4293,238,0,2,0,7,0
28069,218,4716,2,2,2,0,0,0,2,0,0,0,0,0,0,0,0,0,0,0,0,2,32,29,0
28070,218,4716,99,48,90,1,3,5,100,0,0,0,0,0,0,0,0,0,0,0,0,2,32,29,0
28071,218,4716,8,5,5,2,0,1,10,0,0,0,0,0,0,0,0,0,0,0,0,2,32,29,0
28072,218,4716,1217,716,841,84,126,174,1301,14,185,118,215,199,333,1446,2542,8,20687,1149,0,2,32,29,0
28073,218,4716,160,89,115,0,13,31,160,7,15,11,17,22,28,78,124,3,495,27,0,2,32,29,0
28074,218,4716,10,10,9,9,0,0,19,0,0,0,0,0,0,0,0,0,0,0,0,2,32,29,0
28075,218,4716,173,84,99,8,29,36,181,5,12,7,13,17,20,54,81,2,221,12,0,2,32,29,0
28076,218,4716,3,1,1,3,0,0,6,0,0,0,0,0,0,0,0,0,0,0,0,2,32,29,0
28077,51,757,167,116,138,4,5,22,171,8,48,30,56,56,86,292,499,4,2330,129,0,2,3,6,0
28078,256,5938,4293,999,3693,19,54,507,4312,9,155,88,170,164,258,1156,1898,4,9368,520,0,2,20,15,0
28079,256,5938,1482,859,1002,125,135,219,1607,16,219,134,251,235,385,1766,3032,9,27804,1544,1,2,20,15,0
28080,88,2299,773,422,505,30,103,129,803,14,77,46,83,91,129,535,839,7,6334,351,0,2,26,15,0
28081,142,3309,77,34,69,0,0,8,77,3,24,16,29,27,45,114,213,1,387,21,0,2,10,4,0
28082,142,3309,712,438,573,51,9,84,763,14,102,71,128,116,199,733,1364,8,11988,666,0,2,10,4,0
28083,24,600,2,2,2,0,0,0,2,0,0,0,0,0,0,0,0,0,0,0,0,2,2,7,0
28084,24,600,99,48,90,1,3,5,100,0,0,0,0,0,0,0,0,0,0,0,0,2,2,7,0
28085,24,600,8,5,5,2,0,1,10,0,0,0,0,0,0,0,0,0,0,0,0,2,2,7,0
28086,24,600,1217,716,841,84,126,174,1301,14,185,118,215,199,333,1446,2542,8,20687,1149,0,2,2,7,0
28087,24,600,160,89,115,0,13,31,160,7,15,11,17,22,28,78,124,3,495,27,0,2,2,7,0
28088,24,600,10,10,9,9,0,0,19,0,0,0,0,0,0,0,0,0,0,0,0,2,2,7,0
28089,24,600,173,84,99,8,29,36,181,5,12,7,13,17,20,54,81,2,221,12,0,2,2,7,0
28090,24,600,3,1,1,3,0,0,6,0,0,0,0,0,0,0,0,0,0,0,0,2,2,7,0
28091,88,1887,402,202,227,24,74,80,426,12,52,33,61,64,94,339,564,7,3969,220,0,2,11,2,0
28092,88,1985,53,23,39,0,0,13,53,2,8,4,8,10,12,26,39,1,39,2,0,2,12,9,0
28093,88,1985,515,298,307,33,80,99,548,12,63,44,77,75,121,419,753,7,5527,307,0,2,12,9,0
28094,20,522,205,80,86,16,53,53,221,7,18,10,19,25,29,94,134,3,497,27,0,2,10,4,0
28095,50,1112,91,45,69,0,3,18,91,3,9,6,10,12,16,33,57,1,95,5,0,0,283,0,0
28096,50,1112,367,234,237,17,34,68,384,16,55,34,61,71,95,381,584,8,5183,287,0,0,283,0,0
28097,244,5826,722,423,573,19,0,135,741,12,172,101,199,184,300,1320,2257,6,15668,870,0,2,68,6,0
28098,244,5826,1508,847,911,44,250,301,1552,14,148,88,169,162,257,1120,1886,7,15077,837,0,2,68,6,0
28099,305,6770,72,33,56,0,4,12,72,1,1,1,1,2,2,0,2,0,1,0,0,2,32,56,0
28100,305,6770,1454,835,1044,76,110,219,1530,17,275,158,296,292,454,2297,3718,9,34017,1889,1,2,32,56,0
28101,41,829,386,256,301,16,9,68,402,4,59,35,69,63,104,355,621,2,1453,80,0,2,18,39,0
28102,41,829,264,131,164,11,41,46,275,6,38,22,40,44,62,214,338,3,1068,59,0,2,18,39,0
28103,30,654,215,129,180,6,0,29,221,8,65,43,72,73,115,415,711,4,3153,175,0,2,1,2,0
28104,30,654,97,69,77,3,3,16,100,6,22,13,23,28,36,113,173,3,542,30,0,2,1,2,0
28105,224,4845,1943,715,1694,26,18,214,1969,12,185,120,237,197,357,1436,2721,7,20915,1161,0,2,3,1,0
28106,224,4845,1168,838,957,57,25,144,1225,19,348,224,416,367,640,3018,5452,11,61921,3440,1,2,3,1,0
28107,19,669,442,244,305,14,16,103,456,11,68,45,75,79,120,452,756,6,4588,254,0,2,113,58,0
28108,19,669,182,102,99,11,40,35,193,3,11,6,11,14,17,42,64,1,97,5,0,2,113,58,0
28109,2,114,37,13,25,0,6,6,37,1,2,1,2,3,3,2,4,0,2,0,0,2,18,0,0
28110,2,114,133,47,40,1,43,49,134,0,0,0,0,0,0,0,0,0,0,0,0,2,18,0,0
28111,29,716,601,196,481,2,23,85,603,8,63,36,72,71,108,400,664,4,3036,168,0,2,10,10,0
28112,29,716,156,79,106,5,16,28,161,5,14,8,15,19,23,64,97,2,261,14,0,2,10,10,0
28113,99,4081,1289,550,1043,56,32,155,1345,10,167,93,185,177,278,1266,2075,5,11498,638,0,2,42,12,0
28114,152,7140,1392,870,1177,35,17,170,1427,14,494,280,531,508,811,4473,7289,7,54850,3047,2,2,15,5,0
28115,24,1145,75,38,59,1,3,12,76,2,4,2,4,6,6,10,15,1,15,0,0,2,68,0,0
28116,33,2202,1157,318,931,29,22,177,1186,6,104,63,125,110,188,712,1274,3,4596,255,0,2,58,0,0
28117,103,4797,1338,495,1086,10,64,173,1348,11,122,82,157,133,239,883,1686,7,11934,663,0,2,6,0,0
28118,179,7977,139,89,101,2,0,35,141,7,54,34,62,61,96,330,569,4,2287,127,0,2,42,43,0
28119,179,7977,7,5,5,0,0,2,7,1,2,1,2,3,3,2,4,0,2,0,0,2,42,43,0
28120,138,6146,1782,648,1425,9,47,279,1791,8,171,97,189,179,286,1292,2140,4,9462,525,0,2,19,19,0
28121,40,2477,652,304,544,16,6,88,668,6,89,51,101,95,152,591,998,3,3399,188,0,2,47,1,0
28122,97,4228,1020,354,843,12,15,144,1032,8,134,77,144,142,221,970,1580,4,6792,377,0,2,39,4,0
28123,47,2228,722,423,573,19,0,135,741,12,172,101,199,184,300,1320,2257,6,15668,870,0,2,32,0,0
28124,42,1848,386,256,301,16,9,68,402,4,59,35,69,63,104,355,621,2,1453,80,0,2,24,7,0
28125,84,3226,1043,504,840,53,9,147,1096,9,180,112,198,189,310,1377,2344,4,11604,644,0,2,29,1,0
28126,99,5070,1943,715,1694,26,18,214,1969,12,185,120,237,197,357,1436,2721,7,20915,1161,0,2,2,2,0
28127,27,1218,442,244,305,14,16,103,456,11,68,45,75,79,120,452,756,6,4588,254,0,2,118,9,0
28128,40,1425,601,196,481,2,23,85,603,8,63,36,72,71,108,400,664,4,3036,168,0,2,66,4,0
28129,88,2299,773,422,505,30,103,129,803,14,77,46,83,91,129,535,839,7,6334,351,0,2,1,1,0
28130,1,86,42,7,35,4,0,5,46,1,2,1,2,3,3,2,4,0,2,0,0,2,1,1,0
28131,1,86,11,6,10,0,0,1,11,2,4,2,4,6,6,10,15,1,15,0,0,2,1,1,0
28132,53,1164,91,45,69,0,3,18,91,3,9,6,10,12,16,33,57,1,95,5,0,2,21,0,1
28133,53,1164,367,234,237,17,34,68,384,16,55,34,61,71,95,381,584,8,5183,287,0,2,21,0,1
28134,27,1248,442,244,305,14,16,103,456,11,68,45,75,79,120,452,756,6,4588,254,0,2,4,0,1
28135,29,1261,442,244,305,14,16,103,456,11,68,45,75,79,120,452,756,6,4588,254,0,2,1,1,0
28136,30,1268,442,244,305,14,16,103,456,11,68,45,75,79,120,452,756,6,4588,254,0,2,4,2,0
28137,25,397,219,78,157,11,5,46,230,3,24,20,34,27,54,114,256,2,545,30,0,2,1,3,0
28138,25,397,108,64,79,9,0,20,117,5,15,11,19,20,30,70,129,3,410,22,0,2,1,3,0
28139,30,1268,442,244,305,14,16,103,456,11,68,45,75,79,120,452,756,6,4588,254,0,2,5,3,0
28140,53,1164,91,45,69,0,3,18,91,3,9,6,10,12,16,33,57,1,95,5,0,2,21,0,0
28141,53,1164,367,234,237,17,34,68,384,16,55,34,61,71,95,381,584,8,5183,287,0,2,21,0,0
28142,30,1268,442,244,305,14,16,103,456,11,68,45,75,79,120,452,756,6,4588,254,0,2,7,1,0
28143,224,4857,1943,715,1694,26,18,214,1969,12,185,120,237,197,357,1436,2721,7,20915,1161,0,2,13,13,0
28144,224,4857,1168,838,957,57,25,144,1225,19,348,224,416,367,640,3018,5452,11,61921,3440,1,2,13,13,0
28145,41,843,386,256,301,16,9,68,402,4,59,35,69,63,104,355,621,2,1453,80,0,2,2,0,1
28146,41,843,264,131,164,11,41,46,275,6,38,22,40,44,62,214,338,3,1068,59,0,2,2,0,1
28147,43,1873,386,256,301,16,9,68,402,4,59,35,69,63,104,355,621,2,1453,80,0,2,6,0,1
28148,1,86,42,7,35,4,0,5,46,1,2,1,2,3,3,2,4,0,2,0,0,2,1,1,0
28149,1,86,11,6,10,0,0,1,11,2,4,2,4,6,6,10,15,1,15,0,0,2,1,1,0
28150,224,4857,1943,715,1694,26,18,214,1969,12,185,120,237,197,357,1436,2721,7,20915,1161,0,2,13,13,0
28151,224,4857,1168,838,957,57,25,144,1225,19,348,224,416,367,640,3018,5452,11,61921,3440,1,2,13,13,0
28152,43,898,386,256,301,16,9,68,402,4,59,35,69,63,104,355,621,2,1453,80,0,2,12,1,1
28153,43,898,264,131,164,11,41,46,275,6,38,22,40,44,62,214,338,3,1068,59,0,2,12,1,1
28154,1,86,42,7,35,4,0,5,46,1,2,1,2,3,3,2,4,0,2,0,0,2,1,1,0
28155,1,86,11,6,10,0,0,1,11,2,4,2,4,6,6,10,15,1,15,0,0,2,1,1,0
28156,98,2666,1523,757,1297,19,12,193,1542,12,193,117,230,205,347,1508,2664,7,19053,1058,0,2,5,3,0
28157,98,2666,701,378,504,33,58,109,734,13,110,68,126,123,194,794,1346,7,10027,557,0,2,5,3,0
28158,88,2299,773,422,505,30,103,129,803,14,77,46,83,91,129,535,839,7,6334,351,0,2,1,1,0
28159,53,1164,91,45,69,0,3,18,91,3,9,6,10,12,16,33,57,1,95,5,0,2,21,0,0
28160,53,1164,367,234,237,17,34,68,384,16,55,34,61,71,95,381,584,8,5183,287,0,2,21,0,0
28161,96,4691,1523,757,1297,19,12,193,1542,12,193,117,230,205,347,1508,2664,7,19053,1058,0,2,16,0,0
28162,30,1268,442,244,305,14,16,103,456,11,68,45,75,79,120,452,756,6,4588,254,0,2,7,1,0
28163,68,1356,207,111,150,11,0,50,218,5,26,19,36,31,55,133,272,3,943,52,0,2,10,2,0
28164,68,1356,410,198,237,31,55,97,441,11,63,38,72,74,110,414,683,6,4293,238,0,2,10,2,0
28165,75,3898,1296,573,1062,40,33,157,1336,8,201,118,231,209,349,1561,2689,4,12365,686,0,2,20,0,0
28166,43,898,386,256,301,16,9,68,402,4,59,35,69,63,104,355,621,2,1453,80,0,2,14,1,0
28167,43,898,264,131,164,11,41,46,275,6,38,22,40,44,62,214,338,3,1068,59,0,2,14,1,0
28168,43,1873,386,256,301,16,9,68,402,4,59,35,69,63,104,355,621,2,1453,80,0,2,6,0,0
28169,29,724,601,196,481,2,23,85,603,8,63,36,72,71,108,400,664,4,3036,168,0,2,1,1,0
28170,29,724,156,79,106,5,16,28,161,5,14,8,15,19,23,64,97,2,261,14,0,2,1,1,0
28171,41,1472,601,196,481,2,23,85,603,8,63,36,72,71,108,400,664,4,3036,168,0,2,29,0,0
28172,68,1356,207,111,150,11,0,50,218,5,26,19,36,31,55,133,272,3,943,52,0,2,10,2,0
28173,68,1356,410,198,237,31,55,97,441,11,63,38,72,74,110,414,683,6,4293,238,0,2,10,2,0
28174,75,3898,1296,573,1062,40,33,157,1336,8,201,118,231,209,349,1561,2689,4,12365,686,0,2,20,0,0
28175,29,724,601,196,481,2,23,85,603,8,63,36,72,71,108,400,664,4,3036,168,0,2,1,1,0
28176,29,724,156,79,106,5,16,28,161,5,14,8,15,19,23,64,97,2,261,14,0,2,1,1,0
28177,41,1472,601,196,481,2,23,85,603,8,63,36,72,71,108,400,664,4,3036,168,0,2,29,0,0
28178,94,2434,773,422,505,30,103,129,803,14,77,46,83,91,129,535,839,7,6334,351,0,2,23,0,0
28179,34,2285,1157,318,931,29,22,177,1186,6,104,63,125,110,188,712,1274,3,4596,255,0,2,36,0,0
28180,1,86,42,7,35,4,0,5,46,1,2,1,2,3,3,2,4,0,2,0,0,2,1,1,0
28181,1,86,11,6,10,0,0,1,11,2,4,2,4,6,6,10,15,1,15,0,0,2,1,1,0
28182,180,5397,1660,832,1314,41,38,274,1701,20,312,209,395,332,604,2671,5058,12,64042,3557,1,2,1,1,0
28183,180,5397,1057,646,719,113,100,145,1170,18,215,134,248,233,382,1740,3004,10,31186,1732,1,2,1,1,0
28184,34,986,339,213,244,17,9,65,356,10,42,26,48,52,74,259,421,5,2410,133,0,2,6,5,0
28185,256,5938,4293,999,3693,19,54,507,4312,9,155,88,170,164,258,1156,1898,4,9368,520,0,2,2,3,0
28186,256,5938,1482,859,1002,125,135,219,1607,16,219,134,251,235,385,1766,3032,9,27804,1544,1,2,2,3,0
28187,98,2666,1523,757,1297,19,12,193,1542,12,193,117,230,205,347,1508,2664,7,19053,1058,0,2,5,3,0
28188,98,2666,701,378,504,33,58,109,734,13,110,68,126,123,194,794,1346,7,10027,557,0,2,5,3,0
28189,88,2299,773,422,505,30,103,129,803,14,77,46,83,91,129,535,839,7,6334,351,0,2,1,1,0
28190,142,3309,77,34,69,0,0,8,77,3,24,16,29,27,45,114,213,1,387,21,0,2,2,5,0
28191,142,3309,712,438,573,51,9,84,763,14,102,71,128,116,199,733,1364,8,11988,666,0,2,2,5,0
28192,53,1164,91,45,69,0,3,18,91,3,9,6,10,12,16,33,57,1,95,5,0,2,21,0,0
28193,53,1164,367,234,237,17,34,68,384,16,55,34,61,71,95,381,584,8,5183,287,0,2,21,0,0
28194,244,5826,722,423,573,19,0,135,741,12,172,101,199,184,300,1320,2257,6,15668,870,0,2,2,2,0
28195,244,5826,1508,847,911,44,250,301,1552,14,148,88,169,162,257,1120,1886,7,15077,837,0,2,2,2,0
28196,92,1957,1043,504,840,53,9,147,1096,9,180,112,198,189,310,1377,2344,4,11604,644,0,2,5,0,0
28197,92,1957,383,288,292,26,6,62,409,11,65,38,67,76,105,429,656,5,3719,206,0,2,5,0,0
28198,224,4857,1943,715,1694,26,18,214,1969,12,185,120,237,197,357,1436,2721,7,20915,1161,0,2,16,14,0
28199,224,4857,1168,838,957,57,25,144,1225,19,348,224,416,367,640,3018,5452,11,61921,3440,1,2,16,14,0
28200,99,4081,1289,550,1043,56,32,155,1345,10,167,93,185,177,278,1266,2075,5,11498,638,0,2,45,38,0
28201,179,7977,139,89,101,2,0,35,141,7,54,34,62,61,96,330,569,4,2287,127,0,2,6,0,0
28202,179,7977,7,5,5,0,0,2,7,1,2,1,2,3,3,2,4,0,2,0,0,2,6,0,0
28203,96,4691,1523,757,1297,19,12,193,1542,12,193,117,230,205,347,1508,2664,7,19053,1058,0,2,16,0,0
28204,64,2851,1293,570,1093,25,15,163,1318,10,195,123,241,205,364,1516,2795,6,17273,959,0,2,32,11,0
28205,99,5070,1943,715,1694,26,18,214,1969,12,185,120,237,197,357,1436,2721,7,20915,1161,0,2,2,2,0
28206,30,1268,442,244,305,14,16,103,456,11,68,45,75,79,120,452,756,6,4588,254,0,2,7,1,0
28207,256,5953,4293,999,3693,19,54,507,4312,9,155,88,170,164,258,1156,1898,4,9368,520,0,2,10,5,0
28208,256,5953,1482,859,1002,125,135,219,1607,16,219,134,251,235,385,1766,3032,9,27804,1544,1,2,10,5,0
28209,3,33,15,9,9,0,0,6,15,0,0,0,0,0,0,0,0,0,0,0,0,0,15,0,0
28210,180,8007,139,89,101,2,0,35,141,7,54,34,62,61,96,330,569,4,2287,127,0,2,7,0,0
28211,180,8007,7,5,5,0,0,2,7,1,2,1,2,3,3,2,4,0,2,0,0,2,7,0,0
28212,94,2434,773,422,505,30,103,129,803,14,77,46,83,91,129,535,839,7,6334,351,0,2,23,0,0
28213,34,2285,1157,318,931,29,22,177,1186,6,104,63,125,110,188,712,1274,3,4596,255,0,2,36,0,0
28214,258,5960,4293,999,3693,19,54,507,4312,9,155,88,170,164,258,1156,1898,4,9368,520,0,2,4,1,1
28215,258,5960,1482,859,1002,125,135,219,1607,16,219,134,251,235,385,1766,3032,9,27804,1544,1,2,4,1,1
28216,25,1183,75,38,59,1,3,12,76,2,4,2,4,6,6,10,15,1,15,0,0,2,12,0,1
28217,2,18,10,6,6,0,0,4,10,0,0,0,0,0,0,0,0,0,0,0,0,0,10,0,1
28218,256,5953,4293,999,3693,19,54,507,4312,9,155,88,170,164,258,1156,1898,4,9368,520,0,2,10,5,0
28219,256,5953,1482,859,1002,125,135,219,1607,16,219,134,251,235,385,1766,3032,9,27804,1544,1,2,10,5,0
28220,3,33,15,9,9,0,0,6,15,0,0,0,0,0,0,0,0,0,0,0,0,0,15,0,0
28221,180,8007,139,89,101,2,0,35,141,7,54,34,62,61,96,330,569,4,2287,127,0,2,7,0,0
28222,180,8007,7,5,5,0,0,2,7,1,2,1,2,3,3,2,4,0,2,0,0,2,7,0,0
28223,258,5960,4293,999,3693,19,54,507,4312,9,155,88,170,164,258,1156,1898,4,9368,520,0,2,4,1,0
28224,258,5960,1482,859,1002,125,135,219,1607,16,219,134,251,235,385,1766,3032,9,27804,1544,1,2,4,1,0
28225,25,1183,75,38,59,1,3,12,76,2,4,2,4,6,6,10,15,1,15,0,0,2,12,0,0
28226,2,18,10,6,6,0,0,4,10,0,0,0,0,0,0,0,0,0,0,0,0,0,10,0,0
28227,180,5397,1660,832,1314,41,38,274,1701,20,312,209,395,332,604,2671,5058,12,64042,3557,1,2,1,2,0
28228,180,5397,1057,646,719,113,100,145,1170,18,215,134,248,233,382,1740,3004,10,31186,1732,1,2,1,2,0
28229,53,1166,91,45,69,0,3,18,91,3,9,6,10,12,16,33,57,1,95,5,0,2,2,2,0
28230,53,1166,367,234,237,17,34,68,384,16,55,34,61,71,95,381,584,8,5183,287,0,2,2,2,0
28231,180,5397,1660,832,1314,41,38,274,1701,20,312,209,395,332,604,2671,5058,12,64042,3557,1,2,1,2,0
28232,180,5397,1057,646,719,113,100,145,1170,18,215,134,248,233,382,1740,3004,10,31186,1732,1,2,1,2,0
28233,53,1166,91,45,69,0,3,18,91,3,9,6,10,12,16,33,57,1,95,5,0,2,2,2,0
28234,53,1166,367,234,237,17,34,68,384,16,55,34,61,71,95,381,584,8,5183,287,0,2,2,2,0
28235,218,4720,2,2,2,0,0,0,2,0,0,0,0,0,0,0,0,0,0,0,0,2,1,1,0
28236,218,4720,99,48,90,1,3,5,100,0,0,0,0,0,0,0,0,0,0,0,0,2,1,1,0
28237,218,4720,8,5,5,2,0,1,10,0,0,0,0,0,0,0,0,0,0,0,0,2,1,1,0
28238,218,4720,1217,716,841,84,126,174,1301,14,185,118,215,199,333,1446,2542,8,20687,1149,0,2,1,1,0
28239,218,4720,160,89,115,0,13,31,160,7,15,11,17,22,28,78,124,3,495,27,0,2,1,1,0
28240,218,4720,10,10,9,9,0,0,19,0,0,0,0,0,0,0,0,0,0,0,0,2,1,1,0
28241,218,4720,173,84,99,8,29,36,181,5,12,7,13,17,20,54,81,2,221,12,0,2,1,1,0
28242,218,4720,3,1,1,3,0,0,6,0,0,0,0,0,0,0,0,0,0,0,0,2,1,1,0
28243,40,2509,652,304,544,16,6,88,668,6,89,51,101,95,152,591,998,3,3399,188,0,2,7,1,0
28244,52,1137,91,45,69,0,3,18,91,3,9,6,10,12,16,33,57,1,95,5,0,2,2,10,0
28245,52,1137,367,234,237,17,34,68,384,16,55,34,61,71,95,381,584,8,5183,287,0,2,2,10,0
28246,52,1137,91,45,69,0,3,18,91,3,9,6,10,12,16,33,57,1,95,5,0,2,2,10,0
28247,52,1137,367,234,237,17,34,68,384,16,55,34,61,71,95,381,584,8,5183,287,0,2,2,10,0
28248,218,4720,2,2,2,0,0,0,2,0,0,0,0,0,0,0,0,0,0,0,0,2,1,1,0
28249,218,4720,99,48,90,1,3,5,100,0,0,0,0,0,0,0,0,0,0,0,0,2,1,1,0
28250,218,4720,8,5,5,2,0,1,10,0,0,0,0,0,0,0,0,0,0,0,0,2,1,1,0
28251,218,4720,1217,716,841,84,126,174,1301,14,185,118,215,199,333,1446,2542,8,20687,1149,0,2,1,1,0
28252,218,4720,160,89,115,0,13,31,160,7,15,11,17,22,28,78,124,3,495,27,0,2,1,1,0
28253,218,4720,10,10,9,9,0,0,19,0,0,0,0,0,0,0,0,0,0,0,0,2,1,1,0
28254,218,4720,173,84,99,8,29,36,181,5,12,7,13,17,20,54,81,2,221,12,0,2,1,1,0
28255,218,4720,3,1,1,3,0,0,6,0,0,0,0,0,0,0,0,0,0,0,0,2,1,1,0
28256,40,2509,652,304,544,16,6,88,668,6,89,51,101,95,152,591,998,3,3399,188,0,2,7,1,0
28257,227,4920,1943,715,1694,26,18,214,1969,12,185,120,237,197,357,1436,2721,7,20915,1161,0,2,13,2,1
28258,227,4920,1168,838,957,57,25,144,1225,19,348,224,416,367,640,3018,5452,11,61921,3440,1,2,13,2,1
28259,218,4727,2,2,2,0,0,0,2,0,0,0,0,0,0,0,0,0,0,0,0,2,2,0,0
28260,218,4727,99,48,90,1,3,5,100,0,0,0,0,0,0,0,0,0,0,0,0,2,2,0,0
28261,218,4727,8,5,5,2,0,1,10,0,0,0,0,0,0,0,0,0,0,0,0,2,2,0,0
28262,218,4727,1217,716,841,84,126,174,1301,14,185,118,215,199,333,1446,2542,8,20687,1149,0,2,2,0,0
28263,218,4727,160,89,115,0,13,31,160,7,15,11,17,22,28,78,124,3,495,27,0,2,2,0,0
28264,218,4727,10,10,9,9,0,0,19,0,0,0,0,0,0,0,0,0,0,0,0,2,2,0,0
28265,218,4727,173,84,99,8,29,36,181,5,12,7,13,17,20,54,81,2,221,12,0,2,2,0,0
28266,218,4727,3,1,1,3,0,0,6,0,0,0,0,0,0,0,0,0,0,0,0,2,2,0,0
28267,227,4920,1943,715,1694,26,18,214,1969,12,185,120,237,197,357,1436,2721,7,20915,1161,0,2,13,2,0
28268,227,4920,1168,838,957,57,25,144,1225,19,348,224,416,367,640,3018,5452,11,61921,3440,1,2,13,2,0
28269,180,5397,1660,832,1314,41,38,274,1701,20,312,209,395,332,604,2671,5058,12,64042,3557,1,2,1,2,0
28270,180,5397,1057,646,719,113,100,145,1170,18,215,134,248,233,382,1740,3004,10,31186,1732,1,2,1,2,0
28271,68,1356,207,111,150,11,0,50,218,5,26,19,36,31,55,133,272,3,943,52,0,2,10,2,0
28272,68,1356,410,198,237,31,55,97,441,11,63,38,72,74,110,414,683,6,4293,238,0,2,10,2,0
28273,218,4720,2,2,2,0,0,0,2,0,0,0,0,0,0,0,0,0,0,0,0,2,1,1,0
28274,218,4720,99,48,90,1,3,5,100,0,0,0,0,0,0,0,0,0,0,0,0,2,1,1,0
28275,218,4720,8,5,5,2,0,1,10,0,0,0,0,0,0,0,0,0,0,0,0,2,1,1,0
28276,218,4720,1217,716,841,84,126,174,1301,14,185,118,215,199,333,1446,2542,8,20687,1149,0,2,1,1,0
28277,218,4720,160,89,115,0,13,31,160,7,15,11,17,22,28,78,124,3,495,27,0,2,1,1,0
28278,218,4720,10,10,9,9,0,0,19,0,0,0,0,0,0,0,0,0,0,0,0,2,1,1,0
28279,218,4720,173,84,99,8,29,36,181,5,12,7,13,17,20,54,81,2,221,12,0,2,1,1,0
28280,218,4720,3,1,1,3,0,0,6,0,0,0,0,0,0,0,0,0,0,0,0,2,1,1,0
28281,258,5975,4293,999,3693,19,54,507,4312,9,155,88,170,164,258,1156,1898,4,9368,520,0,2,10,5,0
28282,258,5975,1482,859,1002,125,135,219,1607,16,219,134,251,235,385,1766,3032,9,27804,1544,1,2,10,5,0
28283,94,2434,773,422,505,30,103,129,803,14,77,46,83,91,129,535,839,7,6334,351,0,2,23,0,0
28284,52,1139,91,45,69,0,3,18,91,3,9,6,10,12,16,33,57,1,95,5,0,2,2,2,0
28285,52,1139,367,234,237,17,34,68,384,16,55,34,61,71,95,381,584,8,5183,287,0,2,2,2,0
28286,43,898,386,256,301,16,9,68,402,4,59,35,69,63,104,355,621,2,1453,80,0,2,14,1,0
28287,43,898,264,131,164,11,41,46,275,6,38,22,40,44,62,214,338,3,1068,59,0,2,14,1,0
28288,29,724,601,196,481,2,23,85,603,8,63,36,72,71,108,400,664,4,3036,168,0,2,1,1,0
28289,29,724,156,79,106,5,16,28,161,5,14,8,15,19,23,64,97,2,261,14,0,2,1,1,0
28290,3,33,15,9,9,0,0,6,15,0,0,0,0,0,0,0,0,0,0,0,0,0,15,0,0
28291,34,2285,1157,318,931,29,22,177,1186,6,104,63,125,110,188,712,1274,3,4596,255,0,2,36,0,0
28292,180,8007,139,89,101,2,0,35,141,7,54,34,62,61,96,330,569,4,2287,127,0,2,7,0,0
28293,180,8007,7,5,5,0,0,2,7,1,2,1,2,3,3,2,4,0,2,0,0,2,7,0,0
28294,75,3898,1296,573,1062,40,33,157,1336,8,201,118,231,209,349,1561,2689,4,12365,686,0,2,20,0,0
28295,40,2509,652,304,544,16,6,88,668,6,89,51,101,95,152,591,998,3,3399,188,0,2,7,1,0
28296,43,1873,386,256,301,16,9,68,402,4,59,35,69,63,104,355,621,2,1453,80,0,2,6,0,0
28297,41,1472,601,196,481,2,23,85,603,8,63,36,72,71,108,400,664,4,3036,168,0,2,29,0,0
28298,31,934,339,213,244,17,9,65,356,10,42,26,48,52,74,259,421,5,2410,133,0,2,0,15,0
28299,64,2859,1293,570,1093,25,15,163,1318,10,195,123,241,205,364,1516,2795,6,17273,959,0,2,7,1,0
28300,180,5397,1660,832,1314,41,38,274,1701,20,312,209,395,332,604,2671,5058,12,64042,3557,1,2,1,2,0
28301,180,5397,1057,646,719,113,100,145,1170,18,215,134,248,233,382,1740,3004,10,31186,1732,1,2,1,2,0
28302,68,1356,207,111,150,11,0,50,218,5,26,19,36,31,55,133,272,3,943,52,0,2,10,2,0
28303,68,1356,410,198,237,31,55,97,441,11,63,38,72,74,110,414,683,6,4293,238,0,2,10,2,0
28304,218,4720,2,2,2,0,0,0,2,0,0,0,0,0,0,0,0,0,0,0,0,2,1,1,0
28305,218,4720,99,48,90,1,3,5,100,0,0,0,0,0,0,0,0,0,0,0,0,2,1,1,0
28306,218,4720,8,5,5,2,0,1,10,0,0,0,0,0,0,0,0,0,0,0,0,2,1,1,0
28307,218,4720,1217,716,841,84,126,174,1301,14,185,118,215,199,333,1446,2542,8,20687,1149,0,2,1,1,0
28308,218,4720,160,89,115,0,13,31,160,7,15,11,17,22,28,78,124,3,495,27,0,2,1,1,0
28309,218,4720,10,10,9,9,0,0,19,0,0,0,0,0,0,0,0,0,0,0,0,2,1,1,0
28310,218,4720,173,84,99,8,29,36,181,5,12,7,13,17,20,54,81,2,221,12,0,2,1,1,0
28311,218,4720,3,1,1,3,0,0,6,0,0,0,0,0,0,0,0,0,0,0,0,2,1,1,0
28312,258,5975,4293,999,3693,19,54,507,4312,9,155,88,170,164,258,1156,1898,4,9368,520,0,2,10,5,0
28313,258,5975,1482,859,1002,125,135,219,1607,16,219,134,251,235,385,1766,3032,9,27804,1544,1,2,10,5,0
28314,94,2434,773,422,505,30,103,129,803,14,77,46,83,91,129,535,839,7,6334,351,0,2,23,0,0
28315,52,1139,91,45,69,0,3,18,91,3,9,6,10,12,16,33,57,1,95,5,0,2,2,2,0
28316,52,1139,367,234,237,17,34,68,384,16,55,34,61,71,95,381,584,8,5183,287,0,2,2,2,0
28317,43,898,386,256,301,16,9,68,402,4,59,35,69,63,104,355,621,2,1453,80,0,2,14,1,0
28318,43,898,264,131,164,11,41,46,275,6,38,22,40,44,62,214,338,3,1068,59,0,2,14,1,0
28319,29,724,601,196,481,2,23,85,603,8,63,36,72,71,108,400,664,4,3036,168,0,2,1,1,0
28320,29,724,156,79,106,5,16,28,161,5,14,8,15,19,23,64,97,2,261,14,0,2,1,1,0
28321,3,33,15,9,9,0,0,6,15,0,0,0,0,0,0,0,0,0,0,0,0,0,15,0,0
28322,34,2285,1157,318,931,29,22,177,1186,6,104,63,125,110,188,712,1274,3,4596,255,0,2,36,0,0
28323,180,8007,139,89,101,2,0,35,141,7,54,34,62,61,96,330,569,4,2287,127,0,2,7,0,0
28324,180,8007,7,5,5,0,0,2,7,1,2,1,2,3,3,2,4,0,2,0,0,2,7,0,0
28325,75,3898,1296,573,1062,40,33,157,1336,8,201,118,231,209,349,1561,2689,4,12365,686,0,2,20,0,0
28326,40,2509,652,304,544,16,6,88,668,6,89,51,101,95,152,591,998,3,3399,188,0,2,7,1,0
28327,43,1873,386,256,301,16,9,68,402,4,59,35,69,63,104,355,621,2,1453,80,0,2,6,0,0
28328,41,1472,601,196,481,2,23,85,603,8,63,36,72,71,108,400,664,4,3036,168,0,2,29,0,0
28329,31,932,339,213,244,17,9,65,356,10,42,26,48,52,74,259,421,5,2410,133,0,2,0,1,0
28330,31,932,339,213,244,17,9,65,356,10,42,26,48,52,74,259,421,5,2410,133,0,2,0,1,0
28331,223,4835,1943,715,1694,26,18,214,1969,12,185,120,237,197,357,1436,2721,7,20915,1161,0,2,2,3,0
28332,223,4835,1168,838,957,57,25,144,1225,19,348,224,416,367,640,3018,5452,11,61921,3440,1,2,2,3,0
28333,41,1474,601,196,481,2,23,85,603,8,63,36,72,71,108,400,664,4,3036,168,0,2,3,2,0
28334,94,2434,773,422,505,30,103,129,803,14,77,46,83,91,129,535,839,7,6334,351,0,2,2,2,0
28335,218,4736,2,2,2,0,0,0,2,0,0,0,0,0,0,0,0,0,0,0,0,2,4,1,0
28336,218,4736,99,48,90,1,3,5,100,0,0,0,0,0,0,0,0,0,0,0,0,2,4,1,0
28337,218,4736,8,5,5,2,0,1,10,0,0,0,0,0,0,0,0,0,0,0,0,2,4,1,0
28338,218,4736,1217,716,841,84,126,174,1301,14,185,118,215,199,333,1446,2542,8,20687,1149,0,2,4,1,0
28339,218,4736,160,89,115,0,13,31,160,7,15,11,17,22,28,78,124,3,495,27,0,2,4,1,0
28340,218,4736,10,10,9,9,0,0,19,0,0,0,0,0,0,0,0,0,0,0,0,2,4,1,0
28341,218,4736,173,84,99,8,29,36,181,5,12,7,13,17,20,54,81,2,221,12,0,2,4,1,0
28342,218,4736,3,1,1,3,0,0,6,0,0,0,0,0,0,0,0,0,0,0,0,2,4,1,0
28343,94,2434,773,422,505,30,103,129,803,14,77,46,83,91,129,535,839,7,6334,351,0,2,2,2,0
28344,218,4740,2,2,2,0,0,0,2,0,0,0,0,0,0,0,0,0,0,0,0,2,5,0,0
28345,218,4740,99,48,90,1,3,5,100,0,0,0,0,0,0,0,0,0,0,0,0,2,5,0,0
28346,218,4740,8,5,5,2,0,1,10,0,0,0,0,0,0,0,0,0,0,0,0,2,5,0,0
28347,218,4740,1217,716,841,84,126,174,1301,14,185,118,215,199,333,1446,2542,8,20687,1149,0,2,5,0,0
28348,218,4740,160,89,115,0,13,31,160,7,15,11,17,22,28,78,124,3,495,27,0,2,5,0,0
28349,218,4740,10,10,9,9,0,0,19,0,0,0,0,0,0,0,0,0,0,0,0,2,5,0,0
28350,218,4740,173,84,99,8,29,36,181,5,12,7,13,17,20,54,81,2,221,12,0,2,5,0,0
28351,218,4740,3,1,1,3,0,0,6,0,0,0,0,0,0,0,0,0,0,0,0,2,5,0,0
28352,223,4835,1943,715,1694,26,18,214,1969,12,185,120,237,197,357,1436,2721,7,20915,1161,0,2,2,3,0
28353,223,4835,1168,838,957,57,25,144,1225,19,348,224,416,367,640,3018,5452,11,61921,3440,1,2,2,3,0
28354,41,1474,601,196,481,2,23,85,603,8,63,36,72,71,108,400,664,4,3036,168,0,2,3,2,0
28355,2,40,9,6,6,0,0,3,9,0,0,0,0,0,0,0,0,0,0,0,0,2,1,0,1
28356,2,40,13,9,8,0,0,4,13,0,0,0,0,0,0,0,0,0,0,0,0,2,1,0,1
28357,1,319,382,65,130,157,2,92,539,4,10,5,10,14,15,41,57,2,114,6,0,2,1,3,1
28358,60,1078,282,196,195,3,0,86,285,8,130,71,141,138,212,936,1507,4,6538,363,0,2,3,2,1
28359,4,77,127,75,83,2,11,30,129,4,14,7,14,18,21,61,87,2,175,9,0,2,2,1,1
28360,4,77,652,304,544,16,6,88,668,6,89,51,101,95,152,591,998,3,3399,188,0,2,2,1,1
28361,4,77,2,2,2,0,0,0,2,0,0,0,0,0,0,0,0,0,0,0,0,2,2,1,1
28362,4,77,8,5,5,0,0,3,8,0,0,0,0,0,0,0,0,0,0,0,0,2,2,1,1
28363,4,77,2,2,2,0,0,0,2,0,0,0,0,0,0,0,0,0,0,0,0,2,2,1,1
28364,4,77,14,8,8,0,0,6,14,0,0,0,0,0,0,0,0,0,0,0,0,2,2,1,1
28365,4,77,6,4,4,0,0,2,6,0,0,0,0,0,0,0,0,0,0,0,0,2,2,1,1
28366,4,77,6,4,4,0,0,2,6,1,2,1,2,3,3,2,4,0,2,0,0,2,2,1,1
28367,4,77,6,4,4,0,0,2,6,0,0,0,0,0,0,0,0,0,0,0,0,2,2,1,1
28368,4,77,7,5,5,0,0,2,7,0,0,0,0,0,0,0,0,0,0,0,0,2,2,1,1
28369,4,77,6,4,4,0,0,2,6,0,0,0,0,0,0,0,0,0,0,0,0,2,2,1,1
28370,4,77,10,6,6,0,0,4,10,0,0,0,0,0,0,0,0,0,0,0,0,2,2,1,1
28371,4,77,1,1,1,0,0,0,1,0,0,0,0,0,0,0,0,0,0,0,0,2,2,1,1
28372,4,77,1,1,1,0,0,0,1,0,0,0,0,0,0,0,0,0,0,0,0,2,2,1,1
28373,4,77,14,10,10,0,0,4,14,1,1,1,1,2,2,0,2,0,1,0,0,2,2,1,1
28374,4,77,46,26,30,3,0,12,49,3,6,3,6,9,9,20,28,1,42,2,0,2,2,1,1
28375,7,296,72,33,56,0,4,12,72,1,1,1,1,2,2,0,2,0,1,0,0,2,1,0,1
28376,12,229,127,75,83,2,11,30,129,4,14,7,14,18,21,61,87,2,175,9,0,2,0,1,1
28377,12,229,652,304,544,16,6,88,668,6,89,51,101,95,152,591,998,3,3399,188,0,2,0,1,1
28378,12,229,2,2,2,0,0,0,2,0,0,0,0,0,0,0,0,0,0,0,0,2,0,1,1
28379,12,229,8,5,5,0,0,3,8,0,0,0,0,0,0,0,0,0,0,0,0,2,0,1,1
28380,12,229,2,2,2,0,0,0,2,0,0,0,0,0,0,0,0,0,0,0,0,2,0,1,1
28381,12,229,14,8,8,0,0,6,14,0,0,0,0,0,0,0,0,0,0,0,0,2,0,1,1
28382,12,229,6,4,4,0,0,2,6,0,0,0,0,0,0,0,0,0,0,0,0,2,0,1,1
28383,12,229,6,4,4,0,0,2,6,1,2,1,2,3,3,2,4,0,2,0,0,2,0,1,1
28384,12,229,6,4,4,0,0,2,6,0,0,0,0,0,0,0,0,0,0,0,0,2,0,1,1
28385,12,229,7,5,5,0,0,2,7,0,0,0,0,0,0,0,0,0,0,0,0,2,0,1,1
28386,12,229,6,4,4,0,0,2,6,0,0,0,0,0,0,0,0,0,0,0,0,2,0,1,1
28387,12,229,10,6,6,0,0,4,10,0,0,0,0,0,0,0,0,0,0,0,0,2,0,1,1
28388,12,229,1,1,1,0,0,0,1,0,0,0,0,0,0,0,0,0,0,0,0,2,0,1,1
28389,12,229,1,1,1,0,0,0,1,0,0,0,0,0,0,0,0,0,0,0,0,2,0,1,1
28390,12,229,14,10,10,0,0,4,14,1,1,1,1,2,2,0,2,0,1,0,0,2,0,1,1
28391,12,229,46,26,30,3,0,12,49,3,6,3,6,9,9,20,28,1,42,2,0,2,0,1,1
28392,6,71,127,75,83,2,11,30,129,4,14,7,14,18,21,61,87,2,175,9,0,2,1,0,1
28393,6,71,652,304,544,16,6,88,668,6,89,51,101,95,152,591,998,3,3399,188,0,2,1,0,1
28394,6,71,2,2,2,0,0,0,2,0,0,0,0,0,0,0,0,0,0,0,0,2,1,0,1
28395,6,71,8,5,5,0,0,3,8,0,0,0,0,0,0,0,0,0,0,0,0,2,1,0,1
28396,6,71,2,2,2,0,0,0,2,0,0,0,0,0,0,0,0,0,0,0,0,2,1,0,1
28397,6,71,14,8,8,0,0,6,14,0,0,0,0,0,0,0,0,0,0,0,0,2,1,0,1
28398,6,71,6,4,4,0,0,2,6,0,0,0,0,0,0,0,0,0,0,0,0,2,1,0,1
28399,6,71,6,4,4,0,0,2,6,1,2,1,2,3,3,2,4,0,2,0,0,2,1,0,1
28400,6,71,6,4,4,0,0,2,6,0,0,0,0,0,0,0,0,0,0,0,0,2,1,0,1
28401,6,71,7,5,5,0,0,2,7,0,0,0,0,0,0,0,0,0,0,0,0,2,1,0,1
28402,6,71,6,4,4,0,0,2,6,0,0,0,0,0,0,0,0,0,0,0,0,2,1,0,1
28403,6,71,10,6,6,0,0,4,10,0,0,0,0,0,0,0,0,0,0,0,0,2,1,0,1
28404,6,71,1,1,1,0,0,0,1,0,0,0,0,0,0,0,0,0,0,0,0,2,1,0,1
28405,6,71,1,1,1,0,0,0,1,0,0,0,0,0,0,0,0,0,0,0,0,2,1,0,1
28406,6,71,14,10,10,0,0,4,14,1,1,1,1,2,2,0,2,0,1,0,0,2,1,0,1
28407,6,71,46,26,30,3,0,12,49,3,6,3,6,9,9,20,28,1,42,2,0,2,1,0,1
28408,17,378,85,59,61,8,0,16,93,5,18,10,18,23,28,86,126,2,316,17,0,2,1,0,1
28409,12,515,124,78,88,2,3,26,126,4,13,7,13,17,20,56,81,2,163,9,0,2,6,2,1
28410,1,86,42,7,35,4,0,5,46,1,2,1,2,3,3,2,4,0,2,0,0,2,1,0,1
28411,1,86,11,6,10,0,0,1,11,2,4,2,4,6,6,10,15,1,15,0,0,2,1,0,1
28412,11,242,19,8,11,5,0,4,24,2,5,3,6,7,9,13,25,1,30,1,0,2,5,2,1
28413,11,242,102,59,69,5,3,24,107,6,22,15,28,28,43,113,206,3,789,43,0,2,5,2,1
28414,11,242,106,40,36,3,49,17,109,8,17,13,23,25,36,93,167,5,904,50,0,2,5,2,1
28415,222,4859,182,127,129,0,0,53,182,5,39,21,42,44,63,217,343,2,926,51,0,2,15,7,1
28416,222,4859,1165,710,800,67,119,181,1232,18,243,153,282,261,435,2000,3492,10,36473,2026,1,2,15,7,1
28417,68,1565,773,419,590,28,0,166,801,10,204,113,217,214,330,1598,2554,5,13587,754,0,2,8,5,1
28418,68,1565,421,273,302,44,34,57,465,17,81,59,107,98,166,583,1098,11,12329,684,0,2,8,5,1
28419,26,529,2,2,2,0,0,0,2,0,0,0,0,0,0,0,0,0,0,0,0,2,6,2,1
28420,26,529,99,48,90,1,3,5,100,0,0,0,0,0,0,0,0,0,0,0,0,2,6,2,1
28421,26,529,8,5,5,2,0,1,10,0,0,0,0,0,0,0,0,0,0,0,0,2,6,2,1
28422,26,529,1217,716,841,84,126,174,1301,14,185,118,215,199,333,1446,2542,8,20687,1149,0,2,6,2,1
28423,26,529,160,89,115,0,13,31,160,7,15,11,17,22,28,78,124,3,495,27,0,2,6,2,1
28424,26,529,10,10,9,9,0,0,19,0,0,0,0,0,0,0,0,0,0,0,0,2,6,2,1
28425,26,529,173,84,99,8,29,36,181,5,12,7,13,17,20,54,81,2,221,12,0,2,6,2,1
28426,26,529,3,1,1,3,0,0,6,0,0,0,0,0,0,0,0,0,0,0,0,2,6,2,1
28427,180,5401,1660,832,1314,41,38,274,1701,20,312,209,395,332,604,2671,5058,12,64042,3557,1,2,7,4,1
28428,180,5401,1057,646,719,113,100,145,1170,18,215,134,248,233,382,1740,3004,10,31186,1732,1,2,7,4,1
28429,17,348,95,58,50,9,16,20,104,12,33,24,45,45,69,209,378,8,3100,172,0,2,4,1,1
28430,89,1829,477,336,357,30,23,73,507,16,194,134,250,210,384,1538,2962,10,30538,1696,0,2,6,2,1
28431,76,1743,996,429,845,24,10,117,1020,7,76,50,88,83,138,494,879,4,3565,198,0,2,9,5,1
28432,76,1743,456,277,329,12,42,72,468,13,85,50,97,98,147,592,972,7,7212,400,0,2,9,5,1
28433,154,3265,1513,682,1277,25,13,200,1538,11,199,116,219,210,335,1557,2584,6,15641,868,0,2,6,3,1
28434,154,3265,819,519,539,24,98,155,843,15,96,57,106,111,163,690,1107,8,9171,509,0,2,6,3,1
28435,68,1364,207,111,150,11,0,50,218,5,26,19,36,31,55,133,272,3,943,52,0,2,7,4,1
28436,68,1364,410,198,237,31,55,97,441,11,63,38,72,74,110,414,683,6,4293,238,0,2,7,4,1
28437,218,4738,2,2,2,0,0,0,2,0,0,0,0,0,0,0,0,0,0,0,0,2,20,13,1
28438,218,4738,99,48,90,1,3,5,100,0,0,0,0,0,0,0,0,0,0,0,0,2,20,13,1
28439,218,4738,8,5,5,2,0,1,10,0,0,0,0,0,0,0,0,0,0,0,0,2,20,13,1
28440,218,4738,1217,716,841,84,126,174,1301,14,185,118,215,199,333,1446,2542,8,20687,1149,0,2,20,13,1
28441,218,4738,160,89,115,0,13,31,160,7,15,11,17,22,28,78,124,3,495,27,0,2,20,13,1
28442,218,4738,10,10,9,9,0,0,19,0,0,0,0,0,0,0,0,0,0,0,0,2,20,13,1
28443,218,4738,173,84,99,8,29,36,181,5,12,7,13,17,20,54,81,2,221,12,0,2,20,13,1
28444,218,4738,3,1,1,3,0,0,6,0,0,0,0,0,0,0,0,0,0,0,0,2,20,13,1
28445,97,1999,463,295,324,28,62,57,491,12,134,82,154,146,236,989,1696,6,11700,650,0,2,3,4,1
28446,51,757,167,116,138,4,5,22,171,8,48,30,56,56,86,292,499,4,2330,129,0,2,3,1,1
28447,31,936,339,213,244,17,9,65,356,10,42,26,48,52,74,259,421,5,2410,133,0,2,3,1,1
28448,85,2182,1455,414,1257,16,76,112,1471,5,41,23,46,46,69,231,381,2,1069,59,0,2,8,4,1
28449,85,2182,669,365,481,22,61,110,691,15,103,63,122,118,185,747,1273,8,11311,628,0,2,8,4,1
28450,256,6014,4293,999,3693,19,54,507,4312,9,155,88,170,164,258,1156,1898,4,9368,520,0,2,24,22,1
28451,256,6014,1482,859,1002,125,135,219,1607,16,219,134,251,235,385,1766,3032,9,27804,1544,1,2,24,22,1
28452,6,140,44,22,19,0,19,6,44,2,10,6,12,12,18,35,64,1,77,4,0,2,3,1,1
28453,27,968,74,35,59,1,0,14,75,3,14,7,14,17,21,58,85,1,128,7,0,2,8,4,1
28454,27,968,245,125,200,5,7,34,250,7,30,17,34,37,51,166,265,3,1053,58,0,2,8,4,1
28455,52,622,647,139,84,35,284,233,682,0,0,0,0,0,0,0,0,0,0,0,0,2,1,1,1
28456,98,2670,1523,757,1297,19,12,193,1542,12,193,117,230,205,347,1508,2664,7,19053,1058,0,2,6,2,1
28457,98,2670,701,378,504,33,58,109,734,13,110,68,126,123,194,794,1346,7,10027,557,0,2,6,2,1
28458,94,2438,773,422,505,30,103,129,803,14,77,46,83,91,129,535,839,7,6334,351,0,2,7,4,1
28459,142,3319,77,34,69,0,0,8,77,3,24,16,29,27,45,114,213,1,387,21,0,2,9,6,1
28460,142,3319,712,438,573,51,9,84,763,14,102,71,128,116,199,733,1364,8,11988,666,0,2,9,6,1
28461,24,628,2,2,2,0,0,0,2,0,0,0,0,0,0,0,0,0,0,0,0,2,15,13,1
28462,24,628,99,48,90,1,3,5,100,0,0,0,0,0,0,0,0,0,0,0,0,2,15,13,1
28463,24,628,8,5,5,2,0,1,10,0,0,0,0,0,0,0,0,0,0,0,0,2,15,13,1
28464,24,628,1217,716,841,84,126,174,1301,14,185,118,215,199,333,1446,2542,8,20687,1149,0,2,15,13,1
28465,24,628,160,89,115,0,13,31,160,7,15,11,17,22,28,78,124,3,495,27,0,2,15,13,1
28466,24,628,10,10,9,9,0,0,19,0,0,0,0,0,0,0,0,0,0,0,0,2,15,13,1
28467,24,628,173,84,99,8,29,36,181,5,12,7,13,17,20,54,81,2,221,12,0,2,15,13,1
28468,24,628,3,1,1,3,0,0,6,0,0,0,0,0,0,0,0,0,0,0,0,2,15,13,1
28469,30,664,125,97,103,3,0,19,128,9,25,17,27,34,44,144,223,4,1087,60,0,2,5,3,1
28470,23,367,102,57,55,5,16,25,107,5,17,10,18,22,28,81,124,2,330,18,0,2,2,1,1
28471,88,1899,402,202,227,24,74,80,426,12,52,33,61,64,94,339,564,7,3969,220,0,2,6,3,1
28472,52,1075,447,308,343,6,5,95,453,7,96,59,111,103,170,651,1136,4,4600,255,0,2,4,2,1
28473,52,1075,322,174,179,16,74,51,338,10,41,26,46,51,72,252,408,5,2291,127,0,2,4,2,1
28474,88,1993,53,23,39,0,0,13,53,2,8,4,8,10,12,26,39,1,39,2,0,2,8,6,1
28475,88,1993,515,298,307,33,80,99,548,12,63,44,77,75,121,419,753,7,5527,307,0,2,8,6,1
28476,23,389,424,94,331,4,0,89,428,1,5,5,5,6,10,11,25,0,12,0,0,2,6,2,1
28477,23,389,38,23,23,6,0,8,44,3,11,7,11,14,18,42,68,1,102,5,0,2,6,2,1
28478,20,526,205,80,86,16,53,53,221,7,18,10,19,25,29,94,134,3,497,27,0,2,4,1,1
28479,17,523,184,100,137,2,15,30,186,6,38,20,39,44,59,214,322,3,991,55,0,2,7,3,1
28480,17,523,103,65,74,8,5,16,111,7,17,9,17,24,26,89,119,3,417,23,0,2,7,3,1
28481,53,1178,91,45,69,0,3,18,91,3,9,6,10,12,16,33,57,1,95,5,0,2,14,11,1
28482,53,1178,367,234,237,17,34,68,384,16,55,34,61,71,95,381,584,8,5183,287,0,2,14,11,1
28483,244,5842,722,423,573,19,0,135,741,12,172,101,199,184,300,1320,2257,6,15668,870,0,2,13,9,1
28484,244,5842,1508,847,911,44,250,301,1552,14,148,88,169,162,257,1120,1886,7,15077,837,0,2,13,9,1
28485,305,6844,72,33,56,0,4,12,72,1,1,1,1,2,2,0,2,0,1,0,0,2,30,32,1
28486,305,6844,1454,835,1044,76,110,219,1530,17,275,158,296,292,454,2297,3718,9,34017,1889,1,2,30,32,1
28487,91,1836,757,253,292,73,244,162,830,13,61,38,67,74,105,409,651,7,4654,258,0,2,6,6,1
28488,43,902,386,256,301,16,9,68,402,4,59,35,69,63,104,355,621,2,1453,80,0,2,4,3,1
28489,43,902,264,131,164,11,41,46,275,6,38,22,40,44,62,214,338,3,1068,59,0,2,4,3,1
28490,28,707,466,257,367,18,25,50,484,7,126,86,171,133,257,898,1813,4,8612,478,0,2,1,0,1
28491,28,707,507,281,342,29,59,88,536,10,53,29,57,63,86,336,514,5,2764,153,0,2,1,0,1
28492,30,658,215,129,180,6,0,29,221,8,65,43,72,73,115,415,711,4,3153,175,0,2,5,2,1
28493,30,658,97,69,77,3,3,16,100,6,22,13,23,28,36,113,173,3,542,30,0,2,5,2,1
28494,92,1975,1043,504,840,53,9,147,1096,9,180,112,198,189,310,1377,2344,4,11604,644,0,2,10,4,1
28495,92,1975,383,288,292,26,6,62,409,11,65,38,67,76,105,429,656,5,3719,206,0,2,10,4,1
28496,20,420,294,64,250,0,0,43,294,1,20,10,20,21,30,86,131,0,65,3,0,2,5,2,1
28497,20,420,78,46,62,3,0,14,81,3,8,4,8,11,12,28,41,1,62,3,0,2,5,2,1
28498,5,123,110,30,77,3,13,16,113,4,21,15,30,25,45,100,208,2,597,33,0,2,3,1,1
28499,5,123,28,15,21,1,0,6,29,0,0,0,0,0,0,0,0,0,0,0,0,2,3,1,1
28500,70,1394,1178,367,1042,6,15,115,1184,9,94,51,95,103,146,644,976,4,4439,246,0,2,6,2,1
28501,70,1394,177,108,140,8,0,27,185,6,30,16,32,36,48,162,248,3,794,44,0,2,6,2,1
28502,223,4852,1943,715,1694,26,18,214,1969,12,185,120,237,197,357,1436,2721,7,20915,1161,0,2,9,11,1
28503,223,4852,1168,838,957,57,25,144,1225,19,348,224,416,367,640,3018,5452,11,61921,3440,1,2,9,11,1
28504,19,682,442,244,305,14,16,103,456,11,68,45,75,79,120,452,756,6,4588,254,0,2,13,12,1
28505,19,682,182,102,99,11,40,35,193,3,11,6,11,14,17,42,64,1,97,5,0,2,13,12,1
28506,62,1255,1098,241,925,5,10,155,1103,7,46,25,49,53,74,273,423,3,1580,87,0,2,11,5,1
28507,62,1255,282,202,222,14,2,44,296,8,42,24,43,50,67,250,378,4,1548,86,0,2,11,5,1
28508,29,728,601,196,481,2,23,85,603,8,63,36,72,71,108,400,664,4,3036,168,0,2,3,2,1
28509,29,728,156,79,106,5,16,28,161,5,14,8,15,19,23,64,97,2,261,14,0,2,3,2,1
28510,99,4089,1289,550,1043,56,32,155,1345,10,167,93,185,177,278,1266,2075,5,11498,638,0,2,7,3,1
28511,35,1083,182,127,129,0,0,53,182,5,39,21,42,44,63,217,343,2,926,51,0,2,6,4,1
28512,152,7159,1392,870,1177,35,17,170,1427,14,494,280,531,508,811,4473,7289,7,54850,3047,2,2,11,10,1
28513,90,2889,773,419,590,28,0,166,801,10,204,113,217,214,330,1598,2554,5,13587,754,0,2,6,2,1
28514,24,1149,75,38,59,1,3,12,76,2,4,2,4,6,6,10,15,1,15,0,0,2,3,1,1
28515,8,263,51,25,36,0,0,15,51,3,11,6,12,14,18,42,68,1,112,6,0,2,2,1,1
28516,2,51,14,9,9,0,0,5,14,0,0,0,0,0,0,0,0,0,0,0,0,2,2,1,1
28517,1,134,149,67,118,4,0,27,153,1,17,14,28,18,42,69,175,0,144,8,0,2,1,0,1
28518,34,2285,1157,318,931,29,22,177,1186,6,104,63,125,110,188,712,1274,3,4596,255,0,2,1,1,1
28519,63,4333,520,294,400,33,13,81,553,10,261,204,367,271,571,2128,4614,7,32445,1802,1,2,6,5,1
28520,180,8011,139,89,101,2,0,35,141,7,54,34,62,61,96,330,569,4,2287,127,0,2,3,2,1
28521,180,8011,7,5,5,0,0,2,7,1,2,1,2,3,3,2,4,0,2,0,0,2,3,2,1
28522,138,6148,1782,648,1425,9,47,279,1791,8,171,97,189,179,286,1292,2140,4,9462,525,0,2,5,3,1
28523,25,684,256,139,192,9,7,47,265,4,23,12,24,27,36,112,171,2,357,19,0,2,3,2,1
28524,23,583,102,59,69,5,3,24,107,6,22,15,28,28,43,113,206,3,789,43,0,2,5,1,1
28525,111,4174,1450,624,1228,12,26,181,1462,14,306,186,354,320,540,2580,4493,8,36391,2021,1,2,8,4,1
28526,166,4983,1660,832,1314,41,38,274,1701,20,312,209,395,332,604,2671,5058,12,64042,3557,1,2,8,7,1
28527,44,3230,996,429,845,24,10,117,1020,7,76,50,88,83,138,494,879,4,3565,198,0,2,6,3,1
28528,128,5336,1513,682,1277,25,13,200,1538,11,199,116,219,210,335,1557,2584,6,15641,868,0,2,10,6,1
28529,75,3910,1296,573,1062,40,33,157,1336,8,201,118,231,209,349,1561,2689,4,12365,686,0,2,8,3,1
28530,19,453,207,111,150,11,0,50,218,5,26,19,36,31,55,133,272,3,943,52,0,2,8,2,1
28531,92,4718,1457,730,1242,11,6,188,1468,10,292,166,329,302,495,2424,4078,5,22973,1276,1,2,8,3,1
28532,40,2521,652,304,544,16,6,88,668,6,89,51,101,95,152,591,998,3,3399,188,0,2,8,2,1
28533,70,3216,1455,414,1257,16,76,112,1471,5,41,23,46,46,69,231,381,2,1069,59,0,2,9,3,1
28534,2,79,7,6,5,0,0,2,7,1,1,1,2,2,3,0,3,1,3,0,0,2,4,1,1
28535,8,275,74,35,59,1,0,14,75,3,14,7,14,17,21,58,85,1,128,7,0,2,5,2,1
28536,96,4695,1523,757,1297,19,12,193,1542,12,193,117,230,205,347,1508,2664,7,19053,1058,0,2,9,5,1
28537,97,4232,1020,354,843,12,15,144,1032,8,134,77,144,142,221,970,1580,4,6792,377,0,2,4,1,1
28538,42,1903,447,308,343,6,5,95,453,7,96,59,111,103,170,651,1136,4,4600,255,0,2,4,1,1
28539,2,145,53,23,39,0,0,13,53,2,8,4,8,10,12,26,39,1,39,2,0,2,0,1,1
28540,21,662,424,94,331,4,0,89,428,1,5,5,5,6,10,11,25,0,12,0,0,2,4,1,1
28541,38,2306,334,251,279,10,4,40,344,5,127,74,143,132,217,899,1528,2,4303,239,0,2,7,2,1
28542,12,497,184,100,137,2,15,30,186,6,38,20,39,44,59,214,322,3,991,55,0,2,5,1,1
28543,64,2863,1293,570,1093,25,15,163,1318,10,195,123,241,205,364,1516,2795,6,17273,959,0,2,6,3,1
28544,33,1897,384,251,317,7,8,52,391,11,70,44,84,81,128,467,811,6,5355,297,0,2,9,4,1
28545,47,2248,722,423,573,19,0,135,741,12,172,101,199,184,300,1320,2257,6,15668,870,0,2,15,6,1
28546,43,1877,386,256,301,16,9,68,402,4,59,35,69,63,104,355,621,2,1453,80,0,2,5,2,1
28547,16,1245,215,129,180,6,0,29,221,8,65,43,72,73,115,415,711,4,3153,175,0,2,13,9,1
28548,84,3236,1043,504,840,53,9,147,1096,9,180,112,198,189,310,1377,2344,4,11604,644,0,2,12,5,1
28549,14,534,295,56,236,0,4,54,295,2,9,5,10,11,15,30,51,1,57,3,0,2,4,1,1
28550,30,1245,373,158,315,8,0,51,381,5,76,44,79,81,123,486,779,2,2026,112,0,2,3,2,1
28551,77,3225,1178,367,1042,6,15,115,1184,9,94,51,95,103,146,644,976,4,4439,246,0,2,8,3,1
28552,99,5086,1943,715,1694,26,18,214,1969,12,185,120,237,197,357,1436,2721,7,20915,1161,0,2,10,3,1
28553,30,1272,442,244,305,14,16,103,456,11,68,45,75,79,120,452,756,6,4588,254,0,2,4,1,1
28554,51,1917,1098,241,925,5,10,155,1103,7,46,25,49,53,74,273,423,3,1580,87,0,2,7,3,1
28555,40,1147,339,213,244,17,9,65,356,10,42,26,48,52,74,259,421,5,2410,133,0,2,37,1,1
28556,53,629,647,139,84,35,284,233,682,0,0,0,0,0,0,0,0,0,0,0,0,2,10,0,1
28557,64,2924,1293,570,1093,25,15,163,1318,10,195,123,241,205,364,1516,2795,6,17273,959,0,2,22,6,1
28558,40,1155,339,213,244,17,9,65,356,10,42,26,48,52,74,259,421,5,2410,133,0,2,4,2,0
28559,53,633,647,139,84,35,284,233,682,0,0,0,0,0,0,0,0,0,0,0,0,2,4,2,0
28560,64,2924,1293,570,1093,25,15,163,1318,10,195,123,241,205,364,1516,2795,6,17273,959,0,2,12,2,0
28561,2,40,9,6,6,0,0,3,9,0,0,0,0,0,0,0,0,0,0,0,0,2,1,0,0
28562,2,40,13,9,8,0,0,4,13,0,0,0,0,0,0,0,0,0,0,0,0,2,1,0,0
28563,1,319,382,65,130,157,2,92,539,4,10,5,10,14,15,41,57,2,114,6,0,2,1,3,0
28564,60,1078,282,196,195,3,0,86,285,8,130,71,141,138,212,936,1507,4,6538,363,0,2,3,2,0
28565,4,77,127,75,83,2,11,30,129,4,14,7,14,18,21,61,87,2,175,9,0,2,2,1,0
28566,4,77,652,304,544,16,6,88,668,6,89,51,101,95,152,591,998,3,3399,188,0,2,2,1,0
28567,4,77,2,2,2,0,0,0,2,0,0,0,0,0,0,0,0,0,0,0,0,2,2,1,0
28568,4,77,8,5,5,0,0,3,8,0,0,0,0,0,0,0,0,0,0,0,0,2,2,1,0
28569,4,77,2,2,2,0,0,0,2,0,0,0,0,0,0,0,0,0,0,0,0,2,2,1,0
28570,4,77,14,8,8,0,0,6,14,0,0,0,0,0,0,0,0,0,0,0,0,2,2,1,0
28571,4,77,6,4,4,0,0,2,6,0,0,0,0,0,0,0,0,0,0,0,0,2,2,1,0
28572,4,77,6,4,4,0,0,2,6,1,2,1,2,3,3,2,4,0,2,0,0,2,2,1,0
28573,4,77,6,4,4,0,0,2,6,0,0,0,0,0,0,0,0,0,0,0,0,2,2,1,0
28574,4,77,7,5,5,0,0,2,7,0,0,0,0,0,0,0,0,0,0,0,0,2,2,1,0
28575,4,77,6,4,4,0,0,2,6,0,0,0,0,0,0,0,0,0,0,0,0,2,2,1,0
28576,4,77,10,6,6,0,0,4,10,0,0,0,0,0,0,0,0,0,0,0,0,2,2,1,0
28577,4,77,1,1,1,0,0,0,1,0,0,0,0,0,0,0,0,0,0,0,0,2,2,1,0
28578,4,77,1,1,1,0,0,0,1,0,0,0,0,0,0,0,0,0,0,0,0,2,2,1,0
28579,4,77,14,10,10,0,0,4,14,1,1,1,1,2,2,0,2,0,1,0,0,2,2,1,0
28580,4,77,46,26,30,3,0,12,49,3,6,3,6,9,9,20,28,1,42,2,0,2,2,1,0
28581,7,296,72,33,56,0,4,12,72,1,1,1,1,2,2,0,2,0,1,0,0,2,1,0,0
28582,12,229,127,75,83,2,11,30,129,4,14,7,14,18,21,61,87,2,175,9,0,2,0,1,0
28583,12,229,652,304,544,16,6,88,668,6,89,51,101,95,152,591,998,3,3399,188,0,2,0,1,0
28584,12,229,2,2,2,0,0,0,2,0,0,0,0,0,0,0,0,0,0,0,0,2,0,1,0
28585,12,229,8,5,5,0,0,3,8,0,0,0,0,0,0,0,0,0,0,0,0,2,0,1,0
28586,12,229,2,2,2,0,0,0,2,0,0,0,0,0,0,0,0,0,0,0,0,2,0,1,0
28587,12,229,14,8,8,0,0,6,14,0,0,0,0,0,0,0,0,0,0,0,0,2,0,1,0
28588,12,229,6,4,4,0,0,2,6,0,0,0,0,0,0,0,0,0,0,0,0,2,0,1,0
28589,12,229,6,4,4,0,0,2,6,1,2,1,2,3,3,2,4,0,2,0,0,2,0,1,0
28590,12,229,6,4,4,0,0,2,6,0,0,0,0,0,0,0,0,0,0,0,0,2,0,1,0
28591,12,229,7,5,5,0,0,2,7,0,0,0,0,0,0,0,0,0,0,0,0,2,0,1,0
28592,12,229,6,4,4,0,0,2,6,0,0,0,0,0,0,0,0,0,0,0,0,2,0,1,0
28593,12,229,10,6,6,0,0,4,10,0,0,0,0,0,0,0,0,0,0,0,0,2,0,1,0
28594,12,229,1,1,1,0,0,0,1,0,0,0,0,0,0,0,0,0,0,0,0,2,0,1,0
28595,12,229,1,1,1,0,0,0,1,0,0,0,0,0,0,0,0,0,0,0,0,2,0,1,0
28596,12,229,14,10,10,0,0,4,14,1,1,1,1,2,2,0,2,0,1,0,0,2,0,1,0
28597,12,229,46,26,30,3,0,12,49,3,6,3,6,9,9,20,28,1,42,2,0,2,0,1,0
28598,6,71,127,75,83,2,11,30,129,4,14,7,14,18,21,61,87,2,175,9,0,2,1,0,0
28599,6,71,652,304,544,16,6,88,668,6,89,51,101,95,152,591,998,3,3399,188,0,2,1,0,0
28600,6,71,2,2,2,0,0,0,2,0,0,0,0,0,0,0,0,0,0,0,0,2,1,0,0
28601,6,71,8,5,5,0,0,3,8,0,0,0,0,0,0,0,0,0,0,0,0,2,1,0,0
28602,6,71,2,2,2,0,0,0,2,0,0,0,0,0,0,0,0,0,0,0,0,2,1,0,0
28603,6,71,14,8,8,0,0,6,14,0,0,0,0,0,0,0,0,0,0,0,0,2,1,0,0
28604,6,71,6,4,4,0,0,2,6,0,0,0,0,0,0,0,0,0,0,0,0,2,1,0,0
28605,6,71,6,4,4,0,0,2,6,1,2,1,2,3,3,2,4,0,2,0,0,2,1,0,0
28606,6,71,6,4,4,0,0,2,6,0,0,0,0,0,0,0,0,0,0,0,0,2,1,0,0
28607,6,71,7,5,5,0,0,2,7,0,0,0,0,0,0,0,0,0,0,0,0,2,1,0,0
28608,6,71,6,4,4,0,0,2,6,0,0,0,0,0,0,0,0,0,0,0,0,2,1,0,0
28609,6,71,10,6,6,0,0,4,10,0,0,0,0,0,0,0,0,0,0,0,0,2,1,0,0
28610,6,71,1,1,1,0,0,0,1,0,0,0,0,0,0,0,0,0,0,0,0,2,1,0,0
28611,6,71,1,1,1,0,0,0,1,0,0,0,0,0,0,0,0,0,0,0,0,2,1,0,0
28612,6,71,14,10,10,0,0,4,14,1,1,1,1,2,2,0,2,0,1,0,0,2,1,0,0
28613,6,71,46,26,30,3,0,12,49,3,6,3,6,9,9,20,28,1,42,2,0,2,1,0,0
28614,17,378,85,59,61,8,0,16,93,5,18,10,18,23,28,86,126,2,316,17,0,2,1,0,0
28615,12,515,124,78,88,2,3,26,126,4,13,7,13,17,20,56,81,2,163,9,0,2,6,2,0
28616,1,86,42,7,35,4,0,5,46,1,2,1,2,3,3,2,4,0,2,0,0,2,1,0,0
28617,1,86,11,6,10,0,0,1,11,2,4,2,4,6,6,10,15,1,15,0,0,2,1,0,0
28618,11,242,19,8,11,5,0,4,24,2,5,3,6,7,9,13,25,1,30,1,0,2,5,2,0
28619,11,242,102,59,69,5,3,24,107,6,22,15,28,28,43,113,206,3,789,43,0,2,5,2,0
28620,11,242,106,40,36,3,49,17,109,8,17,13,23,25,36,93,167,5,904,50,0,2,5,2,0
28621,222,4859,182,127,129,0,0,53,182,5,39,21,42,44,63,217,343,2,926,51,0,2,15,7,0
28622,222,4859,1165,710,800,67,119,181,1232,18,243,153,282,261,435,2000,3492,10,36473,2026,1,2,15,7,0
28623,68,1565,773,419,590,28,0,166,801,10,204,113,217,214,330,1598,2554,5,13587,754,0,2,8,5,0
28624,68,1565,421,273,302,44,34,57,465,17,81,59,107,98,166,583,1098,11,12329,684,0,2,8,5,0
28625,26,529,2,2,2,0,0,0,2,0,0,0,0,0,0,0,0,0,0,0,0,2,6,2,0
28626,26,529,99,48,90,1,3,5,100,0,0,0,0,0,0,0,0,0,0,0,0,2,6,2,0
28627,26,529,8,5,5,2,0,1,10,0,0,0,0,0,0,0,0,0,0,0,0,2,6,2,0
28628,26,529,1217,716,841,84,126,174,1301,14,185,118,215,199,333,1446,2542,8,20687,1149,0,2,6,2,0
28629,26,529,160,89,115,0,13,31,160,7,15,11,17,22,28,78,124,3,495,27,0,2,6,2,0
28630,26,529,10,10,9,9,0,0,19,0,0,0,0,0,0,0,0,0,0,0,0,2,6,2,0
28631,26,529,173,84,99,8,29,36,181,5,12,7,13,17,20,54,81,2,221,12,0,2,6,2,0
28632,26,529,3,1,1,3,0,0,6,0,0,0,0,0,0,0,0,0,0,0,0,2,6,2,0
28633,180,5401,1660,832,1314,41,38,274,1701,20,312,209,395,332,604,2671,5058,12,64042,3557,1,2,7,4,0
28634,180,5401,1057,646,719,113,100,145,1170,18,215,134,248,233,382,1740,3004,10,31186,1732,1,2,7,4,0
28635,17,348,95,58,50,9,16,20,104,12,33,24,45,45,69,209,378,8,3100,172,0,2,4,1,0
28636,89,1829,477,336,357,30,23,73,507,16,194,134,250,210,384,1538,2962,10,30538,1696,0,2,6,2,0
28637,76,1743,996,429,845,24,10,117,1020,7,76,50,88,83,138,494,879,4,3565,198,0,2,9,5,0
28638,76,1743,456,277,329,12,42,72,468,13,85,50,97,98,147,592,972,7,7212,400,0,2,9,5,0
28639,154,3265,1513,682,1277,25,13,200,1538,11,199,116,219,210,335,1557,2584,6,15641,868,0,2,6,3,0
28640,154,3265,819,519,539,24,98,155,843,15,96,57,106,111,163,690,1107,8,9171,509,0,2,6,3,0
28641,68,1364,207,111,150,11,0,50,218,5,26,19,36,31,55,133,272,3,943,52,0,2,7,4,0
28642,68,1364,410,198,237,31,55,97,441,11,63,38,72,74,110,414,683,6,4293,238,0,2,7,4,0
28643,218,4738,2,2,2,0,0,0,2,0,0,0,0,0,0,0,0,0,0,0,0,2,20,13,0
28644,218,4738,99,48,90,1,3,5,100,0,0,0,0,0,0,0,0,0,0,0,0,2,20,13,0
28645,218,4738,8,5,5,2,0,1,10,0,0,0,0,0,0,0,0,0,0,0,0,2,20,13,0
28646,218,4738,1217,716,841,84,126,174,1301,14,185,118,215,199,333,1446,2542,8,20687,1149,0,2,20,13,0
28647,218,4738,160,89,115,0,13,31,160,7,15,11,17,22,28,78,124,3,495,27,0,2,20,13,0
28648,218,4738,10,10,9,9,0,0,19,0,0,0,0,0,0,0,0,0,0,0,0,2,20,13,0
28649,218,4738,173,84,99,8,29,36,181,5,12,7,13,17,20,54,81,2,221,12,0,2,20,13,0
28650,218,4738,3,1,1,3,0,0,6,0,0,0,0,0,0,0,0,0,0,0,0,2,20,13,0
28651,97,1999,463,295,324,28,62,57,491,12,134,82,154,146,236,989,1696,6,11700,650,0,2,3,4,0
28652,51,757,167,116,138,4,5,22,171,8,48,30,56,56,86,292,499,4,2330,129,0,2,3,1,0
28653,31,936,339,213,244,17,9,65,356,10,42,26,48,52,74,259,421,5,2410,133,0,2,3,1,0
28654,85,2182,1455,414,1257,16,76,112,1471,5,41,23,46,46,69,231,381,2,1069,59,0,2,8,4,0
28655,85,2182,669,365,481,22,61,110,691,15,103,63,122,118,185,747,1273,8,11311,628,0,2,8,4,0
28656,256,6014,4293,999,3693,19,54,507,4312,9,155,88,170,164,258,1156,1898,4,9368,520,0,2,24,22,0
28657,256,6014,1482,859,1002,125,135,219,1607,16,219,134,251,235,385,1766,3032,9,27804,1544,1,2,24,22,0
28658,6,140,44,22,19,0,19,6,44,2,10,6,12,12,18,35,64,1,77,4,0,2,3,1,0
28659,27,968,74,35,59,1,0,14,75,3,14,7,14,17,21,58,85,1,128,7,0,2,8,4,0
28660,27,968,245,125,200,5,7,34,250,7,30,17,34,37,51,166,265,3,1053,58,0,2,8,4,0
28661,52,622,647,139,84,35,284,233,682,0,0,0,0,0,0,0,0,0,0,0,0,2,1,1,0
28662,98,2670,1523,757,1297,19,12,193,1542,12,193,117,230,205,347,1508,2664,7,19053,1058,0,2,6,2,0
28663,98,2670,701,378,504,33,58,109,734,13,110,68,126,123,194,794,1346,7,10027,557,0,2,6,2,0
28664,94,2438,773,422,505,30,103,129,803,14,77,46,83,91,129,535,839,7,6334,351,0,2,7,4,0
28665,142,3319,77,34,69,0,0,8,77,3,24,16,29,27,45,114,213,1,387,21,0,2,9,6,0
28666,142,3319,712,438,573,51,9,84,763,14,102,71,128,116,199,733,1364,8,11988,666,0,2,9,6,0
28667,24,628,2,2,2,0,0,0,2,0,0,0,0,0,0,0,0,0,0,0,0,2,15,13,0
28668,24,628,99,48,90,1,3,5,100,0,0,0,0,0,0,0,0,0,0,0,0,2,15,13,0
28669,24,628,8,5,5,2,0,1,10,0,0,0,0,0,0,0,0,0,0,0,0,2,15,13,0
28670,24,628,1217,716,841,84,126,174,1301,14,185,118,215,199,333,1446,2542,8,20687,1149,0,2,15,13,0
28671,24,628,160,89,115,0,13,31,160,7,15,11,17,22,28,78,124,3,495,27,0,2,15,13,0
28672,24,628,10,10,9,9,0,0,19,0,0,0,0,0,0,0,0,0,0,0,0,2,15,13,0
28673,24,628,173,84,99,8,29,36,181,5,12,7,13,17,20,54,81,2,221,12,0,2,15,13,0
28674,24,628,3,1,1,3,0,0,6,0,0,0,0,0,0,0,0,0,0,0,0,2,15,13,0
28675,30,664,125,97,103,3,0,19,128,9,25,17,27,34,44,144,223,4,1087,60,0,2,5,3,0
28676,23,367,102,57,55,5,16,25,107,5,17,10,18,22,28,81,124,2,330,18,0,2,2,1,0
28677,88,1899,402,202,227,24,74,80,426,12,52,33,61,64,94,339,564,7,3969,220,0,2,6,3,0
28678,52,1075,447,308,343,6,5,95,453,7,96,59,111,103,170,651,1136,4,4600,255,0,2,4,2,0
28679,52,1075,322,174,179,16,74,51,338,10,41,26,46,51,72,252,408,5,2291,127,0,2,4,2,0
28680,88,1993,53,23,39,0,0,13,53,2,8,4,8,10,12,26,39,1,39,2,0,2,8,6,0
28681,88,1993,515,298,307,33,80,99,548,12,63,44,77,75,121,419,753,7,5527,307,0,2,8,6,0
28682,23,389,424,94,331,4,0,89,428,1,5,5,5,6,10,11,25,0,12,0,0,2,6,2,0
28683,23,389,38,23,23,6,0,8,44,3,11,7,11,14,18,42,68,1,102,5,0,2,6,2,0
28684,20,526,205,80,86,16,53,53,221,7,18,10,19,25,29,94,134,3,497,27,0,2,4,1,0
28685,17,523,184,100,137,2,15,30,186,6,38,20,39,44,59,214,322,3,991,55,0,2,7,3,0
28686,17,523,103,65,74,8,5,16,111,7,17,9,17,24,26,89,119,3,417,23,0,2,7,3,0
28687,53,1178,91,45,69,0,3,18,91,3,9,6,10,12,16,33,57,1,95,5,0,2,14,11,0
28688,53,1178,367,234,237,17,34,68,384,16,55,34,61,71,95,381,584,8,5183,287,0,2,14,11,0
28689,244,5842,722,423,573,19,0,135,741,12,172,101,199,184,300,1320,2257,6,15668,870,0,2,13,9,0
28690,244,5842,1508,847,911,44,250,301,1552,14,148,88,169,162,257,1120,1886,7,15077,837,0,2,13,9,0
28691,305,6844,72,33,56,0,4,12,72,1,1,1,1,2,2,0,2,0,1,0,0,2,30,32,0
28692,305,6844,1454,835,1044,76,110,219,1530,17,275,158,296,292,454,2297,3718,9,34017,1889,1,2,30,32,0
28693,91,1836,757,253,292,73,244,162,830,13,61,38,67,74,105,409,651,7,4654,258,0,2,6,6,0
28694,43,902,386,256,301,16,9,68,402,4,59,35,69,63,104,355,621,2,1453,80,0,2,4,3,0
28695,43,902,264,131,164,11,41,46,275,6,38,22,40,44,62,214,338,3,1068,59,0,2,4,3,0
28696,28,707,466,257,367,18,25,50,484,7,126,86,171,133,257,898,1813,4,8612,478,0,2,1,0,0
28697,28,707,507,281,342,29,59,88,536,10,53,29,57,63,86,336,514,5,2764,153,0,2,1,0,0
28698,30,658,215,129,180,6,0,29,221,8,65,43,72,73,115,415,711,4,3153,175,0,2,5,2,0
28699,30,658,97,69,77,3,3,16,100,6,22,13,23,28,36,113,173,3,542,30,0,2,5,2,0
28700,92,1975,1043,504,840,53,9,147,1096,9,180,112,198,189,310,1377,2344,4,11604,644,0,2,10,4,0
28701,92,1975,383,288,292,26,6,62,409,11,65,38,67,76,105,429,656,5,3719,206,0,2,10,4,0
28702,20,420,294,64,250,0,0,43,294,1,20,10,20,21,30,86,131,0,65,3,0,2,5,2,0
28703,20,420,78,46,62,3,0,14,81,3,8,4,8,11,12,28,41,1,62,3,0,2,5,2,0
28704,5,123,110,30,77,3,13,16,113,4,21,15,30,25,45,100,208,2,597,33,0,2,3,1,0
28705,5,123,28,15,21,1,0,6,29,0,0,0,0,0,0,0,0,0,0,0,0,2,3,1,0
28706,70,1394,1178,367,1042,6,15,115,1184,9,94,51,95,103,146,644,976,4,4439,246,0,2,6,2,0
28707,70,1394,177,108,140,8,0,27,185,6,30,16,32,36,48,162,248,3,794,44,0,2,6,2,0
28708,223,4852,1943,715,1694,26,18,214,1969,12,185,120,237,197,357,1436,2721,7,20915,1161,0,2,9,11,0
28709,223,4852,1168,838,957,57,25,144,1225,19,348,224,416,367,640,3018,5452,11,61921,3440,1,2,9,11,0
28710,19,682,442,244,305,14,16,103,456,11,68,45,75,79,120,452,756,6,4588,254,0,2,13,12,0
28711,19,682,182,102,99,11,40,35,193,3,11,6,11,14,17,42,64,1,97,5,0,2,13,12,0
28712,62,1255,1098,241,925,5,10,155,1103,7,46,25,49,53,74,273,423,3,1580,87,0,2,11,5,0
28713,62,1255,282,202,222,14,2,44,296,8,42,24,43,50,67,250,378,4,1548,86,0,2,11,5,0
28714,29,728,601,196,481,2,23,85,603,8,63,36,72,71,108,400,664,4,3036,168,0,2,3,2,0
28715,29,728,156,79,106,5,16,28,161,5,14,8,15,19,23,64,97,2,261,14,0,2,3,2,0
28716,99,4089,1289,550,1043,56,32,155,1345,10,167,93,185,177,278,1266,2075,5,11498,638,0,2,7,3,0
28717,35,1083,182,127,129,0,0,53,182,5,39,21,42,44,63,217,343,2,926,51,0,2,6,4,0
28718,152,7159,1392,870,1177,35,17,170,1427,14,494,280,531,508,811,4473,7289,7,54850,3047,2,2,11,10,0
28719,90,2889,773,419,590,28,0,166,801,10,204,113,217,214,330,1598,2554,5,13587,754,0,2,6,2,0
28720,24,1149,75,38,59,1,3,12,76,2,4,2,4,6,6,10,15,1,15,0,0,2,3,1,0
28721,8,263,51,25,36,0,0,15,51,3,11,6,12,14,18,42,68,1,112,6,0,2,2,1,0
28722,2,51,14,9,9,0,0,5,14,0,0,0,0,0,0,0,0,0,0,0,0,2,2,1,0
28723,1,134,149,67,118,4,0,27,153,1,17,14,28,18,42,69,175,0,144,8,0,2,1,0,0
28724,34,2285,1157,318,931,29,22,177,1186,6,104,63,125,110,188,712,1274,3,4596,255,0,2,1,1,0
28725,63,4333,520,294,400,33,13,81,553,10,261,204,367,271,571,2128,4614,7,32445,1802,1,2,6,5,0
28726,180,8011,139,89,101,2,0,35,141,7,54,34,62,61,96,330,569,4,2287,127,0,2,3,2,0
28727,180,8011,7,5,5,0,0,2,7,1,2,1,2,3,3,2,4,0,2,0,0,2,3,2,0
28728,138,6148,1782,648,1425,9,47,279,1791,8,171,97,189,179,286,1292,2140,4,9462,525,0,2,5,3,0
28729,25,684,256,139,192,9,7,47,265,4,23,12,24,27,36,112,171,2,357,19,0,2,3,2,0
28730,23,583,102,59,69,5,3,24,107,6,22,15,28,28,43,113,206,3,789,43,0,2,5,1,0
28731,111,4174,1450,624,1228,12,26,181,1462,14,306,186,354,320,540,2580,4493,8,36391,2021,1,2,8,4,0
28732,166,4983,1660,832,1314,41,38,274,1701,20,312,209,395,332,604,2671,5058,12,64042,3557,1,2,8,7,0
28733,44,3230,996,429,845,24,10,117,1020,7,76,50,88,83,138,494,879,4,3565,198,0,2,6,3,0
28734,128,5336,1513,682,1277,25,13,200,1538,11,199,116,219,210,335,1557,2584,6,15641,868,0,2,10,6,0
28735,75,3910,1296,573,1062,40,33,157,1336,8,201,118,231,209,349,1561,2689,4,12365,686,0,2,8,3,0
28736,19,453,207,111,150,11,0,50,218,5,26,19,36,31,55,133,272,3,943,52,0,2,8,2,0
28737,92,4718,1457,730,1242,11,6,188,1468,10,292,166,329,302,495,2424,4078,5,22973,1276,1,2,8,3,0
28738,40,2521,652,304,544,16,6,88,668,6,89,51,101,95,152,591,998,3,3399,188,0,2,8,2,0
28739,70,3216,1455,414,1257,16,76,112,1471,5,41,23,46,46,69,231,381,2,1069,59,0,2,9,3,0
28740,2,79,7,6,5,0,0,2,7,1,1,1,2,2,3,0,3,1,3,0,0,2,4,1,0
28741,8,275,74,35,59,1,0,14,75,3,14,7,14,17,21,58,85,1,128,7,0,2,5,2,0
28742,96,4695,1523,757,1297,19,12,193,1542,12,193,117,230,205,347,1508,2664,7,19053,1058,0,2,9,5,0
28743,97,4232,1020,354,843,12,15,144,1032,8,134,77,144,142,221,970,1580,4,6792,377,0,2,4,1,0
28744,42,1903,447,308,343,6,5,95,453,7,96,59,111,103,170,651,1136,4,4600,255,0,2,4,1,0
28745,2,145,53,23,39,0,0,13,53,2,8,4,8,10,12,26,39,1,39,2,0,2,0,1,0
28746,21,662,424,94,331,4,0,89,428,1,5,5,5,6,10,11,25,0,12,0,0,2,4,1,0
28747,38,2306,334,251,279,10,4,40,344,5,127,74,143,132,217,899,1528,2,4303,239,0,2,7,2,0
28748,12,497,184,100,137,2,15,30,186,6,38,20,39,44,59,214,322,3,991,55,0,2,5,1,0
28749,64,2863,1293,570,1093,25,15,163,1318,10,195,123,241,205,364,1516,2795,6,17273,959,0,2,6,3,0
28750,33,1897,384,251,317,7,8,52,391,11,70,44,84,81,128,467,811,6,5355,297,0,2,9,4,0
28751,47,2248,722,423,573,19,0,135,741,12,172,101,199,184,300,1320,2257,6,15668,870,0,2,15,6,0
28752,43,1877,386,256,301,16,9,68,402,4,59,35,69,63,104,355,621,2,1453,80,0,2,5,2,0
28753,16,1245,215,129,180,6,0,29,221,8,65,43,72,73,115,415,711,4,3153,175,0,2,13,9,0
28754,84,3236,1043,504,840,53,9,147,1096,9,180,112,198,189,310,1377,2344,4,11604,644,0,2,12,5,0
28755,14,534,295,56,236,0,4,54,295,2,9,5,10,11,15,30,51,1,57,3,0,2,4,1,0
28756,30,1245,373,158,315,8,0,51,381,5,76,44,79,81,123,486,779,2,2026,112,0,2,3,2,0
28757,77,3225,1178,367,1042,6,15,115,1184,9,94,51,95,103,146,644,976,4,4439,246,0,2,8,3,0
28758,99,5086,1943,715,1694,26,18,214,1969,12,185,120,237,197,357,1436,2721,7,20915,1161,0,2,10,3,0
28759,30,1272,442,244,305,14,16,103,456,11,68,45,75,79,120,452,756,6,4588,254,0,2,4,1,0
28760,51,1917,1098,241,925,5,10,155,1103,7,46,25,49,53,74,273,423,3,1580,87,0,2,7,3,0
28761,40,1155,339,213,244,17,9,65,356,10,42,26,48,52,74,259,421,5,2410,133,0,2,40,2,0
28762,53,633,647,139,84,35,284,233,682,0,0,0,0,0,0,0,0,0,0,0,0,2,13,1,0
28763,64,2924,1293,570,1093,25,15,163,1318,10,195,123,241,205,364,1516,2795,6,17273,959,0,2,33,7,0
28764,70,1387,207,111,150,11,0,50,218,5,26,19,36,31,55,133,272,3,943,52,0,2,13,0,0
28765,70,1387,410,198,237,31,55,97,441,11,63,38,72,74,110,414,683,6,4293,238,0,2,13,0,0
28766,218,4733,2,2,2,0,0,0,2,0,0,0,0,0,0,0,0,0,0,0,0,2,2,5,0
28767,218,4733,99,48,90,1,3,5,100,0,0,0,0,0,0,0,0,0,0,0,0,2,2,5,0
28768,218,4733,8,5,5,2,0,1,10,0,0,0,0,0,0,0,0,0,0,0,0,2,2,5,0
28769,218,4733,1217,716,841,84,126,174,1301,14,185,118,215,199,333,1446,2542,8,20687,1149,0,2,2,5,0
28770,218,4733,160,89,115,0,13,31,160,7,15,11,17,22,28,78,124,3,495,27,0,2,2,5,0
28771,218,4733,10,10,9,9,0,0,19,0,0,0,0,0,0,0,0,0,0,0,0,2,2,5,0
28772,218,4733,173,84,99,8,29,36,181,5,12,7,13,17,20,54,81,2,221,12,0,2,2,5,0
28773,218,4733,3,1,1,3,0,0,6,0,0,0,0,0,0,0,0,0,0,0,0,2,2,5,0
28774,70,1387,207,111,150,11,0,50,218,5,26,19,36,31,55,133,272,3,943,52,0,2,13,0,0
28775,70,1387,410,198,237,31,55,97,441,11,63,38,72,74,110,414,683,6,4293,238,0,2,13,0,0
28776,218,4733,2,2,2,0,0,0,2,0,0,0,0,0,0,0,0,0,0,0,0,2,2,5,0
28777,218,4733,99,48,90,1,3,5,100,0,0,0,0,0,0,0,0,0,0,0,0,2,2,5,0
28778,218,4733,8,5,5,2,0,1,10,0,0,0,0,0,0,0,0,0,0,0,0,2,2,5,0
28779,218,4733,1217,716,841,84,126,174,1301,14,185,118,215,199,333,1446,2542,8,20687,1149,0,2,2,5,0
28780,218,4733,160,89,115,0,13,31,160,7,15,11,17,22,28,78,124,3,495,27,0,2,2,5,0
28781,218,4733,10,10,9,9,0,0,19,0,0,0,0,0,0,0,0,0,0,0,0,2,2,5,0
28782,218,4733,173,84,99,8,29,36,181,5,12,7,13,17,20,54,81,2,221,12,0,2,2,5,0
28783,218,4733,3,1,1,3,0,0,6,0,0,0,0,0,0,0,0,0,0,0,0,2,2,5,0
28784,218,4738,2,2,2,0,0,0,2,0,0,0,0,0,0,0,0,0,0,0,0,2,6,6,0
28785,218,4738,99,48,90,1,3,5,100,0,0,0,0,0,0,0,0,0,0,0,0,2,6,6,0
28786,218,4738,8,5,5,2,0,1,10,0,0,0,0,0,0,0,0,0,0,0,0,2,6,6,0
28787,218,4738,1217,716,841,84,126,174,1301,14,185,118,215,199,333,1446,2542,8,20687,1149,0,2,6,6,0
28788,218,4738,160,89,115,0,13,31,160,7,15,11,17,22,28,78,124,3,495,27,0,2,6,6,0
28789,218,4738,10,10,9,9,0,0,19,0,0,0,0,0,0,0,0,0,0,0,0,2,6,6,0
28790,218,4738,173,84,99,8,29,36,181,5,12,7,13,17,20,54,81,2,221,12,0,2,6,6,0
28791,218,4738,3,1,1,3,0,0,6,0,0,0,0,0,0,0,0,0,0,0,0,2,6,6,0
28792,142,3314,77,34,69,0,0,8,77,3,24,16,29,27,45,114,213,1,387,21,0,2,10,9,0
28793,142,3314,712,438,573,51,9,84,763,14,102,71,128,116,199,733,1364,8,11988,666,0,2,10,9,0
28794,303,6728,72,33,56,0,4,12,72,1,1,1,1,2,2,0,2,0,1,0,0,2,0,9,0
28795,303,6728,1454,835,1044,76,110,219,1530,17,275,158,296,292,454,2297,3718,9,34017,1889,1,2,0,9,0
28796,30,1241,373,158,315,8,0,51,381,5,76,44,79,81,123,486,779,2,2026,112,0,2,1,1,0
28797,4,163,27,21,21,0,0,6,27,3,6,3,6,9,9,20,28,1,42,2,0,0,28,0,0
28798,1,6,2,2,2,0,0,0,2,0,0,0,0,0,0,0,0,0,0,0,0,0,2,0,0
28799,2,40,9,6,6,0,0,3,9,0,0,0,0,0,0,0,0,0,0,0,0,2,1,0,1
28800,2,40,13,9,8,0,0,4,13,0,0,0,0,0,0,0,0,0,0,0,0,2,1,0,1
28801,1,319,382,65,130,157,2,92,539,4,10,5,10,14,15,41,57,2,114,6,0,2,1,3,1
28802,60,1078,282,196,195,3,0,86,285,8,130,71,141,138,212,936,1507,4,6538,363,0,2,3,2,1
28803,4,77,127,75,83,2,11,30,129,4,14,7,14,18,21,61,87,2,175,9,0,2,2,1,1
28804,4,77,652,304,544,16,6,88,668,6,89,51,101,95,152,591,998,3,3399,188,0,2,2,1,1
28805,4,77,2,2,2,0,0,0,2,0,0,0,0,0,0,0,0,0,0,0,0,2,2,1,1
28806,4,77,8,5,5,0,0,3,8,0,0,0,0,0,0,0,0,0,0,0,0,2,2,1,1
28807,4,77,2,2,2,0,0,0,2,0,0,0,0,0,0,0,0,0,0,0,0,2,2,1,1
28808,4,77,14,8,8,0,0,6,14,0,0,0,0,0,0,0,0,0,0,0,0,2,2,1,1
28809,4,77,6,4,4,0,0,2,6,0,0,0,0,0,0,0,0,0,0,0,0,2,2,1,1
28810,4,77,6,4,4,0,0,2,6,1,2,1,2,3,3,2,4,0,2,0,0,2,2,1,1
28811,4,77,6,4,4,0,0,2,6,0,0,0,0,0,0,0,0,0,0,0,0,2,2,1,1
28812,4,77,7,5,5,0,0,2,7,0,0,0,0,0,0,0,0,0,0,0,0,2,2,1,1
28813,4,77,6,4,4,0,0,2,6,0,0,0,0,0,0,0,0,0,0,0,0,2,2,1,1
28814,4,77,10,6,6,0,0,4,10,0,0,0,0,0,0,0,0,0,0,0,0,2,2,1,1
28815,4,77,1,1,1,0,0,0,1,0,0,0,0,0,0,0,0,0,0,0,0,2,2,1,1
28816,4,77,1,1,1,0,0,0,1,0,0,0,0,0,0,0,0,0,0,0,0,2,2,1,1
28817,4,77,14,10,10,0,0,4,14,1,1,1,1,2,2,0,2,0,1,0,0,2,2,1,1
28818,4,77,46,26,30,3,0,12,49,3,6,3,6,9,9,20,28,1,42,2,0,2,2,1,1
28819,7,296,72,33,56,0,4,12,72,1,1,1,1,2,2,0,2,0,1,0,0,2,1,0,1
28820,12,229,127,75,83,2,11,30,129,4,14,7,14,18,21,61,87,2,175,9,0,2,0,1,1
28821,12,229,652,304,544,16,6,88,668,6,89,51,101,95,152,591,998,3,3399,188,0,2,0,1,1
28822,12,229,2,2,2,0,0,0,2,0,0,0,0,0,0,0,0,0,0,0,0,2,0,1,1
28823,12,229,8,5,5,0,0,3,8,0,0,0,0,0,0,0,0,0,0,0,0,2,0,1,1
28824,12,229,2,2,2,0,0,0,2,0,0,0,0,0,0,0,0,0,0,0,0,2,0,1,1
28825,12,229,14,8,8,0,0,6,14,0,0,0,0,0,0,0,0,0,0,0,0,2,0,1,1
28826,12,229,6,4,4,0,0,2,6,0,0,0,0,0,0,0,0,0,0,0,0,2,0,1,1
28827,12,229,6,4,4,0,0,2,6,1,2,1,2,3,3,2,4,0,2,0,0,2,0,1,1
28828,12,229,6,4,4,0,0,2,6,0,0,0,0,0,0,0,0,0,0,0,0,2,0,1,1
28829,12,229,7,5,5,0,0,2,7,0,0,0,0,0,0,0,0,0,0,0,0,2,0,1,1
28830,12,229,6,4,4,0,0,2,6,0,0,0,0,0,0,0,0,0,0,0,0,2,0,1,1
28831,12,229,10,6,6,0,0,4,10,0,0,0,0,0,0,0,0,0,0,0,0,2,0,1,1
28832,12,229,1,1,1,0,0,0,1,0,0,0,0,0,0,0,0,0,0,0,0,2,0,1,1
28833,12,229,1,1,1,0,0,0,1,0,0,0,0,0,0,0,0,0,0,0,0,2,0,1,1
28834,12,229,14,10,10,0,0,4,14,1,1,1,1,2,2,0,2,0,1,0,0,2,0,1,1
28835,12,229,46,26,30,3,0,12,49,3,6,3,6,9,9,20,28,1,42,2,0,2,0,1,1
28836,6,71,127,75,83,2,11,30,129,4,14,7,14,18,21,61,87,2,175,9,0,2,1,0,1
28837,6,71,652,304,544,16,6,88,668,6,89,51,101,95,152,591,998,3,3399,188,0,2,1,0,1
28838,6,71,2,2,2,0,0,0,2,0,0,0,0,0,0,0,0,0,0,0,0,2,1,0,1
28839,6,71,8,5,5,0,0,3,8,0,0,0,0,0,0,0,0,0,0,0,0,2,1,0,1
28840,6,71,2,2,2,0,0,0,2,0,0,0,0,0,0,0,0,0,0,0,0,2,1,0,1
28841,6,71,14,8,8,0,0,6,14,0,0,0,0,0,0,0,0,0,0,0,0,2,1,0,1
28842,6,71,6,4,4,0,0,2,6,0,0,0,0,0,0,0,0,0,0,0,0,2,1,0,1
28843,6,71,6,4,4,0,0,2,6,1,2,1,2,3,3,2,4,0,2,0,0,2,1,0,1
28844,6,71,6,4,4,0,0,2,6,0,0,0,0,0,0,0,0,0,0,0,0,2,1,0,1
28845,6,71,7,5,5,0,0,2,7,0,0,0,0,0,0,0,0,0,0,0,0,2,1,0,1
28846,6,71,6,4,4,0,0,2,6,0,0,0,0,0,0,0,0,0,0,0,0,2,1,0,1
28847,6,71,10,6,6,0,0,4,10,0,0,0,0,0,0,0,0,0,0,0,0,2,1,0,1
28848,6,71,1,1,1,0,0,0,1,0,0,0,0,0,0,0,0,0,0,0,0,2,1,0,1
28849,6,71,1,1,1,0,0,0,1,0,0,0,0,0,0,0,0,0,0,0,0,2,1,0,1
28850,6,71,14,10,10,0,0,4,14,1,1,1,1,2,2,0,2,0,1,0,0,2,1,0,1
28851,6,71,46,26,30,3,0,12,49,3,6,3,6,9,9,20,28,1,42,2,0,2,1,0,1
28852,17,378,85,59,61,8,0,16,93,5,18,10,18,23,28,86,126,2,316,17,0,2,1,0,1
28853,12,515,124,78,88,2,3,26,126,4,13,7,13,17,20,56,81,2,163,9,0,2,6,2,1
28854,1,86,42,7,35,4,0,5,46,1,2,1,2,3,3,2,4,0,2,0,0,2,1,0,1
28855,1,86,11,6,10,0,0,1,11,2,4,2,4,6,6,10,15,1,15,0,0,2,1,0,1
28856,11,242,19,8,11,5,0,4,24,2,5,3,6,7,9,13,25,1,30,1,0,2,5,2,1
28857,11,242,102,59,69,5,3,24,107,6,22,15,28,28,43,113,206,3,789,43,0,2,5,2,1
28858,11,242,106,40,36,3,49,17,109,8,17,13,23,25,36,93,167,5,904,50,0,2,5,2,1
28859,222,4859,182,127,129,0,0,53,182,5,39,21,42,44,63,217,343,2,926,51,0,2,15,7,1
28860,222,4859,1165,710,800,67,119,181,1232,18,243,153,282,261,435,2000,3492,10,36473,2026,1,2,15,7,1
28861,68,1565,773,419,590,28,0,166,801,10,204,113,217,214,330,1598,2554,5,13587,754,0,2,8,5,1
28862,68,1565,421,273,302,44,34,57,465,17,81,59,107,98,166,583,1098,11,12329,684,0,2,8,5,1
28863,26,529,2,2,2,0,0,0,2,0,0,0,0,0,0,0,0,0,0,0,0,2,6,2,1
28864,26,529,99,48,90,1,3,5,100,0,0,0,0,0,0,0,0,0,0,0,0,2,6,2,1
28865,26,529,8,5,5,2,0,1,10,0,0,0,0,0,0,0,0,0,0,0,0,2,6,2,1
28866,26,529,1217,716,841,84,126,174,1301,14,185,118,215,199,333,1446,2542,8,20687,1149,0,2,6,2,1
28867,26,529,160,89,115,0,13,31,160,7,15,11,17,22,28,78,124,3,495,27,0,2,6,2,1
28868,26,529,10,10,9,9,0,0,19,0,0,0,0,0,0,0,0,0,0,0,0,2,6,2,1
28869,26,529,173,84,99,8,29,36,181,5,12,7,13,17,20,54,81,2,221,12,0,2,6,2,1
28870,26,529,3,1,1,3,0,0,6,0,0,0,0,0,0,0,0,0,0,0,0,2,6,2,1
28871,180,5401,1660,832,1314,41,38,274,1701,20,312,209,395,332,604,2671,5058,12,64042,3557,1,2,7,4,1
28872,180,5401,1057,646,719,113,100,145,1170,18,215,134,248,233,382,1740,3004,10,31186,1732,1,2,7,4,1
28873,17,348,95,58,50,9,16,20,104,12,33,24,45,45,69,209,378,8,3100,172,0,2,4,1,1
28874,89,1829,477,336,357,30,23,73,507,16,194,134,250,210,384,1538,2962,10,30538,1696,0,2,6,2,1
28875,76,1743,996,429,845,24,10,117,1020,7,76,50,88,83,138,494,879,4,3565,198,0,2,9,5,1
28876,76,1743,456,277,329,12,42,72,468,13,85,50,97,98,147,592,972,7,7212,400,0,2,9,5,1
28877,154,3265,1513,682,1277,25,13,200,1538,11,199,116,219,210,335,1557,2584,6,15641,868,0,2,6,3,1
28878,154,3265,819,519,539,24,98,155,843,15,96,57,106,111,163,690,1107,8,9171,509,0,2,6,3,1
28879,70,1395,207,111,150,11,0,50,218,5,26,19,36,31,55,133,272,3,943,52,0,2,7,4,1
28880,70,1395,410,198,237,31,55,97,441,11,63,38,72,74,110,414,683,6,4293,238,0,2,7,4,1
28881,218,4751,2,2,2,0,0,0,2,0,0,0,0,0,0,0,0,0,0,0,0,2,20,13,1
28882,218,4751,99,48,90,1,3,5,100,0,0,0,0,0,0,0,0,0,0,0,0,2,20,13,1
28883,218,4751,8,5,5,2,0,1,10,0,0,0,0,0,0,0,0,0,0,0,0,2,20,13,1
28884,218,4751,1217,716,841,84,126,174,1301,14,185,118,215,199,333,1446,2542,8,20687,1149,0,2,20,13,1
28885,218,4751,160,89,115,0,13,31,160,7,15,11,17,22,28,78,124,3,495,27,0,2,20,13,1
28886,218,4751,10,10,9,9,0,0,19,0,0,0,0,0,0,0,0,0,0,0,0,2,20,13,1
28887,218,4751,173,84,99,8,29,36,181,5,12,7,13,17,20,54,81,2,221,12,0,2,20,13,1
28888,218,4751,3,1,1,3,0,0,6,0,0,0,0,0,0,0,0,0,0,0,0,2,20,13,1
28889,97,1999,463,295,324,28,62,57,491,12,134,82,154,146,236,989,1696,6,11700,650,0,2,3,4,1
28890,51,757,167,116,138,4,5,22,171,8,48,30,56,56,86,292,499,4,2330,129,0,2,3,1,1
28891,37,1105,339,213,244,17,9,65,356,10,42,26,48,52,74,259,421,5,2410,133,0,2,3,17,1
28892,85,2182,1455,414,1257,16,76,112,1471,5,41,23,46,46,69,231,381,2,1069,59,0,2,8,4,1
28893,85,2182,669,365,481,22,61,110,691,15,103,63,122,118,185,747,1273,8,11311,628,0,2,8,4,1
28894,258,6040,4293,999,3693,19,54,507,4312,9,155,88,170,164,258,1156,1898,4,9368,520,0,2,26,23,1
28895,258,6040,1482,859,1002,125,135,219,1607,16,219,134,251,235,385,1766,3032,9,27804,1544,1,2,26,23,1
28896,6,140,44,22,19,0,19,6,44,2,10,6,12,12,18,35,64,1,77,4,0,2,3,1,1
28897,27,968,74,35,59,1,0,14,75,3,14,7,14,17,21,58,85,1,128,7,0,2,8,4,1
28898,27,968,245,125,200,5,7,34,250,7,30,17,34,37,51,166,265,3,1053,58,0,2,8,4,1
28899,53,633,647,139,84,35,284,233,682,0,0,0,0,0,0,0,0,0,0,0,0,2,1,1,1
28900,98,2670,1523,757,1297,19,12,193,1542,12,193,117,230,205,347,1508,2664,7,19053,1058,0,2,6,2,1
28901,98,2670,701,378,504,33,58,109,734,13,110,68,126,123,194,794,1346,7,10027,557,0,2,6,2,1
28902,94,2438,773,422,505,30,103,129,803,14,77,46,83,91,129,535,839,7,6334,351,0,2,9,6,1
28903,142,3319,77,34,69,0,0,8,77,3,24,16,29,27,45,114,213,1,387,21,0,2,9,6,1
28904,142,3319,712,438,573,51,9,84,763,14,102,71,128,116,199,733,1364,8,11988,666,0,2,9,6,1
28905,24,628,2,2,2,0,0,0,2,0,0,0,0,0,0,0,0,0,0,0,0,2,15,13,1
28906,24,628,99,48,90,1,3,5,100,0,0,0,0,0,0,0,0,0,0,0,0,2,15,13,1
28907,24,628,8,5,5,2,0,1,10,0,0,0,0,0,0,0,0,0,0,0,0,2,15,13,1
28908,24,628,1217,716,841,84,126,174,1301,14,185,118,215,199,333,1446,2542,8,20687,1149,0,2,15,13,1
28909,24,628,160,89,115,0,13,31,160,7,15,11,17,22,28,78,124,3,495,27,0,2,15,13,1
28910,24,628,10,10,9,9,0,0,19,0,0,0,0,0,0,0,0,0,0,0,0,2,15,13,1
28911,24,628,173,84,99,8,29,36,181,5,12,7,13,17,20,54,81,2,221,12,0,2,15,13,1
28912,24,628,3,1,1,3,0,0,6,0,0,0,0,0,0,0,0,0,0,0,0,2,15,13,1
28913,30,664,125,97,103,3,0,19,128,9,25,17,27,34,44,144,223,4,1087,60,0,2,5,3,1
28914,23,367,102,57,55,5,16,25,107,5,17,10,18,22,28,81,124,2,330,18,0,2,2,1,1
28915,88,1899,402,202,227,24,74,80,426,12,52,33,61,64,94,339,564,7,3969,220,0,2,6,3,1
28916,52,1075,447,308,343,6,5,95,453,7,96,59,111,103,170,651,1136,4,4600,255,0,2,4,2,1
28917,52,1075,322,174,179,16,74,51,338,10,41,26,46,51,72,252,408,5,2291,127,0,2,4,2,1
28918,88,1993,53,23,39,0,0,13,53,2,8,4,8,10,12,26,39,1,39,2,0,2,8,6,1
28919,88,1993,515,298,307,33,80,99,548,12,63,44,77,75,121,419,753,7,5527,307,0,2,8,6,1
28920,23,389,424,94,331,4,0,89,428,1,5,5,5,6,10,11,25,0,12,0,0,2,6,2,1
28921,23,389,38,23,23,6,0,8,44,3,11,7,11,14,18,42,68,1,102,5,0,2,6,2,1
28922,20,526,205,80,86,16,53,53,221,7,18,10,19,25,29,94,134,3,497,27,0,2,4,1,1
28923,17,523,184,100,137,2,15,30,186,6,38,20,39,44,59,214,322,3,991,55,0,2,7,3,1
28924,17,523,103,65,74,8,5,16,111,7,17,9,17,24,26,89,119,3,417,23,0,2,7,3,1
28925,52,1151,91,45,69,0,3,18,91,3,9,6,10,12,16,33,57,1,95,5,0,2,13,10,1
28926,52,1151,367,234,237,17,34,68,384,16,55,34,61,71,95,381,584,8,5183,287,0,2,13,10,1
28927,244,5842,722,423,573,19,0,135,741,12,172,101,199,184,300,1320,2257,6,15668,870,0,2,13,9,1
28928,244,5842,1508,847,911,44,250,301,1552,14,148,88,169,162,257,1120,1886,7,15077,837,0,2,13,9,1
28929,305,6844,72,33,56,0,4,12,72,1,1,1,1,2,2,0,2,0,1,0,0,2,30,32,1
28930,305,6844,1454,835,1044,76,110,219,1530,17,275,158,296,292,454,2297,3718,9,34017,1889,1,2,30,32,1
28931,91,1836,757,253,292,73,244,162,830,13,61,38,67,74,105,409,651,7,4654,258,0,2,6,6,1
28932,43,902,386,256,301,16,9,68,402,4,59,35,69,63,104,355,621,2,1453,80,0,2,4,3,1
28933,43,902,264,131,164,11,41,46,275,6,38,22,40,44,62,214,338,3,1068,59,0,2,4,3,1
28934,28,707,466,257,367,18,25,50,484,7,126,86,171,133,257,898,1813,4,8612,478,0,2,1,0,1
28935,28,707,507,281,342,29,59,88,536,10,53,29,57,63,86,336,514,5,2764,153,0,2,1,0,1
28936,30,658,215,129,180,6,0,29,221,8,65,43,72,73,115,415,711,4,3153,175,0,2,5,2,1
28937,30,658,97,69,77,3,3,16,100,6,22,13,23,28,36,113,173,3,542,30,0,2,5,2,1
28938,92,1975,1043,504,840,53,9,147,1096,9,180,112,198,189,310,1377,2344,4,11604,644,0,2,10,4,1
28939,92,1975,383,288,292,26,6,62,409,11,65,38,67,76,105,429,656,5,3719,206,0,2,10,4,1
28940,20,420,294,64,250,0,0,43,294,1,20,10,20,21,30,86,131,0,65,3,0,2,5,2,1
28941,20,420,78,46,62,3,0,14,81,3,8,4,8,11,12,28,41,1,62,3,0,2,5,2,1
28942,5,123,110,30,77,3,13,16,113,4,21,15,30,25,45,100,208,2,597,33,0,2,3,1,1
28943,5,123,28,15,21,1,0,6,29,0,0,0,0,0,0,0,0,0,0,0,0,2,3,1,1
28944,70,1394,1178,367,1042,6,15,115,1184,9,94,51,95,103,146,644,976,4,4439,246,0,2,6,2,1
28945,70,1394,177,108,140,8,0,27,185,6,30,16,32,36,48,162,248,3,794,44,0,2,6,2,1
28946,226,4927,1943,715,1694,26,18,214,1969,12,185,120,237,197,357,1436,2721,7,20915,1161,0,2,11,14,1
28947,226,4927,1168,838,957,57,25,144,1225,19,348,224,416,367,640,3018,5452,11,61921,3440,1,2,11,14,1
28948,19,682,442,244,305,14,16,103,456,11,68,45,75,79,120,452,756,6,4588,254,0,2,13,12,1
28949,19,682,182,102,99,11,40,35,193,3,11,6,11,14,17,42,64,1,97,5,0,2,13,12,1
28950,62,1255,1098,241,925,5,10,155,1103,7,46,25,49,53,74,273,423,3,1580,87,0,2,11,5,1
28951,62,1255,282,202,222,14,2,44,296,8,42,24,43,50,67,250,378,4,1548,86,0,2,11,5,1
28952,29,728,601,196,481,2,23,85,603,8,63,36,72,71,108,400,664,4,3036,168,0,2,3,2,1
28953,29,728,156,79,106,5,16,28,161,5,14,8,15,19,23,64,97,2,261,14,0,2,3,2,1
28954,99,4089,1289,550,1043,56,32,155,1345,10,167,93,185,177,278,1266,2075,5,11498,638,0,2,7,3,1
28955,35,1083,182,127,129,0,0,53,182,5,39,21,42,44,63,217,343,2,926,51,0,2,6,4,1
28956,152,7159,1392,870,1177,35,17,170,1427,14,494,280,531,508,811,4473,7289,7,54850,3047,2,2,11,10,1
28957,90,2889,773,419,590,28,0,166,801,10,204,113,217,214,330,1598,2554,5,13587,754,0,2,6,2,1
28958,25,1187,75,38,59,1,3,12,76,2,4,2,4,6,6,10,15,1,15,0,0,2,3,1,1
28959,8,263,51,25,36,0,0,15,51,3,11,6,12,14,18,42,68,1,112,6,0,2,2,1,1
28960,2,51,14,9,9,0,0,5,14,0,0,0,0,0,0,0,0,0,0,0,0,2,2,1,1
28961,1,134,149,67,118,4,0,27,153,1,17,14,28,18,42,69,175,0,144,8,0,2,1,0,1
28962,34,2285,1157,318,931,29,22,177,1186,6,104,63,125,110,188,712,1274,3,4596,255,0,2,1,1,1
28963,63,4333,520,294,400,33,13,81,553,10,261,204,367,271,571,2128,4614,7,32445,1802,1,2,6,5,1
28964,180,8011,139,89,101,2,0,35,141,7,54,34,62,61,96,330,569,4,2287,127,0,2,3,2,1
28965,180,8011,7,5,5,0,0,2,7,1,2,1,2,3,3,2,4,0,2,0,0,2,3,2,1
28966,138,6148,1782,648,1425,9,47,279,1791,8,171,97,189,179,286,1292,2140,4,9462,525,0,2,5,3,1
28967,25,684,256,139,192,9,7,47,265,4,23,12,24,27,36,112,171,2,357,19,0,2,3,2,1
28968,23,583,102,59,69,5,3,24,107,6,22,15,28,28,43,113,206,3,789,43,0,2,5,1,1
28969,111,4174,1450,624,1228,12,26,181,1462,14,306,186,354,320,540,2580,4493,8,36391,2021,1,2,8,4,1
28970,166,4983,1660,832,1314,41,38,274,1701,20,312,209,395,332,604,2671,5058,12,64042,3557,1,2,8,7,1
28971,44,3230,996,429,845,24,10,117,1020,7,76,50,88,83,138,494,879,4,3565,198,0,2,6,3,1
28972,128,5336,1513,682,1277,25,13,200,1538,11,199,116,219,210,335,1557,2584,6,15641,868,0,2,10,6,1
28973,75,3910,1296,573,1062,40,33,157,1336,8,201,118,231,209,349,1561,2689,4,12365,686,0,2,8,3,1
28974,19,453,207,111,150,11,0,50,218,5,26,19,36,31,55,133,272,3,943,52,0,2,8,2,1
28975,92,4718,1457,730,1242,11,6,188,1468,10,292,166,329,302,495,2424,4078,5,22973,1276,1,2,8,3,1
28976,40,2521,652,304,544,16,6,88,668,6,89,51,101,95,152,591,998,3,3399,188,0,2,8,2,1
28977,70,3216,1455,414,1257,16,76,112,1471,5,41,23,46,46,69,231,381,2,1069,59,0,2,9,3,1
28978,2,79,7,6,5,0,0,2,7,1,1,1,2,2,3,0,3,1,3,0,0,2,4,1,1
28979,8,275,74,35,59,1,0,14,75,3,14,7,14,17,21,58,85,1,128,7,0,2,5,2,1
28980,96,4695,1523,757,1297,19,12,193,1542,12,193,117,230,205,347,1508,2664,7,19053,1058,0,2,9,5,1
28981,97,4232,1020,354,843,12,15,144,1032,8,134,77,144,142,221,970,1580,4,6792,377,0,2,4,1,1
28982,42,1903,447,308,343,6,5,95,453,7,96,59,111,103,170,651,1136,4,4600,255,0,2,4,1,1
28983,2,145,53,23,39,0,0,13,53,2,8,4,8,10,12,26,39,1,39,2,0,2,0,1,1
28984,21,662,424,94,331,4,0,89,428,1,5,5,5,6,10,11,25,0,12,0,0,2,4,1,1
28985,38,2306,334,251,279,10,4,40,344,5,127,74,143,132,217,899,1528,2,4303,239,0,2,7,2,1
28986,12,497,184,100,137,2,15,30,186,6,38,20,39,44,59,214,322,3,991,55,0,2,5,1,1
28987,64,2936,1293,570,1093,25,15,163,1318,10,195,123,241,205,364,1516,2795,6,17273,959,0,2,13,4,1
28988,33,1897,384,251,317,7,8,52,391,11,70,44,84,81,128,467,811,6,5355,297,0,2,9,4,1
28989,47,2248,722,423,573,19,0,135,741,12,172,101,199,184,300,1320,2257,6,15668,870,0,2,15,6,1
28990,43,1877,386,256,301,16,9,68,402,4,59,35,69,63,104,355,621,2,1453,80,0,2,5,2,1
28991,16,1245,215,129,180,6,0,29,221,8,65,43,72,73,115,415,711,4,3153,175,0,2,13,9,1
28992,84,3236,1043,504,840,53,9,147,1096,9,180,112,198,189,310,1377,2344,4,11604,644,0,2,12,5,1
28993,14,534,295,56,236,0,4,54,295,2,9,5,10,11,15,30,51,1,57,3,0,2,4,1,1
28994,30,1245,373,158,315,8,0,51,381,5,76,44,79,81,123,486,779,2,2026,112,0,2,3,2,1
28995,77,3225,1178,367,1042,6,15,115,1184,9,94,51,95,103,146,644,976,4,4439,246,0,2,8,3,1
28996,99,5086,1943,715,1694,26,18,214,1969,12,185,120,237,197,357,1436,2721,7,20915,1161,0,2,10,3,1
28997,30,1272,442,244,305,14,16,103,456,11,68,45,75,79,120,452,756,6,4588,254,0,2,4,1,1
28998,51,1917,1098,241,925,5,10,155,1103,7,46,25,49,53,74,273,423,3,1580,87,0,2,7,3,1
28999,41,1474,601,196,481,2,23,85,603,8,63,36,72,71,108,400,664,4,3036,168,0,2,3,2,1
29000,2,40,9,6,6,0,0,3,9,0,0,0,0,0,0,0,0,0,0,0,0,2,1,0,0
29001,2,40,13,9,8,0,0,4,13,0,0,0,0,0,0,0,0,0,0,0,0,2,1,0,0
29002,1,319,382,65,130,157,2,92,539,4,10,5,10,14,15,41,57,2,114,6,0,2,1,3,0
29003,60,1078,282,196,195,3,0,86,285,8,130,71,141,138,212,936,1507,4,6538,363,0,2,3,2,0
29004,4,77,127,75,83,2,11,30,129,4,14,7,14,18,21,61,87,2,175,9,0,2,2,1,0
29005,4,77,652,304,544,16,6,88,668,6,89,51,101,95,152,591,998,3,3399,188,0,2,2,1,0
29006,4,77,2,2,2,0,0,0,2,0,0,0,0,0,0,0,0,0,0,0,0,2,2,1,0
29007,4,77,8,5,5,0,0,3,8,0,0,0,0,0,0,0,0,0,0,0,0,2,2,1,0
29008,4,77,2,2,2,0,0,0,2,0,0,0,0,0,0,0,0,0,0,0,0,2,2,1,0
29009,4,77,14,8,8,0,0,6,14,0,0,0,0,0,0,0,0,0,0,0,0,2,2,1,0
29010,4,77,6,4,4,0,0,2,6,0,0,0,0,0,0,0,0,0,0,0,0,2,2,1,0
29011,4,77,6,4,4,0,0,2,6,1,2,1,2,3,3,2,4,0,2,0,0,2,2,1,0
29012,4,77,6,4,4,0,0,2,6,0,0,0,0,0,0,0,0,0,0,0,0,2,2,1,0
29013,4,77,7,5,5,0,0,2,7,0,0,0,0,0,0,0,0,0,0,0,0,2,2,1,0
29014,4,77,6,4,4,0,0,2,6,0,0,0,0,0,0,0,0,0,0,0,0,2,2,1,0
29015,4,77,10,6,6,0,0,4,10,0,0,0,0,0,0,0,0,0,0,0,0,2,2,1,0
29016,4,77,1,1,1,0,0,0,1,0,0,0,0,0,0,0,0,0,0,0,0,2,2,1,0
29017,4,77,1,1,1,0,0,0,1,0,0,0,0,0,0,0,0,0,0,0,0,2,2,1,0
29018,4,77,14,10,10,0,0,4,14,1,1,1,1,2,2,0,2,0,1,0,0,2,2,1,0
29019,4,77,46,26,30,3,0,12,49,3,6,3,6,9,9,20,28,1,42,2,0,2,2,1,0
29020,7,296,72,33,56,0,4,12,72,1,1,1,1,2,2,0,2,0,1,0,0,2,1,0,0
29021,12,229,127,75,83,2,11,30,129,4,14,7,14,18,21,61,87,2,175,9,0,2,0,1,0
29022,12,229,652,304,544,16,6,88,668,6,89,51,101,95,152,591,998,3,3399,188,0,2,0,1,0
29023,12,229,2,2,2,0,0,0,2,0,0,0,0,0,0,0,0,0,0,0,0,2,0,1,0
29024,12,229,8,5,5,0,0,3,8,0,0,0,0,0,0,0,0,0,0,0,0,2,0,1,0
29025,12,229,2,2,2,0,0,0,2,0,0,0,0,0,0,0,0,0,0,0,0,2,0,1,0
29026,12,229,14,8,8,0,0,6,14,0,0,0,0,0,0,0,0,0,0,0,0,2,0,1,0
29027,12,229,6,4,4,0,0,2,6,0,0,0,0,0,0,0,0,0,0,0,0,2,0,1,0
29028,12,229,6,4,4,0,0,2,6,1,2,1,2,3,3,2,4,0,2,0,0,2,0,1,0
29029,12,229,6,4,4,0,0,2,6,0,0,0,0,0,0,0,0,0,0,0,0,2,0,1,0
29030,12,229,7,5,5,0,0,2,7,0,0,0,0,0,0,0,0,0,0,0,0,2,0,1,0
29031,12,229,6,4,4,0,0,2,6,0,0,0,0,0,0,0,0,0,0,0,0,2,0,1,0
29032,12,229,10,6,6,0,0,4,10,0,0,0,0,0,0,0,0,0,0,0,0,2,0,1,0
29033,12,229,1,1,1,0,0,0,1,0,0,0,0,0,0,0,0,0,0,0,0,2,0,1,0
29034,12,229,1,1,1,0,0,0,1,0,0,0,0,0,0,0,0,0,0,0,0,2,0,1,0
29035,12,229,14,10,10,0,0,4,14,1,1,1,1,2,2,0,2,0,1,0,0,2,0,1,0
29036,12,229,46,26,30,3,0,12,49,3,6,3,6,9,9,20,28,1,42,2,0,2,0,1,0
29037,6,71,127,75,83,2,11,30,129,4,14,7,14,18,21,61,87,2,175,9,0,2,1,0,0
29038,6,71,652,304,544,16,6,88,668,6,89,51,101,95,152,591,998,3,3399,188,0,2,1,0,0
29039,6,71,2,2,2,0,0,0,2,0,0,0,0,0,0,0,0,0,0,0,0,2,1,0,0
29040,6,71,8,5,5,0,0,3,8,0,0,0,0,0,0,0,0,0,0,0,0,2,1,0,0
29041,6,71,2,2,2,0,0,0,2,0,0,0,0,0,0,0,0,0,0,0,0,2,1,0,0
29042,6,71,14,8,8,0,0,6,14,0,0,0,0,0,0,0,0,0,0,0,0,2,1,0,0
29043,6,71,6,4,4,0,0,2,6,0,0,0,0,0,0,0,0,0,0,0,0,2,1,0,0
29044,6,71,6,4,4,0,0,2,6,1,2,1,2,3,3,2,4,0,2,0,0,2,1,0,0
29045,6,71,6,4,4,0,0,2,6,0,0,0,0,0,0,0,0,0,0,0,0,2,1,0,0
29046,6,71,7,5,5,0,0,2,7,0,0,0,0,0,0,0,0,0,0,0,0,2,1,0,0
29047,6,71,6,4,4,0,0,2,6,0,0,0,0,0,0,0,0,0,0,0,0,2,1,0,0
29048,6,71,10,6,6,0,0,4,10,0,0,0,0,0,0,0,0,0,0,0,0,2,1,0,0
29049,6,71,1,1,1,0,0,0,1,0,0,0,0,0,0,0,0,0,0,0,0,2,1,0,0
29050,6,71,1,1,1,0,0,0,1,0,0,0,0,0,0,0,0,0,0,0,0,2,1,0,0
29051,6,71,14,10,10,0,0,4,14,1,1,1,1,2,2,0,2,0,1,0,0,2,1,0,0
29052,6,71,46,26,30,3,0,12,49,3,6,3,6,9,9,20,28,1,42,2,0,2,1,0,0
29053,17,378,85,59,61,8,0,16,93,5,18,10,18,23,28,86,126,2,316,17,0,2,1,0,0
29054,12,515,124,78,88,2,3,26,126,4,13,7,13,17,20,56,81,2,163,9,0,2,6,2,0
29055,1,86,42,7,35,4,0,5,46,1,2,1,2,3,3,2,4,0,2,0,0,2,1,0,0
29056,1,86,11,6,10,0,0,1,11,2,4,2,4,6,6,10,15,1,15,0,0,2,1,0,0
29057,11,242,19,8,11,5,0,4,24,2,5,3,6,7,9,13,25,1,30,1,0,2,5,2,0
29058,11,242,102,59,69,5,3,24,107,6,22,15,28,28,43,113,206,3,789,43,0,2,5,2,0
29059,11,242,106,40,36,3,49,17,109,8,17,13,23,25,36,93,167,5,904,50,0,2,5,2,0
29060,222,4859,182,127,129,0,0,53,182,5,39,21,42,44,63,217,343,2,926,51,0,2,15,7,0
29061,222,4859,1165,710,800,67,119,181,1232,18,243,153,282,261,435,2000,3492,10,36473,2026,1,2,15,7,0
29062,68,1565,773,419,590,28,0,166,801,10,204,113,217,214,330,1598,2554,5,13587,754,0,2,8,5,0
29063,68,1565,421,273,302,44,34,57,465,17,81,59,107,98,166,583,1098,11,12329,684,0,2,8,5,0
29064,26,529,2,2,2,0,0,0,2,0,0,0,0,0,0,0,0,0,0,0,0,2,6,2,0
29065,26,529,99,48,90,1,3,5,100,0,0,0,0,0,0,0,0,0,0,0,0,2,6,2,0
29066,26,529,8,5,5,2,0,1,10,0,0,0,0,0,0,0,0,0,0,0,0,2,6,2,0
29067,26,529,1217,716,841,84,126,174,1301,14,185,118,215,199,333,1446,2542,8,20687,1149,0,2,6,2,0
29068,26,529,160,89,115,0,13,31,160,7,15,11,17,22,28,78,124,3,495,27,0,2,6,2,0
29069,26,529,10,10,9,9,0,0,19,0,0,0,0,0,0,0,0,0,0,0,0,2,6,2,0
29070,26,529,173,84,99,8,29,36,181,5,12,7,13,17,20,54,81,2,221,12,0,2,6,2,0
29071,26,529,3,1,1,3,0,0,6,0,0,0,0,0,0,0,0,0,0,0,0,2,6,2,0
29072,180,5401,1660,832,1314,41,38,274,1701,20,312,209,395,332,604,2671,5058,12,64042,3557,1,2,7,4,0
29073,180,5401,1057,646,719,113,100,145,1170,18,215,134,248,233,382,1740,3004,10,31186,1732,1,2,7,4,0
29074,17,348,95,58,50,9,16,20,104,12,33,24,45,45,69,209,378,8,3100,172,0,2,4,1,0
29075,89,1829,477,336,357,30,23,73,507,16,194,134,250,210,384,1538,2962,10,30538,1696,0,2,6,2,0
29076,76,1743,996,429,845,24,10,117,1020,7,76,50,88,83,138,494,879,4,3565,198,0,2,9,5,0
29077,76,1743,456,277,329,12,42,72,468,13,85,50,97,98,147,592,972,7,7212,400,0,2,9,5,0
29078,154,3265,1513,682,1277,25,13,200,1538,11,199,116,219,210,335,1557,2584,6,15641,868,0,2,6,3,0
29079,154,3265,819,519,539,24,98,155,843,15,96,57,106,111,163,690,1107,8,9171,509,0,2,6,3,0
29080,70,1395,207,111,150,11,0,50,218,5,26,19,36,31,55,133,272,3,943,52,0,2,7,4,0
29081,70,1395,410,198,237,31,55,97,441,11,63,38,72,74,110,414,683,6,4293,238,0,2,7,4,0
29082,218,4751,2,2,2,0,0,0,2,0,0,0,0,0,0,0,0,0,0,0,0,2,20,13,0
29083,218,4751,99,48,90,1,3,5,100,0,0,0,0,0,0,0,0,0,0,0,0,2,20,13,0
29084,218,4751,8,5,5,2,0,1,10,0,0,0,0,0,0,0,0,0,0,0,0,2,20,13,0
29085,218,4751,1217,716,841,84,126,174,1301,14,185,118,215,199,333,1446,2542,8,20687,1149,0,2,20,13,0
29086,218,4751,160,89,115,0,13,31,160,7,15,11,17,22,28,78,124,3,495,27,0,2,20,13,0
29087,218,4751,10,10,9,9,0,0,19,0,0,0,0,0,0,0,0,0,0,0,0,2,20,13,0
29088,218,4751,173,84,99,8,29,36,181,5,12,7,13,17,20,54,81,2,221,12,0,2,20,13,0
29089,218,4751,3,1,1,3,0,0,6,0,0,0,0,0,0,0,0,0,0,0,0,2,20,13,0
29090,97,1999,463,295,324,28,62,57,491,12,134,82,154,146,236,989,1696,6,11700,650,0,2,3,4,0
29091,51,757,167,116,138,4,5,22,171,8,48,30,56,56,86,292,499,4,2330,129,0,2,3,1,0
29092,37,1105,339,213,244,17,9,65,356,10,42,26,48,52,74,259,421,5,2410,133,0,2,3,17,0
29093,85,2182,1455,414,1257,16,76,112,1471,5,41,23,46,46,69,231,381,2,1069,59,0,2,8,4,0
29094,85,2182,669,365,481,22,61,110,691,15,103,63,122,118,185,747,1273,8,11311,628,0,2,8,4,0
29095,258,6040,4293,999,3693,19,54,507,4312,9,155,88,170,164,258,1156,1898,4,9368,520,0,2,26,23,0
29096,258,6040,1482,859,1002,125,135,219,1607,16,219,134,251,235,385,1766,3032,9,27804,1544,1,2,26,23,0
29097,6,140,44,22,19,0,19,6,44,2,10,6,12,12,18,35,64,1,77,4,0,2,3,1,0
29098,27,968,74,35,59,1,0,14,75,3,14,7,14,17,21,58,85,1,128,7,0,2,8,4,0
29099,27,968,245,125,200,5,7,34,250,7,30,17,34,37,51,166,265,3,1053,58,0,2,8,4,0
29100,53,633,647,139,84,35,284,233,682,0,0,0,0,0,0,0,0,0,0,0,0,2,1,1,0
29101,98,2670,1523,757,1297,19,12,193,1542,12,193,117,230,205,347,1508,2664,7,19053,1058,0,2,6,2,0
29102,98,2670,701,378,504,33,58,109,734,13,110,68,126,123,194,794,1346,7,10027,557,0,2,6,2,0
29103,94,2438,773,422,505,30,103,129,803,14,77,46,83,91,129,535,839,7,6334,351,0,2,9,6,0
29104,142,3319,77,34,69,0,0,8,77,3,24,16,29,27,45,114,213,1,387,21,0,2,9,6,0
29105,142,3319,712,438,573,51,9,84,763,14,102,71,128,116,199,733,1364,8,11988,666,0,2,9,6,0
29106,24,628,2,2,2,0,0,0,2,0,0,0,0,0,0,0,0,0,0,0,0,2,15,13,0
29107,24,628,99,48,90,1,3,5,100,0,0,0,0,0,0,0,0,0,0,0,0,2,15,13,0
29108,24,628,8,5,5,2,0,1,10,0,0,0,0,0,0,0,0,0,0,0,0,2,15,13,0
29109,24,628,1217,716,841,84,126,174,1301,14,185,118,215,199,333,1446,2542,8,20687,1149,0,2,15,13,0
29110,24,628,160,89,115,0,13,31,160,7,15,11,17,22,28,78,124,3,495,27,0,2,15,13,0
29111,24,628,10,10,9,9,0,0,19,0,0,0,0,0,0,0,0,0,0,0,0,2,15,13,0
29112,24,628,173,84,99,8,29,36,181,5,12,7,13,17,20,54,81,2,221,12,0,2,15,13,0
29113,24,628,3,1,1,3,0,0,6,0,0,0,0,0,0,0,0,0,0,0,0,2,15,13,0
29114,30,664,125,97,103,3,0,19,128,9,25,17,27,34,44,144,223,4,1087,60,0,2,5,3,0
29115,23,367,102,57,55,5,16,25,107,5,17,10,18,22,28,81,124,2,330,18,0,2,2,1,0
29116,88,1899,402,202,227,24,74,80,426,12,52,33,61,64,94,339,564,7,3969,220,0,2,6,3,0
29117,52,1075,447,308,343,6,5,95,453,7,96,59,111,103,170,651,1136,4,4600,255,0,2,4,2,0
29118,52,1075,322,174,179,16,74,51,338,10,41,26,46,51,72,252,408,5,2291,127,0,2,4,2,0
29119,88,1993,53,23,39,0,0,13,53,2,8,4,8,10,12,26,39,1,39,2,0,2,8,6,0
29120,88,1993,515,298,307,33,80,99,548,12,63,44,77,75,121,419,753,7,5527,307,0,2,8,6,0
29121,23,389,424,94,331,4,0,89,428,1,5,5,5,6,10,11,25,0,12,0,0,2,6,2,0
29122,23,389,38,23,23,6,0,8,44,3,11,7,11,14,18,42,68,1,102,5,0,2,6,2,0
29123,20,526,205,80,86,16,53,53,221,7,18,10,19,25,29,94,134,3,497,27,0,2,4,1,0
29124,17,523,184,100,137,2,15,30,186,6,38,20,39,44,59,214,322,3,991,55,0,2,7,3,0
29125,17,523,103,65,74,8,5,16,111,7,17,9,17,24,26,89,119,3,417,23,0,2,7,3,0
29126,52,1151,91,45,69,0,3,18,91,3,9,6,10,12,16,33,57,1,95,5,0,2,13,10,0
29127,52,1151,367,234,237,17,34,68,384,16,55,34,61,71,95,381,584,8,5183,287,0,2,13,10,0
29128,244,5842,722,423,573,19,0,135,741,12,172,101,199,184,300,1320,2257,6,15668,870,0,2,13,9,0
29129,244,5842,1508,847,911,44,250,301,1552,14,148,88,169,162,257,1120,1886,7,15077,837,0,2,13,9,0
29130,305,6844,72,33,56,0,4,12,72,1,1,1,1,2,2,0,2,0,1,0,0,2,30,32,0
29131,305,6844,1454,835,1044,76,110,219,1530,17,275,158,296,292,454,2297,3718,9,34017,1889,1,2,30,32,0
29132,91,1836,757,253,292,73,244,162,830,13,61,38,67,74,105,409,651,7,4654,258,0,2,6,6,0
29133,43,902,386,256,301,16,9,68,402,4,59,35,69,63,104,355,621,2,1453,80,0,2,4,3,0
29134,43,902,264,131,164,11,41,46,275,6,38,22,40,44,62,214,338,3,1068,59,0,2,4,3,0
29135,28,707,466,257,367,18,25,50,484,7,126,86,171,133,257,898,1813,4,8612,478,0,2,1,0,0
29136,28,707,507,281,342,29,59,88,536,10,53,29,57,63,86,336,514,5,2764,153,0,2,1,0,0
29137,30,658,215,129,180,6,0,29,221,8,65,43,72,73,115,415,711,4,3153,175,0,2,5,2,0
29138,30,658,97,69,77,3,3,16,100,6,22,13,23,28,36,113,173,3,542,30,0,2,5,2,0
29139,92,1975,1043,504,840,53,9,147,1096,9,180,112,198,189,310,1377,2344,4,11604,644,0,2,10,4,0
29140,92,1975,383,288,292,26,6,62,409,11,65,38,67,76,105,429,656,5,3719,206,0,2,10,4,0
29141,20,420,294,64,250,0,0,43,294,1,20,10,20,21,30,86,131,0,65,3,0,2,5,2,0
29142,20,420,78,46,62,3,0,14,81,3,8,4,8,11,12,28,41,1,62,3,0,2,5,2,0
29143,5,123,110,30,77,3,13,16,113,4,21,15,30,25,45,100,208,2,597,33,0,2,3,1,0
29144,5,123,28,15,21,1,0,6,29,0,0,0,0,0,0,0,0,0,0,0,0,2,3,1,0
29145,70,1394,1178,367,1042,6,15,115,1184,9,94,51,95,103,146,644,976,4,4439,246,0,2,6,2,0
29146,70,1394,177,108,140,8,0,27,185,6,30,16,32,36,48,162,248,3,794,44,0,2,6,2,0
29147,226,4927,1943,715,1694,26,18,214,1969,12,185,120,237,197,357,1436,2721,7,20915,1161,0,2,11,14,0
29148,226,4927,1168,838,957,57,25,144,1225,19,348,224,416,367,640,3018,5452,11,61921,3440,1,2,11,14,0
29149,19,682,442,244,305,14,16,103,456,11,68,45,75,79,120,452,756,6,4588,254,0,2,13,12,0
29150,19,682,182,102,99,11,40,35,193,3,11,6,11,14,17,42,64,1,97,5,0,2,13,12,0
29151,62,1255,1098,241,925,5,10,155,1103,7,46,25,49,53,74,273,423,3,1580,87,0,2,11,5,0
29152,62,1255,282,202,222,14,2,44,296,8,42,24,43,50,67,250,378,4,1548,86,0,2,11,5,0
29153,29,728,601,196,481,2,23,85,603,8,63,36,72,71,108,400,664,4,3036,168,0,2,3,2,0
29154,29,728,156,79,106,5,16,28,161,5,14,8,15,19,23,64,97,2,261,14,0,2,3,2,0
29155,99,4089,1289,550,1043,56,32,155,1345,10,167,93,185,177,278,1266,2075,5,11498,638,0,2,7,3,0
29156,35,1083,182,127,129,0,0,53,182,5,39,21,42,44,63,217,343,2,926,51,0,2,6,4,0
29157,152,7159,1392,870,1177,35,17,170,1427,14,494,280,531,508,811,4473,7289,7,54850,3047,2,2,11,10,0
29158,90,2889,773,419,590,28,0,166,801,10,204,113,217,214,330,1598,2554,5,13587,754,0,2,6,2,0
29159,25,1187,75,38,59,1,3,12,76,2,4,2,4,6,6,10,15,1,15,0,0,2,3,1,0
29160,8,263,51,25,36,0,0,15,51,3,11,6,12,14,18,42,68,1,112,6,0,2,2,1,0
29161,2,51,14,9,9,0,0,5,14,0,0,0,0,0,0,0,0,0,0,0,0,2,2,1,0
29162,1,134,149,67,118,4,0,27,153,1,17,14,28,18,42,69,175,0,144,8,0,2,1,0,0
29163,34,2285,1157,318,931,29,22,177,1186,6,104,63,125,110,188,712,1274,3,4596,255,0,2,1,1,0
29164,63,4333,520,294,400,33,13,81,553,10,261,204,367,271,571,2128,4614,7,32445,1802,1,2,6,5,0
29165,180,8011,139,89,101,2,0,35,141,7,54,34,62,61,96,330,569,4,2287,127,0,2,3,2,0
29166,180,8011,7,5,5,0,0,2,7,1,2,1,2,3,3,2,4,0,2,0,0,2,3,2,0
29167,138,6148,1782,648,1425,9,47,279,1791,8,171,97,189,179,286,1292,2140,4,9462,525,0,2,5,3,0
29168,25,684,256,139,192,9,7,47,265,4,23,12,24,27,36,112,171,2,357,19,0,2,3,2,0
29169,23,583,102,59,69,5,3,24,107,6,22,15,28,28,43,113,206,3,789,43,0,2,5,1,0
29170,111,4174,1450,624,1228,12,26,181,1462,14,306,186,354,320,540,2580,4493,8,36391,2021,1,2,8,4,0
29171,166,4983,1660,832,1314,41,38,274,1701,20,312,209,395,332,604,2671,5058,12,64042,3557,1,2,8,7,0
29172,44,3230,996,429,845,24,10,117,1020,7,76,50,88,83,138,494,879,4,3565,198,0,2,6,3,0
29173,128,5336,1513,682,1277,25,13,200,1538,11,199,116,219,210,335,1557,2584,6,15641,868,0,2,10,6,0
29174,75,3910,1296,573,1062,40,33,157,1336,8,201,118,231,209,349,1561,2689,4,12365,686,0,2,8,3,0
29175,19,453,207,111,150,11,0,50,218,5,26,19,36,31,55,133,272,3,943,52,0,2,8,2,0
29176,92,4718,1457,730,1242,11,6,188,1468,10,292,166,329,302,495,2424,4078,5,22973,1276,1,2,8,3,0
29177,40,2521,652,304,544,16,6,88,668,6,89,51,101,95,152,591,998,3,3399,188,0,2,8,2,0
29178,70,3216,1455,414,1257,16,76,112,1471,5,41,23,46,46,69,231,381,2,1069,59,0,2,9,3,0
29179,2,79,7,6,5,0,0,2,7,1,1,1,2,2,3,0,3,1,3,0,0,2,4,1,0
29180,8,275,74,35,59,1,0,14,75,3,14,7,14,17,21,58,85,1,128,7,0,2,5,2,0
29181,96,4695,1523,757,1297,19,12,193,1542,12,193,117,230,205,347,1508,2664,7,19053,1058,0,2,9,5,0
29182,97,4232,1020,354,843,12,15,144,1032,8,134,77,144,142,221,970,1580,4,6792,377,0,2,4,1,0
29183,42,1903,447,308,343,6,5,95,453,7,96,59,111,103,170,651,1136,4,4600,255,0,2,4,1,0
29184,2,145,53,23,39,0,0,13,53,2,8,4,8,10,12,26,39,1,39,2,0,2,0,1,0
29185,21,662,424,94,331,4,0,89,428,1,5,5,5,6,10,11,25,0,12,0,0,2,4,1,0
29186,38,2306,334,251,279,10,4,40,344,5,127,74,143,132,217,899,1528,2,4303,239,0,2,7,2,0
29187,12,497,184,100,137,2,15,30,186,6,38,20,39,44,59,214,322,3,991,55,0,2,5,1,0
29188,64,2936,1293,570,1093,25,15,163,1318,10,195,123,241,205,364,1516,2795,6,17273,959,0,2,13,4,0
29189,33,1897,384,251,317,7,8,52,391,11,70,44,84,81,128,467,811,6,5355,297,0,2,9,4,0
29190,47,2248,722,423,573,19,0,135,741,12,172,101,199,184,300,1320,2257,6,15668,870,0,2,15,6,0
29191,43,1877,386,256,301,16,9,68,402,4,59,35,69,63,104,355,621,2,1453,80,0,2,5,2,0
29192,16,1245,215,129,180,6,0,29,221,8,65,43,72,73,115,415,711,4,3153,175,0,2,13,9,0
29193,84,3236,1043,504,840,53,9,147,1096,9,180,112,198,189,310,1377,2344,4,11604,644,0,2,12,5,0
29194,14,534,295,56,236,0,4,54,295,2,9,5,10,11,15,30,51,1,57,3,0,2,4,1,0
29195,30,1245,373,158,315,8,0,51,381,5,76,44,79,81,123,486,779,2,2026,112,0,2,3,2,0
29196,77,3225,1178,367,1042,6,15,115,1184,9,94,51,95,103,146,644,976,4,4439,246,0,2,8,3,0
29197,99,5086,1943,715,1694,26,18,214,1969,12,185,120,237,197,357,1436,2721,7,20915,1161,0,2,10,3,0
29198,30,1272,442,244,305,14,16,103,456,11,68,45,75,79,120,452,756,6,4588,254,0,2,4,1,0
29199,51,1917,1098,241,925,5,10,155,1103,7,46,25,49,53,74,273,423,3,1580,87,0,2,7,3,0
29200,41,1474,601,196,481,2,23,85,603,8,63,36,72,71,108,400,664,4,3036,168,0,2,3,2,0
29201,45,919,386,256,301,16,9,68,402,4,59,35,69,63,104,355,621,2,1453,80,0,2,12,6,1
29202,45,919,264,131,164,11,41,46,275,6,38,22,40,44,62,214,338,3,1068,59,0,2,12,6,1
29203,44,1910,386,256,301,16,9,68,402,4,59,35,69,63,104,355,621,2,1453,80,0,2,6,0,1
29204,142,3324,77,34,69,0,0,8,77,3,24,16,29,27,45,114,213,1,387,21,0,2,10,9,0
29205,142,3324,712,438,573,51,9,84,763,14,102,71,128,116,199,733,1364,8,11988,666,0,2,10,9,0
29206,303,6802,72,33,56,0,4,12,72,1,1,1,1,2,2,0,2,0,1,0,0,2,0,9,0
29207,303,6802,1454,835,1044,76,110,219,1530,17,275,158,296,292,454,2297,3718,9,34017,1889,1,2,0,9,0
29208,30,1245,373,158,315,8,0,51,381,5,76,44,79,81,123,486,779,2,2026,112,0,2,1,1,0
29209,45,919,386,256,301,16,9,68,402,4,59,35,69,63,104,355,621,2,1453,80,0,2,12,6,0
29210,45,919,264,131,164,11,41,46,275,6,38,22,40,44,62,214,338,3,1068,59,0,2,12,6,0
29211,44,1910,386,256,301,16,9,68,402,4,59,35,69,63,104,355,621,2,1453,80,0,2,6,0,0
29212,54,1174,91,45,69,0,3,18,91,3,9,6,10,12,16,33,57,1,95,5,0,2,10,4,0
29213,54,1174,367,234,237,17,34,68,384,16,55,34,61,71,95,381,584,8,5183,287,0,2,10,4,0
29214,31,1314,442,244,305,14,16,103,456,11,68,45,75,79,120,452,756,6,4588,254,0,2,8,1,0
29215,218,4738,2,2,2,0,0,0,2,0,0,0,0,0,0,0,0,0,0,0,0,2,6,6,0
29216,218,4738,99,48,90,1,3,5,100,0,0,0,0,0,0,0,0,0,0,0,0,2,6,6,0
29217,218,4738,8,5,5,2,0,1,10,0,0,0,0,0,0,0,0,0,0,0,0,2,6,6,0
29218,218,4738,1217,716,841,84,126,174,1301,14,185,118,215,199,333,1446,2542,8,20687,1149,0,2,6,6,0
29219,218,4738,160,89,115,0,13,31,160,7,15,11,17,22,28,78,124,3,495,27,0,2,6,6,0
29220,218,4738,10,10,9,9,0,0,19,0,0,0,0,0,0,0,0,0,0,0,0,2,6,6,0
29221,218,4738,173,84,99,8,29,36,181,5,12,7,13,17,20,54,81,2,221,12,0,2,6,6,0
29222,218,4738,3,1,1,3,0,0,6,0,0,0,0,0,0,0,0,0,0,0,0,2,6,6,0
29223,53,1176,91,45,69,0,3,18,91,3,9,6,10,12,16,33,57,1,95,5,0,2,1,1,1
29224,53,1176,367,234,237,17,34,68,384,16,55,34,61,71,95,381,584,8,5183,287,0,2,1,1,1
29225,303,6803,72,33,56,0,4,12,72,1,1,1,1,2,2,0,2,0,1,0,0,2,9,12,1
29226,303,6803,1454,835,1044,76,110,219,1530,17,275,158,296,292,454,2297,3718,9,34017,1889,1,2,9,12,1
29227,54,1188,91,45,69,0,3,18,91,3,9,6,10,12,16,33,57,1,95,5,0,2,10,4,0
29228,54,1188,367,234,237,17,34,68,384,16,55,34,61,71,95,381,584,8,5183,287,0,2,10,4,0
29229,31,1318,442,244,305,14,16,103,456,11,68,45,75,79,120,452,756,6,4588,254,0,2,8,1,0
29230,54,1186,91,45,69,0,3,18,91,3,9,6,10,12,16,33,57,1,95,5,0,2,1,1,0
29231,54,1186,367,234,237,17,34,68,384,16,55,34,61,71,95,381,584,8,5183,287,0,2,1,1,0
29232,4,163,27,21,21,0,0,6,27,3,6,3,6,9,9,20,28,1,42,2,0,0,28,0,0
29233,1,6,2,2,2,0,0,0,2,0,0,0,0,0,0,0,0,0,0,0,0,0,2,0,0
29234,303,6803,72,33,56,0,4,12,72,1,1,1,1,2,2,0,2,0,1,0,0,2,9,12,0
29235,303,6803,1454,835,1044,76,110,219,1530,17,275,158,296,292,454,2297,3718,9,34017,1889,1,2,9,12,0
29236,218,4753,2,2,2,0,0,0,2,0,0,0,0,0,0,0,0,0,0,0,0,2,1,0,0
29237,218,4753,99,48,90,1,3,5,100,0,0,0,0,0,0,0,0,0,0,0,0,2,1,0,0
29238,218,4753,8,5,5,2,0,1,10,0,0,0,0,0,0,0,0,0,0,0,0,2,1,0,0
29239,218,4753,1217,716,841,84,126,174,1301,14,185,118,215,199,333,1446,2542,8,20687,1149,0,2,1,0,0
29240,218,4753,160,89,115,0,13,31,160,7,15,11,17,22,28,78,124,3,495,27,0,2,1,0,0
29241,218,4753,10,10,9,9,0,0,19,0,0,0,0,0,0,0,0,0,0,0,0,2,1,0,0
29242,218,4753,173,84,99,8,29,36,181,5,12,7,13,17,20,54,81,2,221,12,0,2,1,0,0
29243,218,4753,3,1,1,3,0,0,6,0,0,0,0,0,0,0,0,0,0,0,0,2,1,0,0
29244,25,397,219,78,157,11,5,46,230,3,24,20,34,27,54,114,256,2,545,30,0,0,102,0,0
29245,25,397,108,64,79,9,0,20,117,5,15,11,19,20,30,70,129,3,410,22,0,0,102,0,0
29246,44,3230,996,429,845,24,10,117,1020,7,76,50,88,83,138,494,879,4,3565,198,0,2,2,1,0
29247,9,441,219,78,157,11,5,46,230,3,24,20,34,27,54,114,256,2,545,30,0,0,148,0,0
29248,218,4753,2,2,2,0,0,0,2,0,0,0,0,0,0,0,0,0,0,0,0,2,6,6,0
29249,218,4753,99,48,90,1,3,5,100,0,0,0,0,0,0,0,0,0,0,0,0,2,6,6,0
29250,218,4753,8,5,5,2,0,1,10,0,0,0,0,0,0,0,0,0,0,0,0,2,6,6,0
29251,218,4753,1217,716,841,84,126,174,1301,14,185,118,215,199,333,1446,2542,8,20687,1149,0,2,6,6,0
29252,218,4753,160,89,115,0,13,31,160,7,15,11,17,22,28,78,124,3,495,27,0,2,6,6,0
29253,218,4753,10,10,9,9,0,0,19,0,0,0,0,0,0,0,0,0,0,0,0,2,6,6,0
29254,218,4753,173,84,99,8,29,36,181,5,12,7,13,17,20,54,81,2,221,12,0,2,6,6,0
29255,218,4753,3,1,1,3,0,0,6,0,0,0,0,0,0,0,0,0,0,0,0,2,6,6,0
29256,53,1159,91,45,69,0,3,18,91,3,9,6,10,12,16,33,57,1,95,5,0,2,11,5,0
29257,53,1159,367,234,237,17,34,68,384,16,55,34,61,71,95,381,584,8,5183,287,0,2,11,5,0
29258,45,919,386,256,301,16,9,68,402,4,59,35,69,63,104,355,621,2,1453,80,0,2,12,6,0
29259,45,919,264,131,164,11,41,46,275,6,38,22,40,44,62,214,338,3,1068,59,0,2,12,6,0
29260,4,163,27,21,21,0,0,6,27,3,6,3,6,9,9,20,28,1,42,2,0,0,28,0,0
29261,1,6,2,2,2,0,0,0,2,0,0,0,0,0,0,0,0,0,0,0,0,0,2,0,0
29262,44,1910,386,256,301,16,9,68,402,4,59,35,69,63,104,355,621,2,1453,80,0,2,6,0,0
29263,31,1318,442,244,305,14,16,103,456,11,68,45,75,79,120,452,756,6,4588,254,0,2,8,1,0
29264,218,4753,2,2,2,0,0,0,2,0,0,0,0,0,0,0,0,0,0,0,0,2,6,6,0
29265,218,4753,99,48,90,1,3,5,100,0,0,0,0,0,0,0,0,0,0,0,0,2,6,6,0
29266,218,4753,8,5,5,2,0,1,10,0,0,0,0,0,0,0,0,0,0,0,0,2,6,6,0
29267,218,4753,1217,716,841,84,126,174,1301,14,185,118,215,199,333,1446,2542,8,20687,1149,0,2,6,6,0
29268,218,4753,160,89,115,0,13,31,160,7,15,11,17,22,28,78,124,3,495,27,0,2,6,6,0
29269,218,4753,10,10,9,9,0,0,19,0,0,0,0,0,0,0,0,0,0,0,0,2,6,6,0
29270,218,4753,173,84,99,8,29,36,181,5,12,7,13,17,20,54,81,2,221,12,0,2,6,6,0
29271,218,4753,3,1,1,3,0,0,6,0,0,0,0,0,0,0,0,0,0,0,0,2,6,6,0
29272,53,1159,91,45,69,0,3,18,91,3,9,6,10,12,16,33,57,1,95,5,0,2,11,5,0
29273,53,1159,367,234,237,17,34,68,384,16,55,34,61,71,95,381,584,8,5183,287,0,2,11,5,0
29274,45,919,386,256,301,16,9,68,402,4,59,35,69,63,104,355,621,2,1453,80,0,2,12,6,0
29275,45,919,264,131,164,11,41,46,275,6,38,22,40,44,62,214,338,3,1068,59,0,2,12,6,0
29276,4,163,27,21,21,0,0,6,27,3,6,3,6,9,9,20,28,1,42,2,0,0,28,0,0
29277,1,6,2,2,2,0,0,0,2,0,0,0,0,0,0,0,0,0,0,0,0,0,2,0,0
29278,44,1910,386,256,301,16,9,68,402,4,59,35,69,63,104,355,621,2,1453,80,0,2,6,0,0
29279,31,1318,442,244,305,14,16,103,456,11,68,45,75,79,120,452,756,6,4588,254,0,2,8,1,0
29280,68,1562,773,419,590,28,0,166,801,10,204,113,217,214,330,1598,2554,5,13587,754,0,2,3,5,1
29281,68,1562,421,273,302,44,34,57,465,17,81,59,107,98,166,583,1098,11,12329,684,0,2,3,5,1
29282,68,1577,773,419,590,28,0,166,801,10,204,113,217,214,330,1598,2554,5,13587,754,0,2,6,1,1
29283,68,1577,421,273,302,44,34,57,465,17,81,59,107,98,166,583,1098,11,12329,684,0,2,6,1,1
29284,154,3265,1513,682,1277,25,13,200,1538,11,199,116,219,210,335,1557,2584,6,15641,868,0,2,1,1,0
29285,154,3265,819,519,539,24,98,155,843,15,96,57,106,111,163,690,1107,8,9171,509,0,2,1,1,0
29286,97,1999,463,295,324,28,62,57,491,12,134,82,154,146,236,989,1696,6,11700,650,0,2,1,1,0
29287,256,6014,4293,999,3693,19,54,507,4312,9,155,88,170,164,258,1156,1898,4,9368,520,0,2,1,1,0
29288,256,6014,1482,859,1002,125,135,219,1607,16,219,134,251,235,385,1766,3032,9,27804,1544,1,2,1,1,0
29289,52,622,647,139,84,35,284,233,682,0,0,0,0,0,0,0,0,0,0,0,0,2,2,2,0
29290,88,1899,402,202,227,24,74,80,426,12,52,33,61,64,94,339,564,7,3969,220,0,2,1,1,0
29291,54,1186,91,45,69,0,3,18,91,3,9,6,10,12,16,33,57,1,95,5,0,2,5,5,0
29292,54,1186,367,234,237,17,34,68,384,16,55,34,61,71,95,381,584,8,5183,287,0,2,5,5,0
29293,305,6844,72,33,56,0,4,12,72,1,1,1,1,2,2,0,2,0,1,0,0,2,2,2,0
29294,305,6844,1454,835,1044,76,110,219,1530,17,275,158,296,292,454,2297,3718,9,34017,1889,1,2,2,2,0
29295,68,1577,773,419,590,28,0,166,801,10,204,113,217,214,330,1598,2554,5,13587,754,0,2,8,5,0
29296,68,1577,421,273,302,44,34,57,465,17,81,59,107,98,166,583,1098,11,12329,684,0,2,8,5,0
29297,147,3371,77,34,69,0,0,8,77,3,24,16,29,27,45,114,213,1,387,21,0,2,21,8,0
29298,147,3371,712,438,573,51,9,84,763,14,102,71,128,116,199,733,1364,8,11988,666,0,2,21,8,0
29299,304,6811,72,33,56,0,4,12,72,1,1,1,1,2,2,0,2,0,1,0,0,2,8,6,0
29300,304,6811,1454,835,1044,76,110,219,1530,17,275,158,296,292,454,2297,3718,9,34017,1889,1,2,8,6,0
29301,54,1186,91,45,69,0,3,18,91,3,9,6,10,12,16,33,57,1,95,5,0,2,1,1,0
29302,54,1186,367,234,237,17,34,68,384,16,55,34,61,71,95,381,584,8,5183,287,0,2,1,1,0
29303,154,3265,1513,682,1277,25,13,200,1538,11,199,116,219,210,335,1557,2584,6,15641,868,0,2,1,1,0
29304,154,3265,819,519,539,24,98,155,843,15,96,57,106,111,163,690,1107,8,9171,509,0,2,1,1,0
29305,97,1999,463,295,324,28,62,57,491,12,134,82,154,146,236,989,1696,6,11700,650,0,2,1,1,0
29306,256,6014,4293,999,3693,19,54,507,4312,9,155,88,170,164,258,1156,1898,4,9368,520,0,2,1,1,0
29307,256,6014,1482,859,1002,125,135,219,1607,16,219,134,251,235,385,1766,3032,9,27804,1544,1,2,1,1,0
29308,52,622,647,139,84,35,284,233,682,0,0,0,0,0,0,0,0,0,0,0,0,2,2,2,0
29309,88,1899,402,202,227,24,74,80,426,12,52,33,61,64,94,339,564,7,3969,220,0,2,1,1,0
29310,54,1186,91,45,69,0,3,18,91,3,9,6,10,12,16,33,57,1,95,5,0,2,6,6,0
29311,54,1186,367,234,237,17,34,68,384,16,55,34,61,71,95,381,584,8,5183,287,0,2,6,6,0
29312,305,6844,72,33,56,0,4,12,72,1,1,1,1,2,2,0,2,0,1,0,0,2,2,2,0
29313,305,6844,1454,835,1044,76,110,219,1530,17,275,158,296,292,454,2297,3718,9,34017,1889,1,2,2,2,0
29314,147,3371,77,34,69,0,0,8,77,3,24,16,29,27,45,114,213,1,387,21,0,2,21,8,0
29315,147,3371,712,438,573,51,9,84,763,14,102,71,128,116,199,733,1364,8,11988,666,0,2,21,8,0
29316,304,6811,72,33,56,0,4,12,72,1,1,1,1,2,2,0,2,0,1,0,0,2,8,6,0
29317,304,6811,1454,835,1044,76,110,219,1530,17,275,158,296,292,454,2297,3718,9,34017,1889,1,2,8,6,0
29318,57,1214,91,45,69,0,3,18,91,3,9,6,10,12,16,33,57,1,95,5,0,2,17,7,0
29319,57,1214,367,234,237,17,34,68,384,16,55,34,61,71,95,381,584,8,5183,287,0,2,17,7,0
29320,8,377,91,45,69,0,3,18,91,3,9,6,10,12,16,33,57,1,95,5,0,3,18,0,0
29321,77,1753,996,429,845,24,10,117,1020,7,76,50,88,83,138,494,879,4,3565,198,0,2,2,1,1
29322,77,1753,456,277,329,12,42,72,468,13,85,50,97,98,147,592,972,7,7212,400,0,2,2,1,1
29323,57,1214,91,45,69,0,3,18,91,3,9,6,10,12,16,33,57,1,95,5,0,2,17,7,0
29324,57,1214,367,234,237,17,34,68,384,16,55,34,61,71,95,381,584,8,5183,287,0,2,17,7,0
29325,8,377,91,45,69,0,3,18,91,3,9,6,10,12,16,33,57,1,95,5,0,3,18,0,0
29326,7,298,72,33,56,0,4,12,72,1,1,1,1,2,2,0,2,0,1,0,0,2,2,2,0
29327,257,6042,4293,999,3693,19,54,507,4312,9,155,88,170,164,258,1156,1898,4,9368,520,0,2,8,0,0
29328,257,6042,1482,859,1002,125,135,219,1607,16,219,134,251,235,385,1766,3032,9,27804,1544,1,2,8,0,0
29329,7,298,72,33,56,0,4,12,72,1,1,1,1,2,2,0,2,0,1,0,0,2,2,2,0
29330,257,6042,4293,999,3693,19,54,507,4312,9,155,88,170,164,258,1156,1898,4,9368,520,0,2,8,0,0
29331,257,6042,1482,859,1002,125,135,219,1607,16,219,134,251,235,385,1766,3032,9,27804,1544,1,2,8,0,0
29332,155,3277,1513,682,1277,25,13,200,1538,11,199,116,219,210,335,1557,2584,6,15641,868,0,2,3,0,1
29333,155,3277,819,519,539,24,98,155,843,15,96,57,106,111,163,690,1107,8,9171,509,0,2,3,0,1
29334,40,1143,339,213,244,17,9,65,356,10,42,26,48,52,74,259,421,5,2410,133,0,2,8,2,1
29335,65,3000,1293,570,1093,25,15,163,1318,10,195,123,241,205,364,1516,2795,6,17273,959,0,2,16,0,1
29336,52,1096,447,308,343,6,5,95,453,7,96,59,111,103,170,651,1136,4,4600,255,0,2,5,3,1
29337,52,1096,322,174,179,16,74,51,338,10,41,26,46,51,72,252,408,5,2291,127,0,2,5,3,1
29338,42,1907,447,308,343,6,5,95,453,7,96,59,111,103,170,651,1136,4,4600,255,0,2,5,3,1
29339,219,4759,2,2,2,0,0,0,2,0,0,0,0,0,0,0,0,0,0,0,0,2,28,25,1
29340,219,4759,99,48,90,1,3,5,100,0,0,0,0,0,0,0,0,0,0,0,0,2,28,25,1
29341,219,4759,8,5,5,2,0,1,10,0,0,0,0,0,0,0,0,0,0,0,0,2,28,25,1
29342,219,4759,1217,716,841,84,126,174,1301,14,185,118,215,199,333,1446,2542,8,20687,1149,0,2,28,25,1
29343,219,4759,160,89,115,0,13,31,160,7,15,11,17,22,28,78,124,3,495,27,0,2,28,25,1
29344,219,4759,10,10,9,9,0,0,19,0,0,0,0,0,0,0,0,0,0,0,0,2,28,25,1
29345,219,4759,173,84,99,8,29,36,181,5,12,7,13,17,20,54,81,2,221,12,0,2,28,25,1
29346,219,4759,3,1,1,3,0,0,6,0,0,0,0,0,0,0,0,0,0,0,0,2,28,25,1
29347,40,2521,652,304,544,16,6,88,668,6,89,51,101,95,152,591,998,3,3399,188,0,2,5,5,1
29348,155,3277,1513,682,1277,25,13,200,1538,11,199,116,219,210,335,1557,2584,6,15641,868,0,2,3,0,0
29349,155,3277,819,519,539,24,98,155,843,15,96,57,106,111,163,690,1107,8,9171,509,0,2,3,0,0
29350,40,1143,339,213,244,17,9,65,356,10,42,26,48,52,74,259,421,5,2410,133,0,2,8,2,0
29351,65,3000,1293,570,1093,25,15,163,1318,10,195,123,241,205,364,1516,2795,6,17273,959,0,2,16,0,0
29352,219,4759,2,2,2,0,0,0,2,0,0,0,0,0,0,0,0,0,0,0,0,2,28,25,0
29353,219,4759,99,48,90,1,3,5,100,0,0,0,0,0,0,0,0,0,0,0,0,2,28,25,0
29354,219,4759,8,5,5,2,0,1,10,0,0,0,0,0,0,0,0,0,0,0,0,2,28,25,0
29355,219,4759,1217,716,841,84,126,174,1301,14,185,118,215,199,333,1446,2542,8,20687,1149,0,2,28,25,0
29356,219,4759,160,89,115,0,13,31,160,7,15,11,17,22,28,78,124,3,495,27,0,2,28,25,0
29357,219,4759,10,10,9,9,0,0,19,0,0,0,0,0,0,0,0,0,0,0,0,2,28,25,0
29358,219,4759,173,84,99,8,29,36,181,5,12,7,13,17,20,54,81,2,221,12,0,2,28,25,0
29359,219,4759,3,1,1,3,0,0,6,0,0,0,0,0,0,0,0,0,0,0,0,2,28,25,0
29360,40,2521,652,304,544,16,6,88,668,6,89,51,101,95,152,591,998,3,3399,188,0,2,5,5,0
29361,77,1753,996,429,845,24,10,117,1020,7,76,50,88,83,138,494,879,4,3565,198,0,2,2,1,0
29362,77,1753,456,277,329,12,42,72,468,13,85,50,97,98,147,592,972,7,7212,400,0,2,2,1,0
29363,42,1906,447,308,343,6,5,95,453,7,96,59,111,103,170,651,1136,4,4600,255,0,2,1,1,0
29364,142,3324,77,34,69,0,0,8,77,3,24,16,29,27,45,114,213,1,387,21,0,2,10,9,0
29365,142,3324,712,438,573,51,9,84,763,14,102,71,128,116,199,733,1364,8,11988,666,0,2,10,9,0
29366,303,6802,72,33,56,0,4,12,72,1,1,1,1,2,2,0,2,0,1,0,0,2,0,9,0
29367,303,6802,1454,835,1044,76,110,219,1530,17,275,158,296,292,454,2297,3718,9,34017,1889,1,2,0,9,0
29368,30,1245,373,158,315,8,0,51,381,5,76,44,79,81,123,486,779,2,2026,112,0,2,1,1,0
29369,75,3937,1296,573,1062,40,33,157,1336,8,201,118,231,209,349,1561,2689,4,12365,686,0,2,9,0,0
29370,75,4003,1296,573,1062,40,33,157,1336,8,201,118,231,209,349,1561,2689,4,12365,686,0,2,6,0,0
29371,143,3347,77,34,69,0,0,8,77,3,24,16,29,27,45,114,213,1,387,21,0,2,9,1,1
29372,143,3347,712,438,573,51,9,84,763,14,102,71,128,116,199,733,1364,8,11988,666,0,2,9,1,1
29373,70,1383,207,111,150,11,0,50,218,5,26,19,36,31,55,133,272,3,943,52,0,2,8,0,1
29374,70,1383,410,198,237,31,55,97,441,11,63,38,72,74,110,414,683,6,4293,238,0,2,8,0,1
29375,305,6850,72,33,56,0,4,12,72,1,1,1,1,2,2,0,2,0,1,0,0,2,2,1,1
29376,305,6850,1454,835,1044,76,110,219,1530,17,275,158,296,292,454,2297,3718,9,34017,1889,1,2,2,1,1
29377,28,800,256,139,192,9,7,47,265,4,23,12,24,27,36,112,171,2,357,19,0,2,24,0,1
29378,76,3946,1296,573,1062,40,33,157,1336,8,201,118,231,209,349,1561,2689,4,12365,686,0,2,27,0,1
29379,21,498,207,111,150,11,0,50,218,5,26,19,36,31,55,133,272,3,943,52,0,2,12,0,1
29380,70,1383,207,111,150,11,0,50,218,5,26,19,36,31,55,133,272,3,943,52,0,2,8,0,0
29381,70,1383,410,198,237,31,55,97,441,11,63,38,72,74,110,414,683,6,4293,238,0,2,8,0,0
29382,305,6850,72,33,56,0,4,12,72,1,1,1,1,2,2,0,2,0,1,0,0,2,2,1,0
29383,305,6850,1454,835,1044,76,110,219,1530,17,275,158,296,292,454,2297,3718,9,34017,1889,1,2,2,1,0
29384,28,800,256,139,192,9,7,47,265,4,23,12,24,27,36,112,171,2,357,19,0,2,24,0,0
29385,76,3946,1296,573,1062,40,33,157,1336,8,201,118,231,209,349,1561,2689,4,12365,686,0,2,27,0,0
29386,21,498,207,111,150,11,0,50,218,5,26,19,36,31,55,133,272,3,943,52,0,2,12,0,0
29387,52,1096,447,308,343,6,5,95,453,7,96,59,111,103,170,651,1136,4,4600,255,0,2,5,3,0
29388,52,1096,322,174,179,16,74,51,338,10,41,26,46,51,72,252,408,5,2291,127,0,2,5,3,0
29389,42,1906,447,308,343,6,5,95,453,7,96,59,111,103,170,651,1136,4,4600,255,0,2,4,2,0
29390,143,3347,77,34,69,0,0,8,77,3,24,16,29,27,45,114,213,1,387,21,0,2,19,10,0
29391,143,3347,712,438,573,51,9,84,763,14,102,71,128,116,199,733,1364,8,11988,666,0,2,19,10,0
29392,303,6808,72,33,56,0,4,12,72,1,1,1,1,2,2,0,2,0,1,0,0,2,0,9,0
29393,303,6808,1454,835,1044,76,110,219,1530,17,275,158,296,292,454,2297,3718,9,34017,1889,1,2,0,9,0
29394,76,4039,1296,573,1062,40,33,157,1336,8,201,118,231,209,349,1561,2689,4,12365,686,0,2,15,0,0
29395,30,1245,373,158,315,8,0,51,381,5,76,44,79,81,123,486,779,2,2026,112,0,2,1,1,0
29396,147,3379,77,34,69,0,0,8,77,3,24,16,29,27,45,114,213,1,387,21,0,2,5,4,0
29397,147,3379,712,438,573,51,9,84,763,14,102,71,128,116,199,733,1364,8,11988,666,0,2,5,4,0
29398,56,1200,91,45,69,0,3,18,91,3,9,6,10,12,16,33,57,1,95,5,0,2,5,0,0
29399,56,1200,367,234,237,17,34,68,384,16,55,34,61,71,95,381,584,8,5183,287,0,2,5,0,0
29400,301,6795,72,33,56,0,4,12,72,1,1,1,1,2,2,0,2,0,1,0,0,2,3,6,0
29401,301,6795,1454,835,1044,76,110,219,1530,17,275,158,296,292,454,2297,3718,9,34017,1889,1,2,3,6,0
29402,147,3364,77,34,69,0,0,8,77,3,24,16,29,27,45,114,213,1,387,21,0,2,7,4,1
29403,147,3364,712,438,573,51,9,84,763,14,102,71,128,116,199,733,1364,8,11988,666,0,2,7,4,1
29404,304,6818,72,33,56,0,4,12,72,1,1,1,1,2,2,0,2,0,1,0,0,2,4,0,1
29405,304,6818,1454,835,1044,76,110,219,1530,17,275,158,296,292,454,2297,3718,9,34017,1889,1,2,4,0,1
29406,148,3384,77,34,69,0,0,8,77,3,24,16,29,27,45,114,213,1,387,21,0,2,11,7,0
29407,148,3384,712,438,573,51,9,84,763,14,102,71,128,116,199,733,1364,8,11988,666,0,2,11,7,0
29408,146,3375,77,34,69,0,0,8,77,3,24,16,29,27,45,114,213,1,387,21,0,2,4,6,0
29409,146,3375,712,438,573,51,9,84,763,14,102,71,128,116,199,733,1364,8,11988,666,0,2,4,6,0
29410,56,1200,91,45,69,0,3,18,91,3,9,6,10,12,16,33,57,1,95,5,0,2,1,1,0
29411,56,1200,367,234,237,17,34,68,384,16,55,34,61,71,95,381,584,8,5183,287,0,2,1,1,0
29412,31,958,339,213,244,17,9,65,356,10,42,26,48,52,74,259,421,5,2410,133,0,2,15,7,1
29413,65,2927,1293,570,1093,25,15,163,1318,10,195,123,241,205,364,1516,2795,6,17273,959,0,2,27,0,1
29414,146,3375,77,34,69,0,0,8,77,3,24,16,29,27,45,114,213,1,387,21,0,2,18,12,0
29415,146,3375,712,438,573,51,9,84,763,14,102,71,128,116,199,733,1364,8,11988,666,0,2,18,12,0
29416,56,1200,91,45,69,0,3,18,91,3,9,6,10,12,16,33,57,1,95,5,0,2,5,0,0
29417,56,1200,367,234,237,17,34,68,384,16,55,34,61,71,95,381,584,8,5183,287,0,2,5,0,0
29418,304,6818,72,33,56,0,4,12,72,1,1,1,1,2,2,0,2,0,1,0,0,2,3,2,0
29419,304,6818,1454,835,1044,76,110,219,1530,17,275,158,296,292,454,2297,3718,9,34017,1889,1,2,3,2,0
29420,7,298,72,33,56,0,4,12,72,1,1,1,1,2,2,0,2,0,1,0,0,2,2,2,0
29421,68,1577,773,419,590,28,0,166,801,10,204,113,217,214,330,1598,2554,5,13587,754,0,2,8,5,0
29422,68,1577,421,273,302,44,34,57,465,17,81,59,107,98,166,583,1098,11,12329,684,0,2,8,5,0
29423,155,3277,1513,682,1277,25,13,200,1538,11,199,116,219,210,335,1557,2584,6,15641,868,0,2,1,1,0
29424,155,3277,819,519,539,24,98,155,843,15,96,57,106,111,163,690,1107,8,9171,509,0,2,1,1,0
29425,72,1414,207,111,150,11,0,50,218,5,26,19,36,31,55,133,272,3,943,52,0,2,8,0,0
29426,72,1414,410,198,237,31,55,97,441,11,63,38,72,74,110,414,683,6,4293,238,0,2,8,0,0
29427,97,1999,463,295,324,28,62,57,491,12,134,82,154,146,236,989,1696,6,11700,650,0,2,1,1,0
29428,259,6068,4293,999,3693,19,54,507,4312,9,155,88,170,164,258,1156,1898,4,9368,520,0,2,9,1,0
29429,259,6068,1482,859,1002,125,135,219,1607,16,219,134,251,235,385,1766,3032,9,27804,1544,1,2,9,1,0
29430,53,633,647,139,84,35,284,233,682,0,0,0,0,0,0,0,0,0,0,0,0,2,2,2,0
29431,147,3398,77,34,69,0,0,8,77,3,24,16,29,27,45,114,213,1,387,21,0,2,9,1,0
29432,147,3398,712,438,573,51,9,84,763,14,102,71,128,116,199,733,1364,8,11988,666,0,2,9,1,0
29433,88,1899,402,202,227,24,74,80,426,12,52,33,61,64,94,339,564,7,3969,220,0,2,1,1,0
29434,52,1096,447,308,343,6,5,95,453,7,96,59,111,103,170,651,1136,4,4600,255,0,2,5,3,0
29435,52,1096,322,174,179,16,74,51,338,10,41,26,46,51,72,252,408,5,2291,127,0,2,5,3,0
29436,59,1228,91,45,69,0,3,18,91,3,9,6,10,12,16,33,57,1,95,5,0,2,23,13,0
29437,59,1228,367,234,237,17,34,68,384,16,55,34,61,71,95,381,584,8,5183,287,0,2,23,13,0
29438,304,6824,72,33,56,0,4,12,72,1,1,1,1,2,2,0,2,0,1,0,0,2,4,3,0
29439,304,6824,1454,835,1044,76,110,219,1530,17,275,158,296,292,454,2297,3718,9,34017,1889,1,2,4,3,0
29440,28,800,256,139,192,9,7,47,265,4,23,12,24,27,36,112,171,2,357,19,0,2,24,0,0
29441,76,4039,1296,573,1062,40,33,157,1336,8,201,118,231,209,349,1561,2689,4,12365,686,0,2,42,0,0
29442,21,498,207,111,150,11,0,50,218,5,26,19,36,31,55,133,272,3,943,52,0,2,12,0,0
29443,42,1906,447,308,343,6,5,95,453,7,96,59,111,103,170,651,1136,4,4600,255,0,2,4,2,0
29444,8,377,91,45,69,0,3,18,91,3,9,6,10,12,16,33,57,1,95,5,0,3,18,0,0
29445,7,298,72,33,56,0,4,12,72,1,1,1,1,2,2,0,2,0,1,0,0,2,2,2,0
29446,31,958,339,213,244,17,9,65,356,10,42,26,48,52,74,259,421,5,2410,133,0,2,15,7,0
29447,65,2927,1293,570,1093,25,15,163,1318,10,195,123,241,205,364,1516,2795,6,17273,959,0,2,27,0,0
29448,7,298,72,33,56,0,4,12,72,1,1,1,1,2,2,0,2,0,1,0,0,2,2,2,0
29449,77,1753,996,429,845,24,10,117,1020,7,76,50,88,83,138,494,879,4,3565,198,0,2,2,1,0
29450,77,1753,456,277,329,12,42,72,468,13,85,50,97,98,147,592,972,7,7212,400,0,2,2,1,0
29451,155,3277,1513,682,1277,25,13,200,1538,11,199,116,219,210,335,1557,2584,6,15641,868,0,2,3,0,0
29452,155,3277,819,519,539,24,98,155,843,15,96,57,106,111,163,690,1107,8,9171,509,0,2,3,0,0
29453,72,1414,207,111,150,11,0,50,218,5,26,19,36,31,55,133,272,3,943,52,0,2,13,0,0
29454,72,1414,410,198,237,31,55,97,441,11,63,38,72,74,110,414,683,6,4293,238,0,2,13,0,0
29455,219,4759,2,2,2,0,0,0,2,0,0,0,0,0,0,0,0,0,0,0,0,2,30,24,0
29456,219,4759,99,48,90,1,3,5,100,0,0,0,0,0,0,0,0,0,0,0,0,2,30,24,0
29457,219,4759,8,5,5,2,0,1,10,0,0,0,0,0,0,0,0,0,0,0,0,2,30,24,0
29458,219,4759,1217,716,841,84,126,174,1301,14,185,118,215,199,333,1446,2542,8,20687,1149,0,2,30,24,0
29459,219,4759,160,89,115,0,13,31,160,7,15,11,17,22,28,78,124,3,495,27,0,2,30,24,0
29460,219,4759,10,10,9,9,0,0,19,0,0,0,0,0,0,0,0,0,0,0,0,2,30,24,0
29461,219,4759,173,84,99,8,29,36,181,5,12,7,13,17,20,54,81,2,221,12,0,2,30,24,0
29462,219,4759,3,1,1,3,0,0,6,0,0,0,0,0,0,0,0,0,0,0,0,2,30,24,0
29463,40,1165,339,213,244,17,9,65,356,10,42,26,48,52,74,259,421,5,2410,133,0,2,47,3,0
29464,259,6068,4293,999,3693,19,54,507,4312,9,155,88,170,164,258,1156,1898,4,9368,520,0,2,4,0,0
29465,259,6068,1482,859,1002,125,135,219,1607,16,219,134,251,235,385,1766,3032,9,27804,1544,1,2,4,0,0
29466,53,633,647,139,84,35,284,233,682,0,0,0,0,0,0,0,0,0,0,0,0,2,13,1,0
29467,147,3398,77,34,69,0,0,8,77,3,24,16,29,27,45,114,213,1,387,21,0,2,39,20,0
29468,147,3398,712,438,573,51,9,84,763,14,102,71,128,116,199,733,1364,8,11988,666,0,2,39,20,0
29469,59,1228,91,45,69,0,3,18,91,3,9,6,10,12,16,33,57,1,95,5,0,2,7,10,0
29470,59,1228,367,234,237,17,34,68,384,16,55,34,61,71,95,381,584,8,5183,287,0,2,7,10,0
29471,304,6824,72,33,56,0,4,12,72,1,1,1,1,2,2,0,2,0,1,0,0,2,18,18,0
29472,304,6824,1454,835,1044,76,110,219,1530,17,275,158,296,292,454,2297,3718,9,34017,1889,1,2,18,18,0
29473,25,397,219,78,157,11,5,46,230,3,24,20,34,27,54,114,256,2,545,30,0,0,102,0,0
29474,25,397,108,64,79,9,0,20,117,5,15,11,19,20,30,70,129,3,410,22,0,0,102,0,0
29475,226,4927,1943,715,1694,26,18,214,1969,12,185,120,237,197,357,1436,2721,7,20915,1161,0,2,26,15,0
29476,226,4927,1168,838,957,57,25,144,1225,19,348,224,416,367,640,3018,5452,11,61921,3440,1,2,26,15,0
29477,25,1187,75,38,59,1,3,12,76,2,4,2,4,6,6,10,15,1,15,0,0,2,12,0,0
29478,2,18,10,6,6,0,0,4,10,0,0,0,0,0,0,0,0,0,0,0,0,0,10,0,0
29479,44,3230,996,429,845,24,10,117,1020,7,76,50,88,83,138,494,879,4,3565,198,0,2,2,1,0
29480,40,2521,652,304,544,16,6,88,668,6,89,51,101,95,152,591,998,3,3399,188,0,2,5,5,0
29481,66,3064,1293,570,1093,25,15,163,1318,10,195,123,241,205,364,1516,2795,6,17273,959,0,2,49,7,0
29482,9,441,219,78,157,11,5,46,230,3,24,20,34,27,54,114,256,2,545,30,0,0,148,0,0
29483,7,298,72,33,56,0,4,12,72,1,1,1,1,2,2,0,2,0,1,0,0,2,2,2,0
29484,68,1577,773,419,590,28,0,166,801,10,204,113,217,214,330,1598,2554,5,13587,754,0,2,8,5,0
29485,68,1577,421,273,302,44,34,57,465,17,81,59,107,98,166,583,1098,11,12329,684,0,2,8,5,0
29486,155,3277,1513,682,1277,25,13,200,1538,11,199,116,219,210,335,1557,2584,6,15641,868,0,2,1,1,0
29487,155,3277,819,519,539,24,98,155,843,15,96,57,106,111,163,690,1107,8,9171,509,0,2,1,1,0
29488,72,1414,207,111,150,11,0,50,218,5,26,19,36,31,55,133,272,3,943,52,0,2,8,0,0
29489,72,1414,410,198,237,31,55,97,441,11,63,38,72,74,110,414,683,6,4293,238,0,2,8,0,0
29490,97,1999,463,295,324,28,62,57,491,12,134,82,154,146,236,989,1696,6,11700,650,0,2,1,1,0
29491,40,1165,339,213,244,17,9,65,356,10,42,26,48,52,74,259,421,5,2410,133,0,2,15,7,0
29492,259,6068,4293,999,3693,19,54,507,4312,9,155,88,170,164,258,1156,1898,4,9368,520,0,2,9,1,0
29493,259,6068,1482,859,1002,125,135,219,1607,16,219,134,251,235,385,1766,3032,9,27804,1544,1,2,9,1,0
29494,53,633,647,139,84,35,284,233,682,0,0,0,0,0,0,0,0,0,0,0,0,2,2,2,0
29495,147,3398,77,34,69,0,0,8,77,3,24,16,29,27,45,114,213,1,387,21,0,2,9,1,0
29496,147,3398,712,438,573,51,9,84,763,14,102,71,128,116,199,733,1364,8,11988,666,0,2,9,1,0
29497,88,1899,402,202,227,24,74,80,426,12,52,33,61,64,94,339,564,7,3969,220,0,2,1,1,0
29498,52,1096,447,308,343,6,5,95,453,7,96,59,111,103,170,651,1136,4,4600,255,0,2,5,3,0
29499,52,1096,322,174,179,16,74,51,338,10,41,26,46,51,72,252,408,5,2291,127,0,2,5,3,0
29500,59,1228,91,45,69,0,3,18,91,3,9,6,10,12,16,33,57,1,95,5,0,2,23,13,0
29501,59,1228,367,234,237,17,34,68,384,16,55,34,61,71,95,381,584,8,5183,287,0,2,23,13,0
29502,304,6824,72,33,56,0,4,12,72,1,1,1,1,2,2,0,2,0,1,0,0,2,4,3,0
29503,304,6824,1454,835,1044,76,110,219,1530,17,275,158,296,292,454,2297,3718,9,34017,1889,1,2,4,3,0
29504,28,800,256,139,192,9,7,47,265,4,23,12,24,27,36,112,171,2,357,19,0,2,24,0,0
29505,76,4039,1296,573,1062,40,33,157,1336,8,201,118,231,209,349,1561,2689,4,12365,686,0,2,42,0,0
29506,21,498,207,111,150,11,0,50,218,5,26,19,36,31,55,133,272,3,943,52,0,2,12,0,0
29507,42,1906,447,308,343,6,5,95,453,7,96,59,111,103,170,651,1136,4,4600,255,0,2,4,2,0
29508,8,377,91,45,69,0,3,18,91,3,9,6,10,12,16,33,57,1,95,5,0,3,18,0,0
29509,66,3064,1293,570,1093,25,15,163,1318,10,195,123,241,205,364,1516,2795,6,17273,959,0,2,27,0,0
29510,220,4770,2,2,2,0,0,0,2,0,0,0,0,0,0,0,0,0,0,0,0,2,2,0,0
29511,220,4770,99,48,90,1,3,5,100,0,0,0,0,0,0,0,0,0,0,0,0,2,2,0,0
29512,220,4770,8,5,5,2,0,1,10,0,0,0,0,0,0,0,0,0,0,0,0,2,2,0,0
29513,220,4770,1217,716,841,84,126,174,1301,14,185,118,215,199,333,1446,2542,8,20687,1149,0,2,2,0,0
29514,220,4770,160,89,115,0,13,31,160,7,15,11,17,22,28,78,124,3,495,27,0,2,2,0,0
29515,220,4770,10,10,9,9,0,0,19,0,0,0,0,0,0,0,0,0,0,0,0,2,2,0,0
29516,220,4770,173,84,99,8,29,36,181,5,12,7,13,17,20,54,81,2,221,12,0,2,2,0,0
29517,220,4770,3,1,1,3,0,0,6,0,0,0,0,0,0,0,0,0,0,0,0,2,2,0,0
29518,123,5254,1513,682,1277,25,13,200,1538,11,199,116,219,210,335,1557,2584,6,15641,868,0,2,15,32,0
29519,34,1970,384,251,317,7,8,52,391,11,70,44,84,81,128,467,811,6,5355,297,0,2,17,0,0
29520,220,4770,2,2,2,0,0,0,2,0,0,0,0,0,0,0,0,0,0,0,0,2,1,0,0
29521,220,4770,99,48,90,1,3,5,100,0,0,0,0,0,0,0,0,0,0,0,0,2,1,0,0
29522,220,4770,8,5,5,2,0,1,10,0,0,0,0,0,0,0,0,0,0,0,0,2,1,0,0
29523,220,4770,1217,716,841,84,126,174,1301,14,185,118,215,199,333,1446,2542,8,20687,1149,0,2,1,0,0
29524,220,4770,160,89,115,0,13,31,160,7,15,11,17,22,28,78,124,3,495,27,0,2,1,0,0
29525,220,4770,10,10,9,9,0,0,19,0,0,0,0,0,0,0,0,0,0,0,0,2,1,0,0
29526,220,4770,173,84,99,8,29,36,181,5,12,7,13,17,20,54,81,2,221,12,0,2,1,0,0
29527,220,4770,3,1,1,3,0,0,6,0,0,0,0,0,0,0,0,0,0,0,0,2,1,0,0
29528,123,5258,1513,682,1277,25,13,200,1538,11,199,116,219,210,335,1557,2584,6,15641,868,0,2,15,32,0
29529,219,4755,2,2,2,0,0,0,2,0,0,0,0,0,0,0,0,0,0,0,0,2,2,3,0
29530,219,4755,99,48,90,1,3,5,100,0,0,0,0,0,0,0,0,0,0,0,0,2,2,3,0
29531,219,4755,8,5,5,2,0,1,10,0,0,0,0,0,0,0,0,0,0,0,0,2,2,3,0
29532,219,4755,1217,716,841,84,126,174,1301,14,185,118,215,199,333,1446,2542,8,20687,1149,0,2,2,3,0
29533,219,4755,160,89,115,0,13,31,160,7,15,11,17,22,28,78,124,3,495,27,0,2,2,3,0
29534,219,4755,10,10,9,9,0,0,19,0,0,0,0,0,0,0,0,0,0,0,0,2,2,3,0
29535,219,4755,173,84,99,8,29,36,181,5,12,7,13,17,20,54,81,2,221,12,0,2,2,3,0
29536,219,4755,3,1,1,3,0,0,6,0,0,0,0,0,0,0,0,0,0,0,0,2,2,3,0
29537,89,1778,477,336,357,30,23,73,507,16,194,134,250,210,384,1538,2962,10,30538,1696,0,2,34,42,1
29538,155,3275,1513,682,1277,25,13,200,1538,11,199,116,219,210,335,1557,2584,6,15641,868,0,2,2,2,1
29539,155,3275,819,519,539,24,98,155,843,15,96,57,106,111,163,690,1107,8,9171,509,0,2,2,2,1
29540,110,4151,1450,624,1228,12,26,181,1462,14,306,186,354,320,540,2580,4493,8,36391,2021,1,2,2,5,1
29541,89,1778,477,336,357,30,23,73,507,16,194,134,250,210,384,1538,2962,10,30538,1696,0,2,34,42,0
29542,155,3275,1513,682,1277,25,13,200,1538,11,199,116,219,210,335,1557,2584,6,15641,868,0,2,2,2,0
29543,155,3275,819,519,539,24,98,155,843,15,96,57,106,111,163,690,1107,8,9171,509,0,2,2,2,0
29544,110,4151,1450,624,1228,12,26,181,1462,14,306,186,354,320,540,2580,4493,8,36391,2021,1,2,2,5,0
29545,220,4776,2,2,2,0,0,0,2,0,0,0,0,0,0,0,0,0,0,0,0,2,3,1,0
29546,220,4776,99,48,90,1,3,5,100,0,0,0,0,0,0,0,0,0,0,0,0,2,3,1,0
29547,220,4776,8,5,5,2,0,1,10,0,0,0,0,0,0,0,0,0,0,0,0,2,3,1,0
29548,220,4776,1217,716,841,84,126,174,1301,14,185,118,215,199,333,1446,2542,8,20687,1149,0,2,3,1,0
29549,220,4776,160,89,115,0,13,31,160,7,15,11,17,22,28,78,124,3,495,27,0,2,3,1,0
29550,220,4776,10,10,9,9,0,0,19,0,0,0,0,0,0,0,0,0,0,0,0,2,3,1,0
29551,220,4776,173,84,99,8,29,36,181,5,12,7,13,17,20,54,81,2,221,12,0,2,3,1,0
29552,220,4776,3,1,1,3,0,0,6,0,0,0,0,0,0,0,0,0,0,0,0,2,3,1,0
29553,149,3468,77,34,69,0,0,8,77,3,24,16,29,27,45,114,213,1,387,21,0,2,16,0,1
29554,149,3468,712,438,573,51,9,84,763,14,102,71,128,116,199,733,1364,8,11988,666,0,2,16,0,1
29555,87,1953,53,23,39,0,0,13,53,2,8,4,8,10,12,26,39,1,39,2,0,2,1,7,1
29556,87,1953,515,298,307,33,80,99,548,12,63,44,77,75,121,419,753,7,5527,307,0,2,1,7,1
29557,219,4755,2,2,2,0,0,0,2,0,0,0,0,0,0,0,0,0,0,0,0,2,2,3,0
29558,219,4755,99,48,90,1,3,5,100,0,0,0,0,0,0,0,0,0,0,0,0,2,2,3,0
29559,219,4755,8,5,5,2,0,1,10,0,0,0,0,0,0,0,0,0,0,0,0,2,2,3,0
29560,219,4755,1217,716,841,84,126,174,1301,14,185,118,215,199,333,1446,2542,8,20687,1149,0,2,2,3,0
29561,219,4755,160,89,115,0,13,31,160,7,15,11,17,22,28,78,124,3,495,27,0,2,2,3,0
29562,219,4755,10,10,9,9,0,0,19,0,0,0,0,0,0,0,0,0,0,0,0,2,2,3,0
29563,219,4755,173,84,99,8,29,36,181,5,12,7,13,17,20,54,81,2,221,12,0,2,2,3,0
29564,219,4755,3,1,1,3,0,0,6,0,0,0,0,0,0,0,0,0,0,0,0,2,2,3,0
29565,149,3468,77,34,69,0,0,8,77,3,24,16,29,27,45,114,213,1,387,21,0,2,16,0,0
29566,149,3468,712,438,573,51,9,84,763,14,102,71,128,116,199,733,1364,8,11988,666,0,2,16,0,0
29567,87,1953,53,23,39,0,0,13,53,2,8,4,8,10,12,26,39,1,39,2,0,2,1,7,0
29568,87,1953,515,298,307,33,80,99,548,12,63,44,77,75,121,419,753,7,5527,307,0,2,1,7,0
29569,219,4765,2,2,2,0,0,0,2,0,0,0,0,0,0,0,0,0,0,0,0,2,3,3,0
29570,219,4765,99,48,90,1,3,5,100,0,0,0,0,0,0,0,0,0,0,0,0,2,3,3,0
29571,219,4765,8,5,5,2,0,1,10,0,0,0,0,0,0,0,0,0,0,0,0,2,3,3,0
29572,219,4765,1217,716,841,84,126,174,1301,14,185,118,215,199,333,1446,2542,8,20687,1149,0,2,3,3,0
29573,219,4765,160,89,115,0,13,31,160,7,15,11,17,22,28,78,124,3,495,27,0,2,3,3,0
29574,219,4765,10,10,9,9,0,0,19,0,0,0,0,0,0,0,0,0,0,0,0,2,3,3,0
29575,219,4765,173,84,99,8,29,36,181,5,12,7,13,17,20,54,81,2,221,12,0,2,3,3,0
29576,219,4765,3,1,1,3,0,0,6,0,0,0,0,0,0,0,0,0,0,0,0,2,3,3,0
29577,77,4118,1296,573,1062,40,33,157,1336,8,201,118,231,209,349,1561,2689,4,12365,686,0,2,24,0,0
29578,148,3423,77,34,69,0,0,8,77,3,24,16,29,27,45,114,213,1,387,21,0,2,15,14,0
29579,148,3423,712,438,573,51,9,84,763,14,102,71,128,116,199,733,1364,8,11988,666,0,2,15,14,0
29580,308,6881,72,33,56,0,4,12,72,1,1,1,1,2,2,0,2,0,1,0,0,2,14,1,0
29581,308,6881,1454,835,1044,76,110,219,1530,17,275,158,296,292,454,2297,3718,9,34017,1889,1,2,14,1,0
29582,76,4080,1296,573,1062,40,33,157,1336,8,201,118,231,209,349,1561,2689,4,12365,686,0,2,24,8,0
29583,148,3409,77,34,69,0,0,8,77,3,24,16,29,27,45,114,213,1,387,21,0,2,3,4,0
29584,148,3409,712,438,573,51,9,84,763,14,102,71,128,116,199,733,1364,8,11988,666,0,2,3,4,0
29585,76,4115,1296,573,1062,40,33,157,1336,8,201,118,231,209,349,1561,2689,4,12365,686,0,2,13,0,0
29586,76,4117,1296,573,1062,40,33,157,1336,8,201,118,231,209,349,1561,2689,4,12365,686,0,2,11,8,0
29587,150,3460,77,34,69,0,0,8,77,3,24,16,29,27,45,114,213,1,387,21,0,2,11,6,0
29588,150,3460,712,438,573,51,9,84,763,14,102,71,128,116,199,733,1364,8,11988,666,0,2,11,6,0
29589,147,3410,77,34,69,0,0,8,77,3,24,16,29,27,45,114,213,1,387,21,0,2,8,12,0
29590,147,3410,712,438,573,51,9,84,763,14,102,71,128,116,199,733,1364,8,11988,666,0,2,8,12,0
29591,150,3446,77,34,69,0,0,8,77,3,24,16,29,27,45,114,213,1,387,21,0,2,15,5,0
29592,150,3446,712,438,573,51,9,84,763,14,102,71,128,116,199,733,1364,8,11988,666,0,2,15,5,0
29593,148,3413,77,34,69,0,0,8,77,3,24,16,29,27,45,114,213,1,387,21,0,2,6,15,0
29594,148,3413,712,438,573,51,9,84,763,14,102,71,128,116,199,733,1364,8,11988,666,0,2,6,15,0
29595,34,1970,384,251,317,7,8,52,391,11,70,44,84,81,128,467,811,6,5355,297,0,2,5,4,0
29596,148,3413,77,34,69,0,0,8,77,3,24,16,29,27,45,114,213,1,387,21,0,2,34,32,0
29597,148,3413,712,438,573,51,9,84,763,14,102,71,128,116,199,733,1364,8,11988,666,0,2,34,32,0
29598,308,6881,72,33,56,0,4,12,72,1,1,1,1,2,2,0,2,0,1,0,0,2,14,1,0
29599,308,6881,1454,835,1044,76,110,219,1530,17,275,158,296,292,454,2297,3718,9,34017,1889,1,2,14,1,0
29600,76,4117,1296,573,1062,40,33,157,1336,8,201,118,231,209,349,1561,2689,4,12365,686,0,2,42,10,0
29601,219,4765,2,2,2,0,0,0,2,0,0,0,0,0,0,0,0,0,0,0,0,2,3,3,0
29602,219,4765,99,48,90,1,3,5,100,0,0,0,0,0,0,0,0,0,0,0,0,2,3,3,0
29603,219,4765,8,5,5,2,0,1,10,0,0,0,0,0,0,0,0,0,0,0,0,2,3,3,0
29604,219,4765,1217,716,841,84,126,174,1301,14,185,118,215,199,333,1446,2542,8,20687,1149,0,2,3,3,0
29605,219,4765,160,89,115,0,13,31,160,7,15,11,17,22,28,78,124,3,495,27,0,2,3,3,0
29606,219,4765,10,10,9,9,0,0,19,0,0,0,0,0,0,0,0,0,0,0,0,2,3,3,0
29607,219,4765,173,84,99,8,29,36,181,5,12,7,13,17,20,54,81,2,221,12,0,2,3,3,0
29608,219,4765,3,1,1,3,0,0,6,0,0,0,0,0,0,0,0,0,0,0,0,2,3,3,0
29609,77,4118,1296,573,1062,40,33,157,1336,8,201,118,231,209,349,1561,2689,4,12365,686,0,2,24,0,0
29610,227,4936,1943,715,1694,26,18,214,1969,12,185,120,237,197,357,1436,2721,7,20915,1161,0,2,4,1,0
29611,227,4936,1168,838,957,57,25,144,1225,19,348,224,416,367,640,3018,5452,11,61921,3440,1,2,4,1,0
29612,89,1778,477,336,357,30,23,73,507,16,194,134,250,210,384,1538,2962,10,30538,1696,0,2,34,42,0
29613,155,3275,1513,682,1277,25,13,200,1538,11,199,116,219,210,335,1557,2584,6,15641,868,0,2,2,2,0
29614,155,3275,819,519,539,24,98,155,843,15,96,57,106,111,163,690,1107,8,9171,509,0,2,2,2,0
29615,219,4761,2,2,2,0,0,0,2,0,0,0,0,0,0,0,0,0,0,0,0,2,2,3,0
29616,219,4761,99,48,90,1,3,5,100,0,0,0,0,0,0,0,0,0,0,0,0,2,2,3,0
29617,219,4761,8,5,5,2,0,1,10,0,0,0,0,0,0,0,0,0,0,0,0,2,2,3,0
29618,219,4761,1217,716,841,84,126,174,1301,14,185,118,215,199,333,1446,2542,8,20687,1149,0,2,2,3,0
29619,219,4761,160,89,115,0,13,31,160,7,15,11,17,22,28,78,124,3,495,27,0,2,2,3,0
29620,219,4761,10,10,9,9,0,0,19,0,0,0,0,0,0,0,0,0,0,0,0,2,2,3,0
29621,219,4761,173,84,99,8,29,36,181,5,12,7,13,17,20,54,81,2,221,12,0,2,2,3,0
29622,219,4761,3,1,1,3,0,0,6,0,0,0,0,0,0,0,0,0,0,0,0,2,2,3,0
29623,150,3483,77,34,69,0,0,8,77,3,24,16,29,27,45,114,213,1,387,21,0,2,34,32,0
29624,150,3483,712,438,573,51,9,84,763,14,102,71,128,116,199,733,1364,8,11988,666,0,2,34,32,0
29625,308,6881,72,33,56,0,4,12,72,1,1,1,1,2,2,0,2,0,1,0,0,2,14,1,0
29626,308,6881,1454,835,1044,76,110,219,1530,17,275,158,296,292,454,2297,3718,9,34017,1889,1,2,14,1,0
29627,110,4151,1450,624,1228,12,26,181,1462,14,306,186,354,320,540,2580,4493,8,36391,2021,1,2,2,5,0
29628,123,5258,1513,682,1277,25,13,200,1538,11,199,116,219,210,335,1557,2584,6,15641,868,0,2,15,32,0
29629,77,4196,1296,573,1062,40,33,157,1336,8,201,118,231,209,349,1561,2689,4,12365,686,0,2,42,10,0
29630,89,1778,477,336,357,30,23,73,507,16,194,134,250,210,384,1538,2962,10,30538,1696,0,2,34,42,0
29631,155,3275,1513,682,1277,25,13,200,1538,11,199,116,219,210,335,1557,2584,6,15641,868,0,2,2,2,0
29632,155,3275,819,519,539,24,98,155,843,15,96,57,106,111,163,690,1107,8,9171,509,0,2,2,2,0
29633,219,4761,2,2,2,0,0,0,2,0,0,0,0,0,0,0,0,0,0,0,0,2,2,3,0
29634,219,4761,99,48,90,1,3,5,100,0,0,0,0,0,0,0,0,0,0,0,0,2,2,3,0
29635,219,4761,8,5,5,2,0,1,10,0,0,0,0,0,0,0,0,0,0,0,0,2,2,3,0
29636,219,4761,1217,716,841,84,126,174,1301,14,185,118,215,199,333,1446,2542,8,20687,1149,0,2,2,3,0
29637,219,4761,160,89,115,0,13,31,160,7,15,11,17,22,28,78,124,3,495,27,0,2,2,3,0
29638,219,4761,10,10,9,9,0,0,19,0,0,0,0,0,0,0,0,0,0,0,0,2,2,3,0
29639,219,4761,173,84,99,8,29,36,181,5,12,7,13,17,20,54,81,2,221,12,0,2,2,3,0
29640,219,4761,3,1,1,3,0,0,6,0,0,0,0,0,0,0,0,0,0,0,0,2,2,3,0
29641,150,3483,77,34,69,0,0,8,77,3,24,16,29,27,45,114,213,1,387,21,0,2,34,32,0
29642,150,3483,712,438,573,51,9,84,763,14,102,71,128,116,199,733,1364,8,11988,666,0,2,34,32,0
29643,308,6881,72,33,56,0,4,12,72,1,1,1,1,2,2,0,2,0,1,0,0,2,14,1,0
29644,308,6881,1454,835,1044,76,110,219,1530,17,275,158,296,292,454,2297,3718,9,34017,1889,1,2,14,1,0
29645,110,4151,1450,624,1228,12,26,181,1462,14,306,186,354,320,540,2580,4493,8,36391,2021,1,2,2,5,0
29646,123,5258,1513,682,1277,25,13,200,1538,11,199,116,219,210,335,1557,2584,6,15641,868,0,2,15,32,0
29647,77,4196,1296,573,1062,40,33,157,1336,8,201,118,231,209,349,1561,2689,4,12365,686,0,2,42,10,0
29648,220,4775,2,2,2,0,0,0,2,0,0,0,0,0,0,0,0,0,0,0,0,2,6,4,1
29649,220,4775,99,48,90,1,3,5,100,0,0,0,0,0,0,0,0,0,0,0,0,2,6,4,1
29650,220,4775,8,5,5,2,0,1,10,0,0,0,0,0,0,0,0,0,0,0,0,2,6,4,1
29651,220,4775,1217,716,841,84,126,174,1301,14,185,118,215,199,333,1446,2542,8,20687,1149,0,2,6,4,1
29652,220,4775,160,89,115,0,13,31,160,7,15,11,17,22,28,78,124,3,495,27,0,2,6,4,1
29653,220,4775,10,10,9,9,0,0,19,0,0,0,0,0,0,0,0,0,0,0,0,2,6,4,1
29654,220,4775,173,84,99,8,29,36,181,5,12,7,13,17,20,54,81,2,221,12,0,2,6,4,1
29655,220,4775,3,1,1,3,0,0,6,0,0,0,0,0,0,0,0,0,0,0,0,2,6,4,1
29656,77,4244,1296,573,1062,40,33,157,1336,8,201,118,231,209,349,1561,2689,4,12365,686,0,2,14,1,1
29657,227,4936,1943,715,1694,26,18,214,1969,12,185,120,237,197,357,1436,2721,7,20915,1161,0,2,4,1,0
29658,227,4936,1168,838,957,57,25,144,1225,19,348,224,416,367,640,3018,5452,11,61921,3440,1,2,4,1,0
29659,220,4772,2,2,2,0,0,0,2,0,0,0,0,0,0,0,0,0,0,0,0,2,5,0,0
29660,220,4772,99,48,90,1,3,5,100,0,0,0,0,0,0,0,0,0,0,0,0,2,5,0,0
29661,220,4772,8,5,5,2,0,1,10,0,0,0,0,0,0,0,0,0,0,0,0,2,5,0,0
29662,220,4772,1217,716,841,84,126,174,1301,14,185,118,215,199,333,1446,2542,8,20687,1149,0,2,5,0,0
29663,220,4772,160,89,115,0,13,31,160,7,15,11,17,22,28,78,124,3,495,27,0,2,5,0,0
29664,220,4772,10,10,9,9,0,0,19,0,0,0,0,0,0,0,0,0,0,0,0,2,5,0,0
29665,220,4772,173,84,99,8,29,36,181,5,12,7,13,17,20,54,81,2,221,12,0,2,5,0,0
29666,220,4772,3,1,1,3,0,0,6,0,0,0,0,0,0,0,0,0,0,0,0,2,5,0,0
29667,34,1970,384,251,317,7,8,52,391,11,70,44,84,81,128,467,811,6,5355,297,0,2,18,0,0
29668,220,4775,2,2,2,0,0,0,2,0,0,0,0,0,0,0,0,0,0,0,0,2,6,4,0
29669,220,4775,99,48,90,1,3,5,100,0,0,0,0,0,0,0,0,0,0,0,0,2,6,4,0
29670,220,4775,8,5,5,2,0,1,10,0,0,0,0,0,0,0,0,0,0,0,0,2,6,4,0
29671,220,4775,1217,716,841,84,126,174,1301,14,185,118,215,199,333,1446,2542,8,20687,1149,0,2,6,4,0
29672,220,4775,160,89,115,0,13,31,160,7,15,11,17,22,28,78,124,3,495,27,0,2,6,4,0
29673,220,4775,10,10,9,9,0,0,19,0,0,0,0,0,0,0,0,0,0,0,0,2,6,4,0
29674,220,4775,173,84,99,8,29,36,181,5,12,7,13,17,20,54,81,2,221,12,0,2,6,4,0
29675,220,4775,3,1,1,3,0,0,6,0,0,0,0,0,0,0,0,0,0,0,0,2,6,4,0
29676,77,4244,1296,573,1062,40,33,157,1336,8,201,118,231,209,349,1561,2689,4,12365,686,0,2,14,1,0
29677,259,6068,4293,999,3693,19,54,507,4312,9,155,88,170,164,258,1156,1898,4,9368,520,0,2,1,1,0
29678,259,6068,1482,859,1002,125,135,219,1607,16,219,134,251,235,385,1766,3032,9,27804,1544,1,2,1,1,0
29679,99,4099,1289,550,1043,56,32,155,1345,10,167,93,185,177,278,1266,2075,5,11498,638,0,2,2,1,0
29680,2,25,127,75,83,2,11,30,129,4,14,7,14,18,21,61,87,2,175,9,0,2,4,0,0
29681,2,25,652,304,544,16,6,88,668,6,89,51,101,95,152,591,998,3,3399,188,0,2,4,0,0
29682,2,25,2,2,2,0,0,0,2,0,0,0,0,0,0,0,0,0,0,0,0,2,4,0,0
29683,2,25,8,5,5,0,0,3,8,0,0,0,0,0,0,0,0,0,0,0,0,2,4,0,0
29684,2,25,2,2,2,0,0,0,2,0,0,0,0,0,0,0,0,0,0,0,0,2,4,0,0
29685,2,25,14,8,8,0,0,6,14,0,0,0,0,0,0,0,0,0,0,0,0,2,4,0,0
29686,2,25,6,4,4,0,0,2,6,0,0,0,0,0,0,0,0,0,0,0,0,2,4,0,0
29687,2,25,6,4,4,0,0,2,6,1,2,1,2,3,3,2,4,0,2,0,0,2,4,0,0
29688,2,25,6,4,4,0,0,2,6,0,0,0,0,0,0,0,0,0,0,0,0,2,4,0,0
29689,2,25,7,5,5,0,0,2,7,0,0,0,0,0,0,0,0,0,0,0,0,2,4,0,0
29690,2,25,6,4,4,0,0,2,6,0,0,0,0,0,0,0,0,0,0,0,0,2,4,0,0
29691,2,25,10,6,6,0,0,4,10,0,0,0,0,0,0,0,0,0,0,0,0,2,4,0,0
29692,2,25,1,1,1,0,0,0,1,0,0,0,0,0,0,0,0,0,0,0,0,2,4,0,0
29693,2,25,1,1,1,0,0,0,1,0,0,0,0,0,0,0,0,0,0,0,0,2,4,0,0
29694,2,25,14,10,10,0,0,4,14,1,1,1,1,2,2,0,2,0,1,0,0,2,4,0,0
29695,2,25,46,26,30,3,0,12,49,3,6,3,6,9,9,20,28,1,42,2,0,2,4,0,0
29696,148,3416,77,34,69,0,0,8,77,3,24,16,29,27,45,114,213,1,387,21,0,2,2,2,0
29697,148,3416,712,438,573,51,9,84,763,14,102,71,128,116,199,733,1364,8,11988,666,0,2,2,2,0
29698,148,3416,77,34,69,0,0,8,77,3,24,16,29,27,45,114,213,1,387,21,0,2,1,1,0
29699,148,3416,712,438,573,51,9,84,763,14,102,71,128,116,199,733,1364,8,11988,666,0,2,1,1,0
29700,15,703,139,89,101,2,0,35,141,7,54,34,62,61,96,330,569,4,2287,127,0,2,1,1,1
29701,92,4718,1457,730,1242,11,6,188,1468,10,292,166,329,302,495,2424,4078,5,22973,1276,1,2,1,1,1
29702,244,5842,722,423,573,19,0,135,741,12,172,101,199,184,300,1320,2257,6,15668,870,0,2,4,4,0
29703,244,5842,1508,847,911,44,250,301,1552,14,148,88,169,162,257,1120,1886,7,15077,837,0,2,4,4,0
29704,78,1782,996,429,845,24,10,117,1020,7,76,50,88,83,138,494,879,4,3565,198,0,2,5,1,0
29705,78,1782,456,277,329,12,42,72,468,13,85,50,97,98,147,592,972,7,7212,400,0,2,5,1,0
29706,47,3342,996,429,845,24,10,117,1020,7,76,50,88,83,138,494,879,4,3565,198,0,2,21,8,0
29707,259,6068,4293,999,3693,19,54,507,4312,9,155,88,170,164,258,1156,1898,4,9368,520,0,2,1,1,0
29708,259,6068,1482,859,1002,125,135,219,1607,16,219,134,251,235,385,1766,3032,9,27804,1544,1,2,1,1,0
29709,148,3416,77,34,69,0,0,8,77,3,24,16,29,27,45,114,213,1,387,21,0,2,3,3,0
29710,148,3416,712,438,573,51,9,84,763,14,102,71,128,116,199,733,1364,8,11988,666,0,2,3,3,0
29711,244,5842,722,423,573,19,0,135,741,12,172,101,199,184,300,1320,2257,6,15668,870,0,2,4,4,0
29712,244,5842,1508,847,911,44,250,301,1552,14,148,88,169,162,257,1120,1886,7,15077,837,0,2,4,4,0
29713,99,4099,1289,550,1043,56,32,155,1345,10,167,93,185,177,278,1266,2075,5,11498,638,0,2,2,1,0
29714,2,25,127,75,83,2,11,30,129,4,14,7,14,18,21,61,87,2,175,9,0,2,4,0,0
29715,2,25,652,304,544,16,6,88,668,6,89,51,101,95,152,591,998,3,3399,188,0,2,4,0,0
29716,2,25,2,2,2,0,0,0,2,0,0,0,0,0,0,0,0,0,0,0,0,2,4,0,0
29717,2,25,8,5,5,0,0,3,8,0,0,0,0,0,0,0,0,0,0,0,0,2,4,0,0
29718,2,25,2,2,2,0,0,0,2,0,0,0,0,0,0,0,0,0,0,0,0,2,4,0,0
29719,2,25,14,8,8,0,0,6,14,0,0,0,0,0,0,0,0,0,0,0,0,2,4,0,0
29720,2,25,6,4,4,0,0,2,6,0,0,0,0,0,0,0,0,0,0,0,0,2,4,0,0
29721,2,25,6,4,4,0,0,2,6,1,2,1,2,3,3,2,4,0,2,0,0,2,4,0,0
29722,2,25,6,4,4,0,0,2,6,0,0,0,0,0,0,0,0,0,0,0,0,2,4,0,0
29723,2,25,7,5,5,0,0,2,7,0,0,0,0,0,0,0,0,0,0,0,0,2,4,0,0
29724,2,25,6,4,4,0,0,2,6,0,0,0,0,0,0,0,0,0,0,0,0,2,4,0,0
29725,2,25,10,6,6,0,0,4,10,0,0,0,0,0,0,0,0,0,0,0,0,2,4,0,0
29726,2,25,1,1,1,0,0,0,1,0,0,0,0,0,0,0,0,0,0,0,0,2,4,0,0
29727,2,25,1,1,1,0,0,0,1,0,0,0,0,0,0,0,0,0,0,0,0,2,4,0,0
29728,2,25,14,10,10,0,0,4,14,1,1,1,1,2,2,0,2,0,1,0,0,2,4,0,0
29729,2,25,46,26,30,3,0,12,49,3,6,3,6,9,9,20,28,1,42,2,0,2,4,0,0
29730,15,703,139,89,101,2,0,35,141,7,54,34,62,61,96,330,569,4,2287,127,0,2,1,1,0
29731,92,4718,1457,730,1242,11,6,188,1468,10,292,166,329,302,495,2424,4078,5,22973,1276,1,2,1,1,0
29732,78,1782,996,429,845,24,10,117,1020,7,76,50,88,83,138,494,879,4,3565,198,0,2,5,1,0
29733,78,1782,456,277,329,12,42,72,468,13,85,50,97,98,147,592,972,7,7212,400,0,2,5,1,0
29734,47,3342,996,429,845,24,10,117,1020,7,76,50,88,83,138,494,879,4,3565,198,0,2,21,8,0
29735,221,4792,2,2,2,0,0,0,2,0,0,0,0,0,0,0,0,0,0,0,0,2,5,0,0
29736,221,4792,99,48,90,1,3,5,100,0,0,0,0,0,0,0,0,0,0,0,0,2,5,0,0
29737,221,4792,8,5,5,2,0,1,10,0,0,0,0,0,0,0,0,0,0,0,0,2,5,0,0
29738,221,4792,1217,716,841,84,126,174,1301,14,185,118,215,199,333,1446,2542,8,20687,1149,0,2,5,0,0
29739,221,4792,160,89,115,0,13,31,160,7,15,11,17,22,28,78,124,3,495,27,0,2,5,0,0
29740,221,4792,10,10,9,9,0,0,19,0,0,0,0,0,0,0,0,0,0,0,0,2,5,0,0
29741,221,4792,173,84,99,8,29,36,181,5,12,7,13,17,20,54,81,2,221,12,0,2,5,0,0
29742,221,4792,3,1,1,3,0,0,6,0,0,0,0,0,0,0,0,0,0,0,0,2,5,0,0
29743,259,6068,4293,999,3693,19,54,507,4312,9,155,88,170,164,258,1156,1898,4,9368,520,0,2,1,1,0
29744,259,6068,1482,859,1002,125,135,219,1607,16,219,134,251,235,385,1766,3032,9,27804,1544,1,2,1,1,0
29745,150,3486,77,34,69,0,0,8,77,3,24,16,29,27,45,114,213,1,387,21,0,2,3,3,0
29746,150,3486,712,438,573,51,9,84,763,14,102,71,128,116,199,733,1364,8,11988,666,0,2,3,3,0
29747,244,5842,722,423,573,19,0,135,741,12,172,101,199,184,300,1320,2257,6,15668,870,0,2,4,4,0
29748,244,5842,1508,847,911,44,250,301,1552,14,148,88,169,162,257,1120,1886,7,15077,837,0,2,4,4,0
29749,227,4936,1943,715,1694,26,18,214,1969,12,185,120,237,197,357,1436,2721,7,20915,1161,0,2,4,1,0
29750,227,4936,1168,838,957,57,25,144,1225,19,348,224,416,367,640,3018,5452,11,61921,3440,1,2,4,1,0
29751,99,4099,1289,550,1043,56,32,155,1345,10,167,93,185,177,278,1266,2075,5,11498,638,0,2,2,1,0
29752,2,25,127,75,83,2,11,30,129,4,14,7,14,18,21,61,87,2,175,9,0,2,4,0,0
29753,2,25,652,304,544,16,6,88,668,6,89,51,101,95,152,591,998,3,3399,188,0,2,4,0,0
29754,2,25,2,2,2,0,0,0,2,0,0,0,0,0,0,0,0,0,0,0,0,2,4,0,0
29755,2,25,8,5,5,0,0,3,8,0,0,0,0,0,0,0,0,0,0,0,0,2,4,0,0
29756,2,25,2,2,2,0,0,0,2,0,0,0,0,0,0,0,0,0,0,0,0,2,4,0,0
29757,2,25,14,8,8,0,0,6,14,0,0,0,0,0,0,0,0,0,0,0,0,2,4,0,0
29758,2,25,6,4,4,0,0,2,6,0,0,0,0,0,0,0,0,0,0,0,0,2,4,0,0
29759,2,25,6,4,4,0,0,2,6,1,2,1,2,3,3,2,4,0,2,0,0,2,4,0,0
29760,2,25,6,4,4,0,0,2,6,0,0,0,0,0,0,0,0,0,0,0,0,2,4,0,0
29761,2,25,7,5,5,0,0,2,7,0,0,0,0,0,0,0,0,0,0,0,0,2,4,0,0
29762,2,25,6,4,4,0,0,2,6,0,0,0,0,0,0,0,0,0,0,0,0,2,4,0,0
29763,2,25,10,6,6,0,0,4,10,0,0,0,0,0,0,0,0,0,0,0,0,2,4,0,0
29764,2,25,1,1,1,0,0,0,1,0,0,0,0,0,0,0,0,0,0,0,0,2,4,0,0
29765,2,25,1,1,1,0,0,0,1,0,0,0,0,0,0,0,0,0,0,0,0,2,4,0,0
29766,2,25,14,10,10,0,0,4,14,1,1,1,1,2,2,0,2,0,1,0,0,2,4,0,0
29767,2,25,46,26,30,3,0,12,49,3,6,3,6,9,9,20,28,1,42,2,0,2,4,0,0
29768,15,703,139,89,101,2,0,35,141,7,54,34,62,61,96,330,569,4,2287,127,0,2,1,1,0
29769,92,4718,1457,730,1242,11,6,188,1468,10,292,166,329,302,495,2424,4078,5,22973,1276,1,2,1,1,0
29770,34,1970,384,251,317,7,8,52,391,11,70,44,84,81,128,467,811,6,5355,297,0,2,18,0,0
29771,88,1991,53,23,39,0,0,13,53,2,8,4,8,10,12,26,39,1,39,2,0,2,1,1,0
29772,88,1991,515,298,307,33,80,99,548,12,63,44,77,75,121,419,753,7,5527,307,0,2,1,1,0
29773,99,4099,1289,550,1043,56,32,155,1345,10,167,93,185,177,278,1266,2075,5,11498,638,0,2,5,5,0
29774,3,229,53,23,39,0,0,13,53,2,8,4,8,10,12,26,39,1,39,2,0,2,22,0,0
29775,30,1248,373,158,315,8,0,51,381,5,76,44,79,81,123,486,779,2,2026,112,0,2,5,1,0
29776,221,4792,2,2,2,0,0,0,2,0,0,0,0,0,0,0,0,0,0,0,0,2,5,0,0
29777,221,4792,99,48,90,1,3,5,100,0,0,0,0,0,0,0,0,0,0,0,0,2,5,0,0
29778,221,4792,8,5,5,2,0,1,10,0,0,0,0,0,0,0,0,0,0,0,0,2,5,0,0
29779,221,4792,1217,716,841,84,126,174,1301,14,185,118,215,199,333,1446,2542,8,20687,1149,0,2,5,0,0
29780,221,4792,160,89,115,0,13,31,160,7,15,11,17,22,28,78,124,3,495,27,0,2,5,0,0
29781,221,4792,10,10,9,9,0,0,19,0,0,0,0,0,0,0,0,0,0,0,0,2,5,0,0
29782,221,4792,173,84,99,8,29,36,181,5,12,7,13,17,20,54,81,2,221,12,0,2,5,0,0
29783,221,4792,3,1,1,3,0,0,6,0,0,0,0,0,0,0,0,0,0,0,0,2,5,0,0
29784,259,6068,4293,999,3693,19,54,507,4312,9,155,88,170,164,258,1156,1898,4,9368,520,0,2,1,1,0
29785,259,6068,1482,859,1002,125,135,219,1607,16,219,134,251,235,385,1766,3032,9,27804,1544,1,2,1,1,0
29786,150,3486,77,34,69,0,0,8,77,3,24,16,29,27,45,114,213,1,387,21,0,2,3,3,0
29787,150,3486,712,438,573,51,9,84,763,14,102,71,128,116,199,733,1364,8,11988,666,0,2,3,3,0
29788,244,5842,722,423,573,19,0,135,741,12,172,101,199,184,300,1320,2257,6,15668,870,0,2,4,4,0
29789,244,5842,1508,847,911,44,250,301,1552,14,148,88,169,162,257,1120,1886,7,15077,837,0,2,4,4,0
29790,227,4936,1943,715,1694,26,18,214,1969,12,185,120,237,197,357,1436,2721,7,20915,1161,0,2,4,1,0
29791,227,4936,1168,838,957,57,25,144,1225,19,348,224,416,367,640,3018,5452,11,61921,3440,1,2,4,1,0
29792,99,4099,1289,550,1043,56,32,155,1345,10,167,93,185,177,278,1266,2075,5,11498,638,0,2,2,1,0
29793,2,25,127,75,83,2,11,30,129,4,14,7,14,18,21,61,87,2,175,9,0,2,4,0,0
29794,2,25,652,304,544,16,6,88,668,6,89,51,101,95,152,591,998,3,3399,188,0,2,4,0,0
29795,2,25,2,2,2,0,0,0,2,0,0,0,0,0,0,0,0,0,0,0,0,2,4,0,0
29796,2,25,8,5,5,0,0,3,8,0,0,0,0,0,0,0,0,0,0,0,0,2,4,0,0
29797,2,25,2,2,2,0,0,0,2,0,0,0,0,0,0,0,0,0,0,0,0,2,4,0,0
29798,2,25,14,8,8,0,0,6,14,0,0,0,0,0,0,0,0,0,0,0,0,2,4,0,0
29799,2,25,6,4,4,0,0,2,6,0,0,0,0,0,0,0,0,0,0,0,0,2,4,0,0
29800,2,25,6,4,4,0,0,2,6,1,2,1,2,3,3,2,4,0,2,0,0,2,4,0,0
29801,2,25,6,4,4,0,0,2,6,0,0,0,0,0,0,0,0,0,0,0,0,2,4,0,0
29802,2,25,7,5,5,0,0,2,7,0,0,0,0,0,0,0,0,0,0,0,0,2,4,0,0
29803,2,25,6,4,4,0,0,2,6,0,0,0,0,0,0,0,0,0,0,0,0,2,4,0,0
29804,2,25,10,6,6,0,0,4,10,0,0,0,0,0,0,0,0,0,0,0,0,2,4,0,0
29805,2,25,1,1,1,0,0,0,1,0,0,0,0,0,0,0,0,0,0,0,0,2,4,0,0
29806,2,25,1,1,1,0,0,0,1,0,0,0,0,0,0,0,0,0,0,0,0,2,4,0,0
29807,2,25,14,10,10,0,0,4,14,1,1,1,1,2,2,0,2,0,1,0,0,2,4,0,0
29808,2,25,46,26,30,3,0,12,49,3,6,3,6,9,9,20,28,1,42,2,0,2,4,0,0
29809,15,703,139,89,101,2,0,35,141,7,54,34,62,61,96,330,569,4,2287,127,0,2,1,1,0
29810,92,4718,1457,730,1242,11,6,188,1468,10,292,166,329,302,495,2424,4078,5,22973,1276,1,2,1,1,0
29811,34,1970,384,251,317,7,8,52,391,11,70,44,84,81,128,467,811,6,5355,297,0,2,18,0,0
29812,88,1991,53,23,39,0,0,13,53,2,8,4,8,10,12,26,39,1,39,2,0,2,1,1,0
29813,88,1991,515,298,307,33,80,99,548,12,63,44,77,75,121,419,753,7,5527,307,0,2,1,1,0
29814,99,4099,1289,550,1043,56,32,155,1345,10,167,93,185,177,278,1266,2075,5,11498,638,0,2,5,5,0
29815,3,229,53,23,39,0,0,13,53,2,8,4,8,10,12,26,39,1,39,2,0,2,22,0,0
29816,30,1248,373,158,315,8,0,51,381,5,76,44,79,81,123,486,779,2,2026,112,0,2,5,1,0
29817,23,613,102,59,69,5,3,24,107,6,22,15,28,28,43,113,206,3,789,43,0,2,10,4,0
29818,87,1963,53,23,39,0,0,13,53,2,8,4,8,10,12,26,39,1,39,2,0,2,7,5,0
29819,87,1963,515,298,307,33,80,99,548,12,63,44,77,75,121,419,753,7,5527,307,0,2,7,5,0
29820,92,1965,1043,504,840,53,9,147,1096,9,180,112,198,189,310,1377,2344,4,11604,644,0,2,1,2,0
29821,92,1965,383,288,292,26,6,62,409,11,65,38,67,76,105,429,656,5,3719,206,0,2,1,2,0
29822,227,4916,1943,715,1694,26,18,214,1969,12,185,120,237,197,357,1436,2721,7,20915,1161,0,2,2,4,0
29823,227,4916,1168,838,957,57,25,144,1225,19,348,224,416,367,640,3018,5452,11,61921,3440,1,2,2,4,0
29824,77,4237,1296,573,1062,40,33,157,1336,8,201,118,231,209,349,1561,2689,4,12365,686,0,2,3,8,0
29825,2,145,53,23,39,0,0,13,53,2,8,4,8,10,12,26,39,1,39,2,0,2,4,4,0
29826,30,1248,373,158,315,8,0,51,381,5,76,44,79,81,123,486,779,2,2026,112,0,2,12,2,0
29827,228,4924,1943,715,1694,26,18,214,1969,12,185,120,237,197,357,1436,2721,7,20915,1161,0,2,2,2,0
29828,228,4924,1168,838,957,57,25,144,1225,19,348,224,416,367,640,3018,5452,11,61921,3440,1,2,2,2,0
29829,103,4795,1338,495,1086,10,64,173,1348,11,122,82,157,133,239,883,1686,7,11934,663,0,2,1,3,0
29830,23,613,102,59,69,5,3,24,107,6,22,15,28,28,43,113,206,3,789,43,0,2,10,4,0
29831,87,1963,53,23,39,0,0,13,53,2,8,4,8,10,12,26,39,1,39,2,0,2,7,5,0
29832,87,1963,515,298,307,33,80,99,548,12,63,44,77,75,121,419,753,7,5527,307,0,2,7,5,0
29833,92,1965,1043,504,840,53,9,147,1096,9,180,112,198,189,310,1377,2344,4,11604,644,0,2,1,2,0
29834,92,1965,383,288,292,26,6,62,409,11,65,38,67,76,105,429,656,5,3719,206,0,2,1,2,0
29835,228,4924,1943,715,1694,26,18,214,1969,12,185,120,237,197,357,1436,2721,7,20915,1161,0,2,4,6,0
29836,228,4924,1168,838,957,57,25,144,1225,19,348,224,416,367,640,3018,5452,11,61921,3440,1,2,4,6,0
29837,103,4795,1338,495,1086,10,64,173,1348,11,122,82,157,133,239,883,1686,7,11934,663,0,2,1,3,0
29838,77,4237,1296,573,1062,40,33,157,1336,8,201,118,231,209,349,1561,2689,4,12365,686,0,2,3,8,0
29839,2,145,53,23,39,0,0,13,53,2,8,4,8,10,12,26,39,1,39,2,0,2,4,4,0
29840,30,1248,373,158,315,8,0,51,381,5,76,44,79,81,123,486,779,2,2026,112,0,2,12,2,0
29841,148,3416,77,34,69,0,0,8,77,3,24,16,29,27,45,114,213,1,387,21,0,2,2,2,0
29842,148,3416,712,438,573,51,9,84,763,14,102,71,128,116,199,733,1364,8,11988,666,0,2,2,2,0
29843,78,4335,1296,573,1062,40,33,157,1336,8,201,118,231,209,349,1561,2689,4,12365,686,0,2,54,0,0
29844,148,3404,77,34,69,0,0,8,77,3,24,16,29,27,45,114,213,1,387,21,0,2,2,2,0
29845,148,3404,712,438,573,51,9,84,763,14,102,71,128,116,199,733,1364,8,11988,666,0,2,2,2,0
29846,148,3416,77,34,69,0,0,8,77,3,24,16,29,27,45,114,213,1,387,21,0,2,2,2,0
29847,148,3416,712,438,573,51,9,84,763,14,102,71,128,116,199,733,1364,8,11988,666,0,2,2,2,0
29848,78,4335,1296,573,1062,40,33,157,1336,8,201,118,231,209,349,1561,2689,4,12365,686,0,2,54,0,0
29849,148,3404,77,34,69,0,0,8,77,3,24,16,29,27,45,114,213,1,387,21,0,2,2,2,0
29850,148,3404,712,438,573,51,9,84,763,14,102,71,128,116,199,733,1364,8,11988,666,0,2,2,2,0
29851,109,2070,477,336,357,30,23,73,507,16,194,134,250,210,384,1538,2962,10,30538,1696,0,2,46,0,1
29852,111,2091,477,336,357,30,23,73,507,16,194,134,250,210,384,1538,2962,10,30538,1696,0,2,5,6,1
29853,122,4845,1450,624,1228,12,26,181,1462,14,306,186,354,320,540,2580,4493,8,36391,2021,1,2,139,0,1
29854,122,4887,1450,624,1228,12,26,181,1462,14,306,186,354,320,540,2580,4493,8,36391,2021,1,2,2,0,0
29855,62,1174,282,196,195,3,0,86,285,8,130,71,141,138,212,936,1507,4,6538,363,0,2,24,0,0
29856,1,90,13,10,10,0,0,3,13,1,2,1,2,3,3,2,4,0,2,0,0,2,1,1,0
29857,111,2091,477,336,357,30,23,73,507,16,194,134,250,210,384,1538,2962,10,30538,1696,0,2,2,2,0
29858,122,4887,1450,624,1228,12,26,181,1462,14,306,186,354,320,540,2580,4493,8,36391,2021,1,2,8,8,0
29859,111,2094,477,336,357,30,23,73,507,16,194,134,250,210,384,1538,2962,10,30538,1696,0,2,1,1,0
29860,122,4939,1450,624,1228,12,26,181,1462,14,306,186,354,320,540,2580,4493,8,36391,2021,1,2,23,23,0
29861,111,2104,477,336,357,30,23,73,507,16,194,134,250,210,384,1538,2962,10,30538,1696,0,2,2,2,0
29862,108,2074,477,336,357,30,23,73,507,16,194,134,250,210,384,1538,2962,10,30538,1696,0,2,7,9,0
29863,108,2070,477,336,357,30,23,73,507,16,194,134,250,210,384,1538,2962,10,30538,1696,0,2,4,4,0
29864,122,4959,1450,624,1228,12,26,181,1462,14,306,186,354,320,540,2580,4493,8,36391,2021,1,2,10,10,0
29865,58,1067,282,196,195,3,0,86,285,8,130,71,141,138,212,936,1507,4,6538,363,0,2,2,5,1
29866,29,743,601,196,481,2,23,85,603,8,63,36,72,71,108,400,664,4,3036,168,0,2,4,0,1
29867,29,743,156,79,106,5,16,28,161,5,14,8,15,19,23,64,97,2,261,14,0,2,4,0,1
29868,99,4109,1289,550,1043,56,32,155,1345,10,167,93,185,177,278,1266,2075,5,11498,638,0,2,5,2,1
29869,25,1181,75,38,59,1,3,12,76,2,4,2,4,6,6,10,15,1,15,0,0,2,9,10,1
29870,103,4810,1338,495,1086,10,64,173,1348,11,122,82,157,133,239,883,1686,7,11934,663,0,2,6,5,1
29871,180,8032,139,89,101,2,0,35,141,7,54,34,62,61,96,330,569,4,2287,127,0,2,11,8,1
29872,180,8032,7,5,5,0,0,2,7,1,2,1,2,3,3,2,4,0,2,0,0,2,11,8,1
29873,138,6179,1782,648,1425,9,47,279,1791,8,171,97,189,179,286,1292,2140,4,9462,525,0,2,17,16,1
29874,92,4728,1457,730,1242,11,6,188,1468,10,292,166,329,302,495,2424,4078,5,22973,1276,1,2,6,3,1
29875,97,4242,1020,354,843,12,15,144,1032,8,134,77,144,142,221,970,1580,4,6792,377,0,2,5,3,1
29876,21,670,424,94,331,4,0,89,428,1,5,5,5,6,10,11,25,0,12,0,0,2,2,1,1
29877,66,3075,1293,570,1093,25,15,163,1318,10,195,123,241,205,364,1516,2795,6,17273,959,0,2,4,1,1
29878,14,546,295,56,236,0,4,54,295,2,9,5,10,11,15,30,51,1,57,3,0,2,5,2,1
29879,99,5096,1943,715,1694,26,18,214,1969,12,185,120,237,197,357,1436,2721,7,20915,1161,0,2,3,3,1
29880,31,1326,442,244,305,14,16,103,456,11,68,45,75,79,120,452,756,6,4588,254,0,2,2,1,1
29881,45,1575,601,196,481,2,23,85,603,8,63,36,72,71,108,400,664,4,3036,168,0,2,31,0,1
29882,9,447,219,78,157,11,5,46,230,3,24,20,34,27,54,114,256,2,545,30,0,2,8,0,0
29883,1,55,14,12,10,0,0,4,14,1,2,1,2,3,3,2,4,0,2,0,0,0,14,0,0
29884,1,58,14,12,10,0,0,4,14,1,2,1,2,3,3,2,4,0,2,0,0,0,14,0,0
29885,1,55,14,12,10,0,0,4,14,1,2,1,2,3,3,2,4,0,2,0,0,0,14,0,0
29886,1,77,19,18,14,0,0,5,19,1,2,1,2,3,3,2,4,0,2,0,0,0,19,0,0
29887,120,4779,1450,624,1228,12,26,181,1462,14,306,186,354,320,540,2580,4493,8,36391,2021,1,2,35,66,0
29888,92,1983,1043,504,840,53,9,147,1096,9,180,112,198,189,310,1377,2344,4,11604,644,0,2,2,1,0
29889,92,1983,383,288,292,26,6,62,409,11,65,38,67,76,105,429,656,5,3719,206,0,2,2,1,0
29890,86,3304,1043,504,840,53,9,147,1096,9,180,112,198,189,310,1377,2344,4,11604,644,0,2,13,0,0
29891,244,5852,722,423,573,19,0,135,741,12,172,101,199,184,300,1320,2257,6,15668,870,0,2,1,0,0
29892,244,5852,1508,847,911,44,250,301,1552,14,148,88,169,162,257,1120,1886,7,15077,837,0,2,1,0,0
29893,45,3296,996,429,845,24,10,117,1020,7,76,50,88,83,138,494,879,4,3565,198,0,2,0,11,0
29894,58,1067,282,196,195,3,0,86,285,8,130,71,141,138,212,936,1507,4,6538,363,0,2,2,5,0
29895,29,743,601,196,481,2,23,85,603,8,63,36,72,71,108,400,664,4,3036,168,0,2,4,0,0
29896,29,743,156,79,106,5,16,28,161,5,14,8,15,19,23,64,97,2,261,14,0,2,4,0,0
29897,99,4109,1289,550,1043,56,32,155,1345,10,167,93,185,177,278,1266,2075,5,11498,638,0,2,5,2,0
29898,25,1181,75,38,59,1,3,12,76,2,4,2,4,6,6,10,15,1,15,0,0,2,9,10,0
29899,103,4810,1338,495,1086,10,64,173,1348,11,122,82,157,133,239,883,1686,7,11934,663,0,2,6,5,0
29900,180,8032,139,89,101,2,0,35,141,7,54,34,62,61,96,330,569,4,2287,127,0,2,11,8,0
29901,180,8032,7,5,5,0,0,2,7,1,2,1,2,3,3,2,4,0,2,0,0,2,11,8,0
29902,138,6179,1782,648,1425,9,47,279,1791,8,171,97,189,179,286,1292,2140,4,9462,525,0,2,17,16,0
29903,92,4728,1457,730,1242,11,6,188,1468,10,292,166,329,302,495,2424,4078,5,22973,1276,1,2,6,3,0
29904,97,4242,1020,354,843,12,15,144,1032,8,134,77,144,142,221,970,1580,4,6792,377,0,2,5,3,0
29905,21,670,424,94,331,4,0,89,428,1,5,5,5,6,10,11,25,0,12,0,0,2,2,1,0
29906,66,3075,1293,570,1093,25,15,163,1318,10,195,123,241,205,364,1516,2795,6,17273,959,0,2,4,1,0
29907,14,546,295,56,236,0,4,54,295,2,9,5,10,11,15,30,51,1,57,3,0,2,5,2,0
29908,9,447,219,78,157,11,5,46,230,3,24,20,34,27,54,114,256,2,545,30,0,2,8,0,0
29909,99,5096,1943,715,1694,26,18,214,1969,12,185,120,237,197,357,1436,2721,7,20915,1161,0,2,3,3,0
29910,31,1326,442,244,305,14,16,103,456,11,68,45,75,79,120,452,756,6,4588,254,0,2,2,1,0
29911,45,1575,601,196,481,2,23,85,603,8,63,36,72,71,108,400,664,4,3036,168,0,2,31,0,0
29912,150,3474,77,34,69,0,0,8,77,3,24,16,29,27,45,114,213,1,387,21,0,2,4,4,0
29913,150,3474,712,438,573,51,9,84,763,14,102,71,128,116,199,733,1364,8,11988,666,0,2,4,4,0
29914,87,1961,53,23,39,0,0,13,53,2,8,4,8,10,12,26,39,1,39,2,0,2,1,1,0
29915,87,1961,515,298,307,33,80,99,548,12,63,44,77,75,121,419,753,7,5527,307,0,2,1,1,0
29916,99,4109,1289,550,1043,56,32,155,1345,10,167,93,185,177,278,1266,2075,5,11498,638,0,2,5,5,0
29917,23,613,102,59,69,5,3,24,107,6,22,15,28,28,43,113,206,3,789,43,0,2,10,4,0
29918,79,4449,1296,573,1062,40,33,157,1336,8,201,118,231,209,349,1561,2689,4,12365,686,0,2,53,0,0
29919,3,229,53,23,39,0,0,13,53,2,8,4,8,10,12,26,39,1,39,2,0,2,22,0,0
29920,30,1251,373,158,315,8,0,51,381,5,76,44,79,81,123,486,779,2,2026,112,0,2,5,1,0
29921,244,5852,722,423,573,19,0,135,741,12,172,101,199,184,300,1320,2257,6,15668,870,0,2,1,0,0
29922,244,5852,1508,847,911,44,250,301,1552,14,148,88,169,162,257,1120,1886,7,15077,837,0,2,1,0,0
29923,45,3296,996,429,845,24,10,117,1020,7,76,50,88,83,138,494,879,4,3565,198,0,2,0,11,0
29924,108,2057,477,336,357,30,23,73,507,16,194,134,250,210,384,1538,2962,10,30538,1696,0,2,3,5,0
29925,120,4779,1450,624,1228,12,26,181,1462,14,306,186,354,320,540,2580,4493,8,36391,2021,1,2,6,6,0
29926,92,1983,1043,504,840,53,9,147,1096,9,180,112,198,189,310,1377,2344,4,11604,644,0,2,2,1,0
29927,92,1983,383,288,292,26,6,62,409,11,65,38,67,76,105,429,656,5,3719,206,0,2,2,1,0
29928,86,3304,1043,504,840,53,9,147,1096,9,180,112,198,189,310,1377,2344,4,11604,644,0,2,13,0,0
29929,221,4792,2,2,2,0,0,0,2,0,0,0,0,0,0,0,0,0,0,0,0,2,1,1,0
29930,221,4792,99,48,90,1,3,5,100,0,0,0,0,0,0,0,0,0,0,0,0,2,1,1,0
29931,221,4792,8,5,5,2,0,1,10,0,0,0,0,0,0,0,0,0,0,0,0,2,1,1,0
29932,221,4792,1217,716,841,84,126,174,1301,14,185,118,215,199,333,1446,2542,8,20687,1149,0,2,1,1,0
29933,221,4792,160,89,115,0,13,31,160,7,15,11,17,22,28,78,124,3,495,27,0,2,1,1,0
29934,221,4792,10,10,9,9,0,0,19,0,0,0,0,0,0,0,0,0,0,0,0,2,1,1,0
29935,221,4792,173,84,99,8,29,36,181,5,12,7,13,17,20,54,81,2,221,12,0,2,1,1,0
29936,221,4792,3,1,1,3,0,0,6,0,0,0,0,0,0,0,0,0,0,0,0,2,1,1,0
29937,55,783,167,116,138,4,5,22,171,8,48,30,56,56,86,292,499,4,2330,129,0,2,16,10,0
29938,150,3474,77,34,69,0,0,8,77,3,24,16,29,27,45,114,213,1,387,21,0,2,4,4,0
29939,150,3474,712,438,573,51,9,84,763,14,102,71,128,116,199,733,1364,8,11988,666,0,2,4,4,0
29940,87,1961,53,23,39,0,0,13,53,2,8,4,8,10,12,26,39,1,39,2,0,2,1,1,0
29941,87,1961,515,298,307,33,80,99,548,12,63,44,77,75,121,419,753,7,5527,307,0,2,1,1,0
29942,99,4109,1289,550,1043,56,32,155,1345,10,167,93,185,177,278,1266,2075,5,11498,638,0,2,5,5,0
29943,23,613,102,59,69,5,3,24,107,6,22,15,28,28,43,113,206,3,789,43,0,2,10,4,0
29944,79,4449,1296,573,1062,40,33,157,1336,8,201,118,231,209,349,1561,2689,4,12365,686,0,2,53,0,0
29945,3,229,53,23,39,0,0,13,53,2,8,4,8,10,12,26,39,1,39,2,0,2,22,0,0
29946,30,1251,373,158,315,8,0,51,381,5,76,44,79,81,123,486,779,2,2026,112,0,2,5,1,0
29947,92,1973,1043,504,840,53,9,147,1096,9,180,112,198,189,310,1377,2344,4,11604,644,0,2,2,1,0
29948,92,1973,383,288,292,26,6,62,409,11,65,38,67,76,105,429,656,5,3719,206,0,2,2,1,0
29949,86,3304,1043,504,840,53,9,147,1096,9,180,112,198,189,310,1377,2344,4,11604,644,0,2,13,0,0
29950,58,1067,282,196,195,3,0,86,285,8,130,71,141,138,212,936,1507,4,6538,363,0,2,2,5,0
29951,78,1782,996,429,845,24,10,117,1020,7,76,50,88,83,138,494,879,4,3565,198,0,2,5,1,0
29952,78,1782,456,277,329,12,42,72,468,13,85,50,97,98,147,592,972,7,7212,400,0,2,5,1,0
29953,221,4792,2,2,2,0,0,0,2,0,0,0,0,0,0,0,0,0,0,0,0,2,6,4,0
29954,221,4792,99,48,90,1,3,5,100,0,0,0,0,0,0,0,0,0,0,0,0,2,6,4,0
29955,221,4792,8,5,5,2,0,1,10,0,0,0,0,0,0,0,0,0,0,0,0,2,6,4,0
29956,221,4792,1217,716,841,84,126,174,1301,14,185,118,215,199,333,1446,2542,8,20687,1149,0,2,6,4,0
29957,221,4792,160,89,115,0,13,31,160,7,15,11,17,22,28,78,124,3,495,27,0,2,6,4,0
29958,221,4792,10,10,9,9,0,0,19,0,0,0,0,0,0,0,0,0,0,0,0,2,6,4,0
29959,221,4792,173,84,99,8,29,36,181,5,12,7,13,17,20,54,81,2,221,12,0,2,6,4,0
29960,221,4792,3,1,1,3,0,0,6,0,0,0,0,0,0,0,0,0,0,0,0,2,6,4,0
29961,150,3474,77,34,69,0,0,8,77,3,24,16,29,27,45,114,213,1,387,21,0,2,16,0,0
29962,150,3474,712,438,573,51,9,84,763,14,102,71,128,116,199,733,1364,8,11988,666,0,2,16,0,0
29963,87,1961,53,23,39,0,0,13,53,2,8,4,8,10,12,26,39,1,39,2,0,2,8,12,0
29964,87,1961,515,298,307,33,80,99,548,12,63,44,77,75,121,419,753,7,5527,307,0,2,8,12,0
29965,244,5852,722,423,573,19,0,135,741,12,172,101,199,184,300,1320,2257,6,15668,870,0,2,1,0,0
29966,244,5852,1508,847,911,44,250,301,1552,14,148,88,169,162,257,1120,1886,7,15077,837,0,2,1,0,0
29967,92,1973,1043,504,840,53,9,147,1096,9,180,112,198,189,310,1377,2344,4,11604,644,0,2,1,2,0
29968,92,1973,383,288,292,26,6,62,409,11,65,38,67,76,105,429,656,5,3719,206,0,2,1,2,0
29969,228,4924,1943,715,1694,26,18,214,1969,12,185,120,237,197,357,1436,2721,7,20915,1161,0,2,4,6,0
29970,228,4924,1168,838,957,57,25,144,1225,19,348,224,416,367,640,3018,5452,11,61921,3440,1,2,4,6,0
29971,29,743,601,196,481,2,23,85,603,8,63,36,72,71,108,400,664,4,3036,168,0,2,4,0,0
29972,29,743,156,79,106,5,16,28,161,5,14,8,15,19,23,64,97,2,261,14,0,2,4,0,0
29973,99,4109,1289,550,1043,56,32,155,1345,10,167,93,185,177,278,1266,2075,5,11498,638,0,2,5,2,0
29974,25,1181,75,38,59,1,3,12,76,2,4,2,4,6,6,10,15,1,15,0,0,2,9,10,0
29975,103,4810,1338,495,1086,10,64,173,1348,11,122,82,157,133,239,883,1686,7,11934,663,0,2,7,8,0
29976,180,8032,139,89,101,2,0,35,141,7,54,34,62,61,96,330,569,4,2287,127,0,2,11,8,0
29977,180,8032,7,5,5,0,0,2,7,1,2,1,2,3,3,2,4,0,2,0,0,2,11,8,0
29978,138,6179,1782,648,1425,9,47,279,1791,8,171,97,189,179,286,1292,2140,4,9462,525,0,2,17,16,0
29979,45,3296,996,429,845,24,10,117,1020,7,76,50,88,83,138,494,879,4,3565,198,0,2,10,8,0
29980,79,4449,1296,573,1062,40,33,157,1336,8,201,118,231,209,349,1561,2689,4,12365,686,0,2,39,8,0
29981,92,4728,1457,730,1242,11,6,188,1468,10,292,166,329,302,495,2424,4078,5,22973,1276,1,2,6,3,0
29982,97,4242,1020,354,843,12,15,144,1032,8,134,77,144,142,221,970,1580,4,6792,377,0,2,5,3,0
29983,3,229,53,23,39,0,0,13,53,2,8,4,8,10,12,26,39,1,39,2,0,2,4,4,0
29984,21,670,424,94,331,4,0,89,428,1,5,5,5,6,10,11,25,0,12,0,0,2,2,1,0
29985,66,3075,1293,570,1093,25,15,163,1318,10,195,123,241,205,364,1516,2795,6,17273,959,0,2,4,1,0
29986,14,546,295,56,236,0,4,54,295,2,9,5,10,11,15,30,51,1,57,3,0,2,5,2,0
29987,30,1251,373,158,315,8,0,51,381,5,76,44,79,81,123,486,779,2,2026,112,0,2,12,2,0
29988,9,447,219,78,157,11,5,46,230,3,24,20,34,27,54,114,256,2,545,30,0,2,8,0,0
29989,99,5096,1943,715,1694,26,18,214,1969,12,185,120,237,197,357,1436,2721,7,20915,1161,0,2,3,3,0
29990,31,1326,442,244,305,14,16,103,456,11,68,45,75,79,120,452,756,6,4588,254,0,2,2,1,0
29991,45,1575,601,196,481,2,23,85,603,8,63,36,72,71,108,400,664,4,3036,168,0,2,31,0,0
29992,81,1820,996,429,845,24,10,117,1020,7,76,50,88,83,138,494,879,4,3565,198,0,2,9,2,0
29993,81,1820,456,277,329,12,42,72,468,13,85,50,97,98,147,592,972,7,7212,400,0,2,9,2,0
29994,46,3385,996,429,845,24,10,117,1020,7,76,50,88,83,138,494,879,4,3565,198,0,2,25,2,0
29995,92,1973,1043,504,840,53,9,147,1096,9,180,112,198,189,310,1377,2344,4,11604,644,0,2,2,1,0
29996,92,1973,383,288,292,26,6,62,409,11,65,38,67,76,105,429,656,5,3719,206,0,2,2,1,0
29997,86,3304,1043,504,840,53,9,147,1096,9,180,112,198,189,310,1377,2344,4,11604,644,0,2,13,0,0
29998,308,6877,72,33,56,0,4,12,72,1,1,1,1,2,2,0,2,0,1,0,0,2,5,5,0
29999,308,6877,1454,835,1044,76,110,219,1530,17,275,158,296,292,454,2297,3718,9,34017,1889,1,2,5,5,0
30000,30,1260,373,158,315,8,0,51,381,5,76,44,79,81,123,486,779,2,2026,112,0,2,3,1,0
30001,245,5865,722,423,573,19,0,135,741,12,172,101,199,184,300,1320,2257,6,15668,870,0,2,3,0,0
30002,245,5865,1508,847,911,44,250,301,1552,14,148,88,169,162,257,1120,1886,7,15077,837,0,2,3,0,0
30003,220,4772,2,2,2,0,0,0,2,0,0,0,0,0,0,0,0,0,0,0,0,2,1,4,0
30004,220,4772,99,48,90,1,3,5,100,0,0,0,0,0,0,0,0,0,0,0,0,2,1,4,0
30005,220,4772,8,5,5,2,0,1,10,0,0,0,0,0,0,0,0,0,0,0,0,2,1,4,0
30006,220,4772,1217,716,841,84,126,174,1301,14,185,118,215,199,333,1446,2542,8,20687,1149,0,2,1,4,0
30007,220,4772,160,89,115,0,13,31,160,7,15,11,17,22,28,78,124,3,495,27,0,2,1,4,0
30008,220,4772,10,10,9,9,0,0,19,0,0,0,0,0,0,0,0,0,0,0,0,2,1,4,0
30009,220,4772,173,84,99,8,29,36,181,5,12,7,13,17,20,54,81,2,221,12,0,2,1,4,0
30010,220,4772,3,1,1,3,0,0,6,0,0,0,0,0,0,0,0,0,0,0,0,2,1,4,0
30011,80,4548,1296,573,1062,40,33,157,1336,8,201,118,231,209,349,1561,2689,4,12365,686,0,2,22,0,0
30012,220,4772,2,2,2,0,0,0,2,0,0,0,0,0,0,0,0,0,0,0,0,2,1,4,0
30013,220,4772,99,48,90,1,3,5,100,0,0,0,0,0,0,0,0,0,0,0,0,2,1,4,0
30014,220,4772,8,5,5,2,0,1,10,0,0,0,0,0,0,0,0,0,0,0,0,2,1,4,0
30015,220,4772,1217,716,841,84,126,174,1301,14,185,118,215,199,333,1446,2542,8,20687,1149,0,2,1,4,0
30016,220,4772,160,89,115,0,13,31,160,7,15,11,17,22,28,78,124,3,495,27,0,2,1,4,0
30017,220,4772,10,10,9,9,0,0,19,0,0,0,0,0,0,0,0,0,0,0,0,2,1,4,0
30018,220,4772,173,84,99,8,29,36,181,5,12,7,13,17,20,54,81,2,221,12,0,2,1,4,0
30019,220,4772,3,1,1,3,0,0,6,0,0,0,0,0,0,0,0,0,0,0,0,2,1,4,0
30020,80,4548,1296,573,1062,40,33,157,1336,8,201,118,231,209,349,1561,2689,4,12365,686,0,2,22,0,0
30021,180,5413,1660,832,1314,41,38,274,1701,20,312,209,395,332,604,2671,5058,12,64042,3557,1,2,2,1,0
30022,180,5413,1057,646,719,113,100,145,1170,18,215,134,248,233,382,1740,3004,10,31186,1732,1,2,2,1,0
30023,167,5019,1660,832,1314,41,38,274,1701,20,312,209,395,332,604,2671,5058,12,64042,3557,1,2,13,0,0
30024,308,6877,72,33,56,0,4,12,72,1,1,1,1,2,2,0,2,0,1,0,0,2,5,5,0
30025,308,6877,1454,835,1044,76,110,219,1530,17,275,158,296,292,454,2297,3718,9,34017,1889,1,2,5,5,0
30026,30,1260,373,158,315,8,0,51,381,5,76,44,79,81,123,486,779,2,2026,112,0,2,3,1,0
30027,180,5413,1660,832,1314,41,38,274,1701,20,312,209,395,332,604,2671,5058,12,64042,3557,1,2,2,1,0
30028,180,5413,1057,646,719,113,100,145,1170,18,215,134,248,233,382,1740,3004,10,31186,1732,1,2,2,1,0
30029,167,5019,1660,832,1314,41,38,274,1701,20,312,209,395,332,604,2671,5058,12,64042,3557,1,2,13,0,0
30030,1,104,42,7,35,4,0,5,46,1,2,1,2,3,3,2,4,0,2,0,0,2,10,0,0
30031,1,104,11,6,10,0,0,1,11,2,4,2,4,6,6,10,15,1,15,0,0,2,10,0,0
30032,1,104,42,7,35,4,0,5,46,1,2,1,2,3,3,2,4,0,2,0,0,2,10,0,0
30033,1,104,11,6,10,0,0,1,11,2,4,2,4,6,6,10,15,1,15,0,0,2,10,0,0
30034,221,4792,2,2,2,0,0,0,2,0,0,0,0,0,0,0,0,0,0,0,0,2,1,1,0
30035,221,4792,99,48,90,1,3,5,100,0,0,0,0,0,0,0,0,0,0,0,0,2,1,1,0
30036,221,4792,8,5,5,2,0,1,10,0,0,0,0,0,0,0,0,0,0,0,0,2,1,1,0
30037,221,4792,1217,716,841,84,126,174,1301,14,185,118,215,199,333,1446,2542,8,20687,1149,0,2,1,1,0
30038,221,4792,160,89,115,0,13,31,160,7,15,11,17,22,28,78,124,3,495,27,0,2,1,1,0
30039,221,4792,10,10,9,9,0,0,19,0,0,0,0,0,0,0,0,0,0,0,0,2,1,1,0
30040,221,4792,173,84,99,8,29,36,181,5,12,7,13,17,20,54,81,2,221,12,0,2,1,1,0
30041,221,4792,3,1,1,3,0,0,6,0,0,0,0,0,0,0,0,0,0,0,0,2,1,1,0
30042,55,783,167,116,138,4,5,22,171,8,48,30,56,56,86,292,499,4,2330,129,0,2,16,10,0
30043,245,5865,722,423,573,19,0,135,741,12,172,101,199,184,300,1320,2257,6,15668,870,0,2,3,0,0
30044,245,5865,1508,847,911,44,250,301,1552,14,148,88,169,162,257,1120,1886,7,15077,837,0,2,3,0,0
30045,72,1422,207,111,150,11,0,50,218,5,26,19,36,31,55,133,272,3,943,52,0,2,2,2,0
30046,72,1422,410,198,237,31,55,97,441,11,63,38,72,74,110,414,683,6,4293,238,0,2,2,2,0
30047,92,1851,757,253,292,73,244,162,830,13,61,38,67,74,105,409,651,7,4654,258,0,2,9,4,0
30048,66,4389,520,294,400,33,13,81,553,10,261,204,367,271,571,2128,4614,7,32445,1802,1,2,10,0,0
30049,66,4392,520,294,400,33,13,81,553,10,261,204,367,271,571,2128,4614,7,32445,1802,1,2,4,3,0
30050,1,104,42,7,35,4,0,5,46,1,2,1,2,3,3,2,4,0,2,0,0,2,10,0,0
30051,1,104,11,6,10,0,0,1,11,2,4,2,4,6,6,10,15,1,15,0,0,2,10,0,0
30052,180,5413,1660,832,1314,41,38,274,1701,20,312,209,395,332,604,2671,5058,12,64042,3557,1,2,2,1,0
30053,180,5413,1057,646,719,113,100,145,1170,18,215,134,248,233,382,1740,3004,10,31186,1732,1,2,2,1,0
30054,220,4772,2,2,2,0,0,0,2,0,0,0,0,0,0,0,0,0,0,0,0,2,1,4,0
30055,220,4772,99,48,90,1,3,5,100,0,0,0,0,0,0,0,0,0,0,0,0,2,1,4,0
30056,220,4772,8,5,5,2,0,1,10,0,0,0,0,0,0,0,0,0,0,0,0,2,1,4,0
30057,220,4772,1217,716,841,84,126,174,1301,14,185,118,215,199,333,1446,2542,8,20687,1149,0,2,1,4,0
30058,220,4772,160,89,115,0,13,31,160,7,15,11,17,22,28,78,124,3,495,27,0,2,1,4,0
30059,220,4772,10,10,9,9,0,0,19,0,0,0,0,0,0,0,0,0,0,0,0,2,1,4,0
30060,220,4772,173,84,99,8,29,36,181,5,12,7,13,17,20,54,81,2,221,12,0,2,1,4,0
30061,220,4772,3,1,1,3,0,0,6,0,0,0,0,0,0,0,0,0,0,0,0,2,1,4,0
30062,245,5865,722,423,573,19,0,135,741,12,172,101,199,184,300,1320,2257,6,15668,870,0,2,3,0,0
30063,245,5865,1508,847,911,44,250,301,1552,14,148,88,169,162,257,1120,1886,7,15077,837,0,2,3,0,0
30064,308,6877,72,33,56,0,4,12,72,1,1,1,1,2,2,0,2,0,1,0,0,2,5,5,0
30065,308,6877,1454,835,1044,76,110,219,1530,17,275,158,296,292,454,2297,3718,9,34017,1889,1,2,5,5,0
30066,167,5019,1660,832,1314,41,38,274,1701,20,312,209,395,332,604,2671,5058,12,64042,3557,1,2,13,0,0
30067,80,4548,1296,573,1062,40,33,157,1336,8,201,118,231,209,349,1561,2689,4,12365,686,0,2,22,0,0
30068,30,1260,373,158,315,8,0,51,381,5,76,44,79,81,123,486,779,2,2026,112,0,2,3,1,0
30069,41,1220,339,213,244,17,9,65,356,10,42,26,48,52,74,259,421,5,2410,133,0,2,18,10,1
30070,67,3166,1293,570,1093,25,15,163,1318,10,195,123,241,205,364,1516,2795,6,17273,959,0,2,30,1,1
30071,220,4765,2,2,2,0,0,0,2,0,0,0,0,0,0,0,0,0,0,0,0,2,0,7,0
30072,220,4765,99,48,90,1,3,5,100,0,0,0,0,0,0,0,0,0,0,0,0,2,0,7,0
30073,220,4765,8,5,5,2,0,1,10,0,0,0,0,0,0,0,0,0,0,0,0,2,0,7,0
30074,220,4765,1217,716,841,84,126,174,1301,14,185,118,215,199,333,1446,2542,8,20687,1149,0,2,0,7,0
30075,220,4765,160,89,115,0,13,31,160,7,15,11,17,22,28,78,124,3,495,27,0,2,0,7,0
30076,220,4765,10,10,9,9,0,0,19,0,0,0,0,0,0,0,0,0,0,0,0,2,0,7,0
30077,220,4765,173,84,99,8,29,36,181,5,12,7,13,17,20,54,81,2,221,12,0,2,0,7,0
30078,220,4765,3,1,1,3,0,0,6,0,0,0,0,0,0,0,0,0,0,0,0,2,0,7,0
30079,52,611,647,139,84,35,284,233,682,0,0,0,0,0,0,0,0,0,0,0,0,2,0,28,0
30080,31,1865,384,251,317,7,8,52,391,11,70,44,84,81,128,467,811,6,5355,297,0,2,0,42,0
30081,1,104,42,7,35,4,0,5,46,1,2,1,2,3,3,2,4,0,2,0,0,2,10,0,0
30082,1,104,11,6,10,0,0,1,11,2,4,2,4,6,6,10,15,1,15,0,0,2,10,0,0
30083,180,5413,1660,832,1314,41,38,274,1701,20,312,209,395,332,604,2671,5058,12,64042,3557,1,2,2,1,0
30084,180,5413,1057,646,719,113,100,145,1170,18,215,134,248,233,382,1740,3004,10,31186,1732,1,2,2,1,0
30085,220,4772,2,2,2,0,0,0,2,0,0,0,0,0,0,0,0,0,0,0,0,2,1,4,0
30086,220,4772,99,48,90,1,3,5,100,0,0,0,0,0,0,0,0,0,0,0,0,2,1,4,0
30087,220,4772,8,5,5,2,0,1,10,0,0,0,0,0,0,0,0,0,0,0,0,2,1,4,0
30088,220,4772,1217,716,841,84,126,174,1301,14,185,118,215,199,333,1446,2542,8,20687,1149,0,2,1,4,0
30089,220,4772,160,89,115,0,13,31,160,7,15,11,17,22,28,78,124,3,495,27,0,2,1,4,0
30090,220,4772,10,10,9,9,0,0,19,0,0,0,0,0,0,0,0,0,0,0,0,2,1,4,0
30091,220,4772,173,84,99,8,29,36,181,5,12,7,13,17,20,54,81,2,221,12,0,2,1,4,0
30092,220,4772,3,1,1,3,0,0,6,0,0,0,0,0,0,0,0,0,0,0,0,2,1,4,0
30093,245,5865,722,423,573,19,0,135,741,12,172,101,199,184,300,1320,2257,6,15668,870,0,2,3,0,0
30094,245,5865,1508,847,911,44,250,301,1552,14,148,88,169,162,257,1120,1886,7,15077,837,0,2,3,0,0
30095,308,6877,72,33,56,0,4,12,72,1,1,1,1,2,2,0,2,0,1,0,0,2,5,5,0
30096,308,6877,1454,835,1044,76,110,219,1530,17,275,158,296,292,454,2297,3718,9,34017,1889,1,2,5,5,0
30097,167,5019,1660,832,1314,41,38,274,1701,20,312,209,395,332,604,2671,5058,12,64042,3557,1,2,13,0,0
30098,80,4548,1296,573,1062,40,33,157,1336,8,201,118,231,209,349,1561,2689,4,12365,686,0,2,22,0,0
30099,30,1260,373,158,315,8,0,51,381,5,76,44,79,81,123,486,779,2,2026,112,0,2,3,1,0
30100,220,4770,2,2,2,0,0,0,2,0,0,0,0,0,0,0,0,0,0,0,0,2,2,2,0
30101,220,4770,99,48,90,1,3,5,100,0,0,0,0,0,0,0,0,0,0,0,0,2,2,2,0
30102,220,4770,8,5,5,2,0,1,10,0,0,0,0,0,0,0,0,0,0,0,0,2,2,2,0
30103,220,4770,1217,716,841,84,126,174,1301,14,185,118,215,199,333,1446,2542,8,20687,1149,0,2,2,2,0
30104,220,4770,160,89,115,0,13,31,160,7,15,11,17,22,28,78,124,3,495,27,0,2,2,2,0
30105,220,4770,10,10,9,9,0,0,19,0,0,0,0,0,0,0,0,0,0,0,0,2,2,2,0
30106,220,4770,173,84,99,8,29,36,181,5,12,7,13,17,20,54,81,2,221,12,0,2,2,2,0
30107,220,4770,3,1,1,3,0,0,6,0,0,0,0,0,0,0,0,0,0,0,0,2,2,2,0
30108,219,4745,2,2,2,0,0,0,2,0,0,0,0,0,0,0,0,0,0,0,0,2,0,7,0
30109,219,4745,99,48,90,1,3,5,100,0,0,0,0,0,0,0,0,0,0,0,0,2,0,7,0
30110,219,4745,8,5,5,2,0,1,10,0,0,0,0,0,0,0,0,0,0,0,0,2,0,7,0
30111,219,4745,1217,716,841,84,126,174,1301,14,185,118,215,199,333,1446,2542,8,20687,1149,0,2,0,7,0
30112,219,4745,160,89,115,0,13,31,160,7,15,11,17,22,28,78,124,3,495,27,0,2,0,7,0
30113,219,4745,10,10,9,9,0,0,19,0,0,0,0,0,0,0,0,0,0,0,0,2,0,7,0
30114,219,4745,173,84,99,8,29,36,181,5,12,7,13,17,20,54,81,2,221,12,0,2,0,7,0
30115,219,4745,3,1,1,3,0,0,6,0,0,0,0,0,0,0,0,0,0,0,0,2,0,7,0
30116,52,611,647,139,84,35,284,233,682,0,0,0,0,0,0,0,0,0,0,0,0,2,0,28,0
30117,31,1865,384,251,317,7,8,52,391,11,70,44,84,81,128,467,811,6,5355,297,0,2,0,42,0
30118,73,1482,207,111,150,11,0,50,218,5,26,19,36,31,55,133,272,3,943,52,0,2,16,5,0
30119,73,1482,410,198,237,31,55,97,441,11,63,38,72,74,110,414,683,6,4293,238,0,2,16,5,0
30120,138,6248,1782,648,1425,9,47,279,1791,8,171,97,189,179,286,1292,2140,4,9462,525,0,2,17,5,0
30121,89,1926,402,202,227,24,74,80,426,12,52,33,61,64,94,339,564,7,3969,220,0,2,7,4,0
30122,100,4333,1020,354,843,12,15,144,1032,8,134,77,144,142,221,970,1580,4,6792,377,0,2,24,8,0
30123,89,1938,402,202,227,24,74,80,426,12,52,33,61,64,94,339,564,7,3969,220,0,2,2,0,0
30124,139,6303,1782,648,1425,9,47,279,1791,8,171,97,189,179,286,1292,2140,4,9462,525,0,2,12,0,0
30125,73,1512,207,111,150,11,0,50,218,5,26,19,36,31,55,133,272,3,943,52,0,2,3,0,0
30126,73,1512,410,198,237,31,55,97,441,11,63,38,72,74,110,414,683,6,4293,238,0,2,3,0,0
30127,139,6326,1782,648,1425,9,47,279,1791,8,171,97,189,179,286,1292,2140,4,9462,525,0,2,3,1,0
30128,220,4770,2,2,2,0,0,0,2,0,0,0,0,0,0,0,0,0,0,0,0,2,2,2,0
30129,220,4770,99,48,90,1,3,5,100,0,0,0,0,0,0,0,0,0,0,0,0,2,2,2,0
30130,220,4770,8,5,5,2,0,1,10,0,0,0,0,0,0,0,0,0,0,0,0,2,2,2,0
30131,220,4770,1217,716,841,84,126,174,1301,14,185,118,215,199,333,1446,2542,8,20687,1149,0,2,2,2,0
30132,220,4770,160,89,115,0,13,31,160,7,15,11,17,22,28,78,124,3,495,27,0,2,2,2,0
30133,220,4770,10,10,9,9,0,0,19,0,0,0,0,0,0,0,0,0,0,0,0,2,2,2,0
30134,220,4770,173,84,99,8,29,36,181,5,12,7,13,17,20,54,81,2,221,12,0,2,2,2,0
30135,220,4770,3,1,1,3,0,0,6,0,0,0,0,0,0,0,0,0,0,0,0,2,2,2,0
30136,73,1512,207,111,150,11,0,50,218,5,26,19,36,31,55,133,272,3,943,52,0,2,19,5,0
30137,73,1512,410,198,237,31,55,97,441,11,63,38,72,74,110,414,683,6,4293,238,0,2,19,5,0
30138,89,1938,402,202,227,24,74,80,426,12,52,33,61,64,94,339,564,7,3969,220,0,2,9,4,0
30139,139,6326,1782,648,1425,9,47,279,1791,8,171,97,189,179,286,1292,2140,4,9462,525,0,2,31,5,0
30140,100,4333,1020,354,843,12,15,144,1032,8,134,77,144,142,221,970,1580,4,6792,377,0,2,24,8,0
30141,53,1120,447,308,343,6,5,95,453,7,96,59,111,103,170,651,1136,4,4600,255,0,2,5,1,1
30142,53,1120,322,174,179,16,74,51,338,10,41,26,46,51,72,252,408,5,2291,127,0,2,5,1,1
30143,19,699,442,244,305,14,16,103,456,11,68,45,75,79,120,452,756,6,4588,254,0,2,4,2,1
30144,19,699,182,102,99,11,40,35,193,3,11,6,11,14,17,42,64,1,97,5,0,2,4,2,1
30145,35,1433,442,244,305,14,16,103,456,11,68,45,75,79,120,452,756,6,4588,254,0,2,30,3,1
30146,155,3263,1513,682,1277,25,13,200,1538,11,199,116,219,210,335,1557,2584,6,15641,868,0,2,3,3,0
30147,155,3263,819,519,539,24,98,155,843,15,96,57,106,111,163,690,1107,8,9171,509,0,2,3,3,0
30148,19,702,442,244,305,14,16,103,456,11,68,45,75,79,120,452,756,6,4588,254,0,2,3,1,0
30149,19,702,182,102,99,11,40,35,193,3,11,6,11,14,17,42,64,1,97,5,0,2,3,1,0
30150,19,709,442,244,305,14,16,103,456,11,68,45,75,79,120,452,756,6,4588,254,0,2,6,2,0
30151,19,709,182,102,99,11,40,35,193,3,11,6,11,14,17,42,64,1,97,5,0,2,6,2,0
30152,19,709,442,244,305,14,16,103,456,11,68,45,75,79,120,452,756,6,4588,254,0,2,2,2,0
30153,19,709,182,102,99,11,40,35,193,3,11,6,11,14,17,42,64,1,97,5,0,2,2,2,0
30154,155,3263,1513,682,1277,25,13,200,1538,11,199,116,219,210,335,1557,2584,6,15641,868,0,2,3,3,0
30155,155,3263,819,519,539,24,98,155,843,15,96,57,106,111,163,690,1107,8,9171,509,0,2,3,3,0
30156,17,378,85,59,61,8,0,16,93,5,18,10,18,23,28,86,126,2,316,17,0,2,2,2,0
30157,99,4109,1289,550,1043,56,32,155,1345,10,167,93,185,177,278,1266,2075,5,11498,638,0,2,3,3,0
30158,180,8032,139,89,101,2,0,35,141,7,54,34,62,61,96,330,569,4,2287,127,0,2,11,11,0
30159,180,8032,7,5,5,0,0,2,7,1,2,1,2,3,3,2,4,0,2,0,0,2,11,11,0
30160,33,1004,465,148,393,5,8,60,470,4,31,20,31,35,51,161,261,2,523,29,0,2,1,1,0
30161,33,1004,16,12,9,0,0,6,16,1,2,1,2,3,3,2,4,0,2,0,0,2,1,1,0
30162,28,800,256,139,192,9,7,47,265,4,23,12,24,27,36,112,171,2,357,19,0,2,1,1,0
30163,123,5258,1513,682,1277,25,13,200,1538,11,199,116,219,210,335,1557,2584,6,15641,868,0,2,26,26,0
30164,96,4695,1523,757,1297,19,12,193,1542,12,193,117,230,205,347,1508,2664,7,19053,1058,0,2,2,2,0
30165,97,4242,1020,354,843,12,15,144,1032,8,134,77,144,142,221,970,1580,4,6792,377,0,2,1,1,0
30166,21,670,424,94,331,4,0,89,428,1,5,5,5,6,10,11,25,0,12,0,0,2,10,10,0
30167,14,546,295,56,236,0,4,54,295,2,9,5,10,11,15,30,51,1,57,3,0,2,4,4,0
30168,99,5096,1943,715,1694,26,18,214,1969,12,185,120,237,197,357,1436,2721,7,20915,1161,0,2,9,9,0
30169,51,1917,1098,241,925,5,10,155,1103,7,46,25,49,53,74,273,423,3,1580,87,0,2,6,6,0
30170,228,4926,1943,715,1694,26,18,214,1969,12,185,120,237,197,357,1436,2721,7,20915,1161,0,2,2,3,0
30171,228,4926,1168,838,957,57,25,144,1225,19,348,224,416,367,640,3018,5452,11,61921,3440,1,2,2,3,0
30172,228,4926,1943,715,1694,26,18,214,1969,12,185,120,237,197,357,1436,2721,7,20915,1161,0,2,2,3,0
30173,228,4926,1168,838,957,57,25,144,1225,19,348,224,416,367,640,3018,5452,11,61921,3440,1,2,2,3,0
30174,35,1441,442,244,305,14,16,103,456,11,68,45,75,79,120,452,756,6,4588,254,0,2,1,1,0
30175,180,5417,1660,832,1314,41,38,274,1701,20,312,209,395,332,604,2671,5058,12,64042,3557,1,2,1,0,0
30176,180,5417,1057,646,719,113,100,145,1170,18,215,134,248,233,382,1740,3004,10,31186,1732,1,2,1,0,0
30177,78,1787,996,429,845,24,10,117,1020,7,76,50,88,83,138,494,879,4,3565,198,0,2,3,1,0
30178,78,1787,456,277,329,12,42,72,468,13,85,50,97,98,147,592,972,7,7212,400,0,2,3,1,0
30179,220,4774,2,2,2,0,0,0,2,0,0,0,0,0,0,0,0,0,0,0,0,2,1,1,0
30180,220,4774,99,48,90,1,3,5,100,0,0,0,0,0,0,0,0,0,0,0,0,2,1,1,0
30181,220,4774,8,5,5,2,0,1,10,0,0,0,0,0,0,0,0,0,0,0,0,2,1,1,0
30182,220,4774,1217,716,841,84,126,174,1301,14,185,118,215,199,333,1446,2542,8,20687,1149,0,2,1,1,0
30183,220,4774,160,89,115,0,13,31,160,7,15,11,17,22,28,78,124,3,495,27,0,2,1,1,0
30184,220,4774,10,10,9,9,0,0,19,0,0,0,0,0,0,0,0,0,0,0,0,2,1,1,0
30185,220,4774,173,84,99,8,29,36,181,5,12,7,13,17,20,54,81,2,221,12,0,2,1,1,0
30186,220,4774,3,1,1,3,0,0,6,0,0,0,0,0,0,0,0,0,0,0,0,2,1,1,0
30187,51,766,167,116,138,4,5,22,171,8,48,30,56,56,86,292,499,4,2330,129,0,2,4,1,0
30188,30,662,215,129,180,6,0,29,221,8,65,43,72,73,115,415,711,4,3153,175,0,2,1,1,0
30189,30,662,97,69,77,3,3,16,100,6,22,13,23,28,36,113,173,3,542,30,0,2,1,1,0
30190,29,745,601,196,481,2,23,85,603,8,63,36,72,71,108,400,664,4,3036,168,0,2,3,2,0
30191,29,745,156,79,106,5,16,28,161,5,14,8,15,19,23,64,97,2,261,14,0,2,3,2,0
30192,45,1575,601,196,481,2,23,85,603,8,63,36,72,71,108,400,664,4,3036,168,0,2,1,1,0
30193,53,1120,447,308,343,6,5,95,453,7,96,59,111,103,170,651,1136,4,4600,255,0,2,5,1,0
30194,53,1120,322,174,179,16,74,51,338,10,41,26,46,51,72,252,408,5,2291,127,0,2,5,1,0
30195,19,709,442,244,305,14,16,103,456,11,68,45,75,79,120,452,756,6,4588,254,0,2,10,2,0
30196,19,709,182,102,99,11,40,35,193,3,11,6,11,14,17,42,64,1,97,5,0,2,10,2,0
30197,35,1441,442,244,305,14,16,103,456,11,68,45,75,79,120,452,756,6,4588,254,0,2,30,3,0
30198,17,378,85,59,61,8,0,16,93,5,18,10,18,23,28,86,126,2,316,17,0,2,2,2,0
30199,99,4109,1289,550,1043,56,32,155,1345,10,167,93,185,177,278,1266,2075,5,11498,638,0,2,3,3,0
30200,180,8032,139,89,101,2,0,35,141,7,54,34,62,61,96,330,569,4,2287,127,0,2,11,11,0
30201,180,8032,7,5,5,0,0,2,7,1,2,1,2,3,3,2,4,0,2,0,0,2,11,11,0
30202,33,1004,465,148,393,5,8,60,470,4,31,20,31,35,51,161,261,2,523,29,0,2,1,1,0
30203,33,1004,16,12,9,0,0,6,16,1,2,1,2,3,3,2,4,0,2,0,0,2,1,1,0
30204,28,800,256,139,192,9,7,47,265,4,23,12,24,27,36,112,171,2,357,19,0,2,1,1,0
30205,123,5258,1513,682,1277,25,13,200,1538,11,199,116,219,210,335,1557,2584,6,15641,868,0,2,26,26,0
30206,96,4695,1523,757,1297,19,12,193,1542,12,193,117,230,205,347,1508,2664,7,19053,1058,0,2,2,2,0
30207,97,4242,1020,354,843,12,15,144,1032,8,134,77,144,142,221,970,1580,4,6792,377,0,2,1,1,0
30208,21,670,424,94,331,4,0,89,428,1,5,5,5,6,10,11,25,0,12,0,0,2,10,10,0
30209,14,546,295,56,236,0,4,54,295,2,9,5,10,11,15,30,51,1,57,3,0,2,4,4,0
30210,99,5096,1943,715,1694,26,18,214,1969,12,185,120,237,197,357,1436,2721,7,20915,1161,0,2,9,9,0
30211,51,1917,1098,241,925,5,10,155,1103,7,46,25,49,53,74,273,423,3,1580,87,0,2,6,6,0
30212,224,4878,182,127,129,0,0,53,182,5,39,21,42,44,63,217,343,2,926,51,0,2,11,4,0
30213,224,4878,1165,710,800,67,119,181,1232,18,243,153,282,261,435,2000,3492,10,36473,2026,1,2,11,4,0
30214,29,843,256,139,192,9,7,47,265,4,23,12,24,27,36,112,171,2,357,19,0,2,12,0,0
30215,180,5417,1660,832,1314,41,38,274,1701,20,312,209,395,332,604,2671,5058,12,64042,3557,1,2,1,0,0
30216,180,5417,1057,646,719,113,100,145,1170,18,215,134,248,233,382,1740,3004,10,31186,1732,1,2,1,0,0
30217,78,1787,996,429,845,24,10,117,1020,7,76,50,88,83,138,494,879,4,3565,198,0,2,3,1,0
30218,78,1787,456,277,329,12,42,72,468,13,85,50,97,98,147,592,972,7,7212,400,0,2,3,1,0
30219,220,4774,2,2,2,0,0,0,2,0,0,0,0,0,0,0,0,0,0,0,0,2,1,1,0
30220,220,4774,99,48,90,1,3,5,100,0,0,0,0,0,0,0,0,0,0,0,0,2,1,1,0
30221,220,4774,8,5,5,2,0,1,10,0,0,0,0,0,0,0,0,0,0,0,0,2,1,1,0
30222,220,4774,1217,716,841,84,126,174,1301,14,185,118,215,199,333,1446,2542,8,20687,1149,0,2,1,1,0
30223,220,4774,160,89,115,0,13,31,160,7,15,11,17,22,28,78,124,3,495,27,0,2,1,1,0
30224,220,4774,10,10,9,9,0,0,19,0,0,0,0,0,0,0,0,0,0,0,0,2,1,1,0
30225,220,4774,173,84,99,8,29,36,181,5,12,7,13,17,20,54,81,2,221,12,0,2,1,1,0
30226,220,4774,3,1,1,3,0,0,6,0,0,0,0,0,0,0,0,0,0,0,0,2,1,1,0
30227,51,766,167,116,138,4,5,22,171,8,48,30,56,56,86,292,499,4,2330,129,0,2,4,1,0
30228,30,662,215,129,180,6,0,29,221,8,65,43,72,73,115,415,711,4,3153,175,0,2,1,1,0
30229,30,662,97,69,77,3,3,16,100,6,22,13,23,28,36,113,173,3,542,30,0,2,1,1,0
30230,29,745,601,196,481,2,23,85,603,8,63,36,72,71,108,400,664,4,3036,168,0,2,3,2,0
30231,29,745,156,79,106,5,16,28,161,5,14,8,15,19,23,64,97,2,261,14,0,2,3,2,0
30232,45,1575,601,196,481,2,23,85,603,8,63,36,72,71,108,400,664,4,3036,168,0,2,1,1,0
30233,231,4983,182,127,129,0,0,53,182,5,39,21,42,44,63,217,343,2,926,51,0,2,69,22,1
30234,231,4983,1165,710,800,67,119,181,1232,18,243,153,282,261,435,2000,3492,10,36473,2026,1,2,69,22,1
30235,89,1780,477,336,357,30,23,73,507,16,194,134,250,210,384,1538,2962,10,30538,1696,0,2,1,1,1
30236,150,3478,77,34,69,0,0,8,77,3,24,16,29,27,45,114,213,1,387,21,0,2,2,2,1
30237,150,3478,712,438,573,51,9,84,763,14,102,71,128,116,199,733,1364,8,11988,666,0,2,2,2,1
30238,308,6881,72,33,56,0,4,12,72,1,1,1,1,2,2,0,2,0,1,0,0,2,2,2,1
30239,308,6881,1454,835,1044,76,110,219,1530,17,275,158,296,292,454,2297,3718,9,34017,1889,1,2,2,2,1
30240,91,1839,757,253,292,73,244,162,830,13,61,38,67,74,105,409,651,7,4654,258,0,2,3,3,1
30241,92,1977,1043,504,840,53,9,147,1096,9,180,112,198,189,310,1377,2344,4,11604,644,0,2,2,2,1
30242,92,1977,383,288,292,26,6,62,409,11,65,38,67,76,105,429,656,5,3719,206,0,2,2,2,1
30243,62,1263,1098,241,925,5,10,155,1103,7,46,25,49,53,74,273,423,3,1580,87,0,2,5,1,1
30244,62,1263,282,202,222,14,2,44,296,8,42,24,43,50,67,250,378,4,1548,86,0,2,5,1,1
30245,35,1087,182,127,129,0,0,53,182,5,39,21,42,44,63,217,343,2,926,51,0,2,2,2,1
30246,153,7207,1392,870,1177,35,17,170,1427,14,494,280,531,508,811,4473,7289,7,54850,3047,2,2,17,11,1
30247,16,1247,215,129,180,6,0,29,221,8,65,43,72,73,115,415,711,4,3153,175,0,2,1,1,1
30248,84,3302,1043,504,840,53,9,147,1096,9,180,112,198,189,310,1377,2344,4,11604,644,0,2,8,12,1
30249,231,4983,182,127,129,0,0,53,182,5,39,21,42,44,63,217,343,2,926,51,0,2,5,6,0
30250,231,4983,1165,710,800,67,119,181,1232,18,243,153,282,261,435,2000,3492,10,36473,2026,1,2,5,6,0
30251,29,850,256,139,192,9,7,47,265,4,23,12,24,27,36,112,171,2,357,19,0,2,7,2,0
30252,60,1163,282,196,195,3,0,86,285,8,130,71,141,138,212,936,1507,4,6538,363,0,2,24,0,0
30253,1,90,13,10,10,0,0,3,13,1,2,1,2,3,3,2,4,0,2,0,0,2,1,1,0
30254,108,2057,477,336,357,30,23,73,507,16,194,134,250,210,384,1538,2962,10,30538,1696,0,2,41,0,0
30255,1,55,14,12,10,0,0,4,14,1,2,1,2,3,3,2,4,0,2,0,0,0,14,0,0
30256,1,58,14,12,10,0,0,4,14,1,2,1,2,3,3,2,4,0,2,0,0,0,14,0,0
30257,1,55,14,12,10,0,0,4,14,1,2,1,2,3,3,2,4,0,2,0,0,0,14,0,0
30258,1,77,19,18,14,0,0,5,19,1,2,1,2,3,3,2,4,0,2,0,0,0,19,0,0
30259,120,4779,1450,624,1228,12,26,181,1462,14,306,186,354,320,540,2580,4493,8,36391,2021,1,2,110,0,0
30260,46,3395,996,429,845,24,10,117,1020,7,76,50,88,83,138,494,879,4,3565,198,0,2,3,2,0
30261,81,1825,996,429,845,24,10,117,1020,7,76,50,88,83,138,494,879,4,3565,198,0,2,9,2,0
30262,81,1825,456,277,329,12,42,72,468,13,85,50,97,98,147,592,972,7,7212,400,0,2,9,2,0
30263,46,3395,996,429,845,24,10,117,1020,7,76,50,88,83,138,494,879,4,3565,198,0,2,26,2,0
30264,224,4878,182,127,129,0,0,53,182,5,39,21,42,44,63,217,343,2,926,51,0,2,11,4,0
30265,224,4878,1165,710,800,67,119,181,1232,18,243,153,282,261,435,2000,3492,10,36473,2026,1,2,11,4,0
30266,29,850,256,139,192,9,7,47,265,4,23,12,24,27,36,112,171,2,357,19,0,2,17,0,0
30267,231,4983,182,127,129,0,0,53,182,5,39,21,42,44,63,217,343,2,926,51,0,2,68,22,0
30268,231,4983,1165,710,800,67,119,181,1232,18,243,153,282,261,435,2000,3492,10,36473,2026,1,2,68,22,0
30269,108,2059,477,336,357,30,23,73,507,16,194,134,250,210,384,1538,2962,10,30538,1696,0,2,1,1,0
30270,150,3478,77,34,69,0,0,8,77,3,24,16,29,27,45,114,213,1,387,21,0,2,2,2,0
30271,150,3478,712,438,573,51,9,84,763,14,102,71,128,116,199,733,1364,8,11988,666,0,2,2,2,0
30272,308,6881,72,33,56,0,4,12,72,1,1,1,1,2,2,0,2,0,1,0,0,2,2,2,0
30273,308,6881,1454,835,1044,76,110,219,1530,17,275,158,296,292,454,2297,3718,9,34017,1889,1,2,2,2,0
30274,91,1839,757,253,292,73,244,162,830,13,61,38,67,74,105,409,651,7,4654,258,0,2,3,3,0
30275,92,1977,1043,504,840,53,9,147,1096,9,180,112,198,189,310,1377,2344,4,11604,644,0,2,2,2,0
30276,92,1977,383,288,292,26,6,62,409,11,65,38,67,76,105,429,656,5,3719,206,0,2,2,2,0
30277,62,1263,1098,241,925,5,10,155,1103,7,46,25,49,53,74,273,423,3,1580,87,0,2,5,1,0
30278,62,1263,282,202,222,14,2,44,296,8,42,24,43,50,67,250,378,4,1548,86,0,2,5,1,0
30279,35,1087,182,127,129,0,0,53,182,5,39,21,42,44,63,217,343,2,926,51,0,2,2,2,0
30280,153,7207,1392,870,1177,35,17,170,1427,14,494,280,531,508,811,4473,7289,7,54850,3047,2,2,17,11,0
30281,16,1247,215,129,180,6,0,29,221,8,65,43,72,73,115,415,711,4,3153,175,0,2,1,1,0
30282,84,3302,1043,504,840,53,9,147,1096,9,180,112,198,189,310,1377,2344,4,11604,644,0,2,8,12,0
30283,230,4971,1943,715,1694,26,18,214,1969,12,185,120,237,197,357,1436,2721,7,20915,1161,0,2,13,3,0
30284,230,4971,1168,838,957,57,25,144,1225,19,348,224,416,367,640,3018,5452,11,61921,3440,1,2,13,3,0
30285,99,5127,1943,715,1694,26,18,214,1969,12,185,120,237,197,357,1436,2721,7,20915,1161,0,2,18,2,0
30286,230,4971,1943,715,1694,26,18,214,1969,12,185,120,237,197,357,1436,2721,7,20915,1161,0,2,13,3,0
30287,230,4971,1168,838,957,57,25,144,1225,19,348,224,416,367,640,3018,5452,11,61921,3440,1,2,13,3,0
30288,99,5127,1943,715,1694,26,18,214,1969,12,185,120,237,197,357,1436,2721,7,20915,1161,0,2,18,2,0
30289,231,4976,1943,715,1694,26,18,214,1969,12,185,120,237,197,357,1436,2721,7,20915,1161,0,2,2,0,0
30290,231,4976,1168,838,957,57,25,144,1225,19,348,224,416,367,640,3018,5452,11,61921,3440,1,2,2,0,0
30291,100,5223,1943,715,1694,26,18,214,1969,12,185,120,237,197,357,1436,2721,7,20915,1161,0,2,28,1,0
30292,91,1839,757,253,292,73,244,162,830,13,61,38,67,74,105,409,651,7,4654,258,0,2,1,1,0
30293,30,878,256,139,192,9,7,47,265,4,23,12,24,27,36,112,171,2,357,19,0,2,4,0,0
30294,231,4976,1943,715,1694,26,18,214,1969,12,185,120,237,197,357,1436,2721,7,20915,1161,0,2,2,0,0
30295,231,4976,1168,838,957,57,25,144,1225,19,348,224,416,367,640,3018,5452,11,61921,3440,1,2,2,0,0
30296,100,5223,1943,715,1694,26,18,214,1969,12,185,120,237,197,357,1436,2721,7,20915,1161,0,2,28,1,0
30297,17,378,85,59,61,8,0,16,93,5,18,10,18,23,28,86,126,2,316,17,0,2,2,2,0
30298,180,5417,1660,832,1314,41,38,274,1701,20,312,209,395,332,604,2671,5058,12,64042,3557,1,2,1,0,0
30299,180,5417,1057,646,719,113,100,145,1170,18,215,134,248,233,382,1740,3004,10,31186,1732,1,2,1,0,0
30300,81,1825,996,429,845,24,10,117,1020,7,76,50,88,83,138,494,879,4,3565,198,0,2,12,3,0
30301,81,1825,456,277,329,12,42,72,468,13,85,50,97,98,147,592,972,7,7212,400,0,2,12,3,0
30302,219,4747,2,2,2,0,0,0,2,0,0,0,0,0,0,0,0,0,0,0,0,2,3,3,0
30303,219,4747,99,48,90,1,3,5,100,0,0,0,0,0,0,0,0,0,0,0,0,2,3,3,0
30304,219,4747,8,5,5,2,0,1,10,0,0,0,0,0,0,0,0,0,0,0,0,2,3,3,0
30305,219,4747,1217,716,841,84,126,174,1301,14,185,118,215,199,333,1446,2542,8,20687,1149,0,2,3,3,0
30306,219,4747,160,89,115,0,13,31,160,7,15,11,17,22,28,78,124,3,495,27,0,2,3,3,0
30307,219,4747,10,10,9,9,0,0,19,0,0,0,0,0,0,0,0,0,0,0,0,2,3,3,0
30308,219,4747,173,84,99,8,29,36,181,5,12,7,13,17,20,54,81,2,221,12,0,2,3,3,0
30309,219,4747,3,1,1,3,0,0,6,0,0,0,0,0,0,0,0,0,0,0,0,2,3,3,0
30310,55,792,167,116,138,4,5,22,171,8,48,30,56,56,86,292,499,4,2330,129,0,2,4,1,0
30311,53,1120,447,308,343,6,5,95,453,7,96,59,111,103,170,651,1136,4,4600,255,0,2,5,1,0
30312,53,1120,322,174,179,16,74,51,338,10,41,26,46,51,72,252,408,5,2291,127,0,2,5,1,0
30313,30,662,215,129,180,6,0,29,221,8,65,43,72,73,115,415,711,4,3153,175,0,2,1,1,0
30314,30,662,97,69,77,3,3,16,100,6,22,13,23,28,36,113,173,3,542,30,0,2,1,1,0
30315,231,4976,1943,715,1694,26,18,214,1969,12,185,120,237,197,357,1436,2721,7,20915,1161,0,2,17,6,0
30316,231,4976,1168,838,957,57,25,144,1225,19,348,224,416,367,640,3018,5452,11,61921,3440,1,2,17,6,0
30317,19,709,442,244,305,14,16,103,456,11,68,45,75,79,120,452,756,6,4588,254,0,2,10,2,0
30318,19,709,182,102,99,11,40,35,193,3,11,6,11,14,17,42,64,1,97,5,0,2,10,2,0
30319,29,745,601,196,481,2,23,85,603,8,63,36,72,71,108,400,664,4,3036,168,0,2,3,2,0
30320,29,745,156,79,106,5,16,28,161,5,14,8,15,19,23,64,97,2,261,14,0,2,3,2,0
30321,99,4109,1289,550,1043,56,32,155,1345,10,167,93,185,177,278,1266,2075,5,11498,638,0,2,3,3,0
30322,180,8032,139,89,101,2,0,35,141,7,54,34,62,61,96,330,569,4,2287,127,0,2,11,11,0
30323,180,8032,7,5,5,0,0,2,7,1,2,1,2,3,3,2,4,0,2,0,0,2,11,11,0
30324,33,1004,465,148,393,5,8,60,470,4,31,20,31,35,51,161,261,2,523,29,0,2,1,1,0
30325,33,1004,16,12,9,0,0,6,16,1,2,1,2,3,3,2,4,0,2,0,0,2,1,1,0
30326,29,850,256,139,192,9,7,47,265,4,23,12,24,27,36,112,171,2,357,19,0,2,18,1,0
30327,46,3395,996,429,845,24,10,117,1020,7,76,50,88,83,138,494,879,4,3565,198,0,2,26,2,0
30328,123,5258,1513,682,1277,25,13,200,1538,11,199,116,219,210,335,1557,2584,6,15641,868,0,2,26,26,0
30329,96,4695,1523,757,1297,19,12,193,1542,12,193,117,230,205,347,1508,2664,7,19053,1058,0,2,2,2,0
30330,100,4333,1020,354,843,12,15,144,1032,8,134,77,144,142,221,970,1580,4,6792,377,0,2,1,1,0
30331,21,670,424,94,331,4,0,89,428,1,5,5,5,6,10,11,25,0,12,0,0,2,10,10,0
30332,14,546,295,56,236,0,4,54,295,2,9,5,10,11,15,30,51,1,57,3,0,2,4,4,0
30333,100,5223,1943,715,1694,26,18,214,1969,12,185,120,237,197,357,1436,2721,7,20915,1161,0,2,54,11,0
30334,35,1441,442,244,305,14,16,103,456,11,68,45,75,79,120,452,756,6,4588,254,0,2,30,3,0
30335,51,1917,1098,241,925,5,10,155,1103,7,46,25,49,53,74,273,423,3,1580,87,0,2,6,6,0
30336,45,1575,601,196,481,2,23,85,603,8,63,36,72,71,108,400,664,4,3036,168,0,2,1,1,0
30337,91,1839,757,253,292,73,244,162,830,13,61,38,67,74,105,409,651,7,4654,258,0,2,1,1,0
30338,30,878,256,139,192,9,7,47,265,4,23,12,24,27,36,112,171,2,357,19,0,2,4,0,0
30339,1,321,382,65,130,157,2,92,539,4,10,5,10,14,15,41,57,2,114,6,0,2,1,0,0
30340,180,8032,139,89,101,2,0,35,141,7,54,34,62,61,96,330,569,4,2287,127,0,2,3,10,0
30341,180,8032,7,5,5,0,0,2,7,1,2,1,2,3,3,2,4,0,2,0,0,2,3,10,0
30342,180,8032,139,89,101,2,0,35,141,7,54,34,62,61,96,330,569,4,2287,127,0,2,3,10,0
30343,180,8032,7,5,5,0,0,2,7,1,2,1,2,3,3,2,4,0,2,0,0,2,3,10,0
30344,91,1842,757,253,292,73,244,162,830,13,61,38,67,74,105,409,651,7,4654,258,0,2,1,1,0
30345,180,8032,139,89,101,2,0,35,141,7,54,34,62,61,96,330,569,4,2287,127,0,2,3,10,0
30346,180,8032,7,5,5,0,0,2,7,1,2,1,2,3,3,2,4,0,2,0,0,2,3,10,0
30347,30,878,256,139,192,9,7,47,265,4,23,12,24,27,36,112,171,2,357,19,0,2,4,0,0
30348,1,321,382,65,130,157,2,92,539,4,10,5,10,14,15,41,57,2,114,6,0,2,1,0,0
30349,17,378,85,59,61,8,0,16,93,5,18,10,18,23,28,86,126,2,316,17,0,2,2,2,0
30350,180,5417,1660,832,1314,41,38,274,1701,20,312,209,395,332,604,2671,5058,12,64042,3557,1,2,1,0,0
30351,180,5417,1057,646,719,113,100,145,1170,18,215,134,248,233,382,1740,3004,10,31186,1732,1,2,1,0,0
30352,81,1825,996,429,845,24,10,117,1020,7,76,50,88,83,138,494,879,4,3565,198,0,2,12,3,0
30353,81,1825,456,277,329,12,42,72,468,13,85,50,97,98,147,592,972,7,7212,400,0,2,12,3,0
30354,219,4747,2,2,2,0,0,0,2,0,0,0,0,0,0,0,0,0,0,0,0,2,3,3,0
30355,219,4747,99,48,90,1,3,5,100,0,0,0,0,0,0,0,0,0,0,0,0,2,3,3,0
30356,219,4747,8,5,5,2,0,1,10,0,0,0,0,0,0,0,0,0,0,0,0,2,3,3,0
30357,219,4747,1217,716,841,84,126,174,1301,14,185,118,215,199,333,1446,2542,8,20687,1149,0,2,3,3,0
30358,219,4747,160,89,115,0,13,31,160,7,15,11,17,22,28,78,124,3,495,27,0,2,3,3,0
30359,219,4747,10,10,9,9,0,0,19,0,0,0,0,0,0,0,0,0,0,0,0,2,3,3,0
30360,219,4747,173,84,99,8,29,36,181,5,12,7,13,17,20,54,81,2,221,12,0,2,3,3,0
30361,219,4747,3,1,1,3,0,0,6,0,0,0,0,0,0,0,0,0,0,0,0,2,3,3,0
30362,55,792,167,116,138,4,5,22,171,8,48,30,56,56,86,292,499,4,2330,129,0,2,4,1,0
30363,53,1120,447,308,343,6,5,95,453,7,96,59,111,103,170,651,1136,4,4600,255,0,2,5,1,0
30364,53,1120,322,174,179,16,74,51,338,10,41,26,46,51,72,252,408,5,2291,127,0,2,5,1,0
30365,91,1842,757,253,292,73,244,162,830,13,61,38,67,74,105,409,651,7,4654,258,0,2,1,1,0
30366,30,662,215,129,180,6,0,29,221,8,65,43,72,73,115,415,711,4,3153,175,0,2,1,1,0
30367,30,662,97,69,77,3,3,16,100,6,22,13,23,28,36,113,173,3,542,30,0,2,1,1,0
30368,231,4976,1943,715,1694,26,18,214,1969,12,185,120,237,197,357,1436,2721,7,20915,1161,0,2,17,6,0
30369,231,4976,1168,838,957,57,25,144,1225,19,348,224,416,367,640,3018,5452,11,61921,3440,1,2,17,6,0
30370,19,709,442,244,305,14,16,103,456,11,68,45,75,79,120,452,756,6,4588,254,0,2,10,2,0
30371,19,709,182,102,99,11,40,35,193,3,11,6,11,14,17,42,64,1,97,5,0,2,10,2,0
30372,29,745,601,196,481,2,23,85,603,8,63,36,72,71,108,400,664,4,3036,168,0,2,3,2,0
30373,29,745,156,79,106,5,16,28,161,5,14,8,15,19,23,64,97,2,261,14,0,2,3,2,0
30374,99,4109,1289,550,1043,56,32,155,1345,10,167,93,185,177,278,1266,2075,5,11498,638,0,2,3,3,0
30375,180,8032,139,89,101,2,0,35,141,7,54,34,62,61,96,330,569,4,2287,127,0,2,14,21,0
30376,180,8032,7,5,5,0,0,2,7,1,2,1,2,3,3,2,4,0,2,0,0,2,14,21,0
30377,33,1004,465,148,393,5,8,60,470,4,31,20,31,35,51,161,261,2,523,29,0,2,1,1,0
30378,33,1004,16,12,9,0,0,6,16,1,2,1,2,3,3,2,4,0,2,0,0,2,1,1,0
30379,30,878,256,139,192,9,7,47,265,4,23,12,24,27,36,112,171,2,357,19,0,2,22,1,0
30380,46,3395,996,429,845,24,10,117,1020,7,76,50,88,83,138,494,879,4,3565,198,0,2,26,2,0
30381,123,5258,1513,682,1277,25,13,200,1538,11,199,116,219,210,335,1557,2584,6,15641,868,0,2,26,26,0
30382,96,4695,1523,757,1297,19,12,193,1542,12,193,117,230,205,347,1508,2664,7,19053,1058,0,2,2,2,0
30383,100,4333,1020,354,843,12,15,144,1032,8,134,77,144,142,221,970,1580,4,6792,377,0,2,1,1,0
30384,21,670,424,94,331,4,0,89,428,1,5,5,5,6,10,11,25,0,12,0,0,2,10,10,0
30385,14,546,295,56,236,0,4,54,295,2,9,5,10,11,15,30,51,1,57,3,0,2,4,4,0
30386,100,5223,1943,715,1694,26,18,214,1969,12,185,120,237,197,357,1436,2721,7,20915,1161,0,2,54,11,0
30387,35,1441,442,244,305,14,16,103,456,11,68,45,75,79,120,452,756,6,4588,254,0,2,30,3,0
30388,51,1917,1098,241,925,5,10,155,1103,7,46,25,49,53,74,273,423,3,1580,87,0,2,6,6,0
30389,45,1575,601,196,481,2,23,85,603,8,63,36,72,71,108,400,664,4,3036,168,0,2,1,1,0
30390,87,1961,53,23,39,0,0,13,53,2,8,4,8,10,12,26,39,1,39,2,0,2,1,1,1
30391,87,1961,515,298,307,33,80,99,548,12,63,44,77,75,121,419,753,7,5527,307,0,2,1,1,1
30392,105,4860,1338,495,1086,10,64,173,1348,11,122,82,157,133,239,883,1686,7,11934,663,0,2,13,5,1
30393,139,6326,1782,648,1425,9,47,279,1791,8,171,97,189,179,286,1292,2140,4,9462,525,0,2,3,3,1
30394,80,4548,1296,573,1062,40,33,157,1336,8,201,118,231,209,349,1561,2689,4,12365,686,0,2,20,20,1
30395,100,5223,1943,715,1694,26,18,214,1969,12,185,120,237,197,357,1436,2721,7,20915,1161,0,2,5,6,1
30396,87,1961,53,23,39,0,0,13,53,2,8,4,8,10,12,26,39,1,39,2,0,2,1,1,0
30397,87,1961,515,298,307,33,80,99,548,12,63,44,77,75,121,419,753,7,5527,307,0,2,1,1,0
30398,105,4860,1338,495,1086,10,64,173,1348,11,122,82,157,133,239,883,1686,7,11934,663,0,2,13,5,0
30399,139,6326,1782,648,1425,9,47,279,1791,8,171,97,189,179,286,1292,2140,4,9462,525,0,2,3,3,0
30400,80,4548,1296,573,1062,40,33,157,1336,8,201,118,231,209,349,1561,2689,4,12365,686,0,2,20,20,0
30401,100,5223,1943,715,1694,26,18,214,1969,12,185,120,237,197,357,1436,2721,7,20915,1161,0,2,5,6,0
30402,1,321,382,65,130,157,2,92,539,4,10,5,10,14,15,41,57,2,114,6,0,2,1,0,0
30403,1,321,382,65,130,157,2,92,539,4,10,5,10,14,15,41,57,2,114,6,0,2,1,0,0
30404,60,1167,282,196,195,3,0,86,285,8,130,71,141,138,212,936,1507,4,6538,363,0,2,3,3,1
30405,91,1864,757,253,292,73,244,162,830,13,61,38,67,74,105,409,651,7,4654,258,0,2,7,10,1
30406,45,935,386,256,301,16,9,68,402,4,59,35,69,63,104,355,621,2,1453,80,0,2,2,0,1
30407,45,935,264,131,164,11,41,46,275,6,38,22,40,44,62,214,338,3,1068,59,0,2,2,0,1
30408,35,1093,182,127,129,0,0,53,182,5,39,21,42,44,63,217,343,2,926,51,0,2,1,1,1
30409,153,7221,1392,870,1177,35,17,170,1427,14,494,280,531,508,811,4473,7289,7,54850,3047,2,2,4,2,1
30410,92,2899,773,419,590,28,0,166,801,10,204,113,217,214,330,1598,2554,5,13587,754,0,2,9,16,1
30411,1,24,127,75,83,2,11,30,129,4,14,7,14,18,21,61,87,2,175,9,0,2,1,1,1
30412,1,24,652,304,544,16,6,88,668,6,89,51,101,95,152,591,998,3,3399,188,0,2,1,1,1
30413,1,24,2,2,2,0,0,0,2,0,0,0,0,0,0,0,0,0,0,0,0,2,1,1,1
30414,1,24,8,5,5,0,0,3,8,0,0,0,0,0,0,0,0,0,0,0,0,2,1,1,1
30415,1,24,2,2,2,0,0,0,2,0,0,0,0,0,0,0,0,0,0,0,0,2,1,1,1
30416,1,24,14,8,8,0,0,6,14,0,0,0,0,0,0,0,0,0,0,0,0,2,1,1,1
30417,1,24,6,4,4,0,0,2,6,0,0,0,0,0,0,0,0,0,0,0,0,2,1,1,1
30418,1,24,6,4,4,0,0,2,6,1,2,1,2,3,3,2,4,0,2,0,0,2,1,1,1
30419,1,24,6,4,4,0,0,2,6,0,0,0,0,0,0,0,0,0,0,0,0,2,1,1,1
30420,1,24,7,5,5,0,0,2,7,0,0,0,0,0,0,0,0,0,0,0,0,2,1,1,1
30421,1,24,6,4,4,0,0,2,6,0,0,0,0,0,0,0,0,0,0,0,0,2,1,1,1
30422,1,24,10,6,6,0,0,4,10,0,0,0,0,0,0,0,0,0,0,0,0,2,1,1,1
30423,1,24,1,1,1,0,0,0,1,0,0,0,0,0,0,0,0,0,0,0,0,2,1,1,1
30424,1,24,1,1,1,0,0,0,1,0,0,0,0,0,0,0,0,0,0,0,0,2,1,1,1
30425,1,24,14,10,10,0,0,4,14,1,1,1,1,2,2,0,2,0,1,0,0,2,1,1,1
30426,1,24,46,26,30,3,0,12,49,3,6,3,6,9,9,20,28,1,42,2,0,2,1,1,1
30427,105,4868,1338,495,1086,10,64,173,1348,11,122,82,157,133,239,883,1686,7,11934,663,0,2,3,2,1
30428,180,8038,139,89,101,2,0,35,141,7,54,34,62,61,96,330,569,4,2287,127,0,2,2,1,1
30429,180,8038,7,5,5,0,0,2,7,1,2,1,2,3,3,2,4,0,2,0,0,2,2,1,1
30430,139,6352,1782,648,1425,9,47,279,1791,8,171,97,189,179,286,1292,2140,4,9462,525,0,2,4,4,1
30431,30,938,256,139,192,9,7,47,265,4,23,12,24,27,36,112,171,2,357,19,0,2,12,5,1
30432,123,5266,1513,682,1277,25,13,200,1538,11,199,116,219,210,335,1557,2584,6,15641,868,0,2,5,5,1
30433,92,4741,1457,730,1242,11,6,188,1468,10,292,166,329,302,495,2424,4078,5,22973,1276,1,2,4,3,1
30434,42,1932,447,308,343,6,5,95,453,7,96,59,111,103,170,651,1136,4,4600,255,0,2,4,4,1
30435,38,2315,334,251,279,10,4,40,344,5,127,74,143,132,217,899,1528,2,4303,239,0,2,1,5,1
30436,31,1885,384,251,317,7,8,52,391,11,70,44,84,81,128,467,811,6,5355,297,0,2,5,5,1
30437,47,2254,722,423,573,19,0,135,741,12,172,101,199,184,300,1320,2257,6,15668,870,0,2,2,2,1
30438,45,1961,386,256,301,16,9,68,402,4,59,35,69,63,104,355,621,2,1453,80,0,2,13,4,1
30439,84,3328,1043,504,840,53,9,147,1096,9,180,112,198,189,310,1377,2344,4,11604,644,0,2,5,12,1
30440,30,1267,373,158,315,8,0,51,381,5,76,44,79,81,123,486,779,2,2026,112,0,2,2,6,1
30441,100,5228,1943,715,1694,26,18,214,1969,12,185,120,237,197,357,1436,2721,7,20915,1161,0,2,2,1,1
30442,60,1167,282,196,195,3,0,86,285,8,130,71,141,138,212,936,1507,4,6538,363,0,2,3,3,0
30443,91,1864,757,253,292,73,244,162,830,13,61,38,67,74,105,409,651,7,4654,258,0,2,7,10,0
30444,45,935,386,256,301,16,9,68,402,4,59,35,69,63,104,355,621,2,1453,80,0,2,2,0,0
30445,45,935,264,131,164,11,41,46,275,6,38,22,40,44,62,214,338,3,1068,59,0,2,2,0,0
30446,35,1093,182,127,129,0,0,53,182,5,39,21,42,44,63,217,343,2,926,51,0,2,1,1,0
30447,153,7221,1392,870,1177,35,17,170,1427,14,494,280,531,508,811,4473,7289,7,54850,3047,2,2,4,2,0
30448,92,2899,773,419,590,28,0,166,801,10,204,113,217,214,330,1598,2554,5,13587,754,0,2,9,16,0
30449,1,24,127,75,83,2,11,30,129,4,14,7,14,18,21,61,87,2,175,9,0,2,1,1,0
30450,1,24,652,304,544,16,6,88,668,6,89,51,101,95,152,591,998,3,3399,188,0,2,1,1,0
30451,1,24,2,2,2,0,0,0,2,0,0,0,0,0,0,0,0,0,0,0,0,2,1,1,0
30452,1,24,8,5,5,0,0,3,8,0,0,0,0,0,0,0,0,0,0,0,0,2,1,1,0
30453,1,24,2,2,2,0,0,0,2,0,0,0,0,0,0,0,0,0,0,0,0,2,1,1,0
30454,1,24,14,8,8,0,0,6,14,0,0,0,0,0,0,0,0,0,0,0,0,2,1,1,0
30455,1,24,6,4,4,0,0,2,6,0,0,0,0,0,0,0,0,0,0,0,0,2,1,1,0
30456,1,24,6,4,4,0,0,2,6,1,2,1,2,3,3,2,4,0,2,0,0,2,1,1,0
30457,1,24,6,4,4,0,0,2,6,0,0,0,0,0,0,0,0,0,0,0,0,2,1,1,0
30458,1,24,7,5,5,0,0,2,7,0,0,0,0,0,0,0,0,0,0,0,0,2,1,1,0
30459,1,24,6,4,4,0,0,2,6,0,0,0,0,0,0,0,0,0,0,0,0,2,1,1,0
30460,1,24,10,6,6,0,0,4,10,0,0,0,0,0,0,0,0,0,0,0,0,2,1,1,0
30461,1,24,1,1,1,0,0,0,1,0,0,0,0,0,0,0,0,0,0,0,0,2,1,1,0
30462,1,24,1,1,1,0,0,0,1,0,0,0,0,0,0,0,0,0,0,0,0,2,1,1,0
30463,1,24,14,10,10,0,0,4,14,1,1,1,1,2,2,0,2,0,1,0,0,2,1,1,0
30464,1,24,46,26,30,3,0,12,49,3,6,3,6,9,9,20,28,1,42,2,0,2,1,1,0
30465,105,4868,1338,495,1086,10,64,173,1348,11,122,82,157,133,239,883,1686,7,11934,663,0,2,3,2,0
30466,180,8038,139,89,101,2,0,35,141,7,54,34,62,61,96,330,569,4,2287,127,0,2,2,1,0
30467,180,8038,7,5,5,0,0,2,7,1,2,1,2,3,3,2,4,0,2,0,0,2,2,1,0
30468,139,6352,1782,648,1425,9,47,279,1791,8,171,97,189,179,286,1292,2140,4,9462,525,0,2,4,4,0
30469,30,938,256,139,192,9,7,47,265,4,23,12,24,27,36,112,171,2,357,19,0,2,12,5,0
30470,123,5266,1513,682,1277,25,13,200,1538,11,199,116,219,210,335,1557,2584,6,15641,868,0,2,5,5,0
30471,92,4741,1457,730,1242,11,6,188,1468,10,292,166,329,302,495,2424,4078,5,22973,1276,1,2,4,3,0
30472,42,1932,447,308,343,6,5,95,453,7,96,59,111,103,170,651,1136,4,4600,255,0,2,4,4,0
30473,38,2315,334,251,279,10,4,40,344,5,127,74,143,132,217,899,1528,2,4303,239,0,2,1,5,0
30474,31,1885,384,251,317,7,8,52,391,11,70,44,84,81,128,467,811,6,5355,297,0,2,5,5,0
30475,47,2254,722,423,573,19,0,135,741,12,172,101,199,184,300,1320,2257,6,15668,870,0,2,2,2,0
30476,45,1961,386,256,301,16,9,68,402,4,59,35,69,63,104,355,621,2,1453,80,0,2,13,4,0
30477,84,3328,1043,504,840,53,9,147,1096,9,180,112,198,189,310,1377,2344,4,11604,644,0,2,5,12,0
30478,30,1267,373,158,315,8,0,51,381,5,76,44,79,81,123,486,779,2,2026,112,0,2,2,6,0
30479,100,5228,1943,715,1694,26,18,214,1969,12,185,120,237,197,357,1436,2721,7,20915,1161,0,2,2,1,0
30480,73,1510,207,111,150,11,0,50,218,5,26,19,36,31,55,133,272,3,943,52,0,2,0,1,1
30481,73,1510,410,198,237,31,55,97,441,11,63,38,72,74,110,414,683,6,4293,238,0,2,0,1,1
30482,258,6040,4293,999,3693,19,54,507,4312,9,155,88,170,164,258,1156,1898,4,9368,520,0,2,0,6,1
30483,258,6040,1482,859,1002,125,135,219,1607,16,219,134,251,235,385,1766,3032,9,27804,1544,1,2,0,6,1
30484,83,1769,53,23,39,0,0,13,53,2,8,4,8,10,12,26,39,1,39,2,0,2,0,35,1
30485,83,1769,515,298,307,33,80,99,548,12,63,44,77,75,121,419,753,7,5527,307,0,2,0,35,1
30486,18,304,424,94,331,4,0,89,428,1,5,5,5,6,10,11,25,0,12,0,0,2,0,12,1
30487,18,304,38,23,23,6,0,8,44,3,11,7,11,14,18,42,68,1,102,5,0,2,0,12,1
30488,300,6660,72,33,56,0,4,12,72,1,1,1,1,2,2,0,2,0,1,0,0,2,9,53,1
30489,300,6660,1454,835,1044,76,110,219,1530,17,275,158,296,292,454,2297,3718,9,34017,1889,1,2,9,53,1
30490,22,1058,75,38,59,1,3,12,76,2,4,2,4,6,6,10,15,1,15,0,0,2,0,71,1
30491,91,4033,1338,495,1086,10,64,173,1348,11,122,82,157,133,239,883,1686,7,11934,663,0,2,0,293,1
30492,179,8008,139,89,101,2,0,35,141,7,54,34,62,61,96,330,569,4,2287,127,0,2,0,18,1
30493,179,8008,7,5,5,0,0,2,7,1,2,1,2,3,3,2,4,0,2,0,0,2,0,18,1
30494,79,4485,1296,573,1062,40,33,157,1336,8,201,118,231,209,349,1561,2689,4,12365,686,0,2,0,14,1
30495,20,626,424,94,331,4,0,89,428,1,5,5,5,6,10,11,25,0,12,0,0,2,0,68,1
30496,65,2991,1293,570,1093,25,15,163,1318,10,195,123,241,205,364,1516,2795,6,17273,959,0,2,0,22,1
30497,12,478,295,56,236,0,4,54,295,2,9,5,10,11,15,30,51,1,57,3,0,2,0,59,1
30498,29,1210,373,158,315,8,0,51,381,5,76,44,79,81,123,486,779,2,2026,112,0,2,0,14,1
30499,102,5247,1943,715,1694,26,18,214,1969,12,185,120,237,197,357,1436,2721,7,20915,1161,0,2,17,7,1
30500,73,1510,207,111,150,11,0,50,218,5,26,19,36,31,55,133,272,3,943,52,0,2,0,1,0
30501,73,1510,410,198,237,31,55,97,441,11,63,38,72,74,110,414,683,6,4293,238,0,2,0,1,0
30502,258,6040,4293,999,3693,19,54,507,4312,9,155,88,170,164,258,1156,1898,4,9368,520,0,2,0,6,0
30503,258,6040,1482,859,1002,125,135,219,1607,16,219,134,251,235,385,1766,3032,9,27804,1544,1,2,0,6,0
30504,83,1769,53,23,39,0,0,13,53,2,8,4,8,10,12,26,39,1,39,2,0,2,0,35,0
30505,83,1769,515,298,307,33,80,99,548,12,63,44,77,75,121,419,753,7,5527,307,0,2,0,35,0
30506,18,304,424,94,331,4,0,89,428,1,5,5,5,6,10,11,25,0,12,0,0,2,0,12,0
30507,18,304,38,23,23,6,0,8,44,3,11,7,11,14,18,42,68,1,102,5,0,2,0,12,0
30508,300,6660,72,33,56,0,4,12,72,1,1,1,1,2,2,0,2,0,1,0,0,2,9,53,0
30509,300,6660,1454,835,1044,76,110,219,1530,17,275,158,296,292,454,2297,3718,9,34017,1889,1,2,9,53,0
30510,22,1058,75,38,59,1,3,12,76,2,4,2,4,6,6,10,15,1,15,0,0,2,0,71,0
30511,91,4033,1338,495,1086,10,64,173,1348,11,122,82,157,133,239,883,1686,7,11934,663,0,2,0,293,0
30512,179,8008,139,89,101,2,0,35,141,7,54,34,62,61,96,330,569,4,2287,127,0,2,0,18,0
30513,179,8008,7,5,5,0,0,2,7,1,2,1,2,3,3,2,4,0,2,0,0,2,0,18,0
30514,79,4485,1296,573,1062,40,33,157,1336,8,201,118,231,209,349,1561,2689,4,12365,686,0,2,0,14,0
30515,20,626,424,94,331,4,0,89,428,1,5,5,5,6,10,11,25,0,12,0,0,2,0,68,0
30516,65,2991,1293,570,1093,25,15,163,1318,10,195,123,241,205,364,1516,2795,6,17273,959,0,2,0,22,0
30517,12,478,295,56,236,0,4,54,295,2,9,5,10,11,15,30,51,1,57,3,0,2,0,59,0
30518,29,1210,373,158,315,8,0,51,381,5,76,44,79,81,123,486,779,2,2026,112,0,2,0,14,0
30519,102,5247,1943,715,1694,26,18,214,1969,12,185,120,237,197,357,1436,2721,7,20915,1161,0,2,17,7,0
30520,18,306,424,94,331,4,0,89,428,1,5,5,5,6,10,11,25,0,12,0,0,2,3,1,0
30521,18,306,38,23,23,6,0,8,44,3,11,7,11,14,18,42,68,1,102,5,0,2,3,1,0
30522,95,2070,1043,504,840,53,9,147,1096,9,180,112,198,189,310,1377,2344,4,11604,644,0,2,38,23,0
30523,95,2070,383,288,292,26,6,62,409,11,65,38,67,76,105,429,656,5,3719,206,0,2,38,23,0
30524,82,3278,1043,504,840,53,9,147,1096,9,180,112,198,189,310,1377,2344,4,11604,644,0,2,2,12,0
30525,18,306,424,94,331,4,0,89,428,1,5,5,5,6,10,11,25,0,12,0,0,2,3,1,0
30526,18,306,38,23,23,6,0,8,44,3,11,7,11,14,18,42,68,1,102,5,0,2,3,1,0
30527,95,2070,1043,504,840,53,9,147,1096,9,180,112,198,189,310,1377,2344,4,11604,644,0,2,38,23,0
30528,95,2070,383,288,292,26,6,62,409,11,65,38,67,76,105,429,656,5,3719,206,0,2,38,23,0
30529,82,3278,1043,504,840,53,9,147,1096,9,180,112,198,189,310,1377,2344,4,11604,644,0,2,2,12,0
30530,1,321,382,65,130,157,2,92,539,4,10,5,10,14,15,41,57,2,114,6,0,2,1,0,0
30531,60,1167,282,196,195,3,0,86,285,8,130,71,141,138,212,936,1507,4,6538,363,0,2,27,3,0
30532,1,90,13,10,10,0,0,3,13,1,2,1,2,3,3,2,4,0,2,0,0,2,1,1,0
30533,17,378,85,59,61,8,0,16,93,5,18,10,18,23,28,86,126,2,316,17,0,2,2,2,0
30534,231,4983,182,127,129,0,0,53,182,5,39,21,42,44,63,217,343,2,926,51,0,2,68,22,0
30535,231,4983,1165,710,800,67,119,181,1232,18,243,153,282,261,435,2000,3492,10,36473,2026,1,2,68,22,0
30536,180,5417,1660,832,1314,41,38,274,1701,20,312,209,395,332,604,2671,5058,12,64042,3557,1,2,1,0,0
30537,180,5417,1057,646,719,113,100,145,1170,18,215,134,248,233,382,1740,3004,10,31186,1732,1,2,1,0,0
30538,108,2059,477,336,357,30,23,73,507,16,194,134,250,210,384,1538,2962,10,30538,1696,0,2,42,1,0
30539,81,1825,996,429,845,24,10,117,1020,7,76,50,88,83,138,494,879,4,3565,198,0,2,12,3,0
30540,81,1825,456,277,329,12,42,72,468,13,85,50,97,98,147,592,972,7,7212,400,0,2,12,3,0
30541,73,1510,207,111,150,11,0,50,218,5,26,19,36,31,55,133,272,3,943,52,0,2,0,1,0
30542,73,1510,410,198,237,31,55,97,441,11,63,38,72,74,110,414,683,6,4293,238,0,2,0,1,0
30543,219,4747,2,2,2,0,0,0,2,0,0,0,0,0,0,0,0,0,0,0,0,2,3,3,0
30544,219,4747,99,48,90,1,3,5,100,0,0,0,0,0,0,0,0,0,0,0,0,2,3,3,0
30545,219,4747,8,5,5,2,0,1,10,0,0,0,0,0,0,0,0,0,0,0,0,2,3,3,0
30546,219,4747,1217,716,841,84,126,174,1301,14,185,118,215,199,333,1446,2542,8,20687,1149,0,2,3,3,0
30547,219,4747,160,89,115,0,13,31,160,7,15,11,17,22,28,78,124,3,495,27,0,2,3,3,0
30548,219,4747,10,10,9,9,0,0,19,0,0,0,0,0,0,0,0,0,0,0,0,2,3,3,0
30549,219,4747,173,84,99,8,29,36,181,5,12,7,13,17,20,54,81,2,221,12,0,2,3,3,0
30550,219,4747,3,1,1,3,0,0,6,0,0,0,0,0,0,0,0,0,0,0,0,2,3,3,0
30551,55,792,167,116,138,4,5,22,171,8,48,30,56,56,86,292,499,4,2330,129,0,2,4,1,0
30552,258,6040,4293,999,3693,19,54,507,4312,9,155,88,170,164,258,1156,1898,4,9368,520,0,2,0,6,0
30553,258,6040,1482,859,1002,125,135,219,1607,16,219,134,251,235,385,1766,3032,9,27804,1544,1,2,0,6,0
30554,150,3478,77,34,69,0,0,8,77,3,24,16,29,27,45,114,213,1,387,21,0,2,2,2,0
30555,150,3478,712,438,573,51,9,84,763,14,102,71,128,116,199,733,1364,8,11988,666,0,2,2,2,0
30556,53,1120,447,308,343,6,5,95,453,7,96,59,111,103,170,651,1136,4,4600,255,0,2,5,1,0
30557,53,1120,322,174,179,16,74,51,338,10,41,26,46,51,72,252,408,5,2291,127,0,2,5,1,0
30558,83,1769,53,23,39,0,0,13,53,2,8,4,8,10,12,26,39,1,39,2,0,2,1,36,0
30559,83,1769,515,298,307,33,80,99,548,12,63,44,77,75,121,419,753,7,5527,307,0,2,1,36,0
30560,18,306,424,94,331,4,0,89,428,1,5,5,5,6,10,11,25,0,12,0,0,2,3,13,0
30561,18,306,38,23,23,6,0,8,44,3,11,7,11,14,18,42,68,1,102,5,0,2,3,13,0
30562,300,6660,72,33,56,0,4,12,72,1,1,1,1,2,2,0,2,0,1,0,0,2,11,55,0
30563,300,6660,1454,835,1044,76,110,219,1530,17,275,158,296,292,454,2297,3718,9,34017,1889,1,2,11,55,0
30564,91,1864,757,253,292,73,244,162,830,13,61,38,67,74,105,409,651,7,4654,258,0,2,11,14,0
30565,45,935,386,256,301,16,9,68,402,4,59,35,69,63,104,355,621,2,1453,80,0,2,2,0,0
30566,45,935,264,131,164,11,41,46,275,6,38,22,40,44,62,214,338,3,1068,59,0,2,2,0,0
30567,30,662,215,129,180,6,0,29,221,8,65,43,72,73,115,415,711,4,3153,175,0,2,1,1,0
30568,30,662,97,69,77,3,3,16,100,6,22,13,23,28,36,113,173,3,542,30,0,2,1,1,0
30569,95,2070,1043,504,840,53,9,147,1096,9,180,112,198,189,310,1377,2344,4,11604,644,0,2,38,23,0
30570,95,2070,383,288,292,26,6,62,409,11,65,38,67,76,105,429,656,5,3719,206,0,2,38,23,0
30571,231,4976,1943,715,1694,26,18,214,1969,12,185,120,237,197,357,1436,2721,7,20915,1161,0,2,17,6,0
30572,231,4976,1168,838,957,57,25,144,1225,19,348,224,416,367,640,3018,5452,11,61921,3440,1,2,17,6,0
30573,19,709,442,244,305,14,16,103,456,11,68,45,75,79,120,452,756,6,4588,254,0,2,10,2,0
30574,19,709,182,102,99,11,40,35,193,3,11,6,11,14,17,42,64,1,97,5,0,2,10,2,0
30575,62,1263,1098,241,925,5,10,155,1103,7,46,25,49,53,74,273,423,3,1580,87,0,2,5,1,0
30576,62,1263,282,202,222,14,2,44,296,8,42,24,43,50,67,250,378,4,1548,86,0,2,5,1,0
30577,29,745,601,196,481,2,23,85,603,8,63,36,72,71,108,400,664,4,3036,168,0,2,3,2,0
30578,29,745,156,79,106,5,16,28,161,5,14,8,15,19,23,64,97,2,261,14,0,2,3,2,0
30579,99,4109,1289,550,1043,56,32,155,1345,10,167,93,185,177,278,1266,2075,5,11498,638,0,2,3,3,0
30580,35,1093,182,127,129,0,0,53,182,5,39,21,42,44,63,217,343,2,926,51,0,2,3,3,0
30581,153,7221,1392,870,1177,35,17,170,1427,14,494,280,531,508,811,4473,7289,7,54850,3047,2,2,21,13,0
30582,92,2899,773,419,590,28,0,166,801,10,204,113,217,214,330,1598,2554,5,13587,754,0,2,9,16,0
30583,22,1058,75,38,59,1,3,12,76,2,4,2,4,6,6,10,15,1,15,0,0,2,0,71,0
30584,1,55,14,12,10,0,0,4,14,1,2,1,2,3,3,2,4,0,2,0,0,0,14,0,0
30585,1,58,14,12,10,0,0,4,14,1,2,1,2,3,3,2,4,0,2,0,0,0,14,0,0
30586,1,55,14,12,10,0,0,4,14,1,2,1,2,3,3,2,4,0,2,0,0,0,14,0,0
30587,1,77,19,18,14,0,0,5,19,1,2,1,2,3,3,2,4,0,2,0,0,0,19,0,0
30588,1,24,127,75,83,2,11,30,129,4,14,7,14,18,21,61,87,2,175,9,0,2,1,1,0
30589,1,24,652,304,544,16,6,88,668,6,89,51,101,95,152,591,998,3,3399,188,0,2,1,1,0
30590,1,24,2,2,2,0,0,0,2,0,0,0,0,0,0,0,0,0,0,0,0,2,1,1,0
30591,1,24,8,5,5,0,0,3,8,0,0,0,0,0,0,0,0,0,0,0,0,2,1,1,0
30592,1,24,2,2,2,0,0,0,2,0,0,0,0,0,0,0,0,0,0,0,0,2,1,1,0
30593,1,24,14,8,8,0,0,6,14,0,0,0,0,0,0,0,0,0,0,0,0,2,1,1,0
30594,1,24,6,4,4,0,0,2,6,0,0,0,0,0,0,0,0,0,0,0,0,2,1,1,0
30595,1,24,6,4,4,0,0,2,6,1,2,1,2,3,3,2,4,0,2,0,0,2,1,1,0
30596,1,24,6,4,4,0,0,2,6,0,0,0,0,0,0,0,0,0,0,0,0,2,1,1,0
30597,1,24,7,5,5,0,0,2,7,0,0,0,0,0,0,0,0,0,0,0,0,2,1,1,0
30598,1,24,6,4,4,0,0,2,6,0,0,0,0,0,0,0,0,0,0,0,0,2,1,1,0
30599,1,24,10,6,6,0,0,4,10,0,0,0,0,0,0,0,0,0,0,0,0,2,1,1,0
30600,1,24,1,1,1,0,0,0,1,0,0,0,0,0,0,0,0,0,0,0,0,2,1,1,0
30601,1,24,1,1,1,0,0,0,1,0,0,0,0,0,0,0,0,0,0,0,0,2,1,1,0
30602,1,24,14,10,10,0,0,4,14,1,1,1,1,2,2,0,2,0,1,0,0,2,1,1,0
30603,1,24,46,26,30,3,0,12,49,3,6,3,6,9,9,20,28,1,42,2,0,2,1,1,0
30604,91,4033,1338,495,1086,10,64,173,1348,11,122,82,157,133,239,883,1686,7,11934,663,0,2,15,299,0
30605,179,8008,139,89,101,2,0,35,141,7,54,34,62,61,96,330,569,4,2287,127,0,2,16,40,0
30606,179,8008,7,5,5,0,0,2,7,1,2,1,2,3,3,2,4,0,2,0,0,2,16,40,0
30607,33,1004,465,148,393,5,8,60,470,4,31,20,31,35,51,161,261,2,523,29,0,2,1,1,0
30608,33,1004,16,12,9,0,0,6,16,1,2,1,2,3,3,2,4,0,2,0,0,2,1,1,0
30609,139,6352,1782,648,1425,9,47,279,1791,8,171,97,189,179,286,1292,2140,4,9462,525,0,2,7,7,0
30610,30,938,256,139,192,9,7,47,265,4,23,12,24,27,36,112,171,2,357,19,0,2,32,4,0
30611,120,4779,1450,624,1228,12,26,181,1462,14,306,186,354,320,540,2580,4493,8,36391,2021,1,2,110,0,0
30612,46,3395,996,429,845,24,10,117,1020,7,76,50,88,83,138,494,879,4,3565,198,0,2,26,2,0
30613,123,5266,1513,682,1277,25,13,200,1538,11,199,116,219,210,335,1557,2584,6,15641,868,0,2,31,31,0
30614,79,4485,1296,573,1062,40,33,157,1336,8,201,118,231,209,349,1561,2689,4,12365,686,0,2,20,34,0
30615,92,4741,1457,730,1242,11,6,188,1468,10,292,166,329,302,495,2424,4078,5,22973,1276,1,2,4,3,0
30616,96,4695,1523,757,1297,19,12,193,1542,12,193,117,230,205,347,1508,2664,7,19053,1058,0,2,2,2,0
30617,100,4333,1020,354,843,12,15,144,1032,8,134,77,144,142,221,970,1580,4,6792,377,0,2,1,1,0
30618,42,1932,447,308,343,6,5,95,453,7,96,59,111,103,170,651,1136,4,4600,255,0,2,4,4,0
30619,20,626,424,94,331,4,0,89,428,1,5,5,5,6,10,11,25,0,12,0,0,2,6,74,0
30620,38,2315,334,251,279,10,4,40,344,5,127,74,143,132,217,899,1528,2,4303,239,0,2,1,5,0
30621,65,2991,1293,570,1093,25,15,163,1318,10,195,123,241,205,364,1516,2795,6,17273,959,0,2,0,22,0
30622,31,1885,384,251,317,7,8,52,391,11,70,44,84,81,128,467,811,6,5355,297,0,2,5,5,0
30623,47,2254,722,423,573,19,0,135,741,12,172,101,199,184,300,1320,2257,6,15668,870,0,2,2,2,0
30624,45,1961,386,256,301,16,9,68,402,4,59,35,69,63,104,355,621,2,1453,80,0,2,13,4,0
30625,16,1247,215,129,180,6,0,29,221,8,65,43,72,73,115,415,711,4,3153,175,0,2,1,1,0
30626,82,3278,1043,504,840,53,9,147,1096,9,180,112,198,189,310,1377,2344,4,11604,644,0,2,15,36,0
30627,12,478,295,56,236,0,4,54,295,2,9,5,10,11,15,30,51,1,57,3,0,2,0,59,0
30628,29,1210,373,158,315,8,0,51,381,5,76,44,79,81,123,486,779,2,2026,112,0,2,2,20,0
30629,102,5247,1943,715,1694,26,18,214,1969,12,185,120,237,197,357,1436,2721,7,20915,1161,0,2,78,25,0
30630,35,1441,442,244,305,14,16,103,456,11,68,45,75,79,120,452,756,6,4588,254,0,2,30,3,0
30631,51,1917,1098,241,925,5,10,155,1103,7,46,25,49,53,74,273,423,3,1580,87,0,2,6,6,0
30632,45,1575,601,196,481,2,23,85,603,8,63,36,72,71,108,400,664,4,3036,168,0,2,1,1,0
30633,22,1058,75,38,59,1,3,12,76,2,4,2,4,6,6,10,15,1,15,0,0,2,2,2,0
30634,253,5893,4293,999,3693,19,54,507,4312,9,155,88,170,164,258,1156,1898,4,9368,520,0,2,0,37,0
30635,253,5893,1482,859,1002,125,135,219,1607,16,219,134,251,235,385,1766,3032,9,27804,1544,1,2,0,37,0
30636,21,1025,75,38,59,1,3,12,76,2,4,2,4,6,6,10,15,1,15,0,0,2,0,21,0
30637,168,7511,139,89,101,2,0,35,141,7,54,34,62,61,96,330,569,4,2287,127,0,2,2,186,0
30638,168,7511,7,5,5,0,0,2,7,1,2,1,2,3,3,2,4,0,2,0,0,2,2,186,0
30639,253,5889,4293,999,3693,19,54,507,4312,9,155,88,170,164,258,1156,1898,4,9368,520,0,2,1,2,0
30640,253,5889,1482,859,1002,125,135,219,1607,16,219,134,251,235,385,1766,3032,9,27804,1544,1,2,1,2,0
30641,292,6512,72,33,56,0,4,12,72,1,1,1,1,2,2,0,2,0,1,0,0,2,0,42,0
30642,292,6512,1454,835,1044,76,110,219,1530,17,275,158,296,292,454,2297,3718,9,34017,1889,1,2,0,42,0
30643,99,4109,1289,550,1043,56,32,155,1345,10,167,93,185,177,278,1266,2075,5,11498,638,0,2,2,3,0
30644,20,985,75,38,59,1,3,12,76,2,4,2,4,6,6,10,15,1,15,0,0,2,0,17,0
30645,125,5615,1782,648,1425,9,47,279,1791,8,171,97,189,179,286,1292,2140,4,9462,525,0,2,7,157,0
30646,22,1058,75,38,59,1,3,12,76,2,4,2,4,6,6,10,15,1,15,0,0,2,2,2,0
30647,253,5889,4293,999,3693,19,54,507,4312,9,155,88,170,164,258,1156,1898,4,9368,520,0,2,1,39,0
30648,253,5889,1482,859,1002,125,135,219,1607,16,219,134,251,235,385,1766,3032,9,27804,1544,1,2,1,39,0
30649,292,6512,72,33,56,0,4,12,72,1,1,1,1,2,2,0,2,0,1,0,0,2,0,42,0
30650,292,6512,1454,835,1044,76,110,219,1530,17,275,158,296,292,454,2297,3718,9,34017,1889,1,2,0,42,0
30651,99,4109,1289,550,1043,56,32,155,1345,10,167,93,185,177,278,1266,2075,5,11498,638,0,2,2,3,0
30652,20,985,75,38,59,1,3,12,76,2,4,2,4,6,6,10,15,1,15,0,0,2,0,38,0
30653,168,7511,139,89,101,2,0,35,141,7,54,34,62,61,96,330,569,4,2287,127,0,2,2,186,0
30654,168,7511,7,5,5,0,0,2,7,1,2,1,2,3,3,2,4,0,2,0,0,2,2,186,0
30655,125,5615,1782,648,1425,9,47,279,1791,8,171,97,189,179,286,1292,2140,4,9462,525,0,2,7,157,0
30656,156,3283,1513,682,1277,25,13,200,1538,11,199,116,219,210,335,1557,2584,6,15641,868,0,2,4,1,0
30657,156,3283,819,519,539,24,98,155,843,15,96,57,106,111,163,690,1107,8,9171,509,0,2,4,1,0
30658,156,3283,1513,682,1277,25,13,200,1538,11,199,116,219,210,335,1557,2584,6,15641,868,0,2,4,1,0
30659,156,3283,819,519,539,24,98,155,843,15,96,57,106,111,163,690,1107,8,9171,509,0,2,4,1,0
30660,123,5258,1513,682,1277,25,13,200,1538,11,199,116,219,210,335,1557,2584,6,15641,868,0,2,11,11,0
30661,124,5321,1513,682,1277,25,13,200,1538,11,199,116,219,210,335,1557,2584,6,15641,868,0,2,29,0,0
30662,124,5323,1513,682,1277,25,13,200,1538,11,199,116,219,210,335,1557,2584,6,15641,868,0,2,7,2,0
30663,154,3591,77,34,69,0,0,8,77,3,24,16,29,27,45,114,213,1,387,21,0,2,19,1,0
30664,154,3591,712,438,573,51,9,84,763,14,102,71,128,116,199,733,1364,8,11988,666,0,2,19,1,0
30665,102,5249,1943,715,1694,26,18,214,1969,12,185,120,237,197,357,1436,2721,7,20915,1161,0,2,2,2,0
30666,124,5323,1513,682,1277,25,13,200,1538,11,199,116,219,210,335,1557,2584,6,15641,868,0,2,45,11,0
30667,154,3591,77,34,69,0,0,8,77,3,24,16,29,27,45,114,213,1,387,21,0,2,19,1,0
30668,154,3591,712,438,573,51,9,84,763,14,102,71,128,116,199,733,1364,8,11988,666,0,2,19,1,0
30669,102,5249,1943,715,1694,26,18,214,1969,12,185,120,237,197,357,1436,2721,7,20915,1161,0,2,2,2,0
30670,82,1853,996,429,845,24,10,117,1020,7,76,50,88,83,138,494,879,4,3565,198,0,2,11,0,0
30671,82,1853,456,277,329,12,42,72,468,13,85,50,97,98,147,592,972,7,7212,400,0,2,11,0,0
30672,47,3455,996,429,845,24,10,117,1020,7,76,50,88,83,138,494,879,4,3565,198,0,2,12,0,0
30673,49,1683,601,196,481,2,23,85,603,8,63,36,72,71,108,400,664,4,3036,168,0,2,35,0,0
30674,51,1739,601,196,481,2,23,85,603,8,63,36,72,71,108,400,664,4,3036,168,0,2,29,6,0
30675,183,5668,1660,832,1314,41,38,274,1701,20,312,209,395,332,604,2671,5058,12,64042,3557,1,2,58,0,0
30676,183,5668,1057,646,719,113,100,145,1170,18,215,134,248,233,382,1740,3004,10,31186,1732,1,2,58,0,0
30677,51,1754,601,196,481,2,23,85,603,8,63,36,72,71,108,400,664,4,3036,168,0,2,11,12,1
30678,183,5584,1660,832,1314,41,38,274,1701,20,312,209,395,332,604,2671,5058,12,64042,3557,1,2,17,23,1
30679,183,5584,1057,646,719,113,100,145,1170,18,215,134,248,233,382,1740,3004,10,31186,1732,1,2,17,23,1
30680,183,5584,1660,832,1314,41,38,274,1701,20,312,209,395,332,604,2671,5058,12,64042,3557,1,2,1,1,0
30681,183,5584,1057,646,719,113,100,145,1170,18,215,134,248,233,382,1740,3004,10,31186,1732,1,2,1,1,0
30682,51,1740,601,196,481,2,23,85,603,8,63,36,72,71,108,400,664,4,3036,168,0,2,4,4,0
30683,183,5583,1660,832,1314,41,38,274,1701,20,312,209,395,332,604,2671,5058,12,64042,3557,1,2,2,3,0
30684,183,5583,1057,646,719,113,100,145,1170,18,215,134,248,233,382,1740,3004,10,31186,1732,1,2,2,3,0
30685,183,5583,1660,832,1314,41,38,274,1701,20,312,209,395,332,604,2671,5058,12,64042,3557,1,2,4,10,1
30686,183,5583,1057,646,719,113,100,145,1170,18,215,134,248,233,382,1740,3004,10,31186,1732,1,2,4,10,1
30687,184,5591,1660,832,1314,41,38,274,1701,20,312,209,395,332,604,2671,5058,12,64042,3557,1,2,6,5,0
30688,184,5591,1057,646,719,113,100,145,1170,18,215,134,248,233,382,1740,3004,10,31186,1732,1,2,6,5,0
30689,184,5591,1660,832,1314,41,38,274,1701,20,312,209,395,332,604,2671,5058,12,64042,3557,1,2,6,5,0
30690,184,5591,1057,646,719,113,100,145,1170,18,215,134,248,233,382,1740,3004,10,31186,1732,1,2,6,5,0
30691,51,1747,601,196,481,2,23,85,603,8,63,36,72,71,108,400,664,4,3036,168,0,2,8,5,0
30692,184,5591,1660,832,1314,41,38,274,1701,20,312,209,395,332,604,2671,5058,12,64042,3557,1,2,47,0,0
30693,184,5591,1057,646,719,113,100,145,1170,18,215,134,248,233,382,1740,3004,10,31186,1732,1,2,47,0,0
30694,51,1747,601,196,481,2,23,85,603,8,63,36,72,71,108,400,664,4,3036,168,0,2,60,0,0
30695,110,4163,1450,624,1228,12,26,181,1462,14,306,186,354,320,540,2580,4493,8,36391,2021,1,2,2,1,0
30696,92,4758,1457,730,1242,11,6,188,1468,10,292,166,329,302,495,2424,4078,5,22973,1276,1,2,3,0,0
30697,96,4707,1523,757,1297,19,12,193,1542,12,193,117,230,205,347,1508,2664,7,19053,1058,0,2,2,1,0
30698,100,5271,1943,715,1694,26,18,214,1969,12,185,120,237,197,357,1436,2721,7,20915,1161,0,2,8,4,0
30699,222,4823,2,2,2,0,0,0,2,0,0,0,0,0,0,0,0,0,0,0,0,2,11,2,0
30700,222,4823,99,48,90,1,3,5,100,0,0,0,0,0,0,0,0,0,0,0,0,2,11,2,0
30701,222,4823,8,5,5,2,0,1,10,0,0,0,0,0,0,0,0,0,0,0,0,2,11,2,0
30702,222,4823,1217,716,841,84,126,174,1301,14,185,118,215,199,333,1446,2542,8,20687,1149,0,2,11,2,0
30703,222,4823,160,89,115,0,13,31,160,7,15,11,17,22,28,78,124,3,495,27,0,2,11,2,0
30704,222,4823,10,10,9,9,0,0,19,0,0,0,0,0,0,0,0,0,0,0,0,2,11,2,0
30705,222,4823,173,84,99,8,29,36,181,5,12,7,13,17,20,54,81,2,221,12,0,2,11,2,0
30706,222,4823,3,1,1,3,0,0,6,0,0,0,0,0,0,0,0,0,0,0,0,2,11,2,0
30707,94,4851,1457,730,1242,11,6,188,1468,10,292,166,329,302,495,2424,4078,5,22973,1276,1,2,27,0,0
30708,222,4823,2,2,2,0,0,0,2,0,0,0,0,0,0,0,0,0,0,0,0,2,11,2,0
30709,222,4823,99,48,90,1,3,5,100,0,0,0,0,0,0,0,0,0,0,0,0,2,11,2,0
30710,222,4823,8,5,5,2,0,1,10,0,0,0,0,0,0,0,0,0,0,0,0,2,11,2,0
30711,222,4823,1217,716,841,84,126,174,1301,14,185,118,215,199,333,1446,2542,8,20687,1149,0,2,11,2,0
30712,222,4823,160,89,115,0,13,31,160,7,15,11,17,22,28,78,124,3,495,27,0,2,11,2,0
30713,222,4823,10,10,9,9,0,0,19,0,0,0,0,0,0,0,0,0,0,0,0,2,11,2,0
30714,222,4823,173,84,99,8,29,36,181,5,12,7,13,17,20,54,81,2,221,12,0,2,11,2,0
30715,222,4823,3,1,1,3,0,0,6,0,0,0,0,0,0,0,0,0,0,0,0,2,11,2,0
30716,94,4851,1457,730,1242,11,6,188,1468,10,292,166,329,302,495,2424,4078,5,22973,1276,1,2,27,0,0
30717,156,3271,1513,682,1277,25,13,200,1538,11,199,116,219,210,335,1557,2584,6,15641,868,0,2,4,1,0
30718,156,3271,819,519,539,24,98,155,843,15,96,57,106,111,163,690,1107,8,9171,509,0,2,4,1,0
30719,221,4796,2,2,2,0,0,0,2,0,0,0,0,0,0,0,0,0,0,0,0,2,11,2,0
30720,221,4796,99,48,90,1,3,5,100,0,0,0,0,0,0,0,0,0,0,0,0,2,11,2,0
30721,221,4796,8,5,5,2,0,1,10,0,0,0,0,0,0,0,0,0,0,0,0,2,11,2,0
30722,221,4796,1217,716,841,84,126,174,1301,14,185,118,215,199,333,1446,2542,8,20687,1149,0,2,11,2,0
30723,221,4796,160,89,115,0,13,31,160,7,15,11,17,22,28,78,124,3,495,27,0,2,11,2,0
30724,221,4796,10,10,9,9,0,0,19,0,0,0,0,0,0,0,0,0,0,0,0,2,11,2,0
30725,221,4796,173,84,99,8,29,36,181,5,12,7,13,17,20,54,81,2,221,12,0,2,11,2,0
30726,221,4796,3,1,1,3,0,0,6,0,0,0,0,0,0,0,0,0,0,0,0,2,11,2,0
30727,124,5331,1513,682,1277,25,13,200,1538,11,199,116,219,210,335,1557,2584,6,15641,868,0,2,45,11,0
30728,94,4864,1457,730,1242,11,6,188,1468,10,292,166,329,302,495,2424,4078,5,22973,1276,1,2,27,0,0
30729,30,880,256,139,192,9,7,47,265,4,23,12,24,27,36,112,171,2,357,19,0,2,2,1,0
30730,30,940,256,139,192,9,7,47,265,4,23,12,24,27,36,112,171,2,357,19,0,2,2,1,0
30731,156,3271,1513,682,1277,25,13,200,1538,11,199,116,219,210,335,1557,2584,6,15641,868,0,2,4,1,0
30732,156,3271,819,519,539,24,98,155,843,15,96,57,106,111,163,690,1107,8,9171,509,0,2,4,1,0
30733,221,4796,2,2,2,0,0,0,2,0,0,0,0,0,0,0,0,0,0,0,0,2,11,2,0
30734,221,4796,99,48,90,1,3,5,100,0,0,0,0,0,0,0,0,0,0,0,0,2,11,2,0
30735,221,4796,8,5,5,2,0,1,10,0,0,0,0,0,0,0,0,0,0,0,0,2,11,2,0
30736,221,4796,1217,716,841,84,126,174,1301,14,185,118,215,199,333,1446,2542,8,20687,1149,0,2,11,2,0
30737,221,4796,160,89,115,0,13,31,160,7,15,11,17,22,28,78,124,3,495,27,0,2,11,2,0
30738,221,4796,10,10,9,9,0,0,19,0,0,0,0,0,0,0,0,0,0,0,0,2,11,2,0
30739,221,4796,173,84,99,8,29,36,181,5,12,7,13,17,20,54,81,2,221,12,0,2,11,2,0
30740,221,4796,3,1,1,3,0,0,6,0,0,0,0,0,0,0,0,0,0,0,0,2,11,2,0
30741,30,940,256,139,192,9,7,47,265,4,23,12,24,27,36,112,171,2,357,19,0,2,2,1,0
30742,124,5331,1513,682,1277,25,13,200,1538,11,199,116,219,210,335,1557,2584,6,15641,868,0,2,45,11,0
30743,94,4864,1457,730,1242,11,6,188,1468,10,292,166,329,302,495,2424,4078,5,22973,1276,1,2,27,0,0
30744,30,880,256,139,192,9,7,47,265,4,23,12,24,27,36,112,171,2,357,19,0,2,2,1,0
30745,154,3597,77,34,69,0,0,8,77,3,24,16,29,27,45,114,213,1,387,21,0,2,1,1,1
30746,154,3597,712,438,573,51,9,84,763,14,102,71,128,116,199,733,1364,8,11988,666,0,2,1,1,1
30747,20,526,205,80,86,16,53,53,221,7,18,10,19,25,29,94,134,3,497,27,0,2,3,3,1
30748,95,2085,1043,504,840,53,9,147,1096,9,180,112,198,189,310,1377,2344,4,11604,644,0,2,5,3,1
30749,95,2085,383,288,292,26,6,62,409,11,65,38,67,76,105,429,656,5,3719,206,0,2,5,3,1
30750,82,3282,1043,504,840,53,9,147,1096,9,180,112,198,189,310,1377,2344,4,11604,644,0,2,1,1,1
30751,223,4836,2,2,2,0,0,0,2,0,0,0,0,0,0,0,0,0,0,0,0,2,15,4,1
30752,223,4836,99,48,90,1,3,5,100,0,0,0,0,0,0,0,0,0,0,0,0,2,15,4,1
30753,223,4836,8,5,5,2,0,1,10,0,0,0,0,0,0,0,0,0,0,0,0,2,15,4,1
30754,223,4836,1217,716,841,84,126,174,1301,14,185,118,215,199,333,1446,2542,8,20687,1149,0,2,15,4,1
30755,223,4836,160,89,115,0,13,31,160,7,15,11,17,22,28,78,124,3,495,27,0,2,15,4,1
30756,223,4836,10,10,9,9,0,0,19,0,0,0,0,0,0,0,0,0,0,0,0,2,15,4,1
30757,223,4836,173,84,99,8,29,36,181,5,12,7,13,17,20,54,81,2,221,12,0,2,15,4,1
30758,223,4836,3,1,1,3,0,0,6,0,0,0,0,0,0,0,0,0,0,0,0,2,15,4,1
30759,31,1922,384,251,317,7,8,52,391,11,70,44,84,81,128,467,811,6,5355,297,0,2,6,0,1
30760,82,1853,996,429,845,24,10,117,1020,7,76,50,88,83,138,494,879,4,3565,198,0,2,11,0,0
30761,82,1853,456,277,329,12,42,72,468,13,85,50,97,98,147,592,972,7,7212,400,0,2,11,0,0
30762,47,3455,996,429,845,24,10,117,1020,7,76,50,88,83,138,494,879,4,3565,198,0,2,12,0,0
30763,41,1220,339,213,244,17,9,65,356,10,42,26,48,52,74,259,421,5,2410,133,0,2,18,10,0
30764,66,3082,1293,570,1093,25,15,163,1318,10,195,123,241,205,364,1516,2795,6,17273,959,0,2,30,1,0
30765,97,2016,463,295,324,28,62,57,491,12,134,82,154,146,236,989,1696,6,11700,650,0,2,5,2,0
30766,39,2361,334,251,279,10,4,40,344,5,127,74,143,132,217,899,1528,2,4303,239,0,2,6,0,0
30767,223,4836,2,2,2,0,0,0,2,0,0,0,0,0,0,0,0,0,0,0,0,2,15,4,0
30768,223,4836,99,48,90,1,3,5,100,0,0,0,0,0,0,0,0,0,0,0,0,2,15,4,0
30769,223,4836,8,5,5,2,0,1,10,0,0,0,0,0,0,0,0,0,0,0,0,2,15,4,0
30770,223,4836,1217,716,841,84,126,174,1301,14,185,118,215,199,333,1446,2542,8,20687,1149,0,2,15,4,0
30771,223,4836,160,89,115,0,13,31,160,7,15,11,17,22,28,78,124,3,495,27,0,2,15,4,0
30772,223,4836,10,10,9,9,0,0,19,0,0,0,0,0,0,0,0,0,0,0,0,2,15,4,0
30773,223,4836,173,84,99,8,29,36,181,5,12,7,13,17,20,54,81,2,221,12,0,2,15,4,0
30774,223,4836,3,1,1,3,0,0,6,0,0,0,0,0,0,0,0,0,0,0,0,2,15,4,0
30775,31,1922,384,251,317,7,8,52,391,11,70,44,84,81,128,467,811,6,5355,297,0,2,6,0,0
30776,97,2016,463,295,324,28,62,57,491,12,134,82,154,146,236,989,1696,6,11700,650,0,2,5,2,0
30777,39,2361,334,251,279,10,4,40,344,5,127,74,143,132,217,899,1528,2,4303,239,0,2,6,0,0
30778,101,2731,1523,757,1297,19,12,193,1542,12,193,117,230,205,347,1508,2664,7,19053,1058,0,2,17,3,0
30779,101,2731,701,378,504,33,58,109,734,13,110,68,126,123,194,794,1346,7,10027,557,0,2,17,3,0
30780,97,4762,1523,757,1297,19,12,193,1542,12,193,117,230,205,347,1508,2664,7,19053,1058,0,2,19,0,0
30781,101,2732,1523,757,1297,19,12,193,1542,12,193,117,230,205,347,1508,2664,7,19053,1058,0,2,8,4,0
30782,101,2732,701,378,504,33,58,109,734,13,110,68,126,123,194,794,1346,7,10027,557,0,2,8,4,0
30783,231,4976,1943,715,1694,26,18,214,1969,12,185,120,237,197,357,1436,2721,7,20915,1161,0,2,1,1,0
30784,231,4976,1168,838,957,57,25,144,1225,19,348,224,416,367,640,3018,5452,11,61921,3440,1,2,1,1,0
30785,77,3228,1178,367,1042,6,15,115,1184,9,94,51,95,103,146,644,976,4,4439,246,0,2,12,1,0
30786,97,4762,1523,757,1297,19,12,193,1542,12,193,117,230,205,347,1508,2664,7,19053,1058,0,2,1,1,0
30787,100,2714,1523,757,1297,19,12,193,1542,12,193,117,230,205,347,1508,2664,7,19053,1058,0,2,11,16,0
30788,100,2714,701,378,504,33,58,109,734,13,110,68,126,123,194,794,1346,7,10027,557,0,2,11,16,0
30789,97,4761,1523,757,1297,19,12,193,1542,12,193,117,230,205,347,1508,2664,7,19053,1058,0,2,1,2,0
30790,97,4761,1523,757,1297,19,12,193,1542,12,193,117,230,205,347,1508,2664,7,19053,1058,0,2,4,4,0
30791,291,6482,72,33,56,0,4,12,72,1,1,1,1,2,2,0,2,0,1,0,0,2,0,4,0
30792,291,6482,1454,835,1044,76,110,219,1530,17,275,158,296,292,454,2297,3718,9,34017,1889,1,2,0,4,0
30793,17,910,75,38,59,1,3,12,76,2,4,2,4,6,6,10,15,1,15,0,0,2,0,20,0
30794,91,4033,1338,495,1086,10,64,173,1348,11,122,82,157,133,239,883,1686,7,11934,663,0,2,1,1,0
30795,110,4163,1450,624,1228,12,26,181,1462,14,306,186,354,320,540,2580,4493,8,36391,2021,1,2,2,1,0
30796,94,4881,1457,730,1242,11,6,188,1468,10,292,166,329,302,495,2424,4078,5,22973,1276,1,2,3,0,0
30797,96,4707,1523,757,1297,19,12,193,1542,12,193,117,230,205,347,1508,2664,7,19053,1058,0,2,2,1,0
30798,100,5271,1943,715,1694,26,18,214,1969,12,185,120,237,197,357,1436,2721,7,20915,1161,0,2,8,4,0
30799,54,1145,447,308,343,6,5,95,453,7,96,59,111,103,170,651,1136,4,4600,255,0,2,7,1,0
30800,54,1145,322,174,179,16,74,51,338,10,41,26,46,51,72,252,408,5,2291,127,0,2,7,1,0
30801,45,2011,447,308,343,6,5,95,453,7,96,59,111,103,170,651,1136,4,4600,255,0,2,27,0,0
30802,291,6482,72,33,56,0,4,12,72,1,1,1,1,2,2,0,2,0,1,0,0,2,0,4,0
30803,291,6482,1454,835,1044,76,110,219,1530,17,275,158,296,292,454,2297,3718,9,34017,1889,1,2,0,4,0
30804,17,910,75,38,59,1,3,12,76,2,4,2,4,6,6,10,15,1,15,0,0,2,0,20,0
30805,91,4033,1338,495,1086,10,64,173,1348,11,122,82,157,133,239,883,1686,7,11934,663,0,2,1,1,0
30806,54,1145,447,308,343,6,5,95,453,7,96,59,111,103,170,651,1136,4,4600,255,0,2,1,1,0
30807,54,1145,322,174,179,16,74,51,338,10,41,26,46,51,72,252,408,5,2291,127,0,2,1,1,0
30808,91,1842,757,253,292,73,244,162,830,13,61,38,67,74,105,409,651,7,4654,258,0,2,1,1,0
30809,31,911,256,139,192,9,7,47,265,4,23,12,24,27,36,112,171,2,357,19,0,2,5,0,0
30810,91,1876,757,253,292,73,244,162,830,13,61,38,67,74,105,409,651,7,4654,258,0,2,39,34,0
30811,18,939,75,38,59,1,3,12,76,2,4,2,4,6,6,10,15,1,15,0,0,2,6,0,0
30812,30,948,256,139,192,9,7,47,265,4,23,12,24,27,36,112,171,2,357,19,0,2,3,2,0
30813,47,2254,722,423,573,19,0,135,741,12,172,101,199,184,300,1320,2257,6,15668,870,0,2,1,1,0
30814,91,1876,757,253,292,73,244,162,830,13,61,38,67,74,105,409,651,7,4654,258,0,2,39,34,0
30815,18,939,75,38,59,1,3,12,76,2,4,2,4,6,6,10,15,1,15,0,0,2,6,0,0
30816,30,948,256,139,192,9,7,47,265,4,23,12,24,27,36,112,171,2,357,19,0,2,3,2,0
30817,47,2254,722,423,573,19,0,135,741,12,172,101,199,184,300,1320,2257,6,15668,870,0,2,1,1,0
30818,91,1842,757,253,292,73,244,162,830,13,61,38,67,74,105,409,651,7,4654,258,0,2,1,1,0
30819,31,911,256,139,192,9,7,47,265,4,23,12,24,27,36,112,171,2,357,19,0,2,5,0,0
30820,231,4976,1943,715,1694,26,18,214,1969,12,185,120,237,197,357,1436,2721,7,20915,1161,0,2,1,1,0
30821,231,4976,1168,838,957,57,25,144,1225,19,348,224,416,367,640,3018,5452,11,61921,3440,1,2,1,1,0
30822,77,3228,1178,367,1042,6,15,115,1184,9,94,51,95,103,146,644,976,4,4439,246,0,2,12,1,0
30823,154,3597,77,34,69,0,0,8,77,3,24,16,29,27,45,114,213,1,387,21,0,2,1,1,0
30824,154,3597,712,438,573,51,9,84,763,14,102,71,128,116,199,733,1364,8,11988,666,0,2,1,1,0
30825,20,526,205,80,86,16,53,53,221,7,18,10,19,25,29,94,134,3,497,27,0,2,3,3,0
30826,95,2085,1043,504,840,53,9,147,1096,9,180,112,198,189,310,1377,2344,4,11604,644,0,2,5,3,0
30827,95,2085,383,288,292,26,6,62,409,11,65,38,67,76,105,429,656,5,3719,206,0,2,5,3,0
30828,82,3282,1043,504,840,53,9,147,1096,9,180,112,198,189,310,1377,2344,4,11604,644,0,2,1,1,0
30829,100,2714,1523,757,1297,19,12,193,1542,12,193,117,230,205,347,1508,2664,7,19053,1058,0,2,16,3,0
30830,100,2714,701,378,504,33,58,109,734,13,110,68,126,123,194,794,1346,7,10027,557,0,2,16,3,0
30831,97,4761,1523,757,1297,19,12,193,1542,12,193,117,230,205,347,1508,2664,7,19053,1058,0,2,18,0,0
30832,222,4829,2,2,2,0,0,0,2,0,0,0,0,0,0,0,0,0,0,0,0,2,2,2,0
30833,222,4829,99,48,90,1,3,5,100,0,0,0,0,0,0,0,0,0,0,0,0,2,2,2,0
30834,222,4829,8,5,5,2,0,1,10,0,0,0,0,0,0,0,0,0,0,0,0,2,2,2,0
30835,222,4829,1217,716,841,84,126,174,1301,14,185,118,215,199,333,1446,2542,8,20687,1149,0,2,2,2,0
30836,222,4829,160,89,115,0,13,31,160,7,15,11,17,22,28,78,124,3,495,27,0,2,2,2,0
30837,222,4829,10,10,9,9,0,0,19,0,0,0,0,0,0,0,0,0,0,0,0,2,2,2,0
30838,222,4829,173,84,99,8,29,36,181,5,12,7,13,17,20,54,81,2,221,12,0,2,2,2,0
30839,222,4829,3,1,1,3,0,0,6,0,0,0,0,0,0,0,0,0,0,0,0,2,2,2,0
30840,250,5779,4293,999,3693,19,54,507,4312,9,155,88,170,164,258,1156,1898,4,9368,520,0,2,4,27,0
30841,250,5779,1482,859,1002,125,135,219,1607,16,219,134,251,235,385,1766,3032,9,27804,1544,1,2,4,27,0
30842,17,901,75,38,59,1,3,12,76,2,4,2,4,6,6,10,15,1,15,0,0,2,0,22,0
30843,167,7471,139,89,101,2,0,35,141,7,54,34,62,61,96,330,569,4,2287,127,0,2,0,19,0
30844,167,7471,7,5,5,0,0,2,7,1,2,1,2,3,3,2,4,0,2,0,0,2,0,19,0
30845,222,4829,2,2,2,0,0,0,2,0,0,0,0,0,0,0,0,0,0,0,0,2,2,2,0
30846,222,4829,99,48,90,1,3,5,100,0,0,0,0,0,0,0,0,0,0,0,0,2,2,2,0
30847,222,4829,8,5,5,2,0,1,10,0,0,0,0,0,0,0,0,0,0,0,0,2,2,2,0
30848,222,4829,1217,716,841,84,126,174,1301,14,185,118,215,199,333,1446,2542,8,20687,1149,0,2,2,2,0
30849,222,4829,160,89,115,0,13,31,160,7,15,11,17,22,28,78,124,3,495,27,0,2,2,2,0
30850,222,4829,10,10,9,9,0,0,19,0,0,0,0,0,0,0,0,0,0,0,0,2,2,2,0
30851,222,4829,173,84,99,8,29,36,181,5,12,7,13,17,20,54,81,2,221,12,0,2,2,2,0
30852,222,4829,3,1,1,3,0,0,6,0,0,0,0,0,0,0,0,0,0,0,0,2,2,2,0
30853,250,5779,4293,999,3693,19,54,507,4312,9,155,88,170,164,258,1156,1898,4,9368,520,0,2,4,27,0
30854,250,5779,1482,859,1002,125,135,219,1607,16,219,134,251,235,385,1766,3032,9,27804,1544,1,2,4,27,0
30855,17,901,75,38,59,1,3,12,76,2,4,2,4,6,6,10,15,1,15,0,0,2,0,22,0
30856,167,7471,139,89,101,2,0,35,141,7,54,34,62,61,96,330,569,4,2287,127,0,2,0,19,0
30857,167,7471,7,5,5,0,0,2,7,1,2,1,2,3,3,2,4,0,2,0,0,2,0,19,0
30858,184,5593,1660,832,1314,41,38,274,1701,20,312,209,395,332,604,2671,5058,12,64042,3557,1,2,3,3,1
30859,184,5593,1057,646,719,113,100,145,1170,18,215,134,248,233,382,1740,3004,10,31186,1732,1,2,3,3,1
30860,82,1855,996,429,845,24,10,117,1020,7,76,50,88,83,138,494,879,4,3565,198,0,2,3,3,1
30861,82,1855,456,277,329,12,42,72,468,13,85,50,97,98,147,592,972,7,7212,400,0,2,3,3,1
30862,217,4669,2,2,2,0,0,0,2,0,0,0,0,0,0,0,0,0,0,0,0,2,27,55,1
30863,217,4669,99,48,90,1,3,5,100,0,0,0,0,0,0,0,0,0,0,0,0,2,27,55,1
30864,217,4669,8,5,5,2,0,1,10,0,0,0,0,0,0,0,0,0,0,0,0,2,27,55,1
30865,217,4669,1217,716,841,84,126,174,1301,14,185,118,215,199,333,1446,2542,8,20687,1149,0,2,27,55,1
30866,217,4669,160,89,115,0,13,31,160,7,15,11,17,22,28,78,124,3,495,27,0,2,27,55,1
30867,217,4669,10,10,9,9,0,0,19,0,0,0,0,0,0,0,0,0,0,0,0,2,27,55,1
30868,217,4669,173,84,99,8,29,36,181,5,12,7,13,17,20,54,81,2,221,12,0,2,27,55,1
30869,217,4669,3,1,1,3,0,0,6,0,0,0,0,0,0,0,0,0,0,0,0,2,27,55,1
30870,55,796,167,116,138,4,5,22,171,8,48,30,56,56,86,292,499,4,2330,129,0,2,6,6,1
30871,52,621,647,139,84,35,284,233,682,0,0,0,0,0,0,0,0,0,0,0,0,2,3,1,1
30872,76,1637,53,23,39,0,0,13,53,2,8,4,8,10,12,26,39,1,39,2,0,2,5,66,1
30873,76,1637,515,298,307,33,80,99,548,12,63,44,77,75,121,419,753,7,5527,307,0,2,5,66,1
30874,30,664,215,129,180,6,0,29,221,8,65,43,72,73,115,415,711,4,3153,175,0,2,2,2,1
30875,30,664,97,69,77,3,3,16,100,6,22,13,23,28,36,113,173,3,542,30,0,2,2,2,1
30876,230,4915,1943,715,1694,26,18,214,1969,12,185,120,237,197,357,1436,2721,7,20915,1161,0,2,1,11,1
30877,230,4915,1168,838,957,57,25,144,1225,19,348,224,416,367,640,3018,5452,11,61921,3440,1,2,1,11,1
30878,29,743,601,196,481,2,23,85,603,8,63,36,72,71,108,400,664,4,3036,168,0,2,3,3,1
30879,29,743,156,79,106,5,16,28,161,5,14,8,15,19,23,64,97,2,261,14,0,2,3,3,1
30880,99,4118,1289,550,1043,56,32,155,1345,10,167,93,185,177,278,1266,2075,5,11498,638,0,2,1,0,1
30881,18,948,75,38,59,1,3,12,76,2,4,2,4,6,6,10,15,1,15,0,0,2,1,0,1
30882,167,5017,1660,832,1314,41,38,274,1701,20,312,209,395,332,604,2671,5058,12,64042,3557,1,2,3,1,1
30883,90,4699,1457,730,1242,11,6,188,1468,10,292,166,329,302,495,2424,4078,5,22973,1276,1,2,0,61,1
30884,28,1839,384,251,317,7,8,52,391,11,70,44,84,81,128,467,811,6,5355,297,0,2,4,20,1
30885,47,2254,722,423,573,19,0,135,741,12,172,101,199,184,300,1320,2257,6,15668,870,0,2,1,1,1
30886,51,1747,601,196,481,2,23,85,603,8,63,36,72,71,108,400,664,4,3036,168,0,2,2,2,1
30887,100,2715,1523,757,1297,19,12,193,1542,12,193,117,230,205,347,1508,2664,7,19053,1058,0,2,4,2,0
30888,100,2715,701,378,504,33,58,109,734,13,110,68,126,123,194,794,1346,7,10027,557,0,2,4,2,0
30889,97,4761,1523,757,1297,19,12,193,1542,12,193,117,230,205,347,1508,2664,7,19053,1058,0,2,2,2,0
30890,91,1879,757,253,292,73,244,162,830,13,61,38,67,74,105,409,651,7,4654,258,0,2,1,1,0
30891,31,979,256,139,192,9,7,47,265,4,23,12,24,27,36,112,171,2,357,19,0,2,5,0,0
30892,120,4791,1450,624,1228,12,26,181,1462,14,306,186,354,320,540,2580,4493,8,36391,2021,1,2,2,1,0
30893,94,4894,1457,730,1242,11,6,188,1468,10,292,166,329,302,495,2424,4078,5,22973,1276,1,2,3,0,0
30894,97,4773,1523,757,1297,19,12,193,1542,12,193,117,230,205,347,1508,2664,7,19053,1058,0,2,2,1,0
30895,102,5297,1943,715,1694,26,18,214,1969,12,185,120,237,197,357,1436,2721,7,20915,1161,0,2,8,4,0
30896,99,2685,1523,757,1297,19,12,193,1542,12,193,117,230,205,347,1508,2664,7,19053,1058,0,2,0,10,0
30897,99,2685,701,378,504,33,58,109,734,13,110,68,126,123,194,794,1346,7,10027,557,0,2,0,10,0
30898,221,4803,2,2,2,0,0,0,2,0,0,0,0,0,0,0,0,0,0,0,0,2,2,5,1
30899,221,4803,99,48,90,1,3,5,100,0,0,0,0,0,0,0,0,0,0,0,0,2,2,5,1
30900,221,4803,8,5,5,2,0,1,10,0,0,0,0,0,0,0,0,0,0,0,0,2,2,5,1
30901,221,4803,1217,716,841,84,126,174,1301,14,185,118,215,199,333,1446,2542,8,20687,1149,0,2,2,5,1
30902,221,4803,160,89,115,0,13,31,160,7,15,11,17,22,28,78,124,3,495,27,0,2,2,5,1
30903,221,4803,10,10,9,9,0,0,19,0,0,0,0,0,0,0,0,0,0,0,0,2,2,5,1
30904,221,4803,173,84,99,8,29,36,181,5,12,7,13,17,20,54,81,2,221,12,0,2,2,5,1
30905,221,4803,3,1,1,3,0,0,6,0,0,0,0,0,0,0,0,0,0,0,0,2,2,5,1
30906,99,4088,1289,550,1043,56,32,155,1345,10,167,93,185,177,278,1266,2075,5,11498,638,0,2,5,6,1
30907,15,827,75,38,59,1,3,12,76,2,4,2,4,6,6,10,15,1,15,0,0,2,0,19,1
30908,291,6479,72,33,56,0,4,12,72,1,1,1,1,2,2,0,2,0,1,0,0,2,4,7,0
30909,291,6479,1454,835,1044,76,110,219,1530,17,275,158,296,292,454,2297,3718,9,34017,1889,1,2,4,7,0
30910,125,5597,1782,648,1425,9,47,279,1791,8,171,97,189,179,286,1292,2140,4,9462,525,0,2,3,7,0
30911,91,1879,757,253,292,73,244,162,830,13,61,38,67,74,105,409,651,7,4654,258,0,2,1,1,0
30912,31,979,256,139,192,9,7,47,265,4,23,12,24,27,36,112,171,2,357,19,0,2,5,0,0
30913,120,4791,1450,624,1228,12,26,181,1462,14,306,186,354,320,540,2580,4493,8,36391,2021,1,2,2,1,0
30914,94,4894,1457,730,1242,11,6,188,1468,10,292,166,329,302,495,2424,4078,5,22973,1276,1,2,3,0,0
30915,97,4773,1523,757,1297,19,12,193,1542,12,193,117,230,205,347,1508,2664,7,19053,1058,0,2,2,1,0
30916,102,5297,1943,715,1694,26,18,214,1969,12,185,120,237,197,357,1436,2721,7,20915,1161,0,2,8,4,0
30917,100,2715,1523,757,1297,19,12,193,1542,12,193,117,230,205,347,1508,2664,7,19053,1058,0,2,4,2,0
30918,100,2715,701,378,504,33,58,109,734,13,110,68,126,123,194,794,1346,7,10027,557,0,2,4,2,0
30919,97,4773,1523,757,1297,19,12,193,1542,12,193,117,230,205,347,1508,2664,7,19053,1058,0,2,2,2,0
30920,221,4803,2,2,2,0,0,0,2,0,0,0,0,0,0,0,0,0,0,0,0,2,2,5,0
30921,221,4803,99,48,90,1,3,5,100,0,0,0,0,0,0,0,0,0,0,0,0,2,2,5,0
30922,221,4803,8,5,5,2,0,1,10,0,0,0,0,0,0,0,0,0,0,0,0,2,2,5,0
30923,221,4803,1217,716,841,84,126,174,1301,14,185,118,215,199,333,1446,2542,8,20687,1149,0,2,2,5,0
30924,221,4803,160,89,115,0,13,31,160,7,15,11,17,22,28,78,124,3,495,27,0,2,2,5,0
30925,221,4803,10,10,9,9,0,0,19,0,0,0,0,0,0,0,0,0,0,0,0,2,2,5,0
30926,221,4803,173,84,99,8,29,36,181,5,12,7,13,17,20,54,81,2,221,12,0,2,2,5,0
30927,221,4803,3,1,1,3,0,0,6,0,0,0,0,0,0,0,0,0,0,0,0,2,2,5,0
30928,99,2686,1523,757,1297,19,12,193,1542,12,193,117,230,205,347,1508,2664,7,19053,1058,0,2,0,10,0
30929,99,2686,701,378,504,33,58,109,734,13,110,68,126,123,194,794,1346,7,10027,557,0,2,0,10,0
30930,99,4088,1289,550,1043,56,32,155,1345,10,167,93,185,177,278,1266,2075,5,11498,638,0,2,5,6,0
30931,15,827,75,38,59,1,3,12,76,2,4,2,4,6,6,10,15,1,15,0,0,2,0,19,0
30932,291,6479,72,33,56,0,4,12,72,1,1,1,1,2,2,0,2,0,1,0,0,2,4,7,0
30933,291,6479,1454,835,1044,76,110,219,1530,17,275,158,296,292,454,2297,3718,9,34017,1889,1,2,4,7,0
30934,125,5597,1782,648,1425,9,47,279,1791,8,171,97,189,179,286,1292,2140,4,9462,525,0,2,3,7,0
30935,215,4636,2,2,2,0,0,0,2,0,0,0,0,0,0,0,0,0,0,0,0,2,4,7,0
30936,215,4636,99,48,90,1,3,5,100,0,0,0,0,0,0,0,0,0,0,0,0,2,4,7,0
30937,215,4636,8,5,5,2,0,1,10,0,0,0,0,0,0,0,0,0,0,0,0,2,4,7,0
30938,215,4636,1217,716,841,84,126,174,1301,14,185,118,215,199,333,1446,2542,8,20687,1149,0,2,4,7,0
30939,215,4636,160,89,115,0,13,31,160,7,15,11,17,22,28,78,124,3,495,27,0,2,4,7,0
30940,215,4636,10,10,9,9,0,0,19,0,0,0,0,0,0,0,0,0,0,0,0,2,4,7,0
30941,215,4636,173,84,99,8,29,36,181,5,12,7,13,17,20,54,81,2,221,12,0,2,4,7,0
30942,215,4636,3,1,1,3,0,0,6,0,0,0,0,0,0,0,0,0,0,0,0,2,4,7,0
30943,250,5779,4293,999,3693,19,54,507,4312,9,155,88,170,164,258,1156,1898,4,9368,520,0,2,4,27,0
30944,250,5779,1482,859,1002,125,135,219,1607,16,219,134,251,235,385,1766,3032,9,27804,1544,1,2,4,27,0
30945,99,2686,1523,757,1297,19,12,193,1542,12,193,117,230,205,347,1508,2664,7,19053,1058,0,2,4,12,0
30946,99,2686,701,378,504,33,58,109,734,13,110,68,126,123,194,794,1346,7,10027,557,0,2,4,12,0
30947,291,6479,72,33,56,0,4,12,72,1,1,1,1,2,2,0,2,0,1,0,0,2,4,7,0
30948,291,6479,1454,835,1044,76,110,219,1530,17,275,158,296,292,454,2297,3718,9,34017,1889,1,2,4,7,0
30949,91,1879,757,253,292,73,244,162,830,13,61,38,67,74,105,409,651,7,4654,258,0,2,1,1,0
30950,99,4097,1289,550,1043,56,32,155,1345,10,167,93,185,177,278,1266,2075,5,11498,638,0,2,5,6,0
30951,15,836,75,38,59,1,3,12,76,2,4,2,4,6,6,10,15,1,15,0,0,2,0,41,0
30952,167,7471,139,89,101,2,0,35,141,7,54,34,62,61,96,330,569,4,2287,127,0,2,0,19,0
30953,167,7471,7,5,5,0,0,2,7,1,2,1,2,3,3,2,4,0,2,0,0,2,0,19,0
30954,125,5597,1782,648,1425,9,47,279,1791,8,171,97,189,179,286,1292,2140,4,9462,525,0,2,3,7,0
30955,31,979,256,139,192,9,7,47,265,4,23,12,24,27,36,112,171,2,357,19,0,2,5,0,0
30956,120,4791,1450,624,1228,12,26,181,1462,14,306,186,354,320,540,2580,4493,8,36391,2021,1,2,2,1,0
30957,90,4729,1457,730,1242,11,6,188,1468,10,292,166,329,302,495,2424,4078,5,22973,1276,1,2,3,0,0
30958,97,4773,1523,757,1297,19,12,193,1542,12,193,117,230,205,347,1508,2664,7,19053,1058,0,2,4,3,0
30959,102,5297,1943,715,1694,26,18,214,1969,12,185,120,237,197,357,1436,2721,7,20915,1161,0,2,8,4,0
30960,73,1518,207,111,150,11,0,50,218,5,26,19,36,31,55,133,272,3,943,52,0,2,2,2,0
30961,73,1518,410,198,237,31,55,97,441,11,63,38,72,74,110,414,683,6,4293,238,0,2,2,2,0
30962,92,1894,757,253,292,73,244,162,830,13,61,38,67,74,105,409,651,7,4654,258,0,2,9,4,0
30963,66,4392,520,294,400,33,13,81,553,10,261,204,367,271,571,2128,4614,7,32445,1802,1,2,11,0,0
30964,184,5593,1660,832,1314,41,38,274,1701,20,312,209,395,332,604,2671,5058,12,64042,3557,1,2,3,3,0
30965,184,5593,1057,646,719,113,100,145,1170,18,215,134,248,233,382,1740,3004,10,31186,1732,1,2,3,3,0
30966,82,1855,996,429,845,24,10,117,1020,7,76,50,88,83,138,494,879,4,3565,198,0,2,3,3,0
30967,82,1855,456,277,329,12,42,72,468,13,85,50,97,98,147,592,972,7,7212,400,0,2,3,3,0
30968,215,4636,2,2,2,0,0,0,2,0,0,0,0,0,0,0,0,0,0,0,0,2,27,55,0
30969,215,4636,99,48,90,1,3,5,100,0,0,0,0,0,0,0,0,0,0,0,0,2,27,55,0
30970,215,4636,8,5,5,2,0,1,10,0,0,0,0,0,0,0,0,0,0,0,0,2,27,55,0
30971,215,4636,1217,716,841,84,126,174,1301,14,185,118,215,199,333,1446,2542,8,20687,1149,0,2,27,55,0
30972,215,4636,160,89,115,0,13,31,160,7,15,11,17,22,28,78,124,3,495,27,0,2,27,55,0
30973,215,4636,10,10,9,9,0,0,19,0,0,0,0,0,0,0,0,0,0,0,0,2,27,55,0
30974,215,4636,173,84,99,8,29,36,181,5,12,7,13,17,20,54,81,2,221,12,0,2,27,55,0
30975,215,4636,3,1,1,3,0,0,6,0,0,0,0,0,0,0,0,0,0,0,0,2,27,55,0
30976,55,796,167,116,138,4,5,22,171,8,48,30,56,56,86,292,499,4,2330,129,0,2,6,6,0
30977,52,621,647,139,84,35,284,233,682,0,0,0,0,0,0,0,0,0,0,0,0,2,3,1,0
30978,76,1637,53,23,39,0,0,13,53,2,8,4,8,10,12,26,39,1,39,2,0,2,5,66,0
30979,76,1637,515,298,307,33,80,99,548,12,63,44,77,75,121,419,753,7,5527,307,0,2,5,66,0
30980,30,664,215,129,180,6,0,29,221,8,65,43,72,73,115,415,711,4,3153,175,0,2,2,2,0
30981,30,664,97,69,77,3,3,16,100,6,22,13,23,28,36,113,173,3,542,30,0,2,2,2,0
30982,230,4915,1943,715,1694,26,18,214,1969,12,185,120,237,197,357,1436,2721,7,20915,1161,0,2,1,11,0
30983,230,4915,1168,838,957,57,25,144,1225,19,348,224,416,367,640,3018,5452,11,61921,3440,1,2,1,11,0
30984,29,743,601,196,481,2,23,85,603,8,63,36,72,71,108,400,664,4,3036,168,0,2,3,3,0
30985,29,743,156,79,106,5,16,28,161,5,14,8,15,19,23,64,97,2,261,14,0,2,3,3,0
30986,99,4097,1289,550,1043,56,32,155,1345,10,167,93,185,177,278,1266,2075,5,11498,638,0,2,1,0,0
30987,15,836,75,38,59,1,3,12,76,2,4,2,4,6,6,10,15,1,15,0,0,2,1,0,0
30988,167,5017,1660,832,1314,41,38,274,1701,20,312,209,395,332,604,2671,5058,12,64042,3557,1,2,3,1,0
30989,90,4729,1457,730,1242,11,6,188,1468,10,292,166,329,302,495,2424,4078,5,22973,1276,1,2,0,61,0
30990,28,1839,384,251,317,7,8,52,391,11,70,44,84,81,128,467,811,6,5355,297,0,2,4,20,0
30991,47,2254,722,423,573,19,0,135,741,12,172,101,199,184,300,1320,2257,6,15668,870,0,2,1,1,0
30992,51,1747,601,196,481,2,23,85,603,8,63,36,72,71,108,400,664,4,3036,168,0,2,2,2,0
30993,246,5700,4293,999,3693,19,54,507,4312,9,155,88,170,164,258,1156,1898,4,9368,520,0,2,8,25,1
30994,246,5700,1482,859,1002,125,135,219,1607,16,219,134,251,235,385,1766,3032,9,27804,1544,1,2,8,25,1
30995,13,806,75,38,59,1,3,12,76,2,4,2,4,6,6,10,15,1,15,0,0,2,0,11,1
30996,169,7506,139,89,101,2,0,35,141,7,54,34,62,61,96,330,569,4,2287,127,0,2,11,0,1
30997,169,7506,7,5,5,0,0,2,7,1,2,1,2,3,3,2,4,0,2,0,0,2,11,0,1
30998,246,5700,4293,999,3693,19,54,507,4312,9,155,88,170,164,258,1156,1898,4,9368,520,0,2,8,25,0
30999,246,5700,1482,859,1002,125,135,219,1607,16,219,134,251,235,385,1766,3032,9,27804,1544,1,2,8,25,0
31000,13,806,75,38,59,1,3,12,76,2,4,2,4,6,6,10,15,1,15,0,0,2,0,11,0
31001,169,7506,139,89,101,2,0,35,141,7,54,34,62,61,96,330,569,4,2287,127,0,2,11,0,0
31002,169,7506,7,5,5,0,0,2,7,1,2,1,2,3,3,2,4,0,2,0,0,2,11,0,0
31003,99,4845,1523,757,1297,19,12,193,1542,12,193,117,230,205,347,1508,2664,7,19053,1058,0,2,24,11,0
31004,55,770,167,116,138,4,5,22,171,8,48,30,56,56,86,292,499,4,2330,129,0,2,8,17,0
31005,13,788,75,38,59,1,3,12,76,2,4,2,4,6,6,10,15,1,15,0,0,2,6,12,0
31006,215,4638,2,2,2,0,0,0,2,0,0,0,0,0,0,0,0,0,0,0,0,2,6,5,0
31007,215,4638,99,48,90,1,3,5,100,0,0,0,0,0,0,0,0,0,0,0,0,2,6,5,0
31008,215,4638,8,5,5,2,0,1,10,0,0,0,0,0,0,0,0,0,0,0,0,2,6,5,0
31009,215,4638,1217,716,841,84,126,174,1301,14,185,118,215,199,333,1446,2542,8,20687,1149,0,2,6,5,0
31010,215,4638,160,89,115,0,13,31,160,7,15,11,17,22,28,78,124,3,495,27,0,2,6,5,0
31011,215,4638,10,10,9,9,0,0,19,0,0,0,0,0,0,0,0,0,0,0,0,2,6,5,0
31012,215,4638,173,84,99,8,29,36,181,5,12,7,13,17,20,54,81,2,221,12,0,2,6,5,0
31013,215,4638,3,1,1,3,0,0,6,0,0,0,0,0,0,0,0,0,0,0,0,2,6,5,0
31014,13,808,75,38,59,1,3,12,76,2,4,2,4,6,6,10,15,1,15,0,0,2,8,14,0
31015,215,4638,2,2,2,0,0,0,2,0,0,0,0,0,0,0,0,0,0,0,0,2,6,5,0
31016,215,4638,99,48,90,1,3,5,100,0,0,0,0,0,0,0,0,0,0,0,0,2,6,5,0
31017,215,4638,8,5,5,2,0,1,10,0,0,0,0,0,0,0,0,0,0,0,0,2,6,5,0
31018,215,4638,1217,716,841,84,126,174,1301,14,185,118,215,199,333,1446,2542,8,20687,1149,0,2,6,5,0
31019,215,4638,160,89,115,0,13,31,160,7,15,11,17,22,28,78,124,3,495,27,0,2,6,5,0
31020,215,4638,10,10,9,9,0,0,19,0,0,0,0,0,0,0,0,0,0,0,0,2,6,5,0
31021,215,4638,173,84,99,8,29,36,181,5,12,7,13,17,20,54,81,2,221,12,0,2,6,5,0
31022,215,4638,3,1,1,3,0,0,6,0,0,0,0,0,0,0,0,0,0,0,0,2,6,5,0
31023,55,770,167,116,138,4,5,22,171,8,48,30,56,56,86,292,499,4,2330,129,0,2,8,17,0
31024,13,808,75,38,59,1,3,12,76,2,4,2,4,6,6,10,15,1,15,0,0,2,14,26,0
31025,99,4845,1523,757,1297,19,12,193,1542,12,193,117,230,205,347,1508,2664,7,19053,1058,0,2,24,11,0
31026,84,1876,402,202,227,24,74,80,426,12,52,33,61,64,94,339,564,7,3969,220,0,2,21,33,0
31027,90,3983,1338,495,1086,10,64,173,1348,11,122,82,157,133,239,883,1686,7,11934,663,0,2,17,25,0
31028,125,5588,1782,648,1425,9,47,279,1791,8,171,97,189,179,286,1292,2140,4,9462,525,0,2,11,10,0
31029,98,4153,1020,354,843,12,15,144,1032,8,134,77,144,142,221,970,1580,4,6792,377,0,2,4,33,0
31030,84,1876,402,202,227,24,74,80,426,12,52,33,61,64,94,339,564,7,3969,220,0,2,21,33,0
31031,90,3983,1338,495,1086,10,64,173,1348,11,122,82,157,133,239,883,1686,7,11934,663,0,2,17,25,0
31032,125,5588,1782,648,1425,9,47,279,1791,8,171,97,189,179,286,1292,2140,4,9462,525,0,2,11,10,0
31033,98,4153,1020,354,843,12,15,144,1032,8,134,77,144,142,221,970,1580,4,6792,377,0,2,4,33,0
31034,217,4661,2,2,2,0,0,0,2,0,0,0,0,0,0,0,0,0,0,0,0,2,4,1,0
31035,217,4661,99,48,90,1,3,5,100,0,0,0,0,0,0,0,0,0,0,0,0,2,4,1,0
31036,217,4661,8,5,5,2,0,1,10,0,0,0,0,0,0,0,0,0,0,0,0,2,4,1,0
31037,217,4661,1217,716,841,84,126,174,1301,14,185,118,215,199,333,1446,2542,8,20687,1149,0,2,4,1,0
31038,217,4661,160,89,115,0,13,31,160,7,15,11,17,22,28,78,124,3,495,27,0,2,4,1,0
31039,217,4661,10,10,9,9,0,0,19,0,0,0,0,0,0,0,0,0,0,0,0,2,4,1,0
31040,217,4661,173,84,99,8,29,36,181,5,12,7,13,17,20,54,81,2,221,12,0,2,4,1,0
31041,217,4661,3,1,1,3,0,0,6,0,0,0,0,0,0,0,0,0,0,0,0,2,4,1,0
31042,245,5671,4293,999,3693,19,54,507,4312,9,155,88,170,164,258,1156,1898,4,9368,520,0,2,13,12,0
31043,245,5671,1482,859,1002,125,135,219,1607,16,219,134,251,235,385,1766,3032,9,27804,1544,1,2,13,12,0
31044,24,613,2,2,2,0,0,0,2,0,0,0,0,0,0,0,0,0,0,0,0,2,1,10,0
31045,24,613,99,48,90,1,3,5,100,0,0,0,0,0,0,0,0,0,0,0,0,2,1,10,0
31046,24,613,8,5,5,2,0,1,10,0,0,0,0,0,0,0,0,0,0,0,0,2,1,10,0
31047,24,613,1217,716,841,84,126,174,1301,14,185,118,215,199,333,1446,2542,8,20687,1149,0,2,1,10,0
31048,24,613,160,89,115,0,13,31,160,7,15,11,17,22,28,78,124,3,495,27,0,2,1,10,0
31049,24,613,10,10,9,9,0,0,19,0,0,0,0,0,0,0,0,0,0,0,0,2,1,10,0
31050,24,613,173,84,99,8,29,36,181,5,12,7,13,17,20,54,81,2,221,12,0,2,1,10,0
31051,24,613,3,1,1,3,0,0,6,0,0,0,0,0,0,0,0,0,0,0,0,2,1,10,0
31052,69,1497,402,202,227,24,74,80,426,12,52,33,61,64,94,339,564,7,3969,220,0,2,8,93,0
31053,74,1599,53,23,39,0,0,13,53,2,8,4,8,10,12,26,39,1,39,2,0,2,0,15,0
31054,74,1599,515,298,307,33,80,99,548,12,63,44,77,75,121,419,753,7,5527,307,0,2,0,15,0
31055,291,6500,72,33,56,0,4,12,72,1,1,1,1,2,2,0,2,0,1,0,0,2,15,5,0
31056,291,6500,1454,835,1044,76,110,219,1530,17,275,158,296,292,454,2297,3718,9,34017,1889,1,2,15,5,0
31057,62,1233,1098,241,925,5,10,155,1103,7,46,25,49,53,74,273,423,3,1580,87,0,2,0,4,0
31058,62,1233,282,202,222,14,2,44,296,8,42,24,43,50,67,250,378,4,1548,86,0,2,0,4,0
31059,68,3066,1020,354,843,12,15,144,1032,8,134,77,144,142,221,970,1580,4,6792,377,0,2,11,281,0
31060,220,4688,2,2,2,0,0,0,2,0,0,0,0,0,0,0,0,0,0,0,0,2,8,3,0
31061,220,4688,99,48,90,1,3,5,100,0,0,0,0,0,0,0,0,0,0,0,0,2,8,3,0
31062,220,4688,8,5,5,2,0,1,10,0,0,0,0,0,0,0,0,0,0,0,0,2,8,3,0
31063,220,4688,1217,716,841,84,126,174,1301,14,185,118,215,199,333,1446,2542,8,20687,1149,0,2,8,3,0
31064,220,4688,160,89,115,0,13,31,160,7,15,11,17,22,28,78,124,3,495,27,0,2,8,3,0
31065,220,4688,10,10,9,9,0,0,19,0,0,0,0,0,0,0,0,0,0,0,0,2,8,3,0
31066,220,4688,173,84,99,8,29,36,181,5,12,7,13,17,20,54,81,2,221,12,0,2,8,3,0
31067,220,4688,3,1,1,3,0,0,6,0,0,0,0,0,0,0,0,0,0,0,0,2,8,3,0
31068,220,4688,2,2,2,0,0,0,2,0,0,0,0,0,0,0,0,0,0,0,0,2,2,0,0
31069,220,4688,99,48,90,1,3,5,100,0,0,0,0,0,0,0,0,0,0,0,0,2,2,0,0
31070,220,4688,8,5,5,2,0,1,10,0,0,0,0,0,0,0,0,0,0,0,0,2,2,0,0
31071,220,4688,1217,716,841,84,126,174,1301,14,185,118,215,199,333,1446,2542,8,20687,1149,0,2,2,0,0
31072,220,4688,160,89,115,0,13,31,160,7,15,11,17,22,28,78,124,3,495,27,0,2,2,0,0
31073,220,4688,10,10,9,9,0,0,19,0,0,0,0,0,0,0,0,0,0,0,0,2,2,0,0
31074,220,4688,173,84,99,8,29,36,181,5,12,7,13,17,20,54,81,2,221,12,0,2,2,0,0
31075,220,4688,3,1,1,3,0,0,6,0,0,0,0,0,0,0,0,0,0,0,0,2,2,0,0
31076,291,6500,72,33,56,0,4,12,72,1,1,1,1,2,2,0,2,0,1,0,0,2,2,0,0
31077,291,6500,1454,835,1044,76,110,219,1530,17,275,158,296,292,454,2297,3718,9,34017,1889,1,2,2,0,0
31078,220,4688,2,2,2,0,0,0,2,0,0,0,0,0,0,0,0,0,0,0,0,2,14,4,0
31079,220,4688,99,48,90,1,3,5,100,0,0,0,0,0,0,0,0,0,0,0,0,2,14,4,0
31080,220,4688,8,5,5,2,0,1,10,0,0,0,0,0,0,0,0,0,0,0,0,2,14,4,0
31081,220,4688,1217,716,841,84,126,174,1301,14,185,118,215,199,333,1446,2542,8,20687,1149,0,2,14,4,0
31082,220,4688,160,89,115,0,13,31,160,7,15,11,17,22,28,78,124,3,495,27,0,2,14,4,0
31083,220,4688,10,10,9,9,0,0,19,0,0,0,0,0,0,0,0,0,0,0,0,2,14,4,0
31084,220,4688,173,84,99,8,29,36,181,5,12,7,13,17,20,54,81,2,221,12,0,2,14,4,0
31085,220,4688,3,1,1,3,0,0,6,0,0,0,0,0,0,0,0,0,0,0,0,2,14,4,0
31086,245,5671,4293,999,3693,19,54,507,4312,9,155,88,170,164,258,1156,1898,4,9368,520,0,2,13,12,0
31087,245,5671,1482,859,1002,125,135,219,1607,16,219,134,251,235,385,1766,3032,9,27804,1544,1,2,13,12,0
31088,24,613,2,2,2,0,0,0,2,0,0,0,0,0,0,0,0,0,0,0,0,2,1,10,0
31089,24,613,99,48,90,1,3,5,100,0,0,0,0,0,0,0,0,0,0,0,0,2,1,10,0
31090,24,613,8,5,5,2,0,1,10,0,0,0,0,0,0,0,0,0,0,0,0,2,1,10,0
31091,24,613,1217,716,841,84,126,174,1301,14,185,118,215,199,333,1446,2542,8,20687,1149,0,2,1,10,0
31092,24,613,160,89,115,0,13,31,160,7,15,11,17,22,28,78,124,3,495,27,0,2,1,10,0
31093,24,613,10,10,9,9,0,0,19,0,0,0,0,0,0,0,0,0,0,0,0,2,1,10,0
31094,24,613,173,84,99,8,29,36,181,5,12,7,13,17,20,54,81,2,221,12,0,2,1,10,0
31095,24,613,3,1,1,3,0,0,6,0,0,0,0,0,0,0,0,0,0,0,0,2,1,10,0
31096,69,1497,402,202,227,24,74,80,426,12,52,33,61,64,94,339,564,7,3969,220,0,2,8,93,0
31097,74,1599,53,23,39,0,0,13,53,2,8,4,8,10,12,26,39,1,39,2,0,2,0,15,0
31098,74,1599,515,298,307,33,80,99,548,12,63,44,77,75,121,419,753,7,5527,307,0,2,0,15,0
31099,291,6500,72,33,56,0,4,12,72,1,1,1,1,2,2,0,2,0,1,0,0,2,17,5,0
31100,291,6500,1454,835,1044,76,110,219,1530,17,275,158,296,292,454,2297,3718,9,34017,1889,1,2,17,5,0
31101,62,1233,1098,241,925,5,10,155,1103,7,46,25,49,53,74,273,423,3,1580,87,0,2,0,4,0
31102,62,1233,282,202,222,14,2,44,296,8,42,24,43,50,67,250,378,4,1548,86,0,2,0,4,0
31103,68,3066,1020,354,843,12,15,144,1032,8,134,77,144,142,221,970,1580,4,6792,377,0,2,11,281,0
31104,234,4977,1943,715,1694,26,18,214,1969,12,185,120,237,197,357,1436,2721,7,20915,1161,0,2,4,0,0
31105,234,4977,1168,838,957,57,25,144,1225,19,348,224,416,367,640,3018,5452,11,61921,3440,1,2,4,0,0
31106,103,5339,1943,715,1694,26,18,214,1969,12,185,120,237,197,357,1436,2721,7,20915,1161,0,2,12,0,0
31107,234,4977,1943,715,1694,26,18,214,1969,12,185,120,237,197,357,1436,2721,7,20915,1161,0,2,4,0,0
31108,234,4977,1168,838,957,57,25,144,1225,19,348,224,416,367,640,3018,5452,11,61921,3440,1,2,4,0,0
31109,103,5339,1943,715,1694,26,18,214,1969,12,185,120,237,197,357,1436,2721,7,20915,1161,0,2,12,0,0
31110,1,323,382,65,130,157,2,92,539,4,10,5,10,14,15,41,57,2,114,6,0,2,2,1,0
31111,1,321,382,65,130,157,2,92,539,4,10,5,10,14,15,41,57,2,114,6,0,2,1,1,0
31112,21,538,205,80,86,16,53,53,221,7,18,10,19,25,29,94,134,3,497,27,0,2,4,2,0
31113,83,3323,1043,504,840,53,9,147,1096,9,180,112,198,189,310,1377,2344,4,11604,644,0,2,16,0,1
31114,21,538,205,80,86,16,53,53,221,7,18,10,19,25,29,94,134,3,497,27,0,2,8,3,0
31115,21,538,205,80,86,16,53,53,221,7,18,10,19,25,29,94,134,3,497,27,0,2,12,5,0
31116,83,3323,1043,504,840,53,9,147,1096,9,180,112,198,189,310,1377,2344,4,11604,644,0,2,16,0,0
31117,1,321,382,65,130,157,2,92,539,4,10,5,10,14,15,41,57,2,114,6,0,2,1,1,0
31118,60,1167,282,196,195,3,0,86,285,8,130,71,141,138,212,936,1507,4,6538,363,0,2,27,3,0
31119,1,90,13,10,10,0,0,3,13,1,2,1,2,3,3,2,4,0,2,0,0,2,1,1,0
31120,231,4983,182,127,129,0,0,53,182,5,39,21,42,44,63,217,343,2,926,51,0,2,71,32,0
31121,231,4983,1165,710,800,67,119,181,1232,18,243,153,282,261,435,2000,3492,10,36473,2026,1,2,71,32,0
31122,184,5593,1660,832,1314,41,38,274,1701,20,312,209,395,332,604,2671,5058,12,64042,3557,1,2,50,3,0
31123,184,5593,1057,646,719,113,100,145,1170,18,215,134,248,233,382,1740,3004,10,31186,1732,1,2,50,3,0
31124,108,2059,477,336,357,30,23,73,507,16,194,134,250,210,384,1538,2962,10,30538,1696,0,2,42,1,0
31125,82,1855,996,429,845,24,10,117,1020,7,76,50,88,83,138,494,879,4,3565,198,0,2,14,3,0
31126,82,1855,456,277,329,12,42,72,468,13,85,50,97,98,147,592,972,7,7212,400,0,2,14,3,0
31127,156,3271,1513,682,1277,25,13,200,1538,11,199,116,219,210,335,1557,2584,6,15641,868,0,2,3,3,0
31128,156,3271,819,519,539,24,98,155,843,15,96,57,106,111,163,690,1107,8,9171,509,0,2,3,3,0
31129,73,1518,207,111,150,11,0,50,218,5,26,19,36,31,55,133,272,3,943,52,0,2,21,8,0
31130,73,1518,410,198,237,31,55,97,441,11,63,38,72,74,110,414,683,6,4293,238,0,2,21,8,0
31131,220,4688,2,2,2,0,0,0,2,0,0,0,0,0,0,0,0,0,0,0,0,2,67,83,0
31132,220,4688,99,48,90,1,3,5,100,0,0,0,0,0,0,0,0,0,0,0,0,2,67,83,0
31133,220,4688,8,5,5,2,0,1,10,0,0,0,0,0,0,0,0,0,0,0,0,2,67,83,0
31134,220,4688,1217,716,841,84,126,174,1301,14,185,118,215,199,333,1446,2542,8,20687,1149,0,2,67,83,0
31135,220,4688,160,89,115,0,13,31,160,7,15,11,17,22,28,78,124,3,495,27,0,2,67,83,0
31136,220,4688,10,10,9,9,0,0,19,0,0,0,0,0,0,0,0,0,0,0,0,2,67,83,0
31137,220,4688,173,84,99,8,29,36,181,5,12,7,13,17,20,54,81,2,221,12,0,2,67,83,0
31138,220,4688,3,1,1,3,0,0,6,0,0,0,0,0,0,0,0,0,0,0,0,2,67,83,0
31139,97,2016,463,295,324,28,62,57,491,12,134,82,154,146,236,989,1696,6,11700,650,0,2,5,2,0
31140,55,770,167,116,138,4,5,22,171,8,48,30,56,56,86,292,499,4,2330,129,0,2,24,27,0
31141,41,1220,339,213,244,17,9,65,356,10,42,26,48,52,74,259,421,5,2410,133,0,2,18,10,0
31142,245,5671,4293,999,3693,19,54,507,4312,9,155,88,170,164,258,1156,1898,4,9368,520,0,2,26,109,0
31143,245,5671,1482,859,1002,125,135,219,1607,16,219,134,251,235,385,1766,3032,9,27804,1544,1,2,26,109,0
31144,52,621,647,139,84,35,284,233,682,0,0,0,0,0,0,0,0,0,0,0,0,2,2,28,0
31145,99,2686,1523,757,1297,19,12,193,1542,12,193,117,230,205,347,1508,2664,7,19053,1058,0,2,18,13,0
31146,99,2686,701,378,504,33,58,109,734,13,110,68,126,123,194,794,1346,7,10027,557,0,2,18,13,0
31147,154,3597,77,34,69,0,0,8,77,3,24,16,29,27,45,114,213,1,387,21,0,2,22,4,0
31148,154,3597,712,438,573,51,9,84,763,14,102,71,128,116,199,733,1364,8,11988,666,0,2,22,4,0
31149,24,613,2,2,2,0,0,0,2,0,0,0,0,0,0,0,0,0,0,0,0,2,1,10,0
31150,24,613,99,48,90,1,3,5,100,0,0,0,0,0,0,0,0,0,0,0,0,2,1,10,0
31151,24,613,8,5,5,2,0,1,10,0,0,0,0,0,0,0,0,0,0,0,0,2,1,10,0
31152,24,613,1217,716,841,84,126,174,1301,14,185,118,215,199,333,1446,2542,8,20687,1149,0,2,1,10,0
31153,24,613,160,89,115,0,13,31,160,7,15,11,17,22,28,78,124,3,495,27,0,2,1,10,0
31154,24,613,10,10,9,9,0,0,19,0,0,0,0,0,0,0,0,0,0,0,0,2,1,10,0
31155,24,613,173,84,99,8,29,36,181,5,12,7,13,17,20,54,81,2,221,12,0,2,1,10,0
31156,24,613,3,1,1,3,0,0,6,0,0,0,0,0,0,0,0,0,0,0,0,2,1,10,0
31157,69,1497,402,202,227,24,74,80,426,12,52,33,61,64,94,339,564,7,3969,220,0,2,38,130,0
31158,74,1599,53,23,39,0,0,13,53,2,8,4,8,10,12,26,39,1,39,2,0,2,6,117,0
31159,74,1599,515,298,307,33,80,99,548,12,63,44,77,75,121,419,753,7,5527,307,0,2,6,117,0
31160,18,306,424,94,331,4,0,89,428,1,5,5,5,6,10,11,25,0,12,0,0,2,3,13,0
31161,18,306,38,23,23,6,0,8,44,3,11,7,11,14,18,42,68,1,102,5,0,2,3,13,0
31162,21,538,205,80,86,16,53,53,221,7,18,10,19,25,29,94,134,3,497,27,0,2,15,8,0
31163,291,6500,72,33,56,0,4,12,72,1,1,1,1,2,2,0,2,0,1,0,0,2,32,113,0
31164,291,6500,1454,835,1044,76,110,219,1530,17,275,158,296,292,454,2297,3718,9,34017,1889,1,2,32,113,0
31165,92,1894,757,253,292,73,244,162,830,13,61,38,67,74,105,409,651,7,4654,258,0,2,55,48,0
31166,45,935,386,256,301,16,9,68,402,4,59,35,69,63,104,355,621,2,1453,80,0,2,2,0,0
31167,45,935,264,131,164,11,41,46,275,6,38,22,40,44,62,214,338,3,1068,59,0,2,2,0,0
31168,30,664,215,129,180,6,0,29,221,8,65,43,72,73,115,415,711,4,3153,175,0,2,2,2,0
31169,30,664,97,69,77,3,3,16,100,6,22,13,23,28,36,113,173,3,542,30,0,2,2,2,0
31170,95,2085,1043,504,840,53,9,147,1096,9,180,112,198,189,310,1377,2344,4,11604,644,0,2,42,25,0
31171,95,2085,383,288,292,26,6,62,409,11,65,38,67,76,105,429,656,5,3719,206,0,2,42,25,0
31172,234,4977,1943,715,1694,26,18,214,1969,12,185,120,237,197,357,1436,2721,7,20915,1161,0,2,6,12,0
31173,234,4977,1168,838,957,57,25,144,1225,19,348,224,416,367,640,3018,5452,11,61921,3440,1,2,6,12,0
31174,62,1233,1098,241,925,5,10,155,1103,7,46,25,49,53,74,273,423,3,1580,87,0,2,5,5,0
31175,62,1233,282,202,222,14,2,44,296,8,42,24,43,50,67,250,378,4,1548,86,0,2,5,5,0
31176,29,743,601,196,481,2,23,85,603,8,63,36,72,71,108,400,664,4,3036,168,0,2,3,3,0
31177,29,743,156,79,106,5,16,28,161,5,14,8,15,19,23,64,97,2,261,14,0,2,3,3,0
31178,99,4097,1289,550,1043,56,32,155,1345,10,167,93,185,177,278,1266,2075,5,11498,638,0,2,8,9,0
31179,35,1093,182,127,129,0,0,53,182,5,39,21,42,44,63,217,343,2,926,51,0,2,3,3,0
31180,153,7221,1392,870,1177,35,17,170,1427,14,494,280,531,508,811,4473,7289,7,54850,3047,2,2,21,13,0
31181,92,2899,773,419,590,28,0,166,801,10,204,113,217,214,330,1598,2554,5,13587,754,0,2,9,16,0
31182,13,808,75,38,59,1,3,12,76,2,4,2,4,6,6,10,15,1,15,0,0,2,23,209,0
31183,1,55,14,12,10,0,0,4,14,1,2,1,2,3,3,2,4,0,2,0,0,0,14,0,0
31184,1,58,14,12,10,0,0,4,14,1,2,1,2,3,3,2,4,0,2,0,0,0,14,0,0
31185,1,55,14,12,10,0,0,4,14,1,2,1,2,3,3,2,4,0,2,0,0,0,14,0,0
31186,1,77,19,18,14,0,0,5,19,1,2,1,2,3,3,2,4,0,2,0,0,0,19,0,0
31187,1,24,127,75,83,2,11,30,129,4,14,7,14,18,21,61,87,2,175,9,0,2,1,1,0
31188,1,24,652,304,544,16,6,88,668,6,89,51,101,95,152,591,998,3,3399,188,0,2,1,1,0
31189,1,24,2,2,2,0,0,0,2,0,0,0,0,0,0,0,0,0,0,0,0,2,1,1,0
31190,1,24,8,5,5,0,0,3,8,0,0,0,0,0,0,0,0,0,0,0,0,2,1,1,0
31191,1,24,2,2,2,0,0,0,2,0,0,0,0,0,0,0,0,0,0,0,0,2,1,1,0
31192,1,24,14,8,8,0,0,6,14,0,0,0,0,0,0,0,0,0,0,0,0,2,1,1,0
31193,1,24,6,4,4,0,0,2,6,0,0,0,0,0,0,0,0,0,0,0,0,2,1,1,0
31194,1,24,6,4,4,0,0,2,6,1,2,1,2,3,3,2,4,0,2,0,0,2,1,1,0
31195,1,24,6,4,4,0,0,2,6,0,0,0,0,0,0,0,0,0,0,0,0,2,1,1,0
31196,1,24,7,5,5,0,0,2,7,0,0,0,0,0,0,0,0,0,0,0,0,2,1,1,0
31197,1,24,6,4,4,0,0,2,6,0,0,0,0,0,0,0,0,0,0,0,0,2,1,1,0
31198,1,24,10,6,6,0,0,4,10,0,0,0,0,0,0,0,0,0,0,0,0,2,1,1,0
31199,1,24,1,1,1,0,0,0,1,0,0,0,0,0,0,0,0,0,0,0,0,2,1,1,0
31200,1,24,1,1,1,0,0,0,1,0,0,0,0,0,0,0,0,0,0,0,0,2,1,1,0
31201,1,24,14,10,10,0,0,4,14,1,1,1,1,2,2,0,2,0,1,0,0,2,1,1,0
31202,1,24,46,26,30,3,0,12,49,3,6,3,6,9,9,20,28,1,42,2,0,2,1,1,0
31203,66,4392,520,294,400,33,13,81,553,10,261,204,367,271,571,2128,4614,7,32445,1802,1,2,11,0,0
31204,90,3983,1338,495,1086,10,64,173,1348,11,122,82,157,133,239,883,1686,7,11934,663,0,2,33,325,0
31205,169,7506,139,89,101,2,0,35,141,7,54,34,62,61,96,330,569,4,2287,127,0,2,15,224,0
31206,169,7506,7,5,5,0,0,2,7,1,2,1,2,3,3,2,4,0,2,0,0,2,15,224,0
31207,125,5588,1782,648,1425,9,47,279,1791,8,171,97,189,179,286,1292,2140,4,9462,525,0,2,52,179,0
31208,31,979,256,139,192,9,7,47,265,4,23,12,24,27,36,112,171,2,357,19,0,2,15,7,0
31209,120,4791,1450,624,1228,12,26,181,1462,14,306,186,354,320,540,2580,4493,8,36391,2021,1,2,110,0,0
31210,167,5017,1660,832,1314,41,38,274,1701,20,312,209,395,332,604,2671,5058,12,64042,3557,1,2,3,1,0
31211,47,3455,996,429,845,24,10,117,1020,7,76,50,88,83,138,494,879,4,3565,198,0,2,12,0,0
31212,124,5331,1513,682,1277,25,13,200,1538,11,199,116,219,210,335,1557,2584,6,15641,868,0,2,5,5,0
31213,79,4485,1296,573,1062,40,33,157,1336,8,201,118,231,209,349,1561,2689,4,12365,686,0,2,20,34,0
31214,90,4729,1457,730,1242,11,6,188,1468,10,292,166,329,302,495,2424,4078,5,22973,1276,1,2,4,64,0
31215,99,4845,1523,757,1297,19,12,193,1542,12,193,117,230,205,347,1508,2664,7,19053,1058,0,2,31,0,0
31216,68,3066,1020,354,843,12,15,144,1032,8,134,77,144,142,221,970,1580,4,6792,377,0,2,37,320,0
31217,42,1932,447,308,343,6,5,95,453,7,96,59,111,103,170,651,1136,4,4600,255,0,2,4,4,0
31218,20,626,424,94,331,4,0,89,428,1,5,5,5,6,10,11,25,0,12,0,0,2,0,68,0
31219,39,2361,334,251,279,10,4,40,344,5,127,74,143,132,217,899,1528,2,4303,239,0,2,7,5,0
31220,66,3082,1293,570,1093,25,15,163,1318,10,195,123,241,205,364,1516,2795,6,17273,959,0,2,30,23,0
31221,28,1839,384,251,317,7,8,52,391,11,70,44,84,81,128,467,811,6,5355,297,0,2,15,67,0
31222,47,2254,722,423,573,19,0,135,741,12,172,101,199,184,300,1320,2257,6,15668,870,0,2,4,4,0
31223,45,1961,386,256,301,16,9,68,402,4,59,35,69,63,104,355,621,2,1453,80,0,2,13,4,0
31224,16,1247,215,129,180,6,0,29,221,8,65,43,72,73,115,415,711,4,3153,175,0,2,1,1,0
31225,83,3323,1043,504,840,53,9,147,1096,9,180,112,198,189,310,1377,2344,4,11604,644,0,2,31,36,0
31226,12,478,295,56,236,0,4,54,295,2,9,5,10,11,15,30,51,1,57,3,0,2,0,59,0
31227,29,1210,373,158,315,8,0,51,381,5,76,44,79,81,123,486,779,2,2026,112,0,2,2,20,0
31228,77,3228,1178,367,1042,6,15,115,1184,9,94,51,95,103,146,644,976,4,4439,246,0,2,12,1,0
31229,103,5339,1943,715,1694,26,18,214,1969,12,185,120,237,197,357,1436,2721,7,20915,1161,0,2,38,16,0
31230,51,1747,601,196,481,2,23,85,603,8,63,36,72,71,108,400,664,4,3036,168,0,2,62,2,0
31231,112,2133,477,336,357,30,23,73,507,16,194,134,250,210,384,1538,2962,10,30538,1696,0,2,14,0,1
31232,123,4932,1450,624,1228,12,26,181,1462,14,306,186,354,320,540,2580,4493,8,36391,2021,1,2,24,0,1
31233,52,1777,601,196,481,2,23,85,603,8,63,36,72,71,108,400,664,4,3036,168,0,2,24,0,0
31234,45,940,386,256,301,16,9,68,402,4,59,35,69,63,104,355,621,2,1453,80,0,2,4,0,0
31235,45,940,264,131,164,11,41,46,275,6,38,22,40,44,62,214,338,3,1068,59,0,2,4,0,0
31236,45,940,386,256,301,16,9,68,402,4,59,35,69,63,104,355,621,2,1453,80,0,2,1,1,0
31237,45,940,264,131,164,11,41,46,275,6,38,22,40,44,62,214,338,3,1068,59,0,2,1,1,0
31238,45,940,386,256,301,16,9,68,402,4,59,35,69,63,104,355,621,2,1453,80,0,2,4,0,0
31239,45,940,264,131,164,11,41,46,275,6,38,22,40,44,62,214,338,3,1068,59,0,2,4,0,0
31240,52,1777,601,196,481,2,23,85,603,8,63,36,72,71,108,400,664,4,3036,168,0,2,24,0,0
31241,52,1785,601,196,481,2,23,85,603,8,63,36,72,71,108,400,664,4,3036,168,0,2,7,21,0
31242,52,1785,601,196,481,2,23,85,603,8,63,36,72,71,108,400,664,4,3036,168,0,2,7,21,0
31243,94,2363,1455,414,1257,16,76,112,1471,5,41,23,46,46,69,231,381,2,1069,59,0,2,55,2,0
31244,94,2363,669,365,481,22,61,110,691,15,103,63,122,118,185,747,1273,8,11311,628,0,2,55,2,0
31245,71,3276,1455,414,1257,16,76,112,1471,5,41,23,46,46,69,231,381,2,1069,59,0,2,19,0,0
31246,314,6855,72,33,56,0,4,12,72,1,1,1,1,2,2,0,2,0,1,0,0,2,142,46,1
31247,314,6855,1454,835,1044,76,110,219,1530,17,275,158,296,292,454,2297,3718,9,34017,1889,1,2,142,46,1
31248,68,1302,1098,241,925,5,10,155,1103,7,46,25,49,53,74,273,423,3,1580,87,0,2,45,19,1
31249,68,1302,282,202,222,14,2,44,296,8,42,24,43,50,67,250,378,4,1548,86,0,2,45,19,1
31250,90,3974,1338,495,1086,10,64,173,1348,11,122,82,157,133,239,883,1686,7,11934,663,0,2,0,3,1
31251,170,7538,139,89,101,2,0,35,141,7,54,34,62,61,96,330,569,4,2287,127,0,2,39,0,1
31252,170,7538,7,5,5,0,0,2,7,1,2,1,2,3,3,2,4,0,2,0,0,2,39,0,1
31253,1,321,382,65,130,157,2,92,539,4,10,5,10,14,15,41,57,2,114,6,0,2,1,1,0
31254,45,940,386,256,301,16,9,68,402,4,59,35,69,63,104,355,621,2,1453,80,0,2,4,0,0
31255,45,940,264,131,164,11,41,46,275,6,38,22,40,44,62,214,338,3,1068,59,0,2,4,0,0
31256,52,1777,601,196,481,2,23,85,603,8,63,36,72,71,108,400,664,4,3036,168,0,2,24,0,0
31257,112,2133,477,336,357,30,23,73,507,16,194,134,250,210,384,1538,2962,10,30538,1696,0,2,14,0,0
31258,123,4932,1450,624,1228,12,26,181,1462,14,306,186,354,320,540,2580,4493,8,36391,2021,1,2,24,0,0
31259,94,2363,1455,414,1257,16,76,112,1471,5,41,23,46,46,69,231,381,2,1069,59,0,2,55,2,0
31260,94,2363,669,365,481,22,61,110,691,15,103,63,122,118,185,747,1273,8,11311,628,0,2,55,2,0
31261,71,3276,1455,414,1257,16,76,112,1471,5,41,23,46,46,69,231,381,2,1069,59,0,2,19,0,0
31262,172,5098,1660,832,1314,41,38,274,1701,20,312,209,395,332,604,2671,5058,12,64042,3557,1,2,21,0,0
31263,185,5602,1660,832,1314,41,38,274,1701,20,312,209,395,332,604,2671,5058,12,64042,3557,1,2,7,1,0
31264,185,5602,1057,646,719,113,100,145,1170,18,215,134,248,233,382,1740,3004,10,31186,1732,1,2,7,1,0
31265,185,5602,1660,832,1314,41,38,274,1701,20,312,209,395,332,604,2671,5058,12,64042,3557,1,2,7,1,0
31266,185,5602,1057,646,719,113,100,145,1170,18,215,134,248,233,382,1740,3004,10,31186,1732,1,2,7,1,0
31267,172,5098,1660,832,1314,41,38,274,1701,20,312,209,395,332,604,2671,5058,12,64042,3557,1,2,21,0,0
31268,1,323,382,65,130,157,2,92,539,4,10,5,10,14,15,41,57,2,114,6,0,2,2,1,0
31269,231,4977,182,127,129,0,0,53,182,5,39,21,42,44,63,217,343,2,926,51,0,2,0,5,1
31270,231,4977,1165,710,800,67,119,181,1232,18,243,153,282,261,435,2000,3492,10,36473,2026,1,2,0,5,1
31271,182,5535,1660,832,1314,41,38,274,1701,20,312,209,395,332,604,2671,5058,12,64042,3557,1,2,0,13,1
31272,182,5535,1057,646,719,113,100,145,1170,18,215,134,248,233,382,1740,3004,10,31186,1732,1,2,0,13,1
31273,245,5664,4293,999,3693,19,54,507,4312,9,155,88,170,164,258,1156,1898,4,9368,520,0,2,0,6,1
31274,245,5664,1482,859,1002,125,135,219,1607,16,219,134,251,235,385,1766,3032,9,27804,1544,1,2,0,6,1
31275,99,2671,1523,757,1297,19,12,193,1542,12,193,117,230,205,347,1508,2664,7,19053,1058,0,2,7,10,1
31276,99,2671,701,378,504,33,58,109,734,13,110,68,126,123,194,794,1346,7,10027,557,0,2,7,10,1
31277,290,6477,72,33,56,0,4,12,72,1,1,1,1,2,2,0,2,0,1,0,0,2,0,5,1
31278,290,6477,1454,835,1044,76,110,219,1530,17,275,158,296,292,454,2297,3718,9,34017,1889,1,2,0,5,1
31279,27,665,466,257,367,18,25,50,484,7,126,86,171,133,257,898,1813,4,8612,478,0,2,0,10,1
31280,27,665,507,281,342,29,59,88,536,10,53,29,57,63,86,336,514,5,2764,153,0,2,0,10,1
31281,25,546,215,129,180,6,0,29,221,8,65,43,72,73,115,415,711,4,3153,175,0,2,0,24,1
31282,25,546,97,69,77,3,3,16,100,6,22,13,23,28,36,113,173,3,542,30,0,2,0,24,1
31283,231,4941,1943,715,1694,26,18,214,1969,12,185,120,237,197,357,1436,2721,7,20915,1161,0,2,0,9,1
31284,231,4941,1168,838,957,57,25,144,1225,19,348,224,416,367,640,3018,5452,11,61921,3440,1,2,0,9,1
31285,125,5588,1782,648,1425,9,47,279,1791,8,171,97,189,179,286,1292,2140,4,9462,525,0,2,0,1,1
31286,15,1066,215,129,180,6,0,29,221,8,65,43,72,73,115,415,711,4,3153,175,0,2,0,29,1
31287,83,3318,1043,504,840,53,9,147,1096,9,180,112,198,189,310,1377,2344,4,11604,644,0,2,1,6,1
31288,29,1210,373,158,315,8,0,51,381,5,76,44,79,81,123,486,779,2,2026,112,0,2,0,1,1
31289,101,5272,1943,715,1694,26,18,214,1969,12,185,120,237,197,357,1436,2721,7,20915,1161,0,2,0,11,1
31290,92,1891,757,253,292,73,244,162,830,13,61,38,67,74,105,409,651,7,4654,258,0,2,2,2,0
31291,231,4977,182,127,129,0,0,53,182,5,39,21,42,44,63,217,343,2,926,51,0,2,0,5,0
31292,231,4977,1165,710,800,67,119,181,1232,18,243,153,282,261,435,2000,3492,10,36473,2026,1,2,0,5,0
31293,182,5535,1660,832,1314,41,38,274,1701,20,312,209,395,332,604,2671,5058,12,64042,3557,1,2,0,13,0
31294,182,5535,1057,646,719,113,100,145,1170,18,215,134,248,233,382,1740,3004,10,31186,1732,1,2,0,13,0
31295,245,5664,4293,999,3693,19,54,507,4312,9,155,88,170,164,258,1156,1898,4,9368,520,0,2,0,6,0
31296,245,5664,1482,859,1002,125,135,219,1607,16,219,134,251,235,385,1766,3032,9,27804,1544,1,2,0,6,0
31297,99,2671,1523,757,1297,19,12,193,1542,12,193,117,230,205,347,1508,2664,7,19053,1058,0,2,7,10,0
31298,99,2671,701,378,504,33,58,109,734,13,110,68,126,123,194,794,1346,7,10027,557,0,2,7,10,0
31299,290,6477,72,33,56,0,4,12,72,1,1,1,1,2,2,0,2,0,1,0,0,2,0,5,0
31300,290,6477,1454,835,1044,76,110,219,1530,17,275,158,296,292,454,2297,3718,9,34017,1889,1,2,0,5,0
31301,27,665,466,257,367,18,25,50,484,7,126,86,171,133,257,898,1813,4,8612,478,0,2,0,10,0
31302,27,665,507,281,342,29,59,88,536,10,53,29,57,63,86,336,514,5,2764,153,0,2,0,10,0
31303,25,546,215,129,180,6,0,29,221,8,65,43,72,73,115,415,711,4,3153,175,0,2,0,24,0
31304,25,546,97,69,77,3,3,16,100,6,22,13,23,28,36,113,173,3,542,30,0,2,0,24,0
31305,231,4941,1943,715,1694,26,18,214,1969,12,185,120,237,197,357,1436,2721,7,20915,1161,0,2,0,9,0
31306,231,4941,1168,838,957,57,25,144,1225,19,348,224,416,367,640,3018,5452,11,61921,3440,1,2,0,9,0
31307,125,5588,1782,648,1425,9,47,279,1791,8,171,97,189,179,286,1292,2140,4,9462,525,0,2,0,1,0
31308,15,1066,215,129,180,6,0,29,221,8,65,43,72,73,115,415,711,4,3153,175,0,2,0,29,0
31309,83,3318,1043,504,840,53,9,147,1096,9,180,112,198,189,310,1377,2344,4,11604,644,0,2,1,6,0
31310,29,1210,373,158,315,8,0,51,381,5,76,44,79,81,123,486,779,2,2026,112,0,2,0,1,0
31311,101,5272,1943,715,1694,26,18,214,1969,12,185,120,237,197,357,1436,2721,7,20915,1161,0,2,0,11,0
31312,92,1891,757,253,292,73,244,162,830,13,61,38,67,74,105,409,651,7,4654,258,0,2,2,2,0
31313,1,323,382,65,130,157,2,92,539,4,10,5,10,14,15,41,57,2,114,6,0,2,2,1,0
31314,183,5544,1660,832,1314,41,38,274,1701,20,312,209,395,332,604,2671,5058,12,64042,3557,1,2,7,1,0
31315,183,5544,1057,646,719,113,100,145,1170,18,215,134,248,233,382,1740,3004,10,31186,1732,1,2,7,1,0
31316,112,2133,477,336,357,30,23,73,507,16,194,134,250,210,384,1538,2962,10,30538,1696,0,2,14,0,0
31317,94,2363,1455,414,1257,16,76,112,1471,5,41,23,46,46,69,231,381,2,1069,59,0,2,55,2,0
31318,94,2363,669,365,481,22,61,110,691,15,103,63,122,118,185,747,1273,8,11311,628,0,2,55,2,0
31319,92,1891,757,253,292,73,244,162,830,13,61,38,67,74,105,409,651,7,4654,258,0,2,2,2,0
31320,123,4932,1450,624,1228,12,26,181,1462,14,306,186,354,320,540,2580,4493,8,36391,2021,1,2,24,0,0
31321,172,5098,1660,832,1314,41,38,274,1701,20,312,209,395,332,604,2671,5058,12,64042,3557,1,2,21,0,0
31322,71,3276,1455,414,1257,16,76,112,1471,5,41,23,46,46,69,231,381,2,1069,59,0,2,19,0,0
31323,52,1785,601,196,481,2,23,85,603,8,63,36,72,71,108,400,664,4,3036,168,0,2,7,21,0
31324,1,323,382,65,130,157,2,92,539,4,10,5,10,14,15,41,57,2,114,6,0,2,2,1,0
31325,183,5544,1660,832,1314,41,38,274,1701,20,312,209,395,332,604,2671,5058,12,64042,3557,1,2,7,1,0
31326,183,5544,1057,646,719,113,100,145,1170,18,215,134,248,233,382,1740,3004,10,31186,1732,1,2,7,1,0
31327,112,2133,477,336,357,30,23,73,507,16,194,134,250,210,384,1538,2962,10,30538,1696,0,2,14,0,0
31328,94,2363,1455,414,1257,16,76,112,1471,5,41,23,46,46,69,231,381,2,1069,59,0,2,55,2,0
31329,94,2363,669,365,481,22,61,110,691,15,103,63,122,118,185,747,1273,8,11311,628,0,2,55,2,0
31330,92,1891,757,253,292,73,244,162,830,13,61,38,67,74,105,409,651,7,4654,258,0,2,2,2,0
31331,123,4932,1450,624,1228,12,26,181,1462,14,306,186,354,320,540,2580,4493,8,36391,2021,1,2,24,0,0
31332,172,5098,1660,832,1314,41,38,274,1701,20,312,209,395,332,604,2671,5058,12,64042,3557,1,2,21,0,0
31333,71,3276,1455,414,1257,16,76,112,1471,5,41,23,46,46,69,231,381,2,1069,59,0,2,19,0,0
31334,52,1785,601,196,481,2,23,85,603,8,63,36,72,71,108,400,664,4,3036,168,0,2,7,21,0
31335,98,2641,1523,757,1297,19,12,193,1542,12,193,117,230,205,347,1508,2664,7,19053,1058,0,2,3,9,0
31336,98,2641,701,378,504,33,58,109,734,13,110,68,126,123,194,794,1346,7,10027,557,0,2,3,9,0
31337,99,4689,1523,757,1297,19,12,193,1542,12,193,117,230,205,347,1508,2664,7,19053,1058,0,2,31,95,0
31338,98,2660,1523,757,1297,19,12,193,1542,12,193,117,230,205,347,1508,2664,7,19053,1058,0,2,4,0,0
31339,98,2660,701,378,504,33,58,109,734,13,110,68,126,123,194,794,1346,7,10027,557,0,2,4,0,0
31340,106,2921,1523,757,1297,19,12,193,1542,12,193,117,230,205,347,1508,2664,7,19053,1058,0,2,54,10,0
31341,106,2921,701,378,504,33,58,109,734,13,110,68,126,123,194,794,1346,7,10027,557,0,2,54,10,0
31342,106,2923,1523,757,1297,19,12,193,1542,12,193,117,230,205,347,1508,2664,7,19053,1058,0,2,17,9,0
31343,106,2923,701,378,504,33,58,109,734,13,110,68,126,123,194,794,1346,7,10027,557,0,2,17,9,0
31344,106,2923,1523,757,1297,19,12,193,1542,12,193,117,230,205,347,1508,2664,7,19053,1058,0,2,1,1,0
31345,106,2923,701,378,504,33,58,109,734,13,110,68,126,123,194,794,1346,7,10027,557,0,2,1,1,0
31346,107,2933,1523,757,1297,19,12,193,1542,12,193,117,230,205,347,1508,2664,7,19053,1058,0,2,26,19,0
31347,107,2933,701,378,504,33,58,109,734,13,110,68,126,123,194,794,1346,7,10027,557,0,2,26,19,0
31348,100,4747,1523,757,1297,19,12,193,1542,12,193,117,230,205,347,1508,2664,7,19053,1058,0,2,38,0,0
31349,107,2933,1523,757,1297,19,12,193,1542,12,193,117,230,205,347,1508,2664,7,19053,1058,0,2,2,3,0
31350,107,2933,701,378,504,33,58,109,734,13,110,68,126,123,194,794,1346,7,10027,557,0,2,2,3,0
31351,108,2938,1523,757,1297,19,12,193,1542,12,193,117,230,205,347,1508,2664,7,19053,1058,0,2,1,1,0
31352,108,2938,701,378,504,33,58,109,734,13,110,68,126,123,194,794,1346,7,10027,557,0,2,1,1,0
31353,54,1145,447,308,343,6,5,95,453,7,96,59,111,103,170,651,1136,4,4600,255,0,2,7,1,0
31354,54,1145,322,174,179,16,74,51,338,10,41,26,46,51,72,252,408,5,2291,127,0,2,7,1,0
31355,45,2037,447,308,343,6,5,95,453,7,96,59,111,103,170,651,1136,4,4600,255,0,2,27,0,0
31356,19,713,442,244,305,14,16,103,456,11,68,45,75,79,120,452,756,6,4588,254,0,2,1,1,0
31357,19,713,182,102,99,11,40,35,193,3,11,6,11,14,17,42,64,1,97,5,0,2,1,1,0
31358,36,1510,442,244,305,14,16,103,456,11,68,45,75,79,120,452,756,6,4588,254,0,2,16,0,0
31359,22,373,102,57,55,5,16,25,107,5,17,10,18,22,28,81,124,2,330,18,0,2,5,4,0
31360,1,14,6,4,4,0,0,2,6,0,0,0,0,0,0,0,0,0,0,0,0,0,6,0,0
31361,69,3105,1020,354,843,12,15,144,1032,8,134,77,144,142,221,970,1580,4,6792,377,0,2,7,0,0
31362,22,373,102,57,55,5,16,25,107,5,17,10,18,22,28,81,124,2,330,18,0,2,5,4,0
31363,1,14,6,4,4,0,0,2,6,0,0,0,0,0,0,0,0,0,0,0,0,0,6,0,0
31364,69,3105,1020,354,843,12,15,144,1032,8,134,77,144,142,221,970,1580,4,6792,377,0,2,7,0,0
31365,19,713,442,244,305,14,16,103,456,11,68,45,75,79,120,452,756,6,4588,254,0,2,1,1,0
31366,19,713,182,102,99,11,40,35,193,3,11,6,11,14,17,42,64,1,97,5,0,2,1,1,0
31367,36,1510,442,244,305,14,16,103,456,11,68,45,75,79,120,452,756,6,4588,254,0,2,16,0,0
31368,42,1241,339,213,244,17,9,65,356,10,42,26,48,52,74,259,421,5,2410,133,0,2,7,3,1
31369,21,541,205,80,86,16,53,53,221,7,18,10,19,25,29,94,134,3,497,27,0,2,3,3,1
31370,65,3082,1293,570,1093,25,15,163,1318,10,195,123,241,205,364,1516,2795,6,17273,959,0,2,71,55,1
31371,67,1570,773,419,590,28,0,166,801,10,204,113,217,214,330,1598,2554,5,13587,754,0,2,1,3,0
31372,67,1570,421,273,302,44,34,57,465,17,81,59,107,98,166,583,1098,11,12329,684,0,2,1,3,0
31373,185,5602,1660,832,1314,41,38,274,1701,20,312,209,395,332,604,2671,5058,12,64042,3557,1,2,1,1,0
31374,185,5602,1057,646,719,113,100,145,1170,18,215,134,248,233,382,1740,3004,10,31186,1732,1,2,1,1,0
31375,90,3983,1338,495,1086,10,64,173,1348,11,122,82,157,133,239,883,1686,7,11934,663,0,2,2,2,0
31376,124,4939,1450,624,1228,12,26,181,1462,14,306,186,354,320,540,2580,4493,8,36391,2021,1,2,6,4,0
31377,67,1570,773,419,590,28,0,166,801,10,204,113,217,214,330,1598,2554,5,13587,754,0,2,1,3,0
31378,67,1570,421,273,302,44,34,57,465,17,81,59,107,98,166,583,1098,11,12329,684,0,2,1,3,0
31379,185,5602,1660,832,1314,41,38,274,1701,20,312,209,395,332,604,2671,5058,12,64042,3557,1,2,1,1,0
31380,185,5602,1057,646,719,113,100,145,1170,18,215,134,248,233,382,1740,3004,10,31186,1732,1,2,1,1,0
31381,90,3983,1338,495,1086,10,64,173,1348,11,122,82,157,133,239,883,1686,7,11934,663,0,2,2,2,0
31382,124,4939,1450,624,1228,12,26,181,1462,14,306,186,354,320,540,2580,4493,8,36391,2021,1,2,6,4,0
31383,14,429,149,95,105,2,0,41,151,8,54,28,55,62,83,334,494,4,2013,111,0,0,71,0,1
31384,14,429,82,56,54,0,13,15,82,4,13,8,16,17,24,56,98,2,241,13,0,0,71,0,1
31385,16,436,149,95,105,2,0,41,151,8,54,28,55,62,83,334,494,4,2013,111,0,0,75,0,1
31386,12,387,149,95,105,2,0,41,151,8,54,28,55,62,83,334,494,4,2013,111,0,2,28,27,1
31387,12,387,82,56,54,0,13,15,82,4,13,8,16,17,24,56,98,2,241,13,0,2,28,27,1
31388,12,318,149,95,105,2,0,41,151,8,54,28,55,62,83,334,494,4,2013,111,0,2,63,72,1
31389,231,4979,182,127,129,0,0,53,182,5,39,21,42,44,63,217,343,2,926,51,0,2,4,3,1
31390,231,4979,1165,710,800,67,119,181,1232,18,243,153,282,261,435,2000,3492,10,36473,2026,1,2,4,3,1
31391,185,5602,1660,832,1314,41,38,274,1701,20,312,209,395,332,604,2671,5058,12,64042,3557,1,2,5,4,1
31392,185,5602,1057,646,719,113,100,145,1170,18,215,134,248,233,382,1740,3004,10,31186,1732,1,2,5,4,1
31393,112,2103,477,336,357,30,23,73,507,16,194,134,250,210,384,1538,2962,10,30538,1696,0,2,9,11,1
31394,73,1518,207,111,150,11,0,50,218,5,26,19,36,31,55,133,272,3,943,52,0,2,2,1,1
31395,73,1518,410,198,237,31,55,97,441,11,63,38,72,74,110,414,683,6,4293,238,0,2,2,1,1
31396,245,5869,722,423,573,19,0,135,741,12,172,101,199,184,300,1320,2257,6,15668,870,0,2,2,3,1
31397,245,5869,1508,847,911,44,250,301,1552,14,148,88,169,162,257,1120,1886,7,15077,837,0,2,2,3,1
31398,231,4979,182,127,129,0,0,53,182,5,39,21,42,44,63,217,343,2,926,51,0,2,4,3,0
31399,231,4979,1165,710,800,67,119,181,1232,18,243,153,282,261,435,2000,3492,10,36473,2026,1,2,4,3,0
31400,12,387,149,95,105,2,0,41,151,8,54,28,55,62,83,334,494,4,2013,111,0,0,72,0,0
31401,12,387,82,56,54,0,13,15,82,4,13,8,16,17,24,56,98,2,241,13,0,0,72,0,0
31402,185,5602,1660,832,1314,41,38,274,1701,20,312,209,395,332,604,2671,5058,12,64042,3557,1,2,5,4,0
31403,185,5602,1057,646,719,113,100,145,1170,18,215,134,248,233,382,1740,3004,10,31186,1732,1,2,5,4,0
31404,112,2103,477,336,357,30,23,73,507,16,194,134,250,210,384,1538,2962,10,30538,1696,0,2,9,11,0
31405,73,1518,207,111,150,11,0,50,218,5,26,19,36,31,55,133,272,3,943,52,0,2,2,1,0
31406,73,1518,410,198,237,31,55,97,441,11,63,38,72,74,110,414,683,6,4293,238,0,2,2,1,0
31407,245,5869,722,423,573,19,0,135,741,12,172,101,199,184,300,1320,2257,6,15668,870,0,2,2,3,0
31408,245,5869,1508,847,911,44,250,301,1552,14,148,88,169,162,257,1120,1886,7,15077,837,0,2,2,3,0
31409,12,318,149,95,105,2,0,41,151,8,54,28,55,62,83,334,494,4,2013,111,0,0,66,0,0
31410,232,4964,1943,715,1694,26,18,214,1969,12,185,120,237,197,357,1436,2721,7,20915,1161,0,2,3,0,0
31411,232,4964,1168,838,957,57,25,144,1225,19,348,224,416,367,640,3018,5452,11,61921,3440,1,2,3,0,0
31412,7,296,72,33,56,0,4,12,72,1,1,1,1,2,2,0,2,0,1,0,0,2,5,5,1
31413,245,5671,4293,999,3693,19,54,507,4312,9,155,88,170,164,258,1156,1898,4,9368,520,0,2,1,1,1
31414,245,5671,1482,859,1002,125,135,219,1607,16,219,134,251,235,385,1766,3032,9,27804,1544,1,2,1,1,1
31415,245,5880,722,423,573,19,0,135,741,12,172,101,199,184,300,1320,2257,6,15668,870,0,2,5,7,1
31416,245,5880,1508,847,911,44,250,301,1552,14,148,88,169,162,257,1120,1886,7,15077,837,0,2,5,7,1
31417,291,6502,72,33,56,0,4,12,72,1,1,1,1,2,2,0,2,0,1,0,0,2,1,1,1
31418,291,6502,1454,835,1044,76,110,219,1530,17,275,158,296,292,454,2297,3718,9,34017,1889,1,2,1,1,1
31419,124,5347,1513,682,1277,25,13,200,1538,11,199,116,219,210,335,1557,2584,6,15641,868,0,2,12,10,1
31420,39,2363,334,251,279,10,4,40,344,5,127,74,143,132,217,899,1528,2,4303,239,0,2,2,1,1
31421,7,296,72,33,56,0,4,12,72,1,1,1,1,2,2,0,2,0,1,0,0,2,5,5,0
31422,245,5671,4293,999,3693,19,54,507,4312,9,155,88,170,164,258,1156,1898,4,9368,520,0,2,1,1,0
31423,245,5671,1482,859,1002,125,135,219,1607,16,219,134,251,235,385,1766,3032,9,27804,1544,1,2,1,1,0
31424,245,5880,722,423,573,19,0,135,741,12,172,101,199,184,300,1320,2257,6,15668,870,0,2,5,7,0
31425,245,5880,1508,847,911,44,250,301,1552,14,148,88,169,162,257,1120,1886,7,15077,837,0,2,5,7,0
31426,291,6502,72,33,56,0,4,12,72,1,1,1,1,2,2,0,2,0,1,0,0,2,1,1,0
31427,291,6502,1454,835,1044,76,110,219,1530,17,275,158,296,292,454,2297,3718,9,34017,1889,1,2,1,1,0
31428,124,5347,1513,682,1277,25,13,200,1538,11,199,116,219,210,335,1557,2584,6,15641,868,0,2,12,10,0
31429,39,2363,334,251,279,10,4,40,344,5,127,74,143,132,217,899,1528,2,4303,239,0,2,2,1,0
31430,123,5301,1513,682,1277,25,13,200,1538,11,199,116,219,210,335,1557,2584,6,15641,868,0,2,0,9,0
31431,123,5301,1513,682,1277,25,13,200,1538,11,199,116,219,210,335,1557,2584,6,15641,868,0,2,0,9,0
31432,235,4993,1943,715,1694,26,18,214,1969,12,185,120,237,197,357,1436,2721,7,20915,1161,0,2,21,21,0
31433,235,4993,1168,838,957,57,25,144,1225,19,348,224,416,367,640,3018,5452,11,61921,3440,1,2,21,21,0
31434,3,49,16,9,9,0,0,7,16,0,0,0,0,0,0,0,0,0,0,0,0,0,16,0,0
31435,53,1862,601,196,481,2,23,85,603,8,63,36,72,71,108,400,664,4,3036,168,0,2,19,0,0
31436,313,6832,72,33,56,0,4,12,72,1,1,1,1,2,2,0,2,0,1,0,0,2,142,46,0
31437,313,6832,1454,835,1044,76,110,219,1530,17,275,158,296,292,454,2297,3718,9,34017,1889,1,2,142,46,0
31438,68,1302,1098,241,925,5,10,155,1103,7,46,25,49,53,74,273,423,3,1580,87,0,2,45,19,0
31439,68,1302,282,202,222,14,2,44,296,8,42,24,43,50,67,250,378,4,1548,86,0,2,45,19,0
31440,90,3974,1338,495,1086,10,64,173,1348,11,122,82,157,133,239,883,1686,7,11934,663,0,2,0,3,0
31441,170,7538,139,89,101,2,0,35,141,7,54,34,62,61,96,330,569,4,2287,127,0,2,39,0,0
31442,170,7538,7,5,5,0,0,2,7,1,2,1,2,3,3,2,4,0,2,0,0,2,39,0,0
31443,232,4966,1943,715,1694,26,18,214,1969,12,185,120,237,197,357,1436,2721,7,20915,1161,0,2,1,1,0
31444,232,4966,1168,838,957,57,25,144,1225,19,348,224,416,367,640,3018,5452,11,61921,3440,1,2,1,1,0
31445,47,3455,996,429,845,24,10,117,1020,7,76,50,88,83,138,494,879,4,3565,198,0,2,1,1,0
31446,101,5272,1943,715,1694,26,18,214,1969,12,185,120,237,197,357,1436,2721,7,20915,1161,0,2,2,2,0
31447,99,2681,1523,757,1297,19,12,193,1542,12,193,117,230,205,347,1508,2664,7,19053,1058,0,2,1,1,1
31448,99,2681,701,378,504,33,58,109,734,13,110,68,126,123,194,794,1346,7,10027,557,0,2,1,1,1
31449,28,713,466,257,367,18,25,50,484,7,126,86,171,133,257,898,1813,4,8612,478,0,2,4,0,1
31450,28,713,507,281,342,29,59,88,536,10,53,29,57,63,86,336,514,5,2764,153,0,2,4,0,1
31451,71,1445,1178,367,1042,6,15,115,1184,9,94,51,95,103,146,644,976,4,4439,246,0,2,26,25,1
31452,71,1445,177,108,140,8,0,27,185,6,30,16,32,36,48,162,248,3,794,44,0,2,26,25,1
31453,237,5000,1943,715,1694,26,18,214,1969,12,185,120,237,197,357,1436,2721,7,20915,1161,0,2,5,3,1
31454,237,5000,1168,838,957,57,25,144,1225,19,348,224,416,367,640,3018,5452,11,61921,3440,1,2,5,3,1
31455,99,4102,1289,550,1043,56,32,155,1345,10,167,93,185,177,278,1266,2075,5,11498,638,0,2,2,2,1
31456,77,3228,1178,367,1042,6,15,115,1184,9,94,51,95,103,146,644,976,4,4439,246,0,2,1,1,1
31457,103,5339,1943,715,1694,26,18,214,1969,12,185,120,237,197,357,1436,2721,7,20915,1161,0,2,1,1,1
31458,245,5864,722,423,573,19,0,135,741,12,172,101,199,184,300,1320,2257,6,15668,870,0,2,5,8,0
31459,245,5864,1508,847,911,44,250,301,1552,14,148,88,169,162,257,1120,1886,7,15077,837,0,2,5,8,0
31460,71,1439,1178,367,1042,6,15,115,1184,9,94,51,95,103,146,644,976,4,4439,246,0,2,5,2,0
31461,71,1439,177,108,140,8,0,27,185,6,30,16,32,36,48,162,248,3,794,44,0,2,5,2,0
31462,77,3233,1178,367,1042,6,15,115,1184,9,94,51,95,103,146,644,976,4,4439,246,0,2,1,0,0
31463,99,2681,1523,757,1297,19,12,193,1542,12,193,117,230,205,347,1508,2664,7,19053,1058,0,2,1,1,0
31464,99,2681,701,378,504,33,58,109,734,13,110,68,126,123,194,794,1346,7,10027,557,0,2,1,1,0
31465,245,5864,722,423,573,19,0,135,741,12,172,101,199,184,300,1320,2257,6,15668,870,0,2,5,8,0
31466,245,5864,1508,847,911,44,250,301,1552,14,148,88,169,162,257,1120,1886,7,15077,837,0,2,5,8,0
31467,28,713,466,257,367,18,25,50,484,7,126,86,171,133,257,898,1813,4,8612,478,0,2,4,0,0
31468,28,713,507,281,342,29,59,88,536,10,53,29,57,63,86,336,514,5,2764,153,0,2,4,0,0
31469,71,1439,1178,367,1042,6,15,115,1184,9,94,51,95,103,146,644,976,4,4439,246,0,2,31,27,0
31470,71,1439,177,108,140,8,0,27,185,6,30,16,32,36,48,162,248,3,794,44,0,2,31,27,0
31471,237,5000,1943,715,1694,26,18,214,1969,12,185,120,237,197,357,1436,2721,7,20915,1161,0,2,5,3,0
31472,237,5000,1168,838,957,57,25,144,1225,19,348,224,416,367,640,3018,5452,11,61921,3440,1,2,5,3,0
31473,99,4102,1289,550,1043,56,32,155,1345,10,167,93,185,177,278,1266,2075,5,11498,638,0,2,2,2,0
31474,77,3233,1178,367,1042,6,15,115,1184,9,94,51,95,103,146,644,976,4,4439,246,0,2,2,1,0
31475,103,5339,1943,715,1694,26,18,214,1969,12,185,120,237,197,357,1436,2721,7,20915,1161,0,2,1,1,0
31476,238,5016,1943,715,1694,26,18,214,1969,12,185,120,237,197,357,1436,2721,7,20915,1161,0,2,21,21,0
31477,238,5016,1168,838,957,57,25,144,1225,19,348,224,416,367,640,3018,5452,11,61921,3440,1,2,21,21,0
31478,3,49,16,9,9,0,0,7,16,0,0,0,0,0,0,0,0,0,0,0,0,0,16,0,0
31479,53,1862,601,196,481,2,23,85,603,8,63,36,72,71,108,400,664,4,3036,168,0,2,19,0,0
31480,232,4966,1943,715,1694,26,18,214,1969,12,185,120,237,197,357,1436,2721,7,20915,1161,0,2,3,0,0
31481,232,4966,1168,838,957,57,25,144,1225,19,348,224,416,367,640,3018,5452,11,61921,3440,1,2,3,0,0
31482,47,3455,996,429,845,24,10,117,1020,7,76,50,88,83,138,494,879,4,3565,198,0,2,1,1,0
31483,101,5272,1943,715,1694,26,18,214,1969,12,185,120,237,197,357,1436,2721,7,20915,1161,0,2,2,2,0
31484,108,2938,1523,757,1297,19,12,193,1542,12,193,117,230,205,347,1508,2664,7,19053,1058,0,2,66,10,0
31485,108,2938,701,378,504,33,58,109,734,13,110,68,126,123,194,794,1346,7,10027,557,0,2,66,10,0
31486,100,4747,1523,757,1297,19,12,193,1542,12,193,117,230,205,347,1508,2664,7,19053,1058,0,2,69,95,0
31487,19,709,442,244,305,14,16,103,456,11,68,45,75,79,120,452,756,6,4588,254,0,2,2,2,0
31488,19,709,182,102,99,11,40,35,193,3,11,6,11,14,17,42,64,1,97,5,0,2,2,2,0
31489,36,1456,442,244,305,14,16,103,456,11,68,45,75,79,120,452,756,6,4588,254,0,2,4,0,0
31490,19,717,442,244,305,14,16,103,456,11,68,45,75,79,120,452,756,6,4588,254,0,2,2,2,0
31491,19,717,182,102,99,11,40,35,193,3,11,6,11,14,17,42,64,1,97,5,0,2,2,2,0
31492,170,7538,139,89,101,2,0,35,141,7,54,34,62,61,96,330,569,4,2287,127,0,2,1,1,0
31493,170,7538,7,5,5,0,0,2,7,1,2,1,2,3,3,2,4,0,2,0,0,2,1,1,0
31494,93,1905,757,253,292,73,244,162,830,13,61,38,67,74,105,409,651,7,4654,258,0,2,30,0,0
31495,33,1041,256,139,192,9,7,47,265,4,23,12,24,27,36,112,171,2,357,19,0,2,40,0,0
31496,93,1905,757,253,292,73,244,162,830,13,61,38,67,74,105,409,651,7,4654,258,0,2,19,6,0
31497,33,1041,256,139,192,9,7,47,265,4,23,12,24,27,36,112,171,2,357,19,0,2,0,2,0
31498,92,1891,757,253,292,73,244,162,830,13,61,38,67,74,105,409,651,7,4654,258,0,2,0,35,0
31499,33,1041,256,139,192,9,7,47,265,4,23,12,24,27,36,112,171,2,357,19,0,2,14,4,0
31500,18,310,424,94,331,4,0,89,428,1,5,5,5,6,10,11,25,0,12,0,0,2,3,1,1
31501,18,310,38,23,23,6,0,8,44,3,11,7,11,14,18,42,68,1,102,5,0,2,3,1,1
31502,21,653,424,94,331,4,0,89,428,1,5,5,5,6,10,11,25,0,12,0,0,2,15,0,1
31503,18,310,424,94,331,4,0,89,428,1,5,5,5,6,10,11,25,0,12,0,0,2,3,1,0
31504,18,310,38,23,23,6,0,8,44,3,11,7,11,14,18,42,68,1,102,5,0,2,3,1,0
31505,21,653,424,94,331,4,0,89,428,1,5,5,5,6,10,11,25,0,12,0,0,2,15,0,0
31506,52,623,647,139,84,35,284,233,682,0,0,0,0,0,0,0,0,0,0,0,0,2,3,1,0
31507,25,552,215,129,180,6,0,29,221,8,65,43,72,73,115,415,711,4,3153,175,0,2,3,1,0
31508,25,552,97,69,77,3,3,16,100,6,22,13,23,28,36,113,173,3,542,30,0,2,3,1,0
31509,232,4972,1943,715,1694,26,18,214,1969,12,185,120,237,197,357,1436,2721,7,20915,1161,0,2,1,1,0
31510,232,4972,1168,838,957,57,25,144,1225,19,348,224,416,367,640,3018,5452,11,61921,3440,1,2,1,1,0
31511,52,623,647,139,84,35,284,233,682,0,0,0,0,0,0,0,0,0,0,0,0,2,3,1,0
31512,25,552,215,129,180,6,0,29,221,8,65,43,72,73,115,415,711,4,3153,175,0,2,3,1,0
31513,25,552,97,69,77,3,3,16,100,6,22,13,23,28,36,113,173,3,542,30,0,2,3,1,0
31514,232,4972,1943,715,1694,26,18,214,1969,12,185,120,237,197,357,1436,2721,7,20915,1161,0,2,1,1,0
31515,232,4972,1168,838,957,57,25,144,1225,19,348,224,416,367,640,3018,5452,11,61921,3440,1,2,1,1,0
31516,52,625,647,139,84,35,284,233,682,0,0,0,0,0,0,0,0,0,0,0,0,2,3,2,0
31517,232,4978,1943,715,1694,26,18,214,1969,12,185,120,237,197,357,1436,2721,7,20915,1161,0,2,1,1,0
31518,232,4978,1168,838,957,57,25,144,1225,19,348,224,416,367,640,3018,5452,11,61921,3440,1,2,1,1,0
31519,19,720,442,244,305,14,16,103,456,11,68,45,75,79,120,452,756,6,4588,254,0,2,2,1,0
31520,19,720,182,102,99,11,40,35,193,3,11,6,11,14,17,42,64,1,97,5,0,2,2,1,0
31521,19,720,442,244,305,14,16,103,456,11,68,45,75,79,120,452,756,6,4588,254,0,2,4,3,0
31522,19,720,182,102,99,11,40,35,193,3,11,6,11,14,17,42,64,1,97,5,0,2,4,3,0
31523,170,7538,139,89,101,2,0,35,141,7,54,34,62,61,96,330,569,4,2287,127,0,2,1,1,0
31524,170,7538,7,5,5,0,0,2,7,1,2,1,2,3,3,2,4,0,2,0,0,2,1,1,0
31525,36,1456,442,244,305,14,16,103,456,11,68,45,75,79,120,452,756,6,4588,254,0,2,4,0,0
31526,236,5073,1943,715,1694,26,18,214,1969,12,185,120,237,197,357,1436,2721,7,20915,1161,0,2,15,0,0
31527,236,5073,1168,838,957,57,25,144,1225,19,348,224,416,367,640,3018,5452,11,61921,3440,1,2,15,0,0
31528,100,4116,1289,550,1043,56,32,155,1345,10,167,93,185,177,278,1266,2075,5,11498,638,0,2,3,1,0
31529,16,895,75,38,59,1,3,12,76,2,4,2,4,6,6,10,15,1,15,0,0,2,19,0,0
31530,42,1241,339,213,244,17,9,65,356,10,42,26,48,52,74,259,421,5,2410,133,0,2,7,3,0
31531,21,541,205,80,86,16,53,53,221,7,18,10,19,25,29,94,134,3,497,27,0,2,3,3,0
31532,65,3082,1293,570,1093,25,15,163,1318,10,195,123,241,205,364,1516,2795,6,17273,959,0,2,71,55,0
31533,7,296,72,33,56,0,4,12,72,1,1,1,1,2,2,0,2,0,1,0,0,2,5,5,0
31534,231,4973,182,127,129,0,0,53,182,5,39,21,42,44,63,217,343,2,926,51,0,2,4,3,0
31535,231,4973,1165,710,800,67,119,181,1232,18,243,153,282,261,435,2000,3492,10,36473,2026,1,2,4,3,0
31536,67,1570,773,419,590,28,0,166,801,10,204,113,217,214,330,1598,2554,5,13587,754,0,2,1,3,0
31537,67,1570,421,273,302,44,34,57,465,17,81,59,107,98,166,583,1098,11,12329,684,0,2,1,3,0
31538,12,387,149,95,105,2,0,41,151,8,54,28,55,62,83,334,494,4,2013,111,0,0,72,0,0
31539,12,387,82,56,54,0,13,15,82,4,13,8,16,17,24,56,98,2,241,13,0,0,72,0,0
31540,183,5544,1660,832,1314,41,38,274,1701,20,312,209,395,332,604,2671,5058,12,64042,3557,1,2,6,5,0
31541,183,5544,1057,646,719,113,100,145,1170,18,215,134,248,233,382,1740,3004,10,31186,1732,1,2,6,5,0
31542,112,2103,477,336,357,30,23,73,507,16,194,134,250,210,384,1538,2962,10,30538,1696,0,2,9,11,0
31543,73,1518,207,111,150,11,0,50,218,5,26,19,36,31,55,133,272,3,943,52,0,2,2,1,0
31544,73,1518,410,198,237,31,55,97,441,11,63,38,72,74,110,414,683,6,4293,238,0,2,2,1,0
31545,245,5664,4293,999,3693,19,54,507,4312,9,155,88,170,164,258,1156,1898,4,9368,520,0,2,1,1,0
31546,245,5664,1482,859,1002,125,135,219,1607,16,219,134,251,235,385,1766,3032,9,27804,1544,1,2,1,1,0
31547,108,2933,1523,757,1297,19,12,193,1542,12,193,117,230,205,347,1508,2664,7,19053,1058,0,2,1,1,0
31548,108,2933,701,378,504,33,58,109,734,13,110,68,126,123,194,794,1346,7,10027,557,0,2,1,1,0
31549,22,373,102,57,55,5,16,25,107,5,17,10,18,22,28,81,124,2,330,18,0,2,5,4,0
31550,54,1145,447,308,343,6,5,95,453,7,96,59,111,103,170,651,1136,4,4600,255,0,2,7,1,0
31551,54,1145,322,174,179,16,74,51,338,10,41,26,46,51,72,252,408,5,2291,127,0,2,7,1,0
31552,18,310,424,94,331,4,0,89,428,1,5,5,5,6,10,11,25,0,12,0,0,2,3,1,0
31553,18,310,38,23,23,6,0,8,44,3,11,7,11,14,18,42,68,1,102,5,0,2,3,1,0
31554,245,5864,722,423,573,19,0,135,741,12,172,101,199,184,300,1320,2257,6,15668,870,0,2,12,18,0
31555,245,5864,1508,847,911,44,250,301,1552,14,148,88,169,162,257,1120,1886,7,15077,837,0,2,12,18,0
31556,313,6834,72,33,56,0,4,12,72,1,1,1,1,2,2,0,2,0,1,0,0,2,1,1,0
31557,313,6834,1454,835,1044,76,110,219,1530,17,275,158,296,292,454,2297,3718,9,34017,1889,1,2,1,1,0
31558,27,671,466,257,367,18,25,50,484,7,126,86,171,133,257,898,1813,4,8612,478,0,2,4,0,0
31559,27,671,507,281,342,29,59,88,536,10,53,29,57,63,86,336,514,5,2764,153,0,2,4,0,0
31560,71,1439,1178,367,1042,6,15,115,1184,9,94,51,95,103,146,644,976,4,4439,246,0,2,31,27,0
31561,71,1439,177,108,140,8,0,27,185,6,30,16,32,36,48,162,248,3,794,44,0,2,31,27,0
31562,236,5011,1943,715,1694,26,18,214,1969,12,185,120,237,197,357,1436,2721,7,20915,1161,0,2,26,24,0
31563,236,5011,1168,838,957,57,25,144,1225,19,348,224,416,367,640,3018,5452,11,61921,3440,1,2,26,24,0
31564,99,4102,1289,550,1043,56,32,155,1345,10,167,93,185,177,278,1266,2075,5,11498,638,0,2,2,2,0
31565,1,14,6,4,4,0,0,2,6,0,0,0,0,0,0,0,0,0,0,0,0,0,6,0,0
31566,3,49,16,9,9,0,0,7,16,0,0,0,0,0,0,0,0,0,0,0,0,0,16,0,0
31567,12,318,149,95,105,2,0,41,151,8,54,28,55,62,83,334,494,4,2013,111,0,0,66,0,0
31568,90,3974,1338,495,1086,10,64,173,1348,11,122,82,157,133,239,883,1686,7,11934,663,0,2,2,2,0
31569,124,4939,1450,624,1228,12,26,181,1462,14,306,186,354,320,540,2580,4493,8,36391,2021,1,2,6,4,0
31570,123,5301,1513,682,1277,25,13,200,1538,11,199,116,219,210,335,1557,2584,6,15641,868,0,2,11,18,0
31571,69,3105,1020,354,843,12,15,144,1032,8,134,77,144,142,221,970,1580,4,6792,377,0,2,7,0,0
31572,45,2037,447,308,343,6,5,95,453,7,96,59,111,103,170,651,1136,4,4600,255,0,2,27,0,0
31573,21,653,424,94,331,4,0,89,428,1,5,5,5,6,10,11,25,0,12,0,0,2,15,0,0
31574,39,2363,334,251,279,10,4,40,344,5,127,74,143,132,217,899,1528,2,4303,239,0,2,2,1,0
31575,77,3233,1178,367,1042,6,15,115,1184,9,94,51,95,103,146,644,976,4,4439,246,0,2,2,1,0
31576,101,5272,1943,715,1694,26,18,214,1969,12,185,120,237,197,357,1436,2721,7,20915,1161,0,2,1,1,0
31577,37,1525,442,244,305,14,16,103,456,11,68,45,75,79,120,452,756,6,4588,254,0,2,16,0,0
31578,53,1862,601,196,481,2,23,85,603,8,63,36,72,71,108,400,664,4,3036,168,0,2,19,0,0
31579,52,625,647,139,84,35,284,233,682,0,0,0,0,0,0,0,0,0,0,0,0,2,3,2,0
31580,232,4978,1943,715,1694,26,18,214,1969,12,185,120,237,197,357,1436,2721,7,20915,1161,0,2,1,1,0
31581,232,4978,1168,838,957,57,25,144,1225,19,348,224,416,367,640,3018,5452,11,61921,3440,1,2,1,1,0
31582,245,5671,4293,999,3693,19,54,507,4312,9,155,88,170,164,258,1156,1898,4,9368,520,0,2,2,2,0
31583,245,5671,1482,859,1002,125,135,219,1607,16,219,134,251,235,385,1766,3032,9,27804,1544,1,2,2,2,0
31584,94,2438,773,422,505,30,103,129,803,14,77,46,83,91,129,535,839,7,6334,351,0,2,1,1,0
31585,69,1497,402,202,227,24,74,80,426,12,52,33,61,64,94,339,564,7,3969,220,0,2,2,2,0
31586,95,2085,1043,504,840,53,9,147,1096,9,180,112,198,189,310,1377,2344,4,11604,644,0,2,1,1,0
31587,95,2085,383,288,292,26,6,62,409,11,65,38,67,76,105,429,656,5,3719,206,0,2,1,1,0
31588,220,4689,2,2,2,0,0,0,2,0,0,0,0,0,0,0,0,0,0,0,0,2,1,1,0
31589,220,4689,99,48,90,1,3,5,100,0,0,0,0,0,0,0,0,0,0,0,0,2,1,1,0
31590,220,4689,8,5,5,2,0,1,10,0,0,0,0,0,0,0,0,0,0,0,0,2,1,1,0
31591,220,4689,1217,716,841,84,126,174,1301,14,185,118,215,199,333,1446,2542,8,20687,1149,0,2,1,1,0
31592,220,4689,160,89,115,0,13,31,160,7,15,11,17,22,28,78,124,3,495,27,0,2,1,1,0
31593,220,4689,10,10,9,9,0,0,19,0,0,0,0,0,0,0,0,0,0,0,0,2,1,1,0
31594,220,4689,173,84,99,8,29,36,181,5,12,7,13,17,20,54,81,2,221,12,0,2,1,1,0
31595,220,4689,3,1,1,3,0,0,6,0,0,0,0,0,0,0,0,0,0,0,0,2,1,1,0
31596,236,5079,1943,715,1694,26,18,214,1969,12,185,120,237,197,357,1436,2721,7,20915,1161,0,2,15,0,0
31597,236,5079,1168,838,957,57,25,144,1225,19,348,224,416,367,640,3018,5452,11,61921,3440,1,2,15,0,0
31598,100,4116,1289,550,1043,56,32,155,1345,10,167,93,185,177,278,1266,2075,5,11498,638,0,2,3,1,0
31599,16,895,75,38,59,1,3,12,76,2,4,2,4,6,6,10,15,1,15,0,0,2,19,0,0
31600,220,4689,2,2,2,0,0,0,2,0,0,0,0,0,0,0,0,0,0,0,0,2,1,1,0
31601,220,4689,99,48,90,1,3,5,100,0,0,0,0,0,0,0,0,0,0,0,0,2,1,1,0
31602,220,4689,8,5,5,2,0,1,10,0,0,0,0,0,0,0,0,0,0,0,0,2,1,1,0
31603,220,4689,1217,716,841,84,126,174,1301,14,185,118,215,199,333,1446,2542,8,20687,1149,0,2,1,1,0
31604,220,4689,160,89,115,0,13,31,160,7,15,11,17,22,28,78,124,3,495,27,0,2,1,1,0
31605,220,4689,10,10,9,9,0,0,19,0,0,0,0,0,0,0,0,0,0,0,0,2,1,1,0
31606,220,4689,173,84,99,8,29,36,181,5,12,7,13,17,20,54,81,2,221,12,0,2,1,1,0
31607,220,4689,3,1,1,3,0,0,6,0,0,0,0,0,0,0,0,0,0,0,0,2,1,1,0
31608,245,5671,4293,999,3693,19,54,507,4312,9,155,88,170,164,258,1156,1898,4,9368,520,0,2,2,2,0
31609,245,5671,1482,859,1002,125,135,219,1607,16,219,134,251,235,385,1766,3032,9,27804,1544,1,2,2,2,0
31610,94,2438,773,422,505,30,103,129,803,14,77,46,83,91,129,535,839,7,6334,351,0,2,1,1,0
31611,69,1497,402,202,227,24,74,80,426,12,52,33,61,64,94,339,564,7,3969,220,0,2,2,2,0
31612,95,2085,1043,504,840,53,9,147,1096,9,180,112,198,189,310,1377,2344,4,11604,644,0,2,1,1,0
31613,95,2085,383,288,292,26,6,62,409,11,65,38,67,76,105,429,656,5,3719,206,0,2,1,1,0
31614,71,1445,1178,367,1042,6,15,115,1184,9,94,51,95,103,146,644,976,4,4439,246,0,2,1,1,0
31615,71,1445,177,108,140,8,0,27,185,6,30,16,32,36,48,162,248,3,794,44,0,2,1,1,0
31616,220,4689,2,2,2,0,0,0,2,0,0,0,0,0,0,0,0,0,0,0,0,2,1,1,0
31617,220,4689,99,48,90,1,3,5,100,0,0,0,0,0,0,0,0,0,0,0,0,2,1,1,0
31618,220,4689,8,5,5,2,0,1,10,0,0,0,0,0,0,0,0,0,0,0,0,2,1,1,0
31619,220,4689,1217,716,841,84,126,174,1301,14,185,118,215,199,333,1446,2542,8,20687,1149,0,2,1,1,0
31620,220,4689,160,89,115,0,13,31,160,7,15,11,17,22,28,78,124,3,495,27,0,2,1,1,0
31621,220,4689,10,10,9,9,0,0,19,0,0,0,0,0,0,0,0,0,0,0,0,2,1,1,0
31622,220,4689,173,84,99,8,29,36,181,5,12,7,13,17,20,54,81,2,221,12,0,2,1,1,0
31623,220,4689,3,1,1,3,0,0,6,0,0,0,0,0,0,0,0,0,0,0,0,2,1,1,0
31624,245,5664,4293,999,3693,19,54,507,4312,9,155,88,170,164,258,1156,1898,4,9368,520,0,2,2,2,0
31625,245,5664,1482,859,1002,125,135,219,1607,16,219,134,251,235,385,1766,3032,9,27804,1544,1,2,2,2,0
31626,94,2438,773,422,505,30,103,129,803,14,77,46,83,91,129,535,839,7,6334,351,0,2,1,1,0
31627,69,1497,402,202,227,24,74,80,426,12,52,33,61,64,94,339,564,7,3969,220,0,2,2,2,0
31628,95,2085,1043,504,840,53,9,147,1096,9,180,112,198,189,310,1377,2344,4,11604,644,0,2,1,1,0
31629,95,2085,383,288,292,26,6,62,409,11,65,38,67,76,105,429,656,5,3719,206,0,2,1,1,0
31630,52,625,647,139,84,35,284,233,682,0,0,0,0,0,0,0,0,0,0,0,0,2,3,2,0
31631,240,5118,1943,715,1694,26,18,214,1969,12,185,120,237,197,357,1436,2721,7,20915,1161,0,2,16,1,0
31632,240,5118,1168,838,957,57,25,144,1225,19,348,224,416,367,640,3018,5452,11,61921,3440,1,2,16,1,0
31633,100,4121,1289,550,1043,56,32,155,1345,10,167,93,185,177,278,1266,2075,5,11498,638,0,2,3,1,0
31634,16,895,75,38,59,1,3,12,76,2,4,2,4,6,6,10,15,1,15,0,0,2,19,0,0
31635,7,296,72,33,56,0,4,12,72,1,1,1,1,2,2,0,2,0,1,0,0,2,5,5,0
31636,231,4973,182,127,129,0,0,53,182,5,39,21,42,44,63,217,343,2,926,51,0,2,4,3,0
31637,231,4973,1165,710,800,67,119,181,1232,18,243,153,282,261,435,2000,3492,10,36473,2026,1,2,4,3,0
31638,67,1570,773,419,590,28,0,166,801,10,204,113,217,214,330,1598,2554,5,13587,754,0,2,1,3,0
31639,67,1570,421,273,302,44,34,57,465,17,81,59,107,98,166,583,1098,11,12329,684,0,2,1,3,0
31640,12,387,149,95,105,2,0,41,151,8,54,28,55,62,83,334,494,4,2013,111,0,0,72,0,0
31641,12,387,82,56,54,0,13,15,82,4,13,8,16,17,24,56,98,2,241,13,0,0,72,0,0
31642,183,5544,1660,832,1314,41,38,274,1701,20,312,209,395,332,604,2671,5058,12,64042,3557,1,2,6,5,0
31643,183,5544,1057,646,719,113,100,145,1170,18,215,134,248,233,382,1740,3004,10,31186,1732,1,2,6,5,0
31644,112,2103,477,336,357,30,23,73,507,16,194,134,250,210,384,1538,2962,10,30538,1696,0,2,9,11,0
31645,73,1518,207,111,150,11,0,50,218,5,26,19,36,31,55,133,272,3,943,52,0,2,2,1,0
31646,73,1518,410,198,237,31,55,97,441,11,63,38,72,74,110,414,683,6,4293,238,0,2,2,1,0
31647,220,4689,2,2,2,0,0,0,2,0,0,0,0,0,0,0,0,0,0,0,0,2,1,1,0
31648,220,4689,99,48,90,1,3,5,100,0,0,0,0,0,0,0,0,0,0,0,0,2,1,1,0
31649,220,4689,8,5,5,2,0,1,10,0,0,0,0,0,0,0,0,0,0,0,0,2,1,1,0
31650,220,4689,1217,716,841,84,126,174,1301,14,185,118,215,199,333,1446,2542,8,20687,1149,0,2,1,1,0
31651,220,4689,160,89,115,0,13,31,160,7,15,11,17,22,28,78,124,3,495,27,0,2,1,1,0
31652,220,4689,10,10,9,9,0,0,19,0,0,0,0,0,0,0,0,0,0,0,0,2,1,1,0
31653,220,4689,173,84,99,8,29,36,181,5,12,7,13,17,20,54,81,2,221,12,0,2,1,1,0
31654,220,4689,3,1,1,3,0,0,6,0,0,0,0,0,0,0,0,0,0,0,0,2,1,1,0
31655,245,5664,4293,999,3693,19,54,507,4312,9,155,88,170,164,258,1156,1898,4,9368,520,0,2,3,3,0
31656,245,5664,1482,859,1002,125,135,219,1607,16,219,134,251,235,385,1766,3032,9,27804,1544,1,2,3,3,0
31657,108,2933,1523,757,1297,19,12,193,1542,12,193,117,230,205,347,1508,2664,7,19053,1058,0,2,1,1,0
31658,108,2933,701,378,504,33,58,109,734,13,110,68,126,123,194,794,1346,7,10027,557,0,2,1,1,0
31659,94,2438,773,422,505,30,103,129,803,14,77,46,83,91,129,535,839,7,6334,351,0,2,1,1,0
31660,22,373,102,57,55,5,16,25,107,5,17,10,18,22,28,81,124,2,330,18,0,2,5,4,0
31661,69,1497,402,202,227,24,74,80,426,12,52,33,61,64,94,339,564,7,3969,220,0,2,2,2,0
31662,54,1145,447,308,343,6,5,95,453,7,96,59,111,103,170,651,1136,4,4600,255,0,2,7,1,0
31663,54,1145,322,174,179,16,74,51,338,10,41,26,46,51,72,252,408,5,2291,127,0,2,7,1,0
31664,18,310,424,94,331,4,0,89,428,1,5,5,5,6,10,11,25,0,12,0,0,2,3,1,0
31665,18,310,38,23,23,6,0,8,44,3,11,7,11,14,18,42,68,1,102,5,0,2,3,1,0
31666,245,5864,722,423,573,19,0,135,741,12,172,101,199,184,300,1320,2257,6,15668,870,0,2,12,18,0
31667,245,5864,1508,847,911,44,250,301,1552,14,148,88,169,162,257,1120,1886,7,15077,837,0,2,12,18,0
31668,313,6834,72,33,56,0,4,12,72,1,1,1,1,2,2,0,2,0,1,0,0,2,1,1,0
31669,313,6834,1454,835,1044,76,110,219,1530,17,275,158,296,292,454,2297,3718,9,34017,1889,1,2,1,1,0
31670,27,671,466,257,367,18,25,50,484,7,126,86,171,133,257,898,1813,4,8612,478,0,2,4,0,0
31671,27,671,507,281,342,29,59,88,536,10,53,29,57,63,86,336,514,5,2764,153,0,2,4,0,0
31672,95,2085,1043,504,840,53,9,147,1096,9,180,112,198,189,310,1377,2344,4,11604,644,0,2,1,1,0
31673,95,2085,383,288,292,26,6,62,409,11,65,38,67,76,105,429,656,5,3719,206,0,2,1,1,0
31674,71,1445,1178,367,1042,6,15,115,1184,9,94,51,95,103,146,644,976,4,4439,246,0,2,31,27,0
31675,71,1445,177,108,140,8,0,27,185,6,30,16,32,36,48,162,248,3,794,44,0,2,31,27,0
31676,240,5118,1943,715,1694,26,18,214,1969,12,185,120,237,197,357,1436,2721,7,20915,1161,0,2,26,24,0
31677,240,5118,1168,838,957,57,25,144,1225,19,348,224,416,367,640,3018,5452,11,61921,3440,1,2,26,24,0
31678,100,4121,1289,550,1043,56,32,155,1345,10,167,93,185,177,278,1266,2075,5,11498,638,0,2,2,2,0
31679,1,14,6,4,4,0,0,2,6,0,0,0,0,0,0,0,0,0,0,0,0,0,6,0,0
31680,3,49,16,9,9,0,0,7,16,0,0,0,0,0,0,0,0,0,0,0,0,0,16,0,0
31681,12,318,149,95,105,2,0,41,151,8,54,28,55,62,83,334,494,4,2013,111,0,0,66,0,0
31682,90,3974,1338,495,1086,10,64,173,1348,11,122,82,157,133,239,883,1686,7,11934,663,0,2,2,2,0
31683,124,4939,1450,624,1228,12,26,181,1462,14,306,186,354,320,540,2580,4493,8,36391,2021,1,2,6,4,0
31684,123,5301,1513,682,1277,25,13,200,1538,11,199,116,219,210,335,1557,2584,6,15641,868,0,2,11,18,0
31685,69,3105,1020,354,843,12,15,144,1032,8,134,77,144,142,221,970,1580,4,6792,377,0,2,7,0,0
31686,45,2037,447,308,343,6,5,95,453,7,96,59,111,103,170,651,1136,4,4600,255,0,2,27,0,0
31687,21,653,424,94,331,4,0,89,428,1,5,5,5,6,10,11,25,0,12,0,0,2,15,0,0
31688,39,2363,334,251,279,10,4,40,344,5,127,74,143,132,217,899,1528,2,4303,239,0,2,2,1,0
31689,77,3233,1178,367,1042,6,15,115,1184,9,94,51,95,103,146,644,976,4,4439,246,0,2,2,1,0
31690,101,5272,1943,715,1694,26,18,214,1969,12,185,120,237,197,357,1436,2721,7,20915,1161,0,2,1,1,0
31691,37,1525,442,244,305,14,16,103,456,11,68,45,75,79,120,452,756,6,4588,254,0,2,16,0,0
31692,53,1862,601,196,481,2,23,85,603,8,63,36,72,71,108,400,664,4,3036,168,0,2,19,0,0
31693,231,4973,182,127,129,0,0,53,182,5,39,21,42,44,63,217,343,2,926,51,0,2,0,5,0
31694,231,4973,1165,710,800,67,119,181,1232,18,243,153,282,261,435,2000,3492,10,36473,2026,1,2,0,5,0
31695,183,5544,1660,832,1314,41,38,274,1701,20,312,209,395,332,604,2671,5058,12,64042,3557,1,2,0,13,0
31696,183,5544,1057,646,719,113,100,145,1170,18,215,134,248,233,382,1740,3004,10,31186,1732,1,2,0,13,0
31697,42,1241,339,213,244,17,9,65,356,10,42,26,48,52,74,259,421,5,2410,133,0,2,7,3,0
31698,245,5664,4293,999,3693,19,54,507,4312,9,155,88,170,164,258,1156,1898,4,9368,520,0,2,0,6,0
31699,245,5664,1482,859,1002,125,135,219,1607,16,219,134,251,235,385,1766,3032,9,27804,1544,1,2,0,6,0
31700,52,625,647,139,84,35,284,233,682,0,0,0,0,0,0,0,0,0,0,0,0,2,6,3,0
31701,108,2933,1523,757,1297,19,12,193,1542,12,193,117,230,205,347,1508,2664,7,19053,1058,0,2,73,20,0
31702,108,2933,701,378,504,33,58,109,734,13,110,68,126,123,194,794,1346,7,10027,557,0,2,73,20,0
31703,21,541,205,80,86,16,53,53,221,7,18,10,19,25,29,94,134,3,497,27,0,2,3,3,0
31704,313,6834,72,33,56,0,4,12,72,1,1,1,1,2,2,0,2,0,1,0,0,2,142,51,0
31705,313,6834,1454,835,1044,76,110,219,1530,17,275,158,296,292,454,2297,3718,9,34017,1889,1,2,142,51,0
31706,27,671,466,257,367,18,25,50,484,7,126,86,171,133,257,898,1813,4,8612,478,0,2,0,10,0
31707,27,671,507,281,342,29,59,88,536,10,53,29,57,63,86,336,514,5,2764,153,0,2,0,10,0
31708,25,552,215,129,180,6,0,29,221,8,65,43,72,73,115,415,711,4,3153,175,0,2,3,25,0
31709,25,552,97,69,77,3,3,16,100,6,22,13,23,28,36,113,173,3,542,30,0,2,3,25,0
31710,71,1445,1178,367,1042,6,15,115,1184,9,94,51,95,103,146,644,976,4,4439,246,0,2,1,1,0
31711,71,1445,177,108,140,8,0,27,185,6,30,16,32,36,48,162,248,3,794,44,0,2,1,1,0
31712,240,5118,1943,715,1694,26,18,214,1969,12,185,120,237,197,357,1436,2721,7,20915,1161,0,2,20,11,0
31713,240,5118,1168,838,957,57,25,144,1225,19,348,224,416,367,640,3018,5452,11,61921,3440,1,2,20,11,0
31714,19,720,442,244,305,14,16,103,456,11,68,45,75,79,120,452,756,6,4588,254,0,2,3,2,0
31715,19,720,182,102,99,11,40,35,193,3,11,6,11,14,17,42,64,1,97,5,0,2,3,2,0
31716,68,1302,1098,241,925,5,10,155,1103,7,46,25,49,53,74,273,423,3,1580,87,0,2,45,19,0
31717,68,1302,282,202,222,14,2,44,296,8,42,24,43,50,67,250,378,4,1548,86,0,2,45,19,0
31718,100,4121,1289,550,1043,56,32,155,1345,10,167,93,185,177,278,1266,2075,5,11498,638,0,2,3,1,0
31719,16,895,75,38,59,1,3,12,76,2,4,2,4,6,6,10,15,1,15,0,0,2,19,0,0
31720,90,3974,1338,495,1086,10,64,173,1348,11,122,82,157,133,239,883,1686,7,11934,663,0,2,0,3,0
31721,170,7538,139,89,101,2,0,35,141,7,54,34,62,61,96,330,569,4,2287,127,0,2,40,1,0
31722,170,7538,7,5,5,0,0,2,7,1,2,1,2,3,3,2,4,0,2,0,0,2,40,1,0
31723,125,5588,1782,648,1425,9,47,279,1791,8,171,97,189,179,286,1292,2140,4,9462,525,0,2,0,1,0
31724,47,3455,996,429,845,24,10,117,1020,7,76,50,88,83,138,494,879,4,3565,198,0,2,1,1,0
31725,100,4747,1523,757,1297,19,12,193,1542,12,193,117,230,205,347,1508,2664,7,19053,1058,0,2,69,95,0
31726,65,3082,1293,570,1093,25,15,163,1318,10,195,123,241,205,364,1516,2795,6,17273,959,0,2,71,55,0
31727,15,1066,215,129,180,6,0,29,221,8,65,43,72,73,115,415,711,4,3153,175,0,2,0,29,0
31728,83,3318,1043,504,840,53,9,147,1096,9,180,112,198,189,310,1377,2344,4,11604,644,0,2,1,6,0
31729,29,1210,373,158,315,8,0,51,381,5,76,44,79,81,123,486,779,2,2026,112,0,2,0,1,0
31730,101,5272,1943,715,1694,26,18,214,1969,12,185,120,237,197,357,1436,2721,7,20915,1161,0,2,2,13,0
31731,37,1525,442,244,305,14,16,103,456,11,68,45,75,79,120,452,756,6,4588,254,0,2,4,0,0
31732,69,1323,1098,241,925,5,10,155,1103,7,46,25,49,53,74,273,423,3,1580,87,0,2,3,0,0
31733,69,1323,282,202,222,14,2,44,296,8,42,24,43,50,67,250,378,4,1548,86,0,2,3,0,0
31734,2,40,13,9,8,0,0,4,13,0,0,0,0,0,0,0,0,0,0,0,0,0,13,0,0
31735,2,42,14,10,9,0,0,4,14,0,0,0,0,0,0,0,0,0,0,0,0,0,14,0,0
31736,2,33,12,8,7,0,0,4,12,0,0,0,0,0,0,0,0,0,0,0,0,0,12,0,0
31737,52,1990,1098,241,925,5,10,155,1103,7,46,25,49,53,74,273,423,3,1580,87,0,2,15,0,0
31738,69,1323,1098,241,925,5,10,155,1103,7,46,25,49,53,74,273,423,3,1580,87,0,2,3,0,0
31739,69,1323,282,202,222,14,2,44,296,8,42,24,43,50,67,250,378,4,1548,86,0,2,3,0,0
31740,2,40,13,9,8,0,0,4,13,0,0,0,0,0,0,0,0,0,0,0,0,0,13,0,0
31741,2,42,14,10,9,0,0,4,14,0,0,0,0,0,0,0,0,0,0,0,0,0,14,0,0
31742,2,33,12,8,7,0,0,4,12,0,0,0,0,0,0,0,0,0,0,0,0,0,12,0,0
31743,52,1990,1098,241,925,5,10,155,1103,7,46,25,49,53,74,273,423,3,1580,87,0,2,15,0,0
31744,92,1891,757,253,292,73,244,162,830,13,61,38,67,74,105,409,651,7,4654,258,0,2,8,0,0
31745,33,1041,256,139,192,9,7,47,265,4,23,12,24,27,36,112,171,2,357,19,0,2,48,0,0
31746,169,5034,1660,832,1314,41,38,274,1701,20,312,209,395,332,604,2671,5058,12,64042,3557,1,2,13,36,0
31747,169,5034,1660,832,1314,41,38,274,1701,20,312,209,395,332,604,2671,5058,12,64042,3557,1,2,13,36,0
31748,94,2466,773,422,505,30,103,129,803,14,77,46,83,91,129,535,839,7,6334,351,0,2,51,47,0
31749,221,4701,2,2,2,0,0,0,2,0,0,0,0,0,0,0,0,0,0,0,0,2,2,2,0
31750,221,4701,99,48,90,1,3,5,100,0,0,0,0,0,0,0,0,0,0,0,0,2,2,2,0
31751,221,4701,8,5,5,2,0,1,10,0,0,0,0,0,0,0,0,0,0,0,0,2,2,2,0
31752,221,4701,1217,716,841,84,126,174,1301,14,185,118,215,199,333,1446,2542,8,20687,1149,0,2,2,2,0
31753,221,4701,160,89,115,0,13,31,160,7,15,11,17,22,28,78,124,3,495,27,0,2,2,2,0
31754,221,4701,10,10,9,9,0,0,19,0,0,0,0,0,0,0,0,0,0,0,0,2,2,2,0
31755,221,4701,173,84,99,8,29,36,181,5,12,7,13,17,20,54,81,2,221,12,0,2,2,2,0
31756,221,4701,3,1,1,3,0,0,6,0,0,0,0,0,0,0,0,0,0,0,0,2,2,2,0
31757,101,4167,1289,550,1043,56,32,155,1345,10,167,93,185,177,278,1266,2075,5,11498,638,0,2,14,0,0
31758,158,3681,77,34,69,0,0,8,77,3,24,16,29,27,45,114,213,1,387,21,0,2,18,0,0
31759,158,3681,712,438,573,51,9,84,763,14,102,71,128,116,199,733,1364,8,11988,666,0,2,18,0,0
31760,30,1324,373,158,315,8,0,51,381,5,76,44,79,81,123,486,779,2,2026,112,0,2,15,0,0
31761,221,4701,2,2,2,0,0,0,2,0,0,0,0,0,0,0,0,0,0,0,0,2,2,2,0
31762,221,4701,99,48,90,1,3,5,100,0,0,0,0,0,0,0,0,0,0,0,0,2,2,2,0
31763,221,4701,8,5,5,2,0,1,10,0,0,0,0,0,0,0,0,0,0,0,0,2,2,2,0
31764,221,4701,1217,716,841,84,126,174,1301,14,185,118,215,199,333,1446,2542,8,20687,1149,0,2,2,2,0
31765,221,4701,160,89,115,0,13,31,160,7,15,11,17,22,28,78,124,3,495,27,0,2,2,2,0
31766,221,4701,10,10,9,9,0,0,19,0,0,0,0,0,0,0,0,0,0,0,0,2,2,2,0
31767,221,4701,173,84,99,8,29,36,181,5,12,7,13,17,20,54,81,2,221,12,0,2,2,2,0
31768,221,4701,3,1,1,3,0,0,6,0,0,0,0,0,0,0,0,0,0,0,0,2,2,2,0
31769,101,4167,1289,550,1043,56,32,155,1345,10,167,93,185,177,278,1266,2075,5,11498,638,0,2,14,0,0
31770,241,5125,1943,715,1694,26,18,214,1969,12,185,120,237,197,357,1436,2721,7,20915,1161,0,2,8,7,0
31771,241,5125,1168,838,957,57,25,144,1225,19,348,224,416,367,640,3018,5452,11,61921,3440,1,2,8,7,0
31772,101,5303,1943,715,1694,26,18,214,1969,12,185,120,237,197,357,1436,2721,7,20915,1161,0,2,5,2,0
31773,159,3699,77,34,69,0,0,8,77,3,24,16,29,27,45,114,213,1,387,21,0,2,4,1,0
31774,159,3699,712,438,573,51,9,84,763,14,102,71,128,116,199,733,1364,8,11988,666,0,2,4,1,0
31775,80,4558,1296,573,1062,40,33,157,1336,8,201,118,231,209,349,1561,2689,4,12365,686,0,2,20,0,0
31776,94,2466,773,422,505,30,103,129,803,14,77,46,83,91,129,535,839,7,6334,351,0,2,51,47,0
31777,45,955,386,256,301,16,9,68,402,4,59,35,69,63,104,355,621,2,1453,80,0,2,8,5,0
31778,45,955,264,131,164,11,41,46,275,6,38,22,40,44,62,214,338,3,1068,59,0,2,8,5,0
31779,17,930,75,38,59,1,3,12,76,2,4,2,4,6,6,10,15,1,15,0,0,2,9,0,0
31780,241,5125,1943,715,1694,26,18,214,1969,12,185,120,237,197,357,1436,2721,7,20915,1161,0,2,8,7,0
31781,241,5125,1168,838,957,57,25,144,1225,19,348,224,416,367,640,3018,5452,11,61921,3440,1,2,8,7,0
31782,101,5303,1943,715,1694,26,18,214,1969,12,185,120,237,197,357,1436,2721,7,20915,1161,0,2,5,2,0
31783,221,4705,2,2,2,0,0,0,2,0,0,0,0,0,0,0,0,0,0,0,0,2,1,1,1
31784,221,4705,99,48,90,1,3,5,100,0,0,0,0,0,0,0,0,0,0,0,0,2,1,1,1
31785,221,4705,8,5,5,2,0,1,10,0,0,0,0,0,0,0,0,0,0,0,0,2,1,1,1
31786,221,4705,1217,716,841,84,126,174,1301,14,185,118,215,199,333,1446,2542,8,20687,1149,0,2,1,1,1
31787,221,4705,160,89,115,0,13,31,160,7,15,11,17,22,28,78,124,3,495,27,0,2,1,1,1
31788,221,4705,10,10,9,9,0,0,19,0,0,0,0,0,0,0,0,0,0,0,0,2,1,1,1
31789,221,4705,173,84,99,8,29,36,181,5,12,7,13,17,20,54,81,2,221,12,0,2,1,1,1
31790,221,4705,3,1,1,3,0,0,6,0,0,0,0,0,0,0,0,0,0,0,0,2,1,1,1
31791,43,2676,652,304,544,16,6,88,668,6,89,51,101,95,152,591,998,3,3399,188,0,2,36,0,1
31792,45,955,386,256,301,16,9,68,402,4,59,35,69,63,104,355,621,2,1453,80,0,2,8,5,0
31793,45,955,264,131,164,11,41,46,275,6,38,22,40,44,62,214,338,3,1068,59,0,2,8,5,0
31794,17,930,75,38,59,1,3,12,76,2,4,2,4,6,6,10,15,1,15,0,0,2,9,0,0
31795,221,4705,2,2,2,0,0,0,2,0,0,0,0,0,0,0,0,0,0,0,0,2,3,0,0
31796,221,4705,99,48,90,1,3,5,100,0,0,0,0,0,0,0,0,0,0,0,0,2,3,0,0
31797,221,4705,8,5,5,2,0,1,10,0,0,0,0,0,0,0,0,0,0,0,0,2,3,0,0
31798,221,4705,1217,716,841,84,126,174,1301,14,185,118,215,199,333,1446,2542,8,20687,1149,0,2,3,0,0
31799,221,4705,160,89,115,0,13,31,160,7,15,11,17,22,28,78,124,3,495,27,0,2,3,0,0
31800,221,4705,10,10,9,9,0,0,19,0,0,0,0,0,0,0,0,0,0,0,0,2,3,0,0
31801,221,4705,173,84,99,8,29,36,181,5,12,7,13,17,20,54,81,2,221,12,0,2,3,0,0
31802,221,4705,3,1,1,3,0,0,6,0,0,0,0,0,0,0,0,0,0,0,0,2,3,0,0
31803,94,2454,773,422,505,30,103,129,803,14,77,46,83,91,129,535,839,7,6334,351,0,2,43,44,0
31804,94,2454,773,422,505,30,103,129,803,14,77,46,83,91,129,535,839,7,6334,351,0,2,43,44,0
31805,313,6832,72,33,56,0,4,12,72,1,1,1,1,2,2,0,2,0,1,0,0,2,4,6,0
31806,313,6832,1454,835,1044,76,110,219,1530,17,275,158,296,292,454,2297,3718,9,34017,1889,1,2,4,6,0
31807,126,5612,1782,648,1425,9,47,279,1791,8,171,97,189,179,286,1292,2140,4,9462,525,0,2,15,0,0
31808,94,2418,773,422,505,30,103,129,803,14,77,46,83,91,129,535,839,7,6334,351,0,2,0,7,0
31809,247,5178,1943,715,1694,26,18,214,1969,12,185,120,237,197,357,1436,2721,7,20915,1161,0,2,23,4,0
31810,247,5178,1168,838,957,57,25,144,1225,19,348,224,416,367,640,3018,5452,11,61921,3440,1,2,23,4,0
31811,313,6832,72,33,56,0,4,12,72,1,1,1,1,2,2,0,2,0,1,0,0,2,4,6,0
31812,313,6832,1454,835,1044,76,110,219,1530,17,275,158,296,292,454,2297,3718,9,34017,1889,1,2,4,6,0
31813,126,5612,1782,648,1425,9,47,279,1791,8,171,97,189,179,286,1292,2140,4,9462,525,0,2,15,0,0
31814,154,3603,77,34,69,0,0,8,77,3,24,16,29,27,45,114,213,1,387,21,0,2,1,0,1
31815,154,3603,712,438,573,51,9,84,763,14,102,71,128,116,199,733,1364,8,11988,666,0,2,1,0,1
31816,313,6841,72,33,56,0,4,12,72,1,1,1,1,2,2,0,2,0,1,0,0,2,7,5,1
31817,313,6841,1454,835,1044,76,110,219,1530,17,275,158,296,292,454,2297,3718,9,34017,1889,1,2,7,5,1
31818,80,4551,1296,573,1062,40,33,157,1336,8,201,118,231,209,349,1561,2689,4,12365,686,0,2,13,0,1
31819,153,3603,77,34,69,0,0,8,77,3,24,16,29,27,45,114,213,1,387,21,0,2,13,11,0
31820,153,3603,712,438,573,51,9,84,763,14,102,71,128,116,199,733,1364,8,11988,666,0,2,13,11,0
31821,221,4701,2,2,2,0,0,0,2,0,0,0,0,0,0,0,0,0,0,0,0,2,2,2,0
31822,221,4701,99,48,90,1,3,5,100,0,0,0,0,0,0,0,0,0,0,0,0,2,2,2,0
31823,221,4701,8,5,5,2,0,1,10,0,0,0,0,0,0,0,0,0,0,0,0,2,2,2,0
31824,221,4701,1217,716,841,84,126,174,1301,14,185,118,215,199,333,1446,2542,8,20687,1149,0,2,2,2,0
31825,221,4701,160,89,115,0,13,31,160,7,15,11,17,22,28,78,124,3,495,27,0,2,2,2,0
31826,221,4701,10,10,9,9,0,0,19,0,0,0,0,0,0,0,0,0,0,0,0,2,2,2,0
31827,221,4701,173,84,99,8,29,36,181,5,12,7,13,17,20,54,81,2,221,12,0,2,2,2,0
31828,221,4701,3,1,1,3,0,0,6,0,0,0,0,0,0,0,0,0,0,0,0,2,2,2,0
31829,94,2454,773,422,505,30,103,129,803,14,77,46,83,91,129,535,839,7,6334,351,0,2,50,47,0
31830,313,6832,72,33,56,0,4,12,72,1,1,1,1,2,2,0,2,0,1,0,0,2,4,6,0
31831,313,6832,1454,835,1044,76,110,219,1530,17,275,158,296,292,454,2297,3718,9,34017,1889,1,2,4,6,0
31832,92,1891,757,253,292,73,244,162,830,13,61,38,67,74,105,409,651,7,4654,258,0,2,8,0,0
31833,241,5125,1943,715,1694,26,18,214,1969,12,185,120,237,197,357,1436,2721,7,20915,1161,0,2,8,7,0
31834,241,5125,1168,838,957,57,25,144,1225,19,348,224,416,367,640,3018,5452,11,61921,3440,1,2,8,7,0
31835,69,1323,1098,241,925,5,10,155,1103,7,46,25,49,53,74,273,423,3,1580,87,0,2,3,0,0
31836,69,1323,282,202,222,14,2,44,296,8,42,24,43,50,67,250,378,4,1548,86,0,2,3,0,0
31837,101,4167,1289,550,1043,56,32,155,1345,10,167,93,185,177,278,1266,2075,5,11498,638,0,2,14,0,0
31838,2,40,13,9,8,0,0,4,13,0,0,0,0,0,0,0,0,0,0,0,0,0,13,0,0
31839,2,42,14,10,9,0,0,4,14,0,0,0,0,0,0,0,0,0,0,0,0,0,14,0,0
31840,2,33,12,8,7,0,0,4,12,0,0,0,0,0,0,0,0,0,0,0,0,0,12,0,0
31841,126,5612,1782,648,1425,9,47,279,1791,8,171,97,189,179,286,1292,2140,4,9462,525,0,2,15,0,0
31842,33,1041,256,139,192,9,7,47,265,4,23,12,24,27,36,112,171,2,357,19,0,2,48,0,0
31843,169,5034,1660,832,1314,41,38,274,1701,20,312,209,395,332,604,2671,5058,12,64042,3557,1,2,13,36,0
31844,101,5303,1943,715,1694,26,18,214,1969,12,185,120,237,197,357,1436,2721,7,20915,1161,0,2,5,2,0
31845,52,1990,1098,241,925,5,10,155,1103,7,46,25,49,53,74,273,423,3,1580,87,0,2,15,0,0
31846,154,3603,77,34,69,0,0,8,77,3,24,16,29,27,45,114,213,1,387,21,0,2,1,0,0
31847,154,3603,712,438,573,51,9,84,763,14,102,71,128,116,199,733,1364,8,11988,666,0,2,1,0,0
31848,313,6841,72,33,56,0,4,12,72,1,1,1,1,2,2,0,2,0,1,0,0,2,7,5,0
31849,313,6841,1454,835,1044,76,110,219,1530,17,275,158,296,292,454,2297,3718,9,34017,1889,1,2,7,5,0
31850,80,4551,1296,573,1062,40,33,157,1336,8,201,118,231,209,349,1561,2689,4,12365,686,0,2,13,0,0
31851,154,3603,77,34,69,0,0,8,77,3,24,16,29,27,45,114,213,1,387,21,0,2,1,0,0
31852,154,3603,712,438,573,51,9,84,763,14,102,71,128,116,199,733,1364,8,11988,666,0,2,1,0,0
31853,313,6841,72,33,56,0,4,12,72,1,1,1,1,2,2,0,2,0,1,0,0,2,7,5,0
31854,313,6841,1454,835,1044,76,110,219,1530,17,275,158,296,292,454,2297,3718,9,34017,1889,1,2,7,5,0
31855,80,4551,1296,573,1062,40,33,157,1336,8,201,118,231,209,349,1561,2689,4,12365,686,0,2,13,0,0
31856,221,4701,2,2,2,0,0,0,2,0,0,0,0,0,0,0,0,0,0,0,0,2,2,2,0
31857,221,4701,99,48,90,1,3,5,100,0,0,0,0,0,0,0,0,0,0,0,0,2,2,2,0
31858,221,4701,8,5,5,2,0,1,10,0,0,0,0,0,0,0,0,0,0,0,0,2,2,2,0
31859,221,4701,1217,716,841,84,126,174,1301,14,185,118,215,199,333,1446,2542,8,20687,1149,0,2,2,2,0
31860,221,4701,160,89,115,0,13,31,160,7,15,11,17,22,28,78,124,3,495,27,0,2,2,2,0
31861,221,4701,10,10,9,9,0,0,19,0,0,0,0,0,0,0,0,0,0,0,0,2,2,2,0
31862,221,4701,173,84,99,8,29,36,181,5,12,7,13,17,20,54,81,2,221,12,0,2,2,2,0
31863,221,4701,3,1,1,3,0,0,6,0,0,0,0,0,0,0,0,0,0,0,0,2,2,2,0
31864,94,2454,773,422,505,30,103,129,803,14,77,46,83,91,129,535,839,7,6334,351,0,2,50,47,0
31865,154,3603,77,34,69,0,0,8,77,3,24,16,29,27,45,114,213,1,387,21,0,2,1,0,0
31866,154,3603,712,438,573,51,9,84,763,14,102,71,128,116,199,733,1364,8,11988,666,0,2,1,0,0
31867,313,6841,72,33,56,0,4,12,72,1,1,1,1,2,2,0,2,0,1,0,0,2,11,11,0
31868,313,6841,1454,835,1044,76,110,219,1530,17,275,158,296,292,454,2297,3718,9,34017,1889,1,2,11,11,0
31869,92,1891,757,253,292,73,244,162,830,13,61,38,67,74,105,409,651,7,4654,258,0,2,8,0,0
31870,241,5125,1943,715,1694,26,18,214,1969,12,185,120,237,197,357,1436,2721,7,20915,1161,0,2,8,7,0
31871,241,5125,1168,838,957,57,25,144,1225,19,348,224,416,367,640,3018,5452,11,61921,3440,1,2,8,7,0
31872,69,1323,1098,241,925,5,10,155,1103,7,46,25,49,53,74,273,423,3,1580,87,0,2,3,0,0
31873,69,1323,282,202,222,14,2,44,296,8,42,24,43,50,67,250,378,4,1548,86,0,2,3,0,0
31874,101,4167,1289,550,1043,56,32,155,1345,10,167,93,185,177,278,1266,2075,5,11498,638,0,2,14,0,0
31875,2,40,13,9,8,0,0,4,13,0,0,0,0,0,0,0,0,0,0,0,0,0,13,0,0
31876,2,42,14,10,9,0,0,4,14,0,0,0,0,0,0,0,0,0,0,0,0,0,14,0,0
31877,2,33,12,8,7,0,0,4,12,0,0,0,0,0,0,0,0,0,0,0,0,0,12,0,0
31878,126,5612,1782,648,1425,9,47,279,1791,8,171,97,189,179,286,1292,2140,4,9462,525,0,2,15,0,0
31879,33,1041,256,139,192,9,7,47,265,4,23,12,24,27,36,112,171,2,357,19,0,2,48,0,0
31880,169,5034,1660,832,1314,41,38,274,1701,20,312,209,395,332,604,2671,5058,12,64042,3557,1,2,13,36,0
31881,80,4551,1296,573,1062,40,33,157,1336,8,201,118,231,209,349,1561,2689,4,12365,686,0,2,13,0,0
31882,101,5303,1943,715,1694,26,18,214,1969,12,185,120,237,197,357,1436,2721,7,20915,1161,0,2,5,2,0
31883,52,1990,1098,241,925,5,10,155,1103,7,46,25,49,53,74,273,423,3,1580,87,0,2,15,0,0
31884,153,3609,77,34,69,0,0,8,77,3,24,16,29,27,45,114,213,1,387,21,0,2,13,11,0
31885,153,3609,712,438,573,51,9,84,763,14,102,71,128,116,199,733,1364,8,11988,666,0,2,13,11,0
31886,221,4705,2,2,2,0,0,0,2,0,0,0,0,0,0,0,0,0,0,0,0,2,4,1,0
31887,221,4705,99,48,90,1,3,5,100,0,0,0,0,0,0,0,0,0,0,0,0,2,4,1,0
31888,221,4705,8,5,5,2,0,1,10,0,0,0,0,0,0,0,0,0,0,0,0,2,4,1,0
31889,221,4705,1217,716,841,84,126,174,1301,14,185,118,215,199,333,1446,2542,8,20687,1149,0,2,4,1,0
31890,221,4705,160,89,115,0,13,31,160,7,15,11,17,22,28,78,124,3,495,27,0,2,4,1,0
31891,221,4705,10,10,9,9,0,0,19,0,0,0,0,0,0,0,0,0,0,0,0,2,4,1,0
31892,221,4705,173,84,99,8,29,36,181,5,12,7,13,17,20,54,81,2,221,12,0,2,4,1,0
31893,221,4705,3,1,1,3,0,0,6,0,0,0,0,0,0,0,0,0,0,0,0,2,4,1,0
31894,43,2676,652,304,544,16,6,88,668,6,89,51,101,95,152,591,998,3,3399,188,0,2,36,0,0
31895,246,5902,722,423,573,19,0,135,741,12,172,101,199,184,300,1320,2257,6,15668,870,0,2,6,0,0
31896,246,5902,1508,847,911,44,250,301,1552,14,148,88,169,162,257,1120,1886,7,15077,837,0,2,6,0,0
31897,48,2297,722,423,573,19,0,135,741,12,172,101,199,184,300,1320,2257,6,15668,870,0,2,11,0,0
31898,159,3705,77,34,69,0,0,8,77,3,24,16,29,27,45,114,213,1,387,21,0,2,21,0,0
31899,159,3705,712,438,573,51,9,84,763,14,102,71,128,116,199,733,1364,8,11988,666,0,2,21,0,0
31900,81,4624,1296,573,1062,40,33,157,1336,8,201,118,231,209,349,1561,2689,4,12365,686,0,2,20,0,0
31901,30,1324,373,158,315,8,0,51,381,5,76,44,79,81,123,486,779,2,2026,112,0,2,15,0,0
31902,94,2418,773,422,505,30,103,129,803,14,77,46,83,91,129,535,839,7,6334,351,0,2,0,7,0
31903,247,5178,1943,715,1694,26,18,214,1969,12,185,120,237,197,357,1436,2721,7,20915,1161,0,2,23,4,0
31904,247,5178,1168,838,957,57,25,144,1225,19,348,224,416,367,640,3018,5452,11,61921,3440,1,2,23,4,0
31905,246,5902,722,423,573,19,0,135,741,12,172,101,199,184,300,1320,2257,6,15668,870,0,2,6,0,0
31906,246,5902,1508,847,911,44,250,301,1552,14,148,88,169,162,257,1120,1886,7,15077,837,0,2,6,0,0
31907,48,2297,722,423,573,19,0,135,741,12,172,101,199,184,300,1320,2257,6,15668,870,0,2,11,0,0
31908,245,5880,722,423,573,19,0,135,741,12,172,101,199,184,300,1320,2257,6,15668,870,0,2,5,1,0
31909,245,5880,1508,847,911,44,250,301,1552,14,148,88,169,162,257,1120,1886,7,15077,837,0,2,5,1,0
31910,45,1291,339,213,244,17,9,65,356,10,42,26,48,52,74,259,421,5,2410,133,0,2,22,13,1
31911,66,3225,1293,570,1093,25,15,163,1318,10,195,123,241,205,364,1516,2795,6,17273,959,0,2,70,0,1
31912,153,3613,77,34,69,0,0,8,77,3,24,16,29,27,45,114,213,1,387,21,0,2,1,1,0
31913,153,3613,712,438,573,51,9,84,763,14,102,71,128,116,199,733,1364,8,11988,666,0,2,1,1,0
31914,81,4663,1296,573,1062,40,33,157,1336,8,201,118,231,209,349,1561,2689,4,12365,686,0,2,29,0,0
31915,153,3613,77,34,69,0,0,8,77,3,24,16,29,27,45,114,213,1,387,21,0,2,1,1,0
31916,153,3613,712,438,573,51,9,84,763,14,102,71,128,116,199,733,1364,8,11988,666,0,2,1,1,0
31917,81,4663,1296,573,1062,40,33,157,1336,8,201,118,231,209,349,1561,2689,4,12365,686,0,2,29,0,0
31918,228,4801,2,2,2,0,0,0,2,0,0,0,0,0,0,0,0,0,0,0,0,2,38,8,0
31919,228,4801,99,48,90,1,3,5,100,0,0,0,0,0,0,0,0,0,0,0,0,2,38,8,0
31920,228,4801,8,5,5,2,0,1,10,0,0,0,0,0,0,0,0,0,0,0,0,2,38,8,0
31921,228,4801,1217,716,841,84,126,174,1301,14,185,118,215,199,333,1446,2542,8,20687,1149,0,2,38,8,0
31922,228,4801,160,89,115,0,13,31,160,7,15,11,17,22,28,78,124,3,495,27,0,2,38,8,0
31923,228,4801,10,10,9,9,0,0,19,0,0,0,0,0,0,0,0,0,0,0,0,2,38,8,0
31924,228,4801,173,84,99,8,29,36,181,5,12,7,13,17,20,54,81,2,221,12,0,2,38,8,0
31925,228,4801,3,1,1,3,0,0,6,0,0,0,0,0,0,0,0,0,0,0,0,2,38,8,0
31926,98,2019,463,295,324,28,62,57,491,12,134,82,154,146,236,989,1696,6,11700,650,0,2,8,11,0
31927,28,978,74,35,59,1,0,14,75,3,14,7,14,17,21,58,85,1,128,7,0,2,12,8,0
31928,28,978,245,125,200,5,7,34,250,7,30,17,34,37,51,166,265,3,1053,58,0,2,12,8,0
31929,92,4896,1457,730,1242,11,6,188,1468,10,292,166,329,302,495,2424,4078,5,22973,1276,1,2,73,3,0
31930,39,2350,334,251,279,10,4,40,344,5,127,74,143,132,217,899,1528,2,4303,239,0,2,3,4,0
31931,245,5880,722,423,573,19,0,135,741,12,172,101,199,184,300,1320,2257,6,15668,870,0,2,5,1,0
31932,245,5880,1508,847,911,44,250,301,1552,14,148,88,169,162,257,1120,1886,7,15077,837,0,2,5,1,0
31933,221,4705,2,2,2,0,0,0,2,0,0,0,0,0,0,0,0,0,0,0,0,2,1,1,0
31934,221,4705,99,48,90,1,3,5,100,0,0,0,0,0,0,0,0,0,0,0,0,2,1,1,0
31935,221,4705,8,5,5,2,0,1,10,0,0,0,0,0,0,0,0,0,0,0,0,2,1,1,0
31936,221,4705,1217,716,841,84,126,174,1301,14,185,118,215,199,333,1446,2542,8,20687,1149,0,2,1,1,0
31937,221,4705,160,89,115,0,13,31,160,7,15,11,17,22,28,78,124,3,495,27,0,2,1,1,0
31938,221,4705,10,10,9,9,0,0,19,0,0,0,0,0,0,0,0,0,0,0,0,2,1,1,0
31939,221,4705,173,84,99,8,29,36,181,5,12,7,13,17,20,54,81,2,221,12,0,2,1,1,0
31940,221,4705,3,1,1,3,0,0,6,0,0,0,0,0,0,0,0,0,0,0,0,2,1,1,0
31941,1,106,42,7,35,4,0,5,46,1,2,1,2,3,3,2,4,0,2,0,0,2,2,1,0
31942,1,106,11,6,10,0,0,1,11,2,4,2,4,6,6,10,15,1,15,0,0,2,2,1,0
31943,237,5024,1943,715,1694,26,18,214,1969,12,185,120,237,197,357,1436,2721,7,20915,1161,0,2,0,15,0
31944,237,5024,1168,838,957,57,25,144,1225,19,348,224,416,367,640,3018,5452,11,61921,3440,1,2,0,15,0
31945,100,4148,1289,550,1043,56,32,155,1345,10,167,93,185,177,278,1266,2075,5,11498,638,0,2,1,3,0
31946,14,843,75,38,59,1,3,12,76,2,4,2,4,6,6,10,15,1,15,0,0,2,0,19,0
31947,245,5666,4293,999,3693,19,54,507,4312,9,155,88,170,164,258,1156,1898,4,9368,520,0,2,2,2,0
31948,245,5666,1482,859,1002,125,135,219,1607,16,219,134,251,235,385,1766,3032,9,27804,1544,1,2,2,2,0
31949,228,4801,2,2,2,0,0,0,2,0,0,0,0,0,0,0,0,0,0,0,0,2,38,8,0
31950,228,4801,99,48,90,1,3,5,100,0,0,0,0,0,0,0,0,0,0,0,0,2,38,8,0
31951,228,4801,8,5,5,2,0,1,10,0,0,0,0,0,0,0,0,0,0,0,0,2,38,8,0
31952,228,4801,1217,716,841,84,126,174,1301,14,185,118,215,199,333,1446,2542,8,20687,1149,0,2,38,8,0
31953,228,4801,160,89,115,0,13,31,160,7,15,11,17,22,28,78,124,3,495,27,0,2,38,8,0
31954,228,4801,10,10,9,9,0,0,19,0,0,0,0,0,0,0,0,0,0,0,0,2,38,8,0
31955,228,4801,173,84,99,8,29,36,181,5,12,7,13,17,20,54,81,2,221,12,0,2,38,8,0
31956,228,4801,3,1,1,3,0,0,6,0,0,0,0,0,0,0,0,0,0,0,0,2,38,8,0
31957,98,2019,463,295,324,28,62,57,491,12,134,82,154,146,236,989,1696,6,11700,650,0,2,8,11,0
31958,28,978,74,35,59,1,0,14,75,3,14,7,14,17,21,58,85,1,128,7,0,2,12,8,0
31959,28,978,245,125,200,5,7,34,250,7,30,17,34,37,51,166,265,3,1053,58,0,2,12,8,0
31960,92,4896,1457,730,1242,11,6,188,1468,10,292,166,329,302,495,2424,4078,5,22973,1276,1,2,73,3,0
31961,39,2350,334,251,279,10,4,40,344,5,127,74,143,132,217,899,1528,2,4303,239,0,2,3,4,0
31962,1,106,42,7,35,4,0,5,46,1,2,1,2,3,3,2,4,0,2,0,0,2,2,1,0
31963,1,106,11,6,10,0,0,1,11,2,4,2,4,6,6,10,15,1,15,0,0,2,2,1,0
31964,45,1291,339,213,244,17,9,65,356,10,42,26,48,52,74,259,421,5,2410,133,0,2,22,13,0
31965,66,3225,1293,570,1093,25,15,163,1318,10,195,123,241,205,364,1516,2795,6,17273,959,0,2,70,0,0
31966,245,5666,4293,999,3693,19,54,507,4312,9,155,88,170,164,258,1156,1898,4,9368,520,0,2,2,2,0
31967,245,5666,1482,859,1002,125,135,219,1607,16,219,134,251,235,385,1766,3032,9,27804,1544,1,2,2,2,0
31968,237,5024,1943,715,1694,26,18,214,1969,12,185,120,237,197,357,1436,2721,7,20915,1161,0,2,0,15,0
31969,237,5024,1168,838,957,57,25,144,1225,19,348,224,416,367,640,3018,5452,11,61921,3440,1,2,0,15,0
31970,100,4148,1289,550,1043,56,32,155,1345,10,167,93,185,177,278,1266,2075,5,11498,638,0,2,1,3,0
31971,14,843,75,38,59,1,3,12,76,2,4,2,4,6,6,10,15,1,15,0,0,2,0,19,0
31972,1,106,42,7,35,4,0,5,46,1,2,1,2,3,3,2,4,0,2,0,0,2,2,1,0
31973,1,106,11,6,10,0,0,1,11,2,4,2,4,6,6,10,15,1,15,0,0,2,2,1,0
31974,228,4805,2,2,2,0,0,0,2,0,0,0,0,0,0,0,0,0,0,0,0,2,4,1,0
31975,228,4805,99,48,90,1,3,5,100,0,0,0,0,0,0,0,0,0,0,0,0,2,4,1,0
31976,228,4805,8,5,5,2,0,1,10,0,0,0,0,0,0,0,0,0,0,0,0,2,4,1,0
31977,228,4805,1217,716,841,84,126,174,1301,14,185,118,215,199,333,1446,2542,8,20687,1149,0,2,4,1,0
31978,228,4805,160,89,115,0,13,31,160,7,15,11,17,22,28,78,124,3,495,27,0,2,4,1,0
31979,228,4805,10,10,9,9,0,0,19,0,0,0,0,0,0,0,0,0,0,0,0,2,4,1,0
31980,228,4805,173,84,99,8,29,36,181,5,12,7,13,17,20,54,81,2,221,12,0,2,4,1,0
31981,228,4805,3,1,1,3,0,0,6,0,0,0,0,0,0,0,0,0,0,0,0,2,4,1,0
31982,45,1291,339,213,244,17,9,65,356,10,42,26,48,52,74,259,421,5,2410,133,0,2,22,13,0
31983,245,5666,4293,999,3693,19,54,507,4312,9,155,88,170,164,258,1156,1898,4,9368,520,0,2,2,2,0
31984,245,5666,1482,859,1002,125,135,219,1607,16,219,134,251,235,385,1766,3032,9,27804,1544,1,2,2,2,0
31985,94,2418,773,422,505,30,103,129,803,14,77,46,83,91,129,535,839,7,6334,351,0,2,0,7,0
31986,158,3715,77,34,69,0,0,8,77,3,24,16,29,27,45,114,213,1,387,21,0,2,14,12,0
31987,158,3715,712,438,573,51,9,84,763,14,102,71,128,116,199,733,1364,8,11988,666,0,2,14,12,0
31988,246,5918,722,423,573,19,0,135,741,12,172,101,199,184,300,1320,2257,6,15668,870,0,2,5,1,0
31989,246,5918,1508,847,911,44,250,301,1552,14,148,88,169,162,257,1120,1886,7,15077,837,0,2,5,1,0
31990,243,5077,1943,715,1694,26,18,214,1969,12,185,120,237,197,357,1436,2721,7,20915,1161,0,2,23,4,0
31991,243,5077,1168,838,957,57,25,144,1225,19,348,224,416,367,640,3018,5452,11,61921,3440,1,2,23,4,0
31992,82,4736,1296,573,1062,40,33,157,1336,8,201,118,231,209,349,1561,2689,4,12365,686,0,2,29,0,0
31993,43,2676,652,304,544,16,6,88,668,6,89,51,101,95,152,591,998,3,3399,188,0,2,36,0,0
31994,66,3225,1293,570,1093,25,15,163,1318,10,195,123,241,205,364,1516,2795,6,17273,959,0,2,70,0,0
31995,1,106,42,7,35,4,0,5,46,1,2,1,2,3,3,2,4,0,2,0,0,2,2,1,0
31996,1,106,11,6,10,0,0,1,11,2,4,2,4,6,6,10,15,1,15,0,0,2,2,1,0
31997,228,4805,2,2,2,0,0,0,2,0,0,0,0,0,0,0,0,0,0,0,0,2,4,1,0
31998,228,4805,99,48,90,1,3,5,100,0,0,0,0,0,0,0,0,0,0,0,0,2,4,1,0
31999,228,4805,8,5,5,2,0,1,10,0,0,0,0,0,0,0,0,0,0,0,0,2,4,1,0
32000,228,4805,1217,716,841,84,126,174,1301,14,185,118,215,199,333,1446,2542,8,20687,1149,0,2,4,1,0
32001,228,4805,160,89,115,0,13,31,160,7,15,11,17,22,28,78,124,3,495,27,0,2,4,1,0
32002,228,4805,10,10,9,9,0,0,19,0,0,0,0,0,0,0,0,0,0,0,0,2,4,1,0
32003,228,4805,173,84,99,8,29,36,181,5,12,7,13,17,20,54,81,2,221,12,0,2,4,1,0
32004,228,4805,3,1,1,3,0,0,6,0,0,0,0,0,0,0,0,0,0,0,0,2,4,1,0
32005,45,1291,339,213,244,17,9,65,356,10,42,26,48,52,74,259,421,5,2410,133,0,2,22,13,0
32006,245,5666,4293,999,3693,19,54,507,4312,9,155,88,170,164,258,1156,1898,4,9368,520,0,2,2,2,0
32007,245,5666,1482,859,1002,125,135,219,1607,16,219,134,251,235,385,1766,3032,9,27804,1544,1,2,2,2,0
32008,94,2418,773,422,505,30,103,129,803,14,77,46,83,91,129,535,839,7,6334,351,0,2,0,7,0
32009,158,3715,77,34,69,0,0,8,77,3,24,16,29,27,45,114,213,1,387,21,0,2,14,12,0
32010,158,3715,712,438,573,51,9,84,763,14,102,71,128,116,199,733,1364,8,11988,666,0,2,14,12,0
32011,246,5918,722,423,573,19,0,135,741,12,172,101,199,184,300,1320,2257,6,15668,870,0,2,5,1,0
32012,246,5918,1508,847,911,44,250,301,1552,14,148,88,169,162,257,1120,1886,7,15077,837,0,2,5,1,0
32013,243,5077,1943,715,1694,26,18,214,1969,12,185,120,237,197,357,1436,2721,7,20915,1161,0,2,23,4,0
32014,243,5077,1168,838,957,57,25,144,1225,19,348,224,416,367,640,3018,5452,11,61921,3440,1,2,23,4,0
32015,82,4736,1296,573,1062,40,33,157,1336,8,201,118,231,209,349,1561,2689,4,12365,686,0,2,29,0,0
32016,43,2676,652,304,544,16,6,88,668,6,89,51,101,95,152,591,998,3,3399,188,0,2,36,0,0
32017,66,3225,1293,570,1093,25,15,163,1318,10,195,123,241,205,364,1516,2795,6,17273,959,0,2,70,0,0
32018,153,3638,77,34,69,0,0,8,77,3,24,16,29,27,45,114,213,1,387,21,0,2,6,1,0
32019,153,3638,712,438,573,51,9,84,763,14,102,71,128,116,199,733,1364,8,11988,666,0,2,6,1,0
32020,314,6872,72,33,56,0,4,12,72,1,1,1,1,2,2,0,2,0,1,0,0,2,14,6,0
32021,314,6872,1454,835,1044,76,110,219,1530,17,275,158,296,292,454,2297,3718,9,34017,1889,1,2,14,6,0
32022,83,4788,1296,573,1062,40,33,157,1336,8,201,118,231,209,349,1561,2689,4,12365,686,0,2,27,0,0
32023,19,720,442,244,305,14,16,103,456,11,68,45,75,79,120,452,756,6,4588,254,0,2,1,1,0
32024,19,720,182,102,99,11,40,35,193,3,11,6,11,14,17,42,64,1,97,5,0,2,1,1,0
32025,19,720,442,244,305,14,16,103,456,11,68,45,75,79,120,452,756,6,4588,254,0,2,1,1,0
32026,19,720,182,102,99,11,40,35,193,3,11,6,11,14,17,42,64,1,97,5,0,2,1,1,0
32027,153,3638,77,34,69,0,0,8,77,3,24,16,29,27,45,114,213,1,387,21,0,2,6,1,0
32028,153,3638,712,438,573,51,9,84,763,14,102,71,128,116,199,733,1364,8,11988,666,0,2,6,1,0
32029,314,6872,72,33,56,0,4,12,72,1,1,1,1,2,2,0,2,0,1,0,0,2,14,6,0
32030,314,6872,1454,835,1044,76,110,219,1530,17,275,158,296,292,454,2297,3718,9,34017,1889,1,2,14,6,0
32031,83,4788,1296,573,1062,40,33,157,1336,8,201,118,231,209,349,1561,2689,4,12365,686,0,2,27,0,0
32032,74,1599,53,23,39,0,0,13,53,2,8,4,8,10,12,26,39,1,39,2,0,2,2,1,0
32033,74,1599,515,298,307,33,80,99,548,12,63,44,77,75,121,419,753,7,5527,307,0,2,2,1,0
32034,99,2610,773,422,505,30,103,129,803,14,77,46,83,91,129,535,839,7,6334,351,0,2,41,11,0
32035,35,2389,1157,318,931,29,22,177,1186,6,104,63,125,110,188,712,1274,3,4596,255,0,2,48,0,0
32036,248,5184,1943,715,1694,26,18,214,1969,12,185,120,237,197,357,1436,2721,7,20915,1161,0,2,3,1,1
32037,248,5184,1168,838,957,57,25,144,1225,19,348,224,416,367,640,3018,5452,11,61921,3440,1,2,3,1,1
32038,170,5066,1660,832,1314,41,38,274,1701,20,312,209,395,332,604,2671,5058,12,64042,3557,1,2,10,3,1
32039,248,5184,1943,715,1694,26,18,214,1969,12,185,120,237,197,357,1436,2721,7,20915,1161,0,2,3,1,0
32040,248,5184,1168,838,957,57,25,144,1225,19,348,224,416,367,640,3018,5452,11,61921,3440,1,2,3,1,0
32041,170,5066,1660,832,1314,41,38,274,1701,20,312,209,395,332,604,2671,5058,12,64042,3557,1,2,10,3,0
32042,74,1599,53,23,39,0,0,13,53,2,8,4,8,10,12,26,39,1,39,2,0,2,2,1,0
32043,74,1599,515,298,307,33,80,99,548,12,63,44,77,75,121,419,753,7,5527,307,0,2,2,1,0
32044,99,2574,773,422,505,30,103,129,803,14,77,46,83,91,129,535,839,7,6334,351,0,2,41,11,0
32045,35,2389,1157,318,931,29,22,177,1186,6,104,63,125,110,188,712,1274,3,4596,255,0,2,48,0,0
32046,158,3740,77,34,69,0,0,8,77,3,24,16,29,27,45,114,213,1,387,21,0,2,6,1,0
32047,158,3740,712,438,573,51,9,84,763,14,102,71,128,116,199,733,1364,8,11988,666,0,2,6,1,0
32048,74,1599,53,23,39,0,0,13,53,2,8,4,8,10,12,26,39,1,39,2,0,2,2,1,0
32049,74,1599,515,298,307,33,80,99,548,12,63,44,77,75,121,419,753,7,5527,307,0,2,2,1,0
32050,314,6872,72,33,56,0,4,12,72,1,1,1,1,2,2,0,2,0,1,0,0,2,14,6,0
32051,314,6872,1454,835,1044,76,110,219,1530,17,275,158,296,292,454,2297,3718,9,34017,1889,1,2,14,6,0
32052,244,5083,1943,715,1694,26,18,214,1969,12,185,120,237,197,357,1436,2721,7,20915,1161,0,2,3,1,0
32053,244,5083,1168,838,957,57,25,144,1225,19,348,224,416,367,640,3018,5452,11,61921,3440,1,2,3,1,0
32054,19,720,442,244,305,14,16,103,456,11,68,45,75,79,120,452,756,6,4588,254,0,2,1,1,0
32055,19,720,182,102,99,11,40,35,193,3,11,6,11,14,17,42,64,1,97,5,0,2,1,1,0
32056,170,5066,1660,832,1314,41,38,274,1701,20,312,209,395,332,604,2671,5058,12,64042,3557,1,2,10,3,0
32057,84,4861,1296,573,1062,40,33,157,1336,8,201,118,231,209,349,1561,2689,4,12365,686,0,2,27,0,0
32058,95,2929,773,419,590,28,0,166,801,10,204,113,217,214,330,1598,2554,5,13587,754,0,2,8,3,0
32059,81,3273,1178,367,1042,6,15,115,1184,9,94,51,95,103,146,644,976,4,4439,246,0,2,4,1,0
32060,95,2929,773,419,590,28,0,166,801,10,204,113,217,214,330,1598,2554,5,13587,754,0,2,8,3,0
32061,81,3273,1178,367,1042,6,15,115,1184,9,94,51,95,103,146,644,976,4,4439,246,0,2,4,1,0
32062,228,4805,2,2,2,0,0,0,2,0,0,0,0,0,0,0,0,0,0,0,0,2,38,8,0
32063,228,4805,99,48,90,1,3,5,100,0,0,0,0,0,0,0,0,0,0,0,0,2,38,8,0
32064,228,4805,8,5,5,2,0,1,10,0,0,0,0,0,0,0,0,0,0,0,0,2,38,8,0
32065,228,4805,1217,716,841,84,126,174,1301,14,185,118,215,199,333,1446,2542,8,20687,1149,0,2,38,8,0
32066,228,4805,160,89,115,0,13,31,160,7,15,11,17,22,28,78,124,3,495,27,0,2,38,8,0
32067,228,4805,10,10,9,9,0,0,19,0,0,0,0,0,0,0,0,0,0,0,0,2,38,8,0
32068,228,4805,173,84,99,8,29,36,181,5,12,7,13,17,20,54,81,2,221,12,0,2,38,8,0
32069,228,4805,3,1,1,3,0,0,6,0,0,0,0,0,0,0,0,0,0,0,0,2,38,8,0
32070,98,2019,463,295,324,28,62,57,491,12,134,82,154,146,236,989,1696,6,11700,650,0,2,8,11,0
32071,28,978,74,35,59,1,0,14,75,3,14,7,14,17,21,58,85,1,128,7,0,2,12,8,0
32072,28,978,245,125,200,5,7,34,250,7,30,17,34,37,51,166,265,3,1053,58,0,2,12,8,0
32073,99,2574,773,422,505,30,103,129,803,14,77,46,83,91,129,535,839,7,6334,351,0,2,41,11,0
32074,158,3740,77,34,69,0,0,8,77,3,24,16,29,27,45,114,213,1,387,21,0,2,21,0,0
32075,158,3740,712,438,573,51,9,84,763,14,102,71,128,116,199,733,1364,8,11988,666,0,2,21,0,0
32076,246,5918,722,423,573,19,0,135,741,12,172,101,199,184,300,1320,2257,6,15668,870,0,2,6,0,0
32077,246,5918,1508,847,911,44,250,301,1552,14,148,88,169,162,257,1120,1886,7,15077,837,0,2,6,0,0
32078,45,955,386,256,301,16,9,68,402,4,59,35,69,63,104,355,621,2,1453,80,0,2,8,5,0
32079,45,955,264,131,164,11,41,46,275,6,38,22,40,44,62,214,338,3,1068,59,0,2,8,5,0
32080,244,5083,1943,715,1694,26,18,214,1969,12,185,120,237,197,357,1436,2721,7,20915,1161,0,2,0,15,0
32081,244,5083,1168,838,957,57,25,144,1225,19,348,224,416,367,640,3018,5452,11,61921,3440,1,2,0,15,0
32082,100,4148,1289,550,1043,56,32,155,1345,10,167,93,185,177,278,1266,2075,5,11498,638,0,2,1,3,0
32083,14,843,75,38,59,1,3,12,76,2,4,2,4,6,6,10,15,1,15,0,0,2,7,17,0
32084,35,2389,1157,318,931,29,22,177,1186,6,104,63,125,110,188,712,1274,3,4596,255,0,2,48,0,0
32085,84,4861,1296,573,1062,40,33,157,1336,8,201,118,231,209,349,1561,2689,4,12365,686,0,2,20,0,0
32086,92,4896,1457,730,1242,11,6,188,1468,10,292,166,329,302,495,2424,4078,5,22973,1276,1,2,73,3,0
32087,39,2350,334,251,279,10,4,40,344,5,127,74,143,132,217,899,1528,2,4303,239,0,2,3,4,0
32088,48,2297,722,423,573,19,0,135,741,12,172,101,199,184,300,1320,2257,6,15668,870,0,2,11,0,0
32089,30,1324,373,158,315,8,0,51,381,5,76,44,79,81,123,486,779,2,2026,112,0,2,15,0,0
32090,158,3740,77,34,69,0,0,8,77,3,24,16,29,27,45,114,213,1,387,21,0,2,6,1,0
32091,158,3740,712,438,573,51,9,84,763,14,102,71,128,116,199,733,1364,8,11988,666,0,2,6,1,0
32092,74,1599,53,23,39,0,0,13,53,2,8,4,8,10,12,26,39,1,39,2,0,2,2,1,0
32093,74,1599,515,298,307,33,80,99,548,12,63,44,77,75,121,419,753,7,5527,307,0,2,2,1,0
32094,314,6872,72,33,56,0,4,12,72,1,1,1,1,2,2,0,2,0,1,0,0,2,14,6,0
32095,314,6872,1454,835,1044,76,110,219,1530,17,275,158,296,292,454,2297,3718,9,34017,1889,1,2,14,6,0
32096,244,5083,1943,715,1694,26,18,214,1969,12,185,120,237,197,357,1436,2721,7,20915,1161,0,2,3,1,0
32097,244,5083,1168,838,957,57,25,144,1225,19,348,224,416,367,640,3018,5452,11,61921,3440,1,2,3,1,0
32098,19,720,442,244,305,14,16,103,456,11,68,45,75,79,120,452,756,6,4588,254,0,2,1,1,0
32099,19,720,182,102,99,11,40,35,193,3,11,6,11,14,17,42,64,1,97,5,0,2,1,1,0
32100,95,2929,773,419,590,28,0,166,801,10,204,113,217,214,330,1598,2554,5,13587,754,0,2,8,3,0
32101,170,5066,1660,832,1314,41,38,274,1701,20,312,209,395,332,604,2671,5058,12,64042,3557,1,2,10,3,0
32102,84,4861,1296,573,1062,40,33,157,1336,8,201,118,231,209,349,1561,2689,4,12365,686,0,2,27,0,0
32103,81,3273,1178,367,1042,6,15,115,1184,9,94,51,95,103,146,644,976,4,4439,246,0,2,4,1,0
32104,100,2600,773,422,505,30,103,129,803,14,77,46,83,91,129,535,839,7,6334,351,0,2,5,0,0
32105,36,2459,1157,318,931,29,22,177,1186,6,104,63,125,110,188,712,1274,3,4596,255,0,2,34,0,0
32106,100,2600,773,422,505,30,103,129,803,14,77,46,83,91,129,535,839,7,6334,351,0,2,5,0,0
32107,36,2459,1157,318,931,29,22,177,1186,6,104,63,125,110,188,712,1274,3,4596,255,0,2,34,0,0
32108,124,4939,1450,624,1228,12,26,181,1462,14,306,186,354,320,540,2580,4493,8,36391,2021,1,2,1,1,0
32109,92,4912,1457,730,1242,11,6,188,1468,10,292,166,329,302,495,2424,4078,5,22973,1276,1,2,7,7,0
32110,100,2600,773,422,505,30,103,129,803,14,77,46,83,91,129,535,839,7,6334,351,0,2,5,0,0
32111,36,2459,1157,318,931,29,22,177,1186,6,104,63,125,110,188,712,1274,3,4596,255,0,2,34,0,0
32112,124,4939,1450,624,1228,12,26,181,1462,14,306,186,354,320,540,2580,4493,8,36391,2021,1,2,1,1,0
32113,92,4912,1457,730,1242,11,6,188,1468,10,292,166,329,302,495,2424,4078,5,22973,1276,1,2,7,7,0
32114,124,4939,1450,624,1228,12,26,181,1462,14,306,186,354,320,540,2580,4493,8,36391,2021,1,2,1,1,0
32115,92,4912,1457,730,1242,11,6,188,1468,10,292,166,329,302,495,2424,4078,5,22973,1276,1,2,7,7,0
32116,100,2600,773,422,505,30,103,129,803,14,77,46,83,91,129,535,839,7,6334,351,0,2,5,0,0
32117,36,2459,1157,318,931,29,22,177,1186,6,104,63,125,110,188,712,1274,3,4596,255,0,2,34,0,0
32118,124,4939,1450,624,1228,12,26,181,1462,14,306,186,354,320,540,2580,4493,8,36391,2021,1,2,1,1,0
32119,92,4912,1457,730,1242,11,6,188,1468,10,292,166,329,302,495,2424,4078,5,22973,1276,1,2,7,7,0
32120,1,106,42,7,35,4,0,5,46,1,2,1,2,3,3,2,4,0,2,0,0,2,1,1,0
32121,1,106,11,6,10,0,0,1,11,2,4,2,4,6,6,10,15,1,15,0,0,2,1,1,0
32122,1,106,42,7,35,4,0,5,46,1,2,1,2,3,3,2,4,0,2,0,0,2,1,1,0
32123,1,106,11,6,10,0,0,1,11,2,4,2,4,6,6,10,15,1,15,0,0,2,1,1,0
32124,230,4829,2,2,2,0,0,0,2,0,0,0,0,0,0,0,0,0,0,0,0,2,17,9,0
32125,230,4829,99,48,90,1,3,5,100,0,0,0,0,0,0,0,0,0,0,0,0,2,17,9,0
32126,230,4829,8,5,5,2,0,1,10,0,0,0,0,0,0,0,0,0,0,0,0,2,17,9,0
32127,230,4829,1217,716,841,84,126,174,1301,14,185,118,215,199,333,1446,2542,8,20687,1149,0,2,17,9,0
32128,230,4829,160,89,115,0,13,31,160,7,15,11,17,22,28,78,124,3,495,27,0,2,17,9,0
32129,230,4829,10,10,9,9,0,0,19,0,0,0,0,0,0,0,0,0,0,0,0,2,17,9,0
32130,230,4829,173,84,99,8,29,36,181,5,12,7,13,17,20,54,81,2,221,12,0,2,17,9,0
32131,230,4829,3,1,1,3,0,0,6,0,0,0,0,0,0,0,0,0,0,0,0,2,17,9,0
32132,28,978,74,35,59,1,0,14,75,3,14,7,14,17,21,58,85,1,128,7,0,2,1,1,0
32133,28,978,245,125,200,5,7,34,250,7,30,17,34,37,51,166,265,3,1053,58,0,2,1,1,0
32134,111,4421,1289,550,1043,56,32,155,1345,10,167,93,185,177,278,1266,2075,5,11498,638,0,2,55,0,0
32135,96,4991,1457,730,1242,11,6,188,1468,10,292,166,329,302,495,2424,4078,5,22973,1276,1,2,24,1,0
32136,1,106,42,7,35,4,0,5,46,1,2,1,2,3,3,2,4,0,2,0,0,2,1,1,0
32137,1,106,11,6,10,0,0,1,11,2,4,2,4,6,6,10,15,1,15,0,0,2,1,1,0
32138,1,106,42,7,35,4,0,5,46,1,2,1,2,3,3,2,4,0,2,0,0,2,1,1,0
32139,1,106,11,6,10,0,0,1,11,2,4,2,4,6,6,10,15,1,15,0,0,2,1,1,0
32140,230,4829,2,2,2,0,0,0,2,0,0,0,0,0,0,0,0,0,0,0,0,2,17,9,0
32141,230,4829,99,48,90,1,3,5,100,0,0,0,0,0,0,0,0,0,0,0,0,2,17,9,0
32142,230,4829,8,5,5,2,0,1,10,0,0,0,0,0,0,0,0,0,0,0,0,2,17,9,0
32143,230,4829,1217,716,841,84,126,174,1301,14,185,118,215,199,333,1446,2542,8,20687,1149,0,2,17,9,0
32144,230,4829,160,89,115,0,13,31,160,7,15,11,17,22,28,78,124,3,495,27,0,2,17,9,0
32145,230,4829,10,10,9,9,0,0,19,0,0,0,0,0,0,0,0,0,0,0,0,2,17,9,0
32146,230,4829,173,84,99,8,29,36,181,5,12,7,13,17,20,54,81,2,221,12,0,2,17,9,0
32147,230,4829,3,1,1,3,0,0,6,0,0,0,0,0,0,0,0,0,0,0,0,2,17,9,0
32148,28,978,74,35,59,1,0,14,75,3,14,7,14,17,21,58,85,1,128,7,0,2,1,1,0
32149,28,978,245,125,200,5,7,34,250,7,30,17,34,37,51,166,265,3,1053,58,0,2,1,1,0
32150,111,4421,1289,550,1043,56,32,155,1345,10,167,93,185,177,278,1266,2075,5,11498,638,0,2,55,0,0
32151,96,4991,1457,730,1242,11,6,188,1468,10,292,166,329,302,495,2424,4078,5,22973,1276,1,2,24,1,0
32152,1,108,42,7,35,4,0,5,46,1,2,1,2,3,3,2,4,0,2,0,0,2,1,0,0
32153,1,108,11,6,10,0,0,1,11,2,4,2,4,6,6,10,15,1,15,0,0,2,1,0,0
32154,38,2327,334,251,279,10,4,40,344,5,127,74,143,132,217,899,1528,2,4303,239,0,2,6,5,0
32155,1,108,42,7,35,4,0,5,46,1,2,1,2,3,3,2,4,0,2,0,0,2,1,0,0
32156,1,108,11,6,10,0,0,1,11,2,4,2,4,6,6,10,15,1,15,0,0,2,1,0,0
32157,38,2327,334,251,279,10,4,40,344,5,127,74,143,132,217,899,1528,2,4303,239,0,2,6,5,0
32158,48,1340,339,213,244,17,9,65,356,10,42,26,48,52,74,259,421,5,2410,133,0,2,22,5,1
32159,67,3269,1293,570,1093,25,15,163,1318,10,195,123,241,205,364,1516,2795,6,17273,959,0,2,14,0,1
32160,157,3295,1513,682,1277,25,13,200,1538,11,199,116,219,210,335,1557,2584,6,15641,868,0,2,5,0,1
32161,157,3295,819,519,539,24,98,155,843,15,96,57,106,111,163,690,1107,8,9171,509,0,2,5,0,1
32162,125,5375,1513,682,1277,25,13,200,1538,11,199,116,219,210,335,1557,2584,6,15641,868,0,2,24,0,1
32163,157,3295,1513,682,1277,25,13,200,1538,11,199,116,219,210,335,1557,2584,6,15641,868,0,2,5,0,0
32164,157,3295,819,519,539,24,98,155,843,15,96,57,106,111,163,690,1107,8,9171,509,0,2,5,0,0
32165,125,5375,1513,682,1277,25,13,200,1538,11,199,116,219,210,335,1557,2584,6,15641,868,0,2,24,0,0
32166,183,5547,1660,832,1314,41,38,274,1701,20,312,209,395,332,604,2671,5058,12,64042,3557,1,2,3,3,0
32167,183,5547,1057,646,719,113,100,145,1170,18,215,134,248,233,382,1740,3004,10,31186,1732,1,2,3,3,0
32168,2,40,9,6,6,0,0,3,9,0,0,0,0,0,0,0,0,0,0,0,0,2,0,1,0
32169,2,40,13,9,8,0,0,4,13,0,0,0,0,0,0,0,0,0,0,0,0,2,0,1,0
32170,1,108,42,7,35,4,0,5,46,1,2,1,2,3,3,2,4,0,2,0,0,2,0,1,0
32171,1,108,11,6,10,0,0,1,11,2,4,2,4,6,6,10,15,1,15,0,0,2,0,1,0
32172,17,348,95,58,50,9,16,20,104,12,33,24,45,45,69,209,378,8,3100,172,0,2,0,1,0
32173,52,625,647,139,84,35,284,233,682,0,0,0,0,0,0,0,0,0,0,0,0,2,0,1,0
32174,100,2600,773,422,505,30,103,129,803,14,77,46,83,91,129,535,839,7,6334,351,0,2,0,1,0
32175,158,3740,77,34,69,0,0,8,77,3,24,16,29,27,45,114,213,1,387,21,0,2,0,1,0
32176,158,3740,712,438,573,51,9,84,763,14,102,71,128,116,199,733,1364,8,11988,666,0,2,0,1,0
32177,69,1497,402,202,227,24,74,80,426,12,52,33,61,64,94,339,564,7,3969,220,0,2,0,1,0
32178,59,1228,91,45,69,0,3,18,91,3,9,6,10,12,16,33,57,1,95,5,0,2,0,1,0
32179,59,1228,367,234,237,17,34,68,384,16,55,34,61,71,95,381,584,8,5183,287,0,2,0,1,0
32180,95,2929,773,419,590,28,0,166,801,10,204,113,217,214,330,1598,2554,5,13587,754,0,2,0,1,0
32181,4,163,27,21,21,0,0,6,27,3,6,3,6,9,9,20,28,1,42,2,0,2,0,1,0
32182,15,1066,215,129,180,6,0,29,221,8,65,43,72,73,115,415,711,4,3153,175,0,2,0,1,0
32183,53,1862,601,196,481,2,23,85,603,8,63,36,72,71,108,400,664,4,3036,168,0,2,0,1,0
32184,183,5547,1660,832,1314,41,38,274,1701,20,312,209,395,332,604,2671,5058,12,64042,3557,1,2,3,3,0
32185,183,5547,1057,646,719,113,100,145,1170,18,215,134,248,233,382,1740,3004,10,31186,1732,1,2,3,3,0
32186,49,1371,339,213,244,17,9,65,356,10,42,26,48,52,74,259,421,5,2410,133,0,2,24,17,1
32187,68,3294,1293,570,1093,25,15,163,1318,10,195,123,241,205,364,1516,2795,6,17273,959,0,2,11,6,1
32188,49,1371,339,213,244,17,9,65,356,10,42,26,48,52,74,259,421,5,2410,133,0,2,29,5,0
32189,68,3294,1293,570,1093,25,15,163,1318,10,195,123,241,205,364,1516,2795,6,17273,959,0,2,19,0,0
32190,246,5928,722,423,573,19,0,135,741,12,172,101,199,184,300,1320,2257,6,15668,870,0,2,1,0,0
32191,246,5928,1508,847,911,44,250,301,1552,14,148,88,169,162,257,1120,1886,7,15077,837,0,2,1,0,0
32192,2,40,9,6,6,0,0,3,9,0,0,0,0,0,0,0,0,0,0,0,0,2,0,1,0
32193,2,40,13,9,8,0,0,4,13,0,0,0,0,0,0,0,0,0,0,0,0,2,0,1,0
32194,1,108,42,7,35,4,0,5,46,1,2,1,2,3,3,2,4,0,2,0,0,2,0,1,0
32195,1,108,11,6,10,0,0,1,11,2,4,2,4,6,6,10,15,1,15,0,0,2,0,1,0
32196,17,348,95,58,50,9,16,20,104,12,33,24,45,45,69,209,378,8,3100,172,0,2,0,1,0
32197,52,625,647,139,84,35,284,233,682,0,0,0,0,0,0,0,0,0,0,0,0,2,0,1,0
32198,100,2600,773,422,505,30,103,129,803,14,77,46,83,91,129,535,839,7,6334,351,0,2,0,1,0
32199,158,3740,77,34,69,0,0,8,77,3,24,16,29,27,45,114,213,1,387,21,0,2,0,1,0
32200,158,3740,712,438,573,51,9,84,763,14,102,71,128,116,199,733,1364,8,11988,666,0,2,0,1,0
32201,69,1497,402,202,227,24,74,80,426,12,52,33,61,64,94,339,564,7,3969,220,0,2,0,1,0
32202,59,1228,91,45,69,0,3,18,91,3,9,6,10,12,16,33,57,1,95,5,0,2,0,1,0
32203,59,1228,367,234,237,17,34,68,384,16,55,34,61,71,95,381,584,8,5183,287,0,2,0,1,0
32204,95,2929,773,419,590,28,0,166,801,10,204,113,217,214,330,1598,2554,5,13587,754,0,2,0,1,0
32205,4,163,27,21,21,0,0,6,27,3,6,3,6,9,9,20,28,1,42,2,0,2,0,1,0
32206,15,1066,215,129,180,6,0,29,221,8,65,43,72,73,115,415,711,4,3153,175,0,2,0,1,0
32207,53,1862,601,196,481,2,23,85,603,8,63,36,72,71,108,400,664,4,3036,168,0,2,0,1,0
32208,246,5928,722,423,573,19,0,135,741,12,172,101,199,184,300,1320,2257,6,15668,870,0,2,1,0,0
32209,246,5928,1508,847,911,44,250,301,1552,14,148,88,169,162,257,1120,1886,7,15077,837,0,2,1,0,0
32210,78,1822,996,429,845,24,10,117,1020,7,76,50,88,83,138,494,879,4,3565,198,0,2,10,13,0
32211,78,1822,456,277,329,12,42,72,468,13,85,50,97,98,147,592,972,7,7212,400,0,2,10,13,0
32212,78,1822,996,429,845,24,10,117,1020,7,76,50,88,83,138,494,879,4,3565,198,0,2,10,13,0
32213,78,1822,456,277,329,12,42,72,468,13,85,50,97,98,147,592,972,7,7212,400,0,2,10,13,0
32214,248,5735,4293,999,3693,19,54,507,4312,9,155,88,170,164,258,1156,1898,4,9368,520,0,2,18,5,1
32215,248,5735,1482,859,1002,125,135,219,1607,16,219,134,251,235,385,1766,3032,9,27804,1544,1,2,18,5,1
32216,95,2086,1043,504,840,53,9,147,1096,9,180,112,198,189,310,1377,2344,4,11604,644,0,2,1,0,1
32217,95,2086,383,288,292,26,6,62,409,11,65,38,67,76,105,429,656,5,3719,206,0,2,1,0,1
32218,170,7538,139,89,101,2,0,35,141,7,54,34,62,61,96,330,569,4,2287,127,0,2,1,1,1
32219,170,7538,7,5,5,0,0,2,7,1,2,1,2,3,3,2,4,0,2,0,0,2,1,1,1
32220,171,7568,4293,999,3693,19,54,507,4312,9,155,88,170,164,258,1156,1898,4,9368,520,0,2,38,0,0
32221,171,7568,1482,859,1002,125,135,219,1607,16,219,134,251,235,385,1766,3032,9,27804,1544,1,2,38,0,0
32222,248,5735,4293,999,3693,19,54,507,4312,9,155,88,170,164,258,1156,1898,4,9368,520,0,2,0,1,0
32223,248,5735,1482,859,1002,125,135,219,1607,16,219,134,251,235,385,1766,3032,9,27804,1544,1,2,0,1,0
32224,95,2085,1043,504,840,53,9,147,1096,9,180,112,198,189,310,1377,2344,4,11604,644,0,2,0,1,0
32225,95,2085,383,288,292,26,6,62,409,11,65,38,67,76,105,429,656,5,3719,206,0,2,0,1,0
32226,171,7568,4293,999,3693,19,54,507,4312,9,155,88,170,164,258,1156,1898,4,9368,520,0,2,1,1,0
32227,171,7568,1482,859,1002,125,135,219,1607,16,219,134,251,235,385,1766,3032,9,27804,1544,1,2,1,1,0
32228,247,5132,1943,715,1694,26,18,214,1969,12,185,120,237,197,357,1436,2721,7,20915,1161,0,2,6,1,1
32229,247,5132,1168,838,957,57,25,144,1225,19,348,224,416,367,640,3018,5452,11,61921,3440,1,2,6,1,1
32230,102,5395,1943,715,1694,26,18,214,1969,12,185,120,237,197,357,1436,2721,7,20915,1161,0,2,20,0,1
32231,247,5125,1943,715,1694,26,18,214,1969,12,185,120,237,197,357,1436,2721,7,20915,1161,0,2,7,7,0
32232,247,5125,1168,838,957,57,25,144,1225,19,348,224,416,367,640,3018,5452,11,61921,3440,1,2,7,7,0
32233,96,4991,1457,730,1242,11,6,188,1468,10,292,166,329,302,495,2424,4078,5,22973,1276,1,2,3,3,0
32234,30,1324,373,158,315,8,0,51,381,5,76,44,79,81,123,486,779,2,2026,112,0,2,1,1,0
32235,101,5370,1943,715,1694,26,18,214,1969,12,185,120,237,197,357,1436,2721,7,20915,1161,0,2,10,10,0
32236,247,5125,1943,715,1694,26,18,214,1969,12,185,120,237,197,357,1436,2721,7,20915,1161,0,2,11,6,0
32237,247,5125,1168,838,957,57,25,144,1225,19,348,224,416,367,640,3018,5452,11,61921,3440,1,2,11,6,0
32238,96,4991,1457,730,1242,11,6,188,1468,10,292,166,329,302,495,2424,4078,5,22973,1276,1,2,3,3,0
32239,30,1324,373,158,315,8,0,51,381,5,76,44,79,81,123,486,779,2,2026,112,0,2,1,1,0
32240,101,5370,1943,715,1694,26,18,214,1969,12,185,120,237,197,357,1436,2721,7,20915,1161,0,2,29,9,0
32241,1,94,42,7,35,4,0,5,46,1,2,1,2,3,3,2,4,0,2,0,0,2,1,8,0
32242,1,94,11,6,10,0,0,1,11,2,4,2,4,6,6,10,15,1,15,0,0,2,1,8,0
32243,1,94,42,7,35,4,0,5,46,1,2,1,2,3,3,2,4,0,2,0,0,2,1,8,0
32244,1,94,11,6,10,0,0,1,11,2,4,2,4,6,6,10,15,1,15,0,0,2,1,8,0
32245,171,7568,4293,999,3693,19,54,507,4312,9,155,88,170,164,258,1156,1898,4,9368,520,0,2,3,3,0
32246,171,7568,1482,859,1002,125,135,219,1607,16,219,134,251,235,385,1766,3032,9,27804,1544,1,2,3,3,0
32247,248,5735,4293,999,3693,19,54,507,4312,9,155,88,170,164,258,1156,1898,4,9368,520,0,2,17,5,0
32248,248,5735,1482,859,1002,125,135,219,1607,16,219,134,251,235,385,1766,3032,9,27804,1544,1,2,17,5,0
32249,171,7568,4293,999,3693,19,54,507,4312,9,155,88,170,164,258,1156,1898,4,9368,520,0,3,38,0,0
32250,171,7568,1482,859,1002,125,135,219,1607,16,219,134,251,235,385,1766,3032,9,27804,1544,1,3,38,0,0
32251,125,5391,1513,682,1277,25,13,200,1538,11,199,116,219,210,335,1557,2584,6,15641,868,0,2,14,6,0
32252,125,5391,1513,682,1277,25,13,200,1538,11,199,116,219,210,335,1557,2584,6,15641,868,0,2,14,6,0
32253,169,5066,1660,832,1314,41,38,274,1701,20,312,209,395,332,604,2671,5058,12,64042,3557,1,2,1,2,1
32254,169,5066,1660,832,1314,41,38,274,1701,20,312,209,395,332,604,2671,5058,12,64042,3557,1,2,1,2,0
32255,2,40,9,6,6,0,0,3,9,0,0,0,0,0,0,0,0,0,0,0,0,2,0,1,0
32256,2,40,13,9,8,0,0,4,13,0,0,0,0,0,0,0,0,0,0,0,0,2,0,1,0
32257,1,94,42,7,35,4,0,5,46,1,2,1,2,3,3,2,4,0,2,0,0,2,2,9,0
32258,1,94,11,6,10,0,0,1,11,2,4,2,4,6,6,10,15,1,15,0,0,2,2,9,0
32259,17,348,95,58,50,9,16,20,104,12,33,24,45,45,69,209,378,8,3100,172,0,2,0,1,0
32260,157,3295,1513,682,1277,25,13,200,1538,11,199,116,219,210,335,1557,2584,6,15641,868,0,2,5,0,0
32261,157,3295,819,519,539,24,98,155,843,15,96,57,106,111,163,690,1107,8,9171,509,0,2,5,0,0
32262,52,625,647,139,84,35,284,233,682,0,0,0,0,0,0,0,0,0,0,0,0,2,0,1,0
32263,100,2600,773,422,505,30,103,129,803,14,77,46,83,91,129,535,839,7,6334,351,0,2,0,1,0
32264,158,3740,77,34,69,0,0,8,77,3,24,16,29,27,45,114,213,1,387,21,0,2,0,1,0
32265,158,3740,712,438,573,51,9,84,763,14,102,71,128,116,199,733,1364,8,11988,666,0,2,0,1,0
32266,69,1497,402,202,227,24,74,80,426,12,52,33,61,64,94,339,564,7,3969,220,0,2,0,1,0
32267,59,1228,91,45,69,0,3,18,91,3,9,6,10,12,16,33,57,1,95,5,0,2,0,1,0
32268,59,1228,367,234,237,17,34,68,384,16,55,34,61,71,95,381,584,8,5183,287,0,2,0,1,0
32269,95,2929,773,419,590,28,0,166,801,10,204,113,217,214,330,1598,2554,5,13587,754,0,2,0,1,0
32270,4,163,27,21,21,0,0,6,27,3,6,3,6,9,9,20,28,1,42,2,0,2,0,1,0
32271,169,5066,1660,832,1314,41,38,274,1701,20,312,209,395,332,604,2671,5058,12,64042,3557,1,2,1,2,0
32272,125,5391,1513,682,1277,25,13,200,1538,11,199,116,219,210,335,1557,2584,6,15641,868,0,2,38,6,0
32273,38,2327,334,251,279,10,4,40,344,5,127,74,143,132,217,899,1528,2,4303,239,0,2,6,5,0
32274,15,1066,215,129,180,6,0,29,221,8,65,43,72,73,115,415,711,4,3153,175,0,2,0,1,0
32275,53,1862,601,196,481,2,23,85,603,8,63,36,72,71,108,400,664,4,3036,168,0,2,0,1,0
32276,228,4805,2,2,2,0,0,0,2,0,0,0,0,0,0,0,0,0,0,0,0,2,1,1,0
32277,228,4805,99,48,90,1,3,5,100,0,0,0,0,0,0,0,0,0,0,0,0,2,1,1,0
32278,228,4805,8,5,5,2,0,1,10,0,0,0,0,0,0,0,0,0,0,0,0,2,1,1,0
32279,228,4805,1217,716,841,84,126,174,1301,14,185,118,215,199,333,1446,2542,8,20687,1149,0,2,1,1,0
32280,228,4805,160,89,115,0,13,31,160,7,15,11,17,22,28,78,124,3,495,27,0,2,1,1,0
32281,228,4805,10,10,9,9,0,0,19,0,0,0,0,0,0,0,0,0,0,0,0,2,1,1,0
32282,228,4805,173,84,99,8,29,36,181,5,12,7,13,17,20,54,81,2,221,12,0,2,1,1,0
32283,228,4805,3,1,1,3,0,0,6,0,0,0,0,0,0,0,0,0,0,0,0,2,1,1,0
32284,2,40,9,6,6,0,0,3,9,0,0,0,0,0,0,0,0,0,0,0,0,2,0,1,0
32285,2,40,13,9,8,0,0,4,13,0,0,0,0,0,0,0,0,0,0,0,0,2,0,1,0
32286,1,94,42,7,35,4,0,5,46,1,2,1,2,3,3,2,4,0,2,0,0,2,2,9,0
32287,1,94,11,6,10,0,0,1,11,2,4,2,4,6,6,10,15,1,15,0,0,2,2,9,0
32288,17,348,95,58,50,9,16,20,104,12,33,24,45,45,69,209,378,8,3100,172,0,2,0,1,0
32289,157,3295,1513,682,1277,25,13,200,1538,11,199,116,219,210,335,1557,2584,6,15641,868,0,2,5,0,0
32290,157,3295,819,519,539,24,98,155,843,15,96,57,106,111,163,690,1107,8,9171,509,0,2,5,0,0
32291,52,625,647,139,84,35,284,233,682,0,0,0,0,0,0,0,0,0,0,0,0,2,0,1,0
32292,100,2600,773,422,505,30,103,129,803,14,77,46,83,91,129,535,839,7,6334,351,0,2,0,1,0
32293,158,3740,77,34,69,0,0,8,77,3,24,16,29,27,45,114,213,1,387,21,0,2,0,1,0
32294,158,3740,712,438,573,51,9,84,763,14,102,71,128,116,199,733,1364,8,11988,666,0,2,0,1,0
32295,69,1497,402,202,227,24,74,80,426,12,52,33,61,64,94,339,564,7,3969,220,0,2,0,1,0
32296,59,1228,91,45,69,0,3,18,91,3,9,6,10,12,16,33,57,1,95,5,0,2,0,1,0
32297,59,1228,367,234,237,17,34,68,384,16,55,34,61,71,95,381,584,8,5183,287,0,2,0,1,0
32298,95,2929,773,419,590,28,0,166,801,10,204,113,217,214,330,1598,2554,5,13587,754,0,2,0,1,0
32299,4,163,27,21,21,0,0,6,27,3,6,3,6,9,9,20,28,1,42,2,0,2,0,1,0
32300,169,5066,1660,832,1314,41,38,274,1701,20,312,209,395,332,604,2671,5058,12,64042,3557,1,2,1,2,0
32301,125,5391,1513,682,1277,25,13,200,1538,11,199,116,219,210,335,1557,2584,6,15641,868,0,2,38,6,0
32302,38,2327,334,251,279,10,4,40,344,5,127,74,143,132,217,899,1528,2,4303,239,0,2,6,5,0
32303,15,1066,215,129,180,6,0,29,221,8,65,43,72,73,115,415,711,4,3153,175,0,2,0,1,0
32304,53,1862,601,196,481,2,23,85,603,8,63,36,72,71,108,400,664,4,3036,168,0,2,0,1,0
32305,233,5719,722,423,573,19,0,135,741,12,172,101,199,184,300,1320,2257,6,15668,870,0,2,0,42,0
32306,233,5719,1508,847,911,44,250,301,1552,14,148,88,169,162,257,1120,1886,7,15077,837,0,2,0,42,0
32307,233,5719,722,423,573,19,0,135,741,12,172,101,199,184,300,1320,2257,6,15668,870,0,2,0,42,0
32308,233,5719,1508,847,911,44,250,301,1552,14,148,88,169,162,257,1120,1886,7,15077,837,0,2,0,42,0
32309,313,6859,72,33,56,0,4,12,72,1,1,1,1,2,2,0,2,0,1,0,0,2,16,17,1
32310,313,6859,1454,835,1044,76,110,219,1530,17,275,158,296,292,454,2297,3718,9,34017,1889,1,2,16,17,1
32311,313,6859,72,33,56,0,4,12,72,1,1,1,1,2,2,0,2,0,1,0,0,2,2,2,0
32312,313,6859,1454,835,1044,76,110,219,1530,17,275,158,296,292,454,2297,3718,9,34017,1889,1,2,2,2,0
32313,313,6859,72,33,56,0,4,12,72,1,1,1,1,2,2,0,2,0,1,0,0,2,16,17,0
32314,313,6859,1454,835,1044,76,110,219,1530,17,275,158,296,292,454,2297,3718,9,34017,1889,1,2,16,17,0
32315,246,5918,722,423,573,19,0,135,741,12,172,101,199,184,300,1320,2257,6,15668,870,0,2,1,1,0
32316,246,5918,1508,847,911,44,250,301,1552,14,148,88,169,162,257,1120,1886,7,15077,837,0,2,1,1,0
32317,246,5918,722,423,573,19,0,135,741,12,172,101,199,184,300,1320,2257,6,15668,870,0,2,1,1,0
32318,246,5918,1508,847,911,44,250,301,1552,14,148,88,169,162,257,1120,1886,7,15077,837,0,2,1,1,0
32319,183,5550,1660,832,1314,41,38,274,1701,20,312,209,395,332,604,2671,5058,12,64042,3557,1,2,3,3,0
32320,183,5550,1057,646,719,113,100,145,1170,18,215,134,248,233,382,1740,3004,10,31186,1732,1,2,3,3,0
32321,84,4869,1296,573,1062,40,33,157,1336,8,201,118,231,209,349,1561,2689,4,12365,686,0,2,2,1,0
32322,84,4869,1296,573,1062,40,33,157,1336,8,201,118,231,209,349,1561,2689,4,12365,686,0,2,2,1,0
32323,48,1338,339,213,244,17,9,65,356,10,42,26,48,52,74,259,421,5,2410,133,0,2,6,11,1
32324,311,6810,72,33,56,0,4,12,72,1,1,1,1,2,2,0,2,0,1,0,0,2,9,22,1
32325,311,6810,1454,835,1044,76,110,219,1530,17,275,158,296,292,454,2297,3718,9,34017,1889,1,2,9,22,1
32326,48,1338,339,213,244,17,9,65,356,10,42,26,48,52,74,259,421,5,2410,133,0,2,1,1,0
32327,309,6777,72,33,56,0,4,12,72,1,1,1,1,2,2,0,2,0,1,0,0,2,0,5,0
32328,309,6777,1454,835,1044,76,110,219,1530,17,275,158,296,292,454,2297,3718,9,34017,1889,1,2,0,5,0
32329,48,1338,339,213,244,17,9,65,356,10,42,26,48,52,74,259,421,5,2410,133,0,2,6,11,0
32330,309,6777,72,33,56,0,4,12,72,1,1,1,1,2,2,0,2,0,1,0,0,2,4,22,0
32331,309,6777,1454,835,1044,76,110,219,1530,17,275,158,296,292,454,2297,3718,9,34017,1889,1,2,4,22,0
32332,183,5550,1660,832,1314,41,38,274,1701,20,312,209,395,332,604,2671,5058,12,64042,3557,1,2,2,0,0
32333,183,5550,1057,646,719,113,100,145,1170,18,215,134,248,233,382,1740,3004,10,31186,1732,1,2,2,0,0
32334,183,5550,1660,832,1314,41,38,274,1701,20,312,209,395,332,604,2671,5058,12,64042,3557,1,2,5,3,0
32335,183,5550,1057,646,719,113,100,145,1170,18,215,134,248,233,382,1740,3004,10,31186,1732,1,2,5,3,0
32336,230,4967,182,127,129,0,0,53,182,5,39,21,42,44,63,217,343,2,926,51,0,2,7,12,0
32337,230,4967,1165,710,800,67,119,181,1232,18,243,153,282,261,435,2000,3492,10,36473,2026,1,2,7,12,0
32338,1,323,382,65,130,157,2,92,539,4,10,5,10,14,15,41,57,2,114,6,0,2,1,1,0
32339,170,5135,1660,832,1314,41,38,274,1701,20,312,209,395,332,604,2671,5058,12,64042,3557,1,2,23,0,0
32340,170,5135,1660,832,1314,41,38,274,1701,20,312,209,395,332,604,2671,5058,12,64042,3557,1,2,23,0,0
32341,1,323,382,65,130,157,2,92,539,4,10,5,10,14,15,41,57,2,114,6,0,2,1,1,0
32342,230,4967,182,127,129,0,0,53,182,5,39,21,42,44,63,217,343,2,926,51,0,2,7,12,0
32343,230,4967,1165,710,800,67,119,181,1232,18,243,153,282,261,435,2000,3492,10,36473,2026,1,2,7,12,0
32344,66,3225,1293,570,1093,25,15,163,1318,10,195,123,241,205,364,1516,2795,6,17273,959,0,2,2,4,0
32345,66,3254,1293,570,1093,25,15,163,1318,10,195,123,241,205,364,1516,2795,6,17273,959,0,2,10,3,1
32346,48,1341,339,213,244,17,9,65,356,10,42,26,48,52,74,259,421,5,2410,133,0,2,2,2,0
32347,311,6841,72,33,56,0,4,12,72,1,1,1,1,2,2,0,2,0,1,0,0,2,10,0,0
32348,311,6841,1454,835,1044,76,110,219,1530,17,275,158,296,292,454,2297,3718,9,34017,1889,1,2,10,0,0
32349,112,4510,1289,550,1043,56,32,155,1345,10,167,93,185,177,278,1266,2075,5,11498,638,0,2,28,0,0
32350,48,1341,339,213,244,17,9,65,356,10,42,26,48,52,74,259,421,5,2410,133,0,2,2,2,0
32351,66,3254,1293,570,1093,25,15,163,1318,10,195,123,241,205,364,1516,2795,6,17273,959,0,2,12,7,0
32352,1,323,382,65,130,157,2,92,539,4,10,5,10,14,15,41,57,2,114,6,0,2,1,1,0
32353,183,5553,1660,832,1314,41,38,274,1701,20,312,209,395,332,604,2671,5058,12,64042,3557,1,2,5,3,0
32354,183,5553,1057,646,719,113,100,145,1170,18,215,134,248,233,382,1740,3004,10,31186,1732,1,2,5,3,0
32355,230,4829,2,2,2,0,0,0,2,0,0,0,0,0,0,0,0,0,0,0,0,2,1,1,0
32356,230,4829,99,48,90,1,3,5,100,0,0,0,0,0,0,0,0,0,0,0,0,2,1,1,0
32357,230,4829,8,5,5,2,0,1,10,0,0,0,0,0,0,0,0,0,0,0,0,2,1,1,0
32358,230,4829,1217,716,841,84,126,174,1301,14,185,118,215,199,333,1446,2542,8,20687,1149,0,2,1,1,0
32359,230,4829,160,89,115,0,13,31,160,7,15,11,17,22,28,78,124,3,495,27,0,2,1,1,0
32360,230,4829,10,10,9,9,0,0,19,0,0,0,0,0,0,0,0,0,0,0,0,2,1,1,0
32361,230,4829,173,84,99,8,29,36,181,5,12,7,13,17,20,54,81,2,221,12,0,2,1,1,0
32362,230,4829,3,1,1,3,0,0,6,0,0,0,0,0,0,0,0,0,0,0,0,2,1,1,0
32363,233,5719,722,423,573,19,0,135,741,12,172,101,199,184,300,1320,2257,6,15668,870,0,2,1,1,0
32364,233,5719,1508,847,911,44,250,301,1552,14,148,88,169,162,257,1120,1886,7,15077,837,0,2,1,1,0
32365,308,6764,72,33,56,0,4,12,72,1,1,1,1,2,2,0,2,0,1,0,0,2,16,17,0
32366,308,6764,1454,835,1044,76,110,219,1530,17,275,158,296,292,454,2297,3718,9,34017,1889,1,2,16,17,0
32367,170,5135,1660,832,1314,41,38,274,1701,20,312,209,395,332,604,2671,5058,12,64042,3557,1,2,23,0,0
32368,84,4869,1296,573,1062,40,33,157,1336,8,201,118,231,209,349,1561,2689,4,12365,686,0,2,2,1,0
32369,68,3323,1293,570,1093,25,15,163,1318,10,195,123,241,205,364,1516,2795,6,17273,959,0,2,12,7,0
32370,1,323,382,65,130,157,2,92,539,4,10,5,10,14,15,41,57,2,114,6,0,2,1,1,0
32371,183,5553,1660,832,1314,41,38,274,1701,20,312,209,395,332,604,2671,5058,12,64042,3557,1,2,5,3,0
32372,183,5553,1057,646,719,113,100,145,1170,18,215,134,248,233,382,1740,3004,10,31186,1732,1,2,5,3,0
32373,230,4829,2,2,2,0,0,0,2,0,0,0,0,0,0,0,0,0,0,0,0,2,1,1,0
32374,230,4829,99,48,90,1,3,5,100,0,0,0,0,0,0,0,0,0,0,0,0,2,1,1,0
32375,230,4829,8,5,5,2,0,1,10,0,0,0,0,0,0,0,0,0,0,0,0,2,1,1,0
32376,230,4829,1217,716,841,84,126,174,1301,14,185,118,215,199,333,1446,2542,8,20687,1149,0,2,1,1,0
32377,230,4829,160,89,115,0,13,31,160,7,15,11,17,22,28,78,124,3,495,27,0,2,1,1,0
32378,230,4829,10,10,9,9,0,0,19,0,0,0,0,0,0,0,0,0,0,0,0,2,1,1,0
32379,230,4829,173,84,99,8,29,36,181,5,12,7,13,17,20,54,81,2,221,12,0,2,1,1,0
32380,230,4829,3,1,1,3,0,0,6,0,0,0,0,0,0,0,0,0,0,0,0,2,1,1,0
32381,233,5719,722,423,573,19,0,135,741,12,172,101,199,184,300,1320,2257,6,15668,870,0,2,1,1,0
32382,233,5719,1508,847,911,44,250,301,1552,14,148,88,169,162,257,1120,1886,7,15077,837,0,2,1,1,0
32383,308,6764,72,33,56,0,4,12,72,1,1,1,1,2,2,0,2,0,1,0,0,2,16,17,0
32384,308,6764,1454,835,1044,76,110,219,1530,17,275,158,296,292,454,2297,3718,9,34017,1889,1,2,16,17,0
32385,170,5135,1660,832,1314,41,38,274,1701,20,312,209,395,332,604,2671,5058,12,64042,3557,1,2,23,0,0
32386,84,4869,1296,573,1062,40,33,157,1336,8,201,118,231,209,349,1561,2689,4,12365,686,0,2,2,1,0
32387,68,3323,1293,570,1093,25,15,163,1318,10,195,123,241,205,364,1516,2795,6,17273,959,0,2,12,7,0
32388,95,2385,1455,414,1257,16,76,112,1471,5,41,23,46,46,69,231,381,2,1069,59,0,2,3,0,0
32389,95,2385,669,365,481,22,61,110,691,15,103,63,122,118,185,747,1273,8,11311,628,0,2,3,0,0
32390,245,5668,4293,999,3693,19,54,507,4312,9,155,88,170,164,258,1156,1898,4,9368,520,0,2,1,1,0
32391,245,5668,1482,859,1002,125,135,219,1607,16,219,134,251,235,385,1766,3032,9,27804,1544,1,2,1,1,0
32392,170,7538,139,89,101,2,0,35,141,7,54,34,62,61,96,330,569,4,2287,127,0,2,2,2,0
32393,170,7538,7,5,5,0,0,2,7,1,2,1,2,3,3,2,4,0,2,0,0,2,2,2,0
32394,72,3308,1455,414,1257,16,76,112,1471,5,41,23,46,46,69,231,381,2,1069,59,0,2,12,0,0
32395,21,541,205,80,86,16,53,53,221,7,18,10,19,25,29,94,134,3,497,27,0,2,5,1,0
32396,21,541,205,80,86,16,53,53,221,7,18,10,19,25,29,94,134,3,497,27,0,2,1,1,0
32397,21,541,205,80,86,16,53,53,221,7,18,10,19,25,29,94,134,3,497,27,0,2,1,1,0
32398,95,2385,1455,414,1257,16,76,112,1471,5,41,23,46,46,69,231,381,2,1069,59,0,2,3,0,0
32399,95,2385,669,365,481,22,61,110,691,15,103,63,122,118,185,747,1273,8,11311,628,0,2,3,0,0
32400,21,541,205,80,86,16,53,53,221,7,18,10,19,25,29,94,134,3,497,27,0,2,5,1,0
32401,72,3308,1455,414,1257,16,76,112,1471,5,41,23,46,46,69,231,381,2,1069,59,0,2,12,0,0
32402,310,6828,72,33,56,0,4,12,72,1,1,1,1,2,2,0,2,0,1,0,0,2,10,0,0
32403,310,6828,1454,835,1044,76,110,219,1530,17,275,158,296,292,454,2297,3718,9,34017,1889,1,2,10,0,0
32404,112,4510,1289,550,1043,56,32,155,1345,10,167,93,185,177,278,1266,2075,5,11498,638,0,2,28,0,0
32405,233,5732,722,423,573,19,0,135,741,12,172,101,199,184,300,1320,2257,6,15668,870,0,2,2,0,1
32406,233,5732,1508,847,911,44,250,301,1552,14,148,88,169,162,257,1120,1886,7,15077,837,0,2,2,0,1
32407,49,2385,722,423,573,19,0,135,741,12,172,101,199,184,300,1320,2257,6,15668,870,0,2,16,0,1
32408,233,5732,722,423,573,19,0,135,741,12,172,101,199,184,300,1320,2257,6,15668,870,0,2,2,0,0
32409,233,5732,1508,847,911,44,250,301,1552,14,148,88,169,162,257,1120,1886,7,15077,837,0,2,2,0,0
32410,49,2385,722,423,573,19,0,135,741,12,172,101,199,184,300,1320,2257,6,15668,870,0,2,16,0,0
32411,233,4889,2,2,2,0,0,0,2,0,0,0,0,0,0,0,0,0,0,0,0,2,8,0,0
32412,233,4889,99,48,90,1,3,5,100,0,0,0,0,0,0,0,0,0,0,0,0,2,8,0,0
32413,233,4889,8,5,5,2,0,1,10,0,0,0,0,0,0,0,0,0,0,0,0,2,8,0,0
32414,233,4889,1217,716,841,84,126,174,1301,14,185,118,215,199,333,1446,2542,8,20687,1149,0,2,8,0,0
32415,233,4889,160,89,115,0,13,31,160,7,15,11,17,22,28,78,124,3,495,27,0,2,8,0,0
32416,233,4889,10,10,9,9,0,0,19,0,0,0,0,0,0,0,0,0,0,0,0,2,8,0,0
32417,233,4889,173,84,99,8,29,36,181,5,12,7,13,17,20,54,81,2,221,12,0,2,8,0,0
32418,233,4889,3,1,1,3,0,0,6,0,0,0,0,0,0,0,0,0,0,0,0,2,8,0,0
32419,29,1886,384,251,317,7,8,52,391,11,70,44,84,81,128,467,811,6,5355,297,0,2,7,0,0
32420,233,4889,2,2,2,0,0,0,2,0,0,0,0,0,0,0,0,0,0,0,0,2,8,0,0
32421,233,4889,99,48,90,1,3,5,100,0,0,0,0,0,0,0,0,0,0,0,0,2,8,0,0
32422,233,4889,8,5,5,2,0,1,10,0,0,0,0,0,0,0,0,0,0,0,0,2,8,0,0
32423,233,4889,1217,716,841,84,126,174,1301,14,185,118,215,199,333,1446,2542,8,20687,1149,0,2,8,0,0
32424,233,4889,160,89,115,0,13,31,160,7,15,11,17,22,28,78,124,3,495,27,0,2,8,0,0
32425,233,4889,10,10,9,9,0,0,19,0,0,0,0,0,0,0,0,0,0,0,0,2,8,0,0
32426,233,4889,173,84,99,8,29,36,181,5,12,7,13,17,20,54,81,2,221,12,0,2,8,0,0
32427,233,4889,3,1,1,3,0,0,6,0,0,0,0,0,0,0,0,0,0,0,0,2,8,0,0
32428,29,1886,384,251,317,7,8,52,391,11,70,44,84,81,128,467,811,6,5355,297,0,2,7,0,0
32429,157,3301,1513,682,1277,25,13,200,1538,11,199,116,219,210,335,1557,2584,6,15641,868,0,2,4,1,0
32430,157,3301,819,519,539,24,98,155,843,15,96,57,106,111,163,690,1107,8,9171,509,0,2,4,1,0
32431,125,5391,1513,682,1277,25,13,200,1538,11,199,116,219,210,335,1557,2584,6,15641,868,0,2,8,1,0
32432,24,614,2,2,2,0,0,0,2,0,0,0,0,0,0,0,0,0,0,0,0,2,1,0,0
32433,24,614,99,48,90,1,3,5,100,0,0,0,0,0,0,0,0,0,0,0,0,2,1,0,0
32434,24,614,8,5,5,2,0,1,10,0,0,0,0,0,0,0,0,0,0,0,0,2,1,0,0
32435,24,614,1217,716,841,84,126,174,1301,14,185,118,215,199,333,1446,2542,8,20687,1149,0,2,1,0,0
32436,24,614,160,89,115,0,13,31,160,7,15,11,17,22,28,78,124,3,495,27,0,2,1,0,0
32437,24,614,10,10,9,9,0,0,19,0,0,0,0,0,0,0,0,0,0,0,0,2,1,0,0
32438,24,614,173,84,99,8,29,36,181,5,12,7,13,17,20,54,81,2,221,12,0,2,1,0,0
32439,24,614,3,1,1,3,0,0,6,0,0,0,0,0,0,0,0,0,0,0,0,2,1,0,0
32440,157,3301,1513,682,1277,25,13,200,1538,11,199,116,219,210,335,1557,2584,6,15641,868,0,2,4,1,0
32441,157,3301,819,519,539,24,98,155,843,15,96,57,106,111,163,690,1107,8,9171,509,0,2,4,1,0
32442,125,5391,1513,682,1277,25,13,200,1538,11,199,116,219,210,335,1557,2584,6,15641,868,0,2,8,1,0
32443,233,5758,722,423,573,19,0,135,741,12,172,101,199,184,300,1320,2257,6,15668,870,0,2,2,0,0
32444,233,5758,1508,847,911,44,250,301,1552,14,148,88,169,162,257,1120,1886,7,15077,837,0,2,2,0,0
32445,100,4734,1523,757,1297,19,12,193,1542,12,193,117,230,205,347,1508,2664,7,19053,1058,0,2,1,5,0
32446,68,3312,1293,570,1093,25,15,163,1318,10,195,123,241,205,364,1516,2795,6,17273,959,0,2,0,3,0
32447,233,5758,722,423,573,19,0,135,741,12,172,101,199,184,300,1320,2257,6,15668,870,0,2,2,0,0
32448,233,5758,1508,847,911,44,250,301,1552,14,148,88,169,162,257,1120,1886,7,15077,837,0,2,2,0,0
32449,100,4734,1523,757,1297,19,12,193,1542,12,193,117,230,205,347,1508,2664,7,19053,1058,0,2,1,5,0
32450,68,3312,1293,570,1093,25,15,163,1318,10,195,123,241,205,364,1516,2795,6,17273,959,0,2,0,3,0
32451,157,3301,1513,682,1277,25,13,200,1538,11,199,116,219,210,335,1557,2584,6,15641,868,0,2,4,1,0
32452,157,3301,819,519,539,24,98,155,843,15,96,57,106,111,163,690,1107,8,9171,509,0,2,4,1,0
32453,125,5391,1513,682,1277,25,13,200,1538,11,199,116,219,210,335,1557,2584,6,15641,868,0,2,8,1,0
32454,159,3342,1513,682,1277,25,13,200,1538,11,199,116,219,210,335,1557,2584,6,15641,868,0,2,39,26,0
32455,159,3342,819,519,539,24,98,155,843,15,96,57,106,111,163,690,1107,8,9171,509,0,2,39,26,0
32456,125,5391,1513,682,1277,25,13,200,1538,11,199,116,219,210,335,1557,2584,6,15641,868,0,2,1,1,0
32457,159,3338,1513,682,1277,25,13,200,1538,11,199,116,219,210,335,1557,2584,6,15641,868,0,2,10,14,0
32458,159,3338,819,519,539,24,98,155,843,15,96,57,106,111,163,690,1107,8,9171,509,0,2,10,14,0
32459,157,3301,1513,682,1277,25,13,200,1538,11,199,116,219,210,335,1557,2584,6,15641,868,0,2,4,1,0
32460,157,3301,819,519,539,24,98,155,843,15,96,57,106,111,163,690,1107,8,9171,509,0,2,4,1,0
32461,125,5391,1513,682,1277,25,13,200,1538,11,199,116,219,210,335,1557,2584,6,15641,868,0,2,8,1,0
32462,37,940,466,257,367,18,25,50,484,7,126,86,171,133,257,898,1813,4,8612,478,0,2,83,0,0
32463,37,940,507,281,342,29,59,88,536,10,53,29,57,63,86,336,514,5,2764,153,0,2,83,0,0
32464,89,1894,1043,504,840,53,9,147,1096,9,180,112,198,189,310,1377,2344,4,11604,644,0,2,1,37,0
32465,89,1894,383,288,292,26,6,62,409,11,65,38,67,76,105,429,656,5,3719,206,0,2,1,37,0
32466,249,5128,1943,715,1694,26,18,214,1969,12,185,120,237,197,357,1436,2721,7,20915,1161,0,2,22,17,0
32467,249,5128,1168,838,957,57,25,144,1225,19,348,224,416,367,640,3018,5452,11,61921,3440,1,2,22,17,0
32468,102,5449,1943,715,1694,26,18,214,1969,12,185,120,237,197,357,1436,2721,7,20915,1161,0,2,15,0,0
32469,37,940,466,257,367,18,25,50,484,7,126,86,171,133,257,898,1813,4,8612,478,0,2,83,0,0
32470,37,940,507,281,342,29,59,88,536,10,53,29,57,63,86,336,514,5,2764,153,0,2,83,0,0
32471,89,1894,1043,504,840,53,9,147,1096,9,180,112,198,189,310,1377,2344,4,11604,644,0,2,1,37,0
32472,89,1894,383,288,292,26,6,62,409,11,65,38,67,76,105,429,656,5,3719,206,0,2,1,37,0
32473,249,5128,1943,715,1694,26,18,214,1969,12,185,120,237,197,357,1436,2721,7,20915,1161,0,2,22,17,0
32474,249,5128,1168,838,957,57,25,144,1225,19,348,224,416,367,640,3018,5452,11,61921,3440,1,2,22,17,0
32475,102,5449,1943,715,1694,26,18,214,1969,12,185,120,237,197,357,1436,2721,7,20915,1161,0,2,15,0,0
32476,159,3344,1513,682,1277,25,13,200,1538,11,199,116,219,210,335,1557,2584,6,15641,868,0,2,49,40,0
32477,159,3344,819,519,539,24,98,155,843,15,96,57,106,111,163,690,1107,8,9171,509,0,2,49,40,0
32478,125,5391,1513,682,1277,25,13,200,1538,11,199,116,219,210,335,1557,2584,6,15641,868,0,2,1,1,0
32479,233,5797,722,423,573,19,0,135,741,12,172,101,199,184,300,1320,2257,6,15668,870,0,2,10,2,0
32480,233,5797,1508,847,911,44,250,301,1552,14,148,88,169,162,257,1120,1886,7,15077,837,0,2,10,2,0
32481,100,4747,1523,757,1297,19,12,193,1542,12,193,117,230,205,347,1508,2664,7,19053,1058,0,2,2,1,0
32482,245,5668,4293,999,3693,19,54,507,4312,9,155,88,170,164,258,1156,1898,4,9368,520,0,2,1,1,0
32483,245,5668,1482,859,1002,125,135,219,1607,16,219,134,251,235,385,1766,3032,9,27804,1544,1,2,1,1,0
32484,170,7538,139,89,101,2,0,35,141,7,54,34,62,61,96,330,569,4,2287,127,0,2,2,2,0
32485,170,7538,7,5,5,0,0,2,7,1,2,1,2,3,3,2,4,0,2,0,0,2,2,2,0
32486,233,5797,722,423,573,19,0,135,741,12,172,101,199,184,300,1320,2257,6,15668,870,0,2,10,2,0
32487,233,5797,1508,847,911,44,250,301,1552,14,148,88,169,162,257,1120,1886,7,15077,837,0,2,10,2,0
32488,100,4747,1523,757,1297,19,12,193,1542,12,193,117,230,205,347,1508,2664,7,19053,1058,0,2,2,1,0
32489,234,4906,2,2,2,0,0,0,2,0,0,0,0,0,0,0,0,0,0,0,0,2,8,3,0
32490,234,4906,99,48,90,1,3,5,100,0,0,0,0,0,0,0,0,0,0,0,0,2,8,3,0
32491,234,4906,8,5,5,2,0,1,10,0,0,0,0,0,0,0,0,0,0,0,0,2,8,3,0
32492,234,4906,1217,716,841,84,126,174,1301,14,185,118,215,199,333,1446,2542,8,20687,1149,0,2,8,3,0
32493,234,4906,160,89,115,0,13,31,160,7,15,11,17,22,28,78,124,3,495,27,0,2,8,3,0
32494,234,4906,10,10,9,9,0,0,19,0,0,0,0,0,0,0,0,0,0,0,0,2,8,3,0
32495,234,4906,173,84,99,8,29,36,181,5,12,7,13,17,20,54,81,2,221,12,0,2,8,3,0
32496,234,4906,3,1,1,3,0,0,6,0,0,0,0,0,0,0,0,0,0,0,0,2,8,3,0
32497,97,5074,1457,730,1242,11,6,188,1468,10,292,166,329,302,495,2424,4078,5,22973,1276,1,2,13,0,0
32498,249,5132,1943,715,1694,26,18,214,1969,12,185,120,237,197,357,1436,2721,7,20915,1161,0,2,2,2,0
32499,249,5132,1168,838,957,57,25,144,1225,19,348,224,416,367,640,3018,5452,11,61921,3440,1,2,2,2,0
32500,97,5072,1457,730,1242,11,6,188,1468,10,292,166,329,302,495,2424,4078,5,22973,1276,1,2,1,1,0
32501,248,5116,1943,715,1694,26,18,214,1969,12,185,120,237,197,357,1436,2721,7,20915,1161,0,2,0,2,0
32502,248,5116,1168,838,957,57,25,144,1225,19,348,224,416,367,640,3018,5452,11,61921,3440,1,2,0,2,0
32503,234,4906,2,2,2,0,0,0,2,0,0,0,0,0,0,0,0,0,0,0,0,2,8,3,0
32504,234,4906,99,48,90,1,3,5,100,0,0,0,0,0,0,0,0,0,0,0,0,2,8,3,0
32505,234,4906,8,5,5,2,0,1,10,0,0,0,0,0,0,0,0,0,0,0,0,2,8,3,0
32506,234,4906,1217,716,841,84,126,174,1301,14,185,118,215,199,333,1446,2542,8,20687,1149,0,2,8,3,0
32507,234,4906,160,89,115,0,13,31,160,7,15,11,17,22,28,78,124,3,495,27,0,2,8,3,0
32508,234,4906,10,10,9,9,0,0,19,0,0,0,0,0,0,0,0,0,0,0,0,2,8,3,0
32509,234,4906,173,84,99,8,29,36,181,5,12,7,13,17,20,54,81,2,221,12,0,2,8,3,0
32510,234,4906,3,1,1,3,0,0,6,0,0,0,0,0,0,0,0,0,0,0,0,2,8,3,0
32511,248,5116,1943,715,1694,26,18,214,1969,12,185,120,237,197,357,1436,2721,7,20915,1161,0,2,1,3,0
32512,248,5116,1168,838,957,57,25,144,1225,19,348,224,416,367,640,3018,5452,11,61921,3440,1,2,1,3,0
32513,97,5072,1457,730,1242,11,6,188,1468,10,292,166,329,302,495,2424,4078,5,22973,1276,1,2,13,0,0
32514,78,1822,996,429,845,24,10,117,1020,7,76,50,88,83,138,494,879,4,3565,198,0,2,3,4,0
32515,78,1822,456,277,329,12,42,72,468,13,85,50,97,98,147,592,972,7,7212,400,0,2,3,4,0
32516,78,1822,996,429,845,24,10,117,1020,7,76,50,88,83,138,494,879,4,3565,198,0,2,3,4,0
32517,78,1822,456,277,329,12,42,72,468,13,85,50,97,98,147,592,972,7,7212,400,0,2,3,4,0
32518,248,5119,1943,715,1694,26,18,214,1969,12,185,120,237,197,357,1436,2721,7,20915,1161,0,2,3,1,0
32519,248,5119,1168,838,957,57,25,144,1225,19,348,224,416,367,640,3018,5452,11,61921,3440,1,2,3,1,0
32520,103,5526,1943,715,1694,26,18,214,1969,12,185,120,237,197,357,1436,2721,7,20915,1161,0,2,25,0,0
32521,248,5119,1943,715,1694,26,18,214,1969,12,185,120,237,197,357,1436,2721,7,20915,1161,0,2,3,1,0
32522,248,5119,1168,838,957,57,25,144,1225,19,348,224,416,367,640,3018,5452,11,61921,3440,1,2,3,1,0
32523,103,5526,1943,715,1694,26,18,214,1969,12,185,120,237,197,357,1436,2721,7,20915,1161,0,2,25,0,0
32524,234,4911,2,2,2,0,0,0,2,0,0,0,0,0,0,0,0,0,0,0,0,2,1,1,0
32525,234,4911,99,48,90,1,3,5,100,0,0,0,0,0,0,0,0,0,0,0,0,2,1,1,0
32526,234,4911,8,5,5,2,0,1,10,0,0,0,0,0,0,0,0,0,0,0,0,2,1,1,0
32527,234,4911,1217,716,841,84,126,174,1301,14,185,118,215,199,333,1446,2542,8,20687,1149,0,2,1,1,0
32528,234,4911,160,89,115,0,13,31,160,7,15,11,17,22,28,78,124,3,495,27,0,2,1,1,0
32529,234,4911,10,10,9,9,0,0,19,0,0,0,0,0,0,0,0,0,0,0,0,2,1,1,0
32530,234,4911,173,84,99,8,29,36,181,5,12,7,13,17,20,54,81,2,221,12,0,2,1,1,0
32531,234,4911,3,1,1,3,0,0,6,0,0,0,0,0,0,0,0,0,0,0,0,2,1,1,0
32532,158,3743,77,34,69,0,0,8,77,3,24,16,29,27,45,114,213,1,387,21,0,2,1,1,0
32533,158,3743,712,438,573,51,9,84,763,14,102,71,128,116,199,733,1364,8,11988,666,0,2,1,1,0
32534,89,1902,1043,504,840,53,9,147,1096,9,180,112,198,189,310,1377,2344,4,11604,644,0,2,3,3,0
32535,89,1902,383,288,292,26,6,62,409,11,65,38,67,76,105,429,656,5,3719,206,0,2,3,3,0
32536,248,5121,1943,715,1694,26,18,214,1969,12,185,120,237,197,357,1436,2721,7,20915,1161,0,2,1,1,0
32537,248,5121,1168,838,957,57,25,144,1225,19,348,224,416,367,640,3018,5452,11,61921,3440,1,2,1,1,0
32538,100,5227,1457,730,1242,11,6,188,1468,10,292,166,329,302,495,2424,4078,5,22973,1276,1,2,39,0,0
32539,234,4911,2,2,2,0,0,0,2,0,0,0,0,0,0,0,0,0,0,0,0,2,1,1,0
32540,234,4911,99,48,90,1,3,5,100,0,0,0,0,0,0,0,0,0,0,0,0,2,1,1,0
32541,234,4911,8,5,5,2,0,1,10,0,0,0,0,0,0,0,0,0,0,0,0,2,1,1,0
32542,234,4911,1217,716,841,84,126,174,1301,14,185,118,215,199,333,1446,2542,8,20687,1149,0,2,1,1,0
32543,234,4911,160,89,115,0,13,31,160,7,15,11,17,22,28,78,124,3,495,27,0,2,1,1,0
32544,234,4911,10,10,9,9,0,0,19,0,0,0,0,0,0,0,0,0,0,0,0,2,1,1,0
32545,234,4911,173,84,99,8,29,36,181,5,12,7,13,17,20,54,81,2,221,12,0,2,1,1,0
32546,234,4911,3,1,1,3,0,0,6,0,0,0,0,0,0,0,0,0,0,0,0,2,1,1,0
32547,158,3743,77,34,69,0,0,8,77,3,24,16,29,27,45,114,213,1,387,21,0,2,1,1,0
32548,158,3743,712,438,573,51,9,84,763,14,102,71,128,116,199,733,1364,8,11988,666,0,2,1,1,0
32549,89,1902,1043,504,840,53,9,147,1096,9,180,112,198,189,310,1377,2344,4,11604,644,0,2,3,3,0
32550,89,1902,383,288,292,26,6,62,409,11,65,38,67,76,105,429,656,5,3719,206,0,2,3,3,0
32551,248,5121,1943,715,1694,26,18,214,1969,12,185,120,237,197,357,1436,2721,7,20915,1161,0,2,1,1,0
32552,248,5121,1168,838,957,57,25,144,1225,19,348,224,416,367,640,3018,5452,11,61921,3440,1,2,1,1,0
32553,100,5227,1457,730,1242,11,6,188,1468,10,292,166,329,302,495,2424,4078,5,22973,1276,1,2,39,0,0
32554,235,4912,2,2,2,0,0,0,2,0,0,0,0,0,0,0,0,0,0,0,0,2,4,1,0
32555,235,4912,99,48,90,1,3,5,100,0,0,0,0,0,0,0,0,0,0,0,0,2,4,1,0
32556,235,4912,8,5,5,2,0,1,10,0,0,0,0,0,0,0,0,0,0,0,0,2,4,1,0
32557,235,4912,1217,716,841,84,126,174,1301,14,185,118,215,199,333,1446,2542,8,20687,1149,0,2,4,1,0
32558,235,4912,160,89,115,0,13,31,160,7,15,11,17,22,28,78,124,3,495,27,0,2,4,1,0
32559,235,4912,10,10,9,9,0,0,19,0,0,0,0,0,0,0,0,0,0,0,0,2,4,1,0
32560,235,4912,173,84,99,8,29,36,181,5,12,7,13,17,20,54,81,2,221,12,0,2,4,1,0
32561,235,4912,3,1,1,3,0,0,6,0,0,0,0,0,0,0,0,0,0,0,0,2,4,1,0
32562,29,1894,384,251,317,7,8,52,391,11,70,44,84,81,128,467,811,6,5355,297,0,2,3,0,0
32563,235,4917,2,2,2,0,0,0,2,0,0,0,0,0,0,0,0,0,0,0,0,2,4,1,0
32564,235,4917,99,48,90,1,3,5,100,0,0,0,0,0,0,0,0,0,0,0,0,2,4,1,0
32565,235,4917,8,5,5,2,0,1,10,0,0,0,0,0,0,0,0,0,0,0,0,2,4,1,0
32566,235,4917,1217,716,841,84,126,174,1301,14,185,118,215,199,333,1446,2542,8,20687,1149,0,2,4,1,0
32567,235,4917,160,89,115,0,13,31,160,7,15,11,17,22,28,78,124,3,495,27,0,2,4,1,0
32568,235,4917,10,10,9,9,0,0,19,0,0,0,0,0,0,0,0,0,0,0,0,2,4,1,0
32569,235,4917,173,84,99,8,29,36,181,5,12,7,13,17,20,54,81,2,221,12,0,2,4,1,0
32570,235,4917,3,1,1,3,0,0,6,0,0,0,0,0,0,0,0,0,0,0,0,2,4,1,0
32571,29,1894,384,251,317,7,8,52,391,11,70,44,84,81,128,467,811,6,5355,297,0,2,3,0,0
32572,24,614,2,2,2,0,0,0,2,0,0,0,0,0,0,0,0,0,0,0,0,2,1,0,0
32573,24,614,99,48,90,1,3,5,100,0,0,0,0,0,0,0,0,0,0,0,0,2,1,0,0
32574,24,614,8,5,5,2,0,1,10,0,0,0,0,0,0,0,0,0,0,0,0,2,1,0,0
32575,24,614,1217,716,841,84,126,174,1301,14,185,118,215,199,333,1446,2542,8,20687,1149,0,2,1,0,0
32576,24,614,160,89,115,0,13,31,160,7,15,11,17,22,28,78,124,3,495,27,0,2,1,0,0
32577,24,614,10,10,9,9,0,0,19,0,0,0,0,0,0,0,0,0,0,0,0,2,1,0,0
32578,24,614,173,84,99,8,29,36,181,5,12,7,13,17,20,54,81,2,221,12,0,2,1,0,0
32579,24,614,3,1,1,3,0,0,6,0,0,0,0,0,0,0,0,0,0,0,0,2,1,0,0
32580,176,5282,1660,832,1314,41,38,274,1701,20,312,209,395,332,604,2671,5058,12,64042,3557,1,2,52,17,0
32581,158,3743,77,34,69,0,0,8,77,3,24,16,29,27,45,114,213,1,387,21,0,2,1,1,0
32582,158,3743,712,438,573,51,9,84,763,14,102,71,128,116,199,733,1364,8,11988,666,0,2,1,1,0
32583,47,3455,996,429,845,24,10,117,1020,7,76,50,88,83,138,494,879,4,3565,198,0,2,1,1,0
32584,112,4510,1289,550,1043,56,32,155,1345,10,167,93,185,177,278,1266,2075,5,11498,638,0,2,2,0,0
32585,54,1156,447,308,343,6,5,95,453,7,96,59,111,103,170,651,1136,4,4600,255,0,2,5,0,1
32586,54,1156,322,174,179,16,74,51,338,10,41,26,46,51,72,252,408,5,2291,127,0,2,5,0,1
32587,47,2152,447,308,343,6,5,95,453,7,96,59,111,103,170,651,1136,4,4600,255,0,2,25,0,1
32588,90,3956,1338,495,1086,10,64,173,1348,11,122,82,157,133,239,883,1686,7,11934,663,0,2,0,2,0
32589,170,5125,1660,832,1314,41,38,274,1701,20,312,209,395,332,604,2671,5058,12,64042,3557,1,2,1,1,0
32590,233,5808,722,423,573,19,0,135,741,12,172,101,199,184,300,1320,2257,6,15668,870,0,2,7,2,1
32591,233,5808,1508,847,911,44,250,301,1552,14,148,88,169,162,257,1120,1886,7,15077,837,0,2,7,2,1
32592,232,5798,722,423,573,19,0,135,741,12,172,101,199,184,300,1320,2257,6,15668,870,0,2,3,5,1
32593,232,5798,1508,847,911,44,250,301,1552,14,148,88,169,162,257,1120,1886,7,15077,837,0,2,3,5,1
32594,29,1879,384,251,317,7,8,52,391,11,70,44,84,81,128,467,811,6,5355,297,0,2,4,5,0
32595,21,500,207,111,150,11,0,50,218,5,26,19,36,31,55,133,272,3,943,52,0,2,13,8,1
32596,29,1306,373,158,315,8,0,51,381,5,76,44,79,81,123,486,779,2,2026,112,0,2,2,4,1
32597,230,4977,182,127,129,0,0,53,182,5,39,21,42,44,63,217,343,2,926,51,0,2,1,0,0
32598,230,4977,1165,710,800,67,119,181,1232,18,243,153,282,261,435,2000,3492,10,36473,2026,1,2,1,0,0
32599,36,1120,182,127,129,0,0,53,182,5,39,21,42,44,63,217,343,2,926,51,0,2,4,0,0
32600,112,4514,1289,550,1043,56,32,155,1345,10,167,93,185,177,278,1266,2075,5,11498,638,0,2,2,2,0
32601,14,845,75,38,59,1,3,12,76,2,4,2,4,6,6,10,15,1,15,0,0,2,1,1,0
32602,36,2461,1157,318,931,29,22,177,1186,6,104,63,125,110,188,712,1274,3,4596,255,0,2,1,1,0
32603,90,3992,1338,495,1086,10,64,173,1348,11,122,82,157,133,239,883,1686,7,11934,663,0,2,9,9,0
32604,171,7580,4293,999,3693,19,54,507,4312,9,155,88,170,164,258,1156,1898,4,9368,520,0,2,6,6,0
32605,171,7580,1482,859,1002,125,135,219,1607,16,219,134,251,235,385,1766,3032,9,27804,1544,1,2,6,6,0
32606,170,5149,1660,832,1314,41,38,274,1701,20,312,209,395,332,604,2671,5058,12,64042,3557,1,2,7,7,0
32607,47,3469,996,429,845,24,10,117,1020,7,76,50,88,83,138,494,879,4,3565,198,0,2,7,7,0
32608,125,5393,1513,682,1277,25,13,200,1538,11,199,116,219,210,335,1557,2584,6,15641,868,0,2,1,1,0
32609,84,4877,1296,573,1062,40,33,157,1336,8,201,118,231,209,349,1561,2689,4,12365,686,0,2,4,4,0
32610,100,5229,1457,730,1242,11,6,188,1468,10,292,166,329,302,495,2424,4078,5,22973,1276,1,2,1,1,0
32611,72,3310,1455,414,1257,16,76,112,1471,5,41,23,46,46,69,231,381,2,1069,59,0,2,1,1,0
32612,21,655,424,94,331,4,0,89,428,1,5,5,5,6,10,11,25,0,12,0,0,2,1,1,0
32613,83,3328,1043,504,840,53,9,147,1096,9,180,112,198,189,310,1377,2344,4,11604,644,0,2,5,5,0
32614,81,3287,1178,367,1042,6,15,115,1184,9,94,51,95,103,146,644,976,4,4439,246,0,2,9,7,0
32615,37,1527,442,244,305,14,16,103,456,11,68,45,75,79,120,452,756,6,4588,254,0,2,1,1,0
32616,52,1994,1098,241,925,5,10,155,1103,7,46,25,49,53,74,273,423,3,1580,87,0,2,2,2,0
32617,125,5396,1513,682,1277,25,13,200,1538,11,199,116,219,210,335,1557,2584,6,15641,868,0,2,11,1,0
32618,159,3781,77,34,69,0,0,8,77,3,24,16,29,27,45,114,213,1,387,21,0,2,9,0,0
32619,159,3781,712,438,573,51,9,84,763,14,102,71,128,116,199,733,1364,8,11988,666,0,2,9,0,0
32620,170,7547,139,89,101,2,0,35,141,7,54,34,62,61,96,330,569,4,2287,127,0,2,1,0,0
32621,170,7547,7,5,5,0,0,2,7,1,2,1,2,3,3,2,4,0,2,0,0,2,1,0,0
32622,30,1324,373,158,315,8,0,51,381,5,76,44,79,81,123,486,779,2,2026,112,0,2,2,1,0
32623,30,1342,373,158,315,8,0,51,381,5,76,44,79,81,123,486,779,2,2026,112,0,2,2,2,0
32624,53,1862,601,196,481,2,23,85,603,8,63,36,72,71,108,400,664,4,3036,168,0,2,4,2,0
32625,29,743,601,196,481,2,23,85,603,8,63,36,72,71,108,400,664,4,3036,168,0,2,2,1,0
32626,29,743,156,79,106,5,16,28,161,5,14,8,15,19,23,64,97,2,261,14,0,2,2,1,0
32627,36,2459,1157,318,931,29,22,177,1186,6,104,63,125,110,188,712,1274,3,4596,255,0,2,1,0,0
32628,103,5526,1943,715,1694,26,18,214,1969,12,185,120,237,197,357,1436,2721,7,20915,1161,0,2,0,1,0
32629,36,2434,1157,318,931,29,22,177,1186,6,104,63,125,110,188,712,1274,3,4596,255,0,2,6,7,0
32630,36,2425,1157,318,931,29,22,177,1186,6,104,63,125,110,188,712,1274,3,4596,255,0,2,4,4,0
32631,75,1617,53,23,39,0,0,13,53,2,8,4,8,10,12,26,39,1,39,2,0,2,8,1,1
32632,75,1617,515,298,307,33,80,99,548,12,63,44,77,75,121,419,753,7,5527,307,0,2,8,1,1
32633,85,4928,1296,573,1062,40,33,157,1336,8,201,118,231,209,349,1561,2689,4,12365,686,0,2,18,0,1
32634,159,3781,77,34,69,0,0,8,77,3,24,16,29,27,45,114,213,1,387,21,0,2,9,0,0
32635,159,3781,712,438,573,51,9,84,763,14,102,71,128,116,199,733,1364,8,11988,666,0,2,9,0,0
32636,21,500,207,111,150,11,0,50,218,5,26,19,36,31,55,133,272,3,943,52,0,2,13,8,0
32637,29,1306,373,158,315,8,0,51,381,5,76,44,79,81,123,486,779,2,2026,112,0,2,2,4,0
32638,52,625,647,139,84,35,284,233,682,0,0,0,0,0,0,0,0,0,0,0,0,2,2,1,0
32639,54,1156,447,308,343,6,5,95,453,7,96,59,111,103,170,651,1136,4,4600,255,0,2,5,0,0
32640,54,1156,322,174,179,16,74,51,338,10,41,26,46,51,72,252,408,5,2291,127,0,2,5,0,0
32641,232,5798,722,423,573,19,0,135,741,12,172,101,199,184,300,1320,2257,6,15668,870,0,2,10,7,0
32642,232,5798,1508,847,911,44,250,301,1552,14,148,88,169,162,257,1120,1886,7,15077,837,0,2,10,7,0
32643,90,3956,1338,495,1086,10,64,173,1348,11,122,82,157,133,239,883,1686,7,11934,663,0,2,0,2,0
32644,170,5125,1660,832,1314,41,38,274,1701,20,312,209,395,332,604,2671,5058,12,64042,3557,1,2,1,1,0
32645,47,2152,447,308,343,6,5,95,453,7,96,59,111,103,170,651,1136,4,4600,255,0,2,25,0,0
32646,29,1879,384,251,317,7,8,52,391,11,70,44,84,81,128,467,811,6,5355,297,0,2,4,5,0
32647,230,4977,182,127,129,0,0,53,182,5,39,21,42,44,63,217,343,2,926,51,0,2,1,0,0
32648,230,4977,1165,710,800,67,119,181,1232,18,243,153,282,261,435,2000,3492,10,36473,2026,1,2,1,0,0
32649,36,1120,182,127,129,0,0,53,182,5,39,21,42,44,63,217,343,2,926,51,0,2,4,0,0
32650,112,4514,1289,550,1043,56,32,155,1345,10,167,93,185,177,278,1266,2075,5,11498,638,0,2,2,2,0
32651,14,845,75,38,59,1,3,12,76,2,4,2,4,6,6,10,15,1,15,0,0,2,1,1,0
32652,36,2461,1157,318,931,29,22,177,1186,6,104,63,125,110,188,712,1274,3,4596,255,0,2,1,1,0
32653,90,3974,1338,495,1086,10,64,173,1348,11,122,82,157,133,239,883,1686,7,11934,663,0,2,9,9,0
32654,171,7580,4293,999,3693,19,54,507,4312,9,155,88,170,164,258,1156,1898,4,9368,520,0,2,6,6,0
32655,171,7580,1482,859,1002,125,135,219,1607,16,219,134,251,235,385,1766,3032,9,27804,1544,1,2,6,6,0
32656,170,5139,1660,832,1314,41,38,274,1701,20,312,209,395,332,604,2671,5058,12,64042,3557,1,2,7,7,0
32657,47,3469,996,429,845,24,10,117,1020,7,76,50,88,83,138,494,879,4,3565,198,0,2,7,7,0
32658,125,5393,1513,682,1277,25,13,200,1538,11,199,116,219,210,335,1557,2584,6,15641,868,0,2,1,1,0
32659,84,4877,1296,573,1062,40,33,157,1336,8,201,118,231,209,349,1561,2689,4,12365,686,0,2,4,4,0
32660,100,5229,1457,730,1242,11,6,188,1468,10,292,166,329,302,495,2424,4078,5,22973,1276,1,2,1,1,0
32661,72,3310,1455,414,1257,16,76,112,1471,5,41,23,46,46,69,231,381,2,1069,59,0,2,1,1,0
32662,21,655,424,94,331,4,0,89,428,1,5,5,5,6,10,11,25,0,12,0,0,2,1,1,0
32663,83,3328,1043,504,840,53,9,147,1096,9,180,112,198,189,310,1377,2344,4,11604,644,0,2,5,5,0
32664,81,3287,1178,367,1042,6,15,115,1184,9,94,51,95,103,146,644,976,4,4439,246,0,2,9,7,0
32665,37,1527,442,244,305,14,16,103,456,11,68,45,75,79,120,452,756,6,4588,254,0,2,1,1,0
32666,52,1994,1098,241,925,5,10,155,1103,7,46,25,49,53,74,273,423,3,1580,87,0,2,2,2,0
32667,176,5286,1660,832,1314,41,38,274,1701,20,312,209,395,332,604,2671,5058,12,64042,3557,1,2,52,17,0
32668,125,5396,1513,682,1277,25,13,200,1538,11,199,116,219,210,335,1557,2584,6,15641,868,0,2,11,1,0
32669,60,1610,466,257,367,18,25,50,484,7,126,86,171,133,257,898,1813,4,8612,478,0,2,132,0,1
32670,60,1610,507,281,342,29,59,88,536,10,53,29,57,63,86,336,514,5,2764,153,0,2,132,0,1
32671,21,1078,466,257,367,18,25,50,484,7,126,86,171,133,257,898,1813,4,8612,478,0,0,183,0,1
32672,235,4919,2,2,2,0,0,0,2,0,0,0,0,0,0,0,0,0,0,0,0,2,1,0,0
32673,235,4919,99,48,90,1,3,5,100,0,0,0,0,0,0,0,0,0,0,0,0,2,1,0,0
32674,235,4919,8,5,5,2,0,1,10,0,0,0,0,0,0,0,0,0,0,0,0,2,1,0,0
32675,235,4919,1217,716,841,84,126,174,1301,14,185,118,215,199,333,1446,2542,8,20687,1149,0,2,1,0,0
32676,235,4919,160,89,115,0,13,31,160,7,15,11,17,22,28,78,124,3,495,27,0,2,1,0,0
32677,235,4919,10,10,9,9,0,0,19,0,0,0,0,0,0,0,0,0,0,0,0,2,1,0,0
32678,235,4919,173,84,99,8,29,36,181,5,12,7,13,17,20,54,81,2,221,12,0,2,1,0,0
32679,235,4919,3,1,1,3,0,0,6,0,0,0,0,0,0,0,0,0,0,0,0,2,1,0,0
32680,54,657,647,139,84,35,284,233,682,0,0,0,0,0,0,0,0,0,0,0,0,2,35,0,0
32681,66,1698,466,257,367,18,25,50,484,7,126,86,171,133,257,898,1813,4,8612,478,0,2,16,0,0
32682,66,1698,507,281,342,29,59,88,536,10,53,29,57,63,86,336,514,5,2764,153,0,2,16,0,0
32683,25,1292,466,257,367,18,25,50,484,7,126,86,171,133,257,898,1813,4,8612,478,0,2,50,0,0
32684,66,1701,466,257,367,18,25,50,484,7,126,86,171,133,257,898,1813,4,8612,478,0,2,2,0,0
32685,66,1701,507,281,342,29,59,88,536,10,53,29,57,63,86,336,514,5,2764,153,0,2,2,0,0
32686,54,657,647,139,84,35,284,233,682,0,0,0,0,0,0,0,0,0,0,0,0,2,2,2,0
32687,66,1702,466,257,367,18,25,50,484,7,126,86,171,133,257,898,1813,4,8612,478,0,2,1,1,0
32688,66,1702,507,281,342,29,59,88,536,10,53,29,57,63,86,336,514,5,2764,153,0,2,1,1,0
32689,25,1299,466,257,367,18,25,50,484,7,126,86,171,133,257,898,1813,4,8612,478,0,2,23,4,0
32690,66,1712,466,257,367,18,25,50,484,7,126,86,171,133,257,898,1813,4,8612,478,0,2,2,1,1
32691,66,1712,507,281,342,29,59,88,536,10,53,29,57,63,86,336,514,5,2764,153,0,2,2,1,1
32692,26,1396,466,257,367,18,25,50,484,7,126,86,171,133,257,898,1813,4,8612,478,0,2,21,3,1
32693,66,1712,466,257,367,18,25,50,484,7,126,86,171,133,257,898,1813,4,8612,478,0,2,2,2,1
32694,66,1712,507,281,342,29,59,88,536,10,53,29,57,63,86,336,514,5,2764,153,0,2,2,2,1
32695,27,1494,466,257,367,18,25,50,484,7,126,86,171,133,257,898,1813,4,8612,478,0,2,23,0,1
32696,170,7547,139,89,101,2,0,35,141,7,54,34,62,61,96,330,569,4,2287,127,0,2,1,0,0
32697,170,7547,7,5,5,0,0,2,7,1,2,1,2,3,3,2,4,0,2,0,0,2,1,0,0
32698,30,1324,373,158,315,8,0,51,381,5,76,44,79,81,123,486,779,2,2026,112,0,2,2,1,0
32699,53,1862,601,196,481,2,23,85,603,8,63,36,72,71,108,400,664,4,3036,168,0,2,4,2,0
32700,159,3781,77,34,69,0,0,8,77,3,24,16,29,27,45,114,213,1,387,21,0,2,1,1,0
32701,159,3781,712,438,573,51,9,84,763,14,102,71,128,116,199,733,1364,8,11988,666,0,2,1,1,0
32702,29,743,601,196,481,2,23,85,603,8,63,36,72,71,108,400,664,4,3036,168,0,2,2,1,0
32703,29,743,156,79,106,5,16,28,161,5,14,8,15,19,23,64,97,2,261,14,0,2,2,1,0
32704,112,4514,1289,550,1043,56,32,155,1345,10,167,93,185,177,278,1266,2075,5,11498,638,0,2,2,0,0
32705,36,2427,1157,318,931,29,22,177,1186,6,104,63,125,110,188,712,1274,3,4596,255,0,2,11,11,0
32706,47,3469,996,429,845,24,10,117,1020,7,76,50,88,83,138,494,879,4,3565,198,0,2,1,1,0
32707,29,1324,373,158,315,8,0,51,381,5,76,44,79,81,123,486,779,2,2026,112,0,2,2,2,0
32708,103,5526,1943,715,1694,26,18,214,1969,12,185,120,237,197,357,1436,2721,7,20915,1161,0,2,0,1,0
32709,112,2106,477,336,357,30,23,73,507,16,194,134,250,210,384,1538,2962,10,30538,1696,0,2,9,9,1
32710,78,1824,996,429,845,24,10,117,1020,7,76,50,88,83,138,494,879,4,3565,198,0,2,1,1,1
32711,78,1824,456,277,329,12,42,72,468,13,85,50,97,98,147,592,972,7,7212,400,0,2,1,1,1
32712,248,5735,4293,999,3693,19,54,507,4312,9,155,88,170,164,258,1156,1898,4,9368,520,0,2,1,1,1
32713,248,5735,1482,859,1002,125,135,219,1607,16,219,134,251,235,385,1766,3032,9,27804,1544,1,2,1,1,1
32714,100,2601,773,422,505,30,103,129,803,14,77,46,83,91,129,535,839,7,6334,351,0,2,1,1,1
32715,103,5544,1943,715,1694,26,18,214,1969,12,185,120,237,197,357,1436,2721,7,20915,1161,0,2,10,9,1
32716,113,2113,477,336,357,30,23,73,507,16,194,134,250,210,384,1538,2962,10,30538,1696,0,2,34,24,1
32717,126,4991,1450,624,1228,12,26,181,1462,14,306,186,354,320,540,2580,4493,8,36391,2021,1,2,11,0,1
32718,248,5737,4293,999,3693,19,54,507,4312,9,155,88,170,164,258,1156,1898,4,9368,520,0,2,1,1,0
32719,248,5737,1482,859,1002,125,135,219,1607,16,219,134,251,235,385,1766,3032,9,27804,1544,1,2,1,1,0
32720,24,614,2,2,2,0,0,0,2,0,0,0,0,0,0,0,0,0,0,0,0,2,1,0,0
32721,24,614,99,48,90,1,3,5,100,0,0,0,0,0,0,0,0,0,0,0,0,2,1,0,0
32722,24,614,8,5,5,2,0,1,10,0,0,0,0,0,0,0,0,0,0,0,0,2,1,0,0
32723,24,614,1217,716,841,84,126,174,1301,14,185,118,215,199,333,1446,2542,8,20687,1149,0,2,1,0,0
32724,24,614,160,89,115,0,13,31,160,7,15,11,17,22,28,78,124,3,495,27,0,2,1,0,0
32725,24,614,10,10,9,9,0,0,19,0,0,0,0,0,0,0,0,0,0,0,0,2,1,0,0
32726,24,614,173,84,99,8,29,36,181,5,12,7,13,17,20,54,81,2,221,12,0,2,1,0,0
32727,24,614,3,1,1,3,0,0,6,0,0,0,0,0,0,0,0,0,0,0,0,2,1,0,0
32728,171,7589,4293,999,3693,19,54,507,4312,9,155,88,170,164,258,1156,1898,4,9368,520,0,2,3,2,0
32729,171,7589,1482,859,1002,125,135,219,1607,16,219,134,251,235,385,1766,3032,9,27804,1544,1,2,3,2,0
32730,125,5398,1513,682,1277,25,13,200,1538,11,199,116,219,210,335,1557,2584,6,15641,868,0,2,11,1,0
32731,29,1324,373,158,315,8,0,51,381,5,76,44,79,81,123,486,779,2,2026,112,0,2,2,1,0
32732,53,1862,601,196,481,2,23,85,603,8,63,36,72,71,108,400,664,4,3036,168,0,2,4,2,0
32733,248,5737,4293,999,3693,19,54,507,4312,9,155,88,170,164,258,1156,1898,4,9368,520,0,2,1,1,0
32734,248,5737,1482,859,1002,125,135,219,1607,16,219,134,251,235,385,1766,3032,9,27804,1544,1,2,1,1,0
32735,24,614,2,2,2,0,0,0,2,0,0,0,0,0,0,0,0,0,0,0,0,2,1,0,0
32736,24,614,99,48,90,1,3,5,100,0,0,0,0,0,0,0,0,0,0,0,0,2,1,0,0
32737,24,614,8,5,5,2,0,1,10,0,0,0,0,0,0,0,0,0,0,0,0,2,1,0,0
32738,24,614,1217,716,841,84,126,174,1301,14,185,118,215,199,333,1446,2542,8,20687,1149,0,2,1,0,0
32739,24,614,160,89,115,0,13,31,160,7,15,11,17,22,28,78,124,3,495,27,0,2,1,0,0
32740,24,614,10,10,9,9,0,0,19,0,0,0,0,0,0,0,0,0,0,0,0,2,1,0,0
32741,24,614,173,84,99,8,29,36,181,5,12,7,13,17,20,54,81,2,221,12,0,2,1,0,0
32742,24,614,3,1,1,3,0,0,6,0,0,0,0,0,0,0,0,0,0,0,0,2,1,0,0
32743,171,7589,4293,999,3693,19,54,507,4312,9,155,88,170,164,258,1156,1898,4,9368,520,0,2,3,2,0
32744,171,7589,1482,859,1002,125,135,219,1607,16,219,134,251,235,385,1766,3032,9,27804,1544,1,2,3,2,0
32745,125,5398,1513,682,1277,25,13,200,1538,11,199,116,219,210,335,1557,2584,6,15641,868,0,2,11,1,0
32746,29,1324,373,158,315,8,0,51,381,5,76,44,79,81,123,486,779,2,2026,112,0,2,2,1,0
32747,53,1862,601,196,481,2,23,85,603,8,63,36,72,71,108,400,664,4,3036,168,0,2,4,2,0
32748,28,452,219,78,157,11,5,46,230,3,24,20,34,27,54,114,256,2,545,30,0,2,14,2,0
32749,28,452,108,64,79,9,0,20,117,5,15,11,19,20,30,70,129,3,410,22,0,2,14,2,0
32750,72,1466,1178,367,1042,6,15,115,1184,9,94,51,95,103,146,644,976,4,4439,246,0,2,19,11,0
32751,72,1466,177,108,140,8,0,27,185,6,30,16,32,36,48,162,248,3,794,44,0,2,19,11,0
32752,66,1714,466,257,367,18,25,50,484,7,126,86,171,133,257,898,1813,4,8612,478,0,2,3,1,0
32753,66,1714,507,281,342,29,59,88,536,10,53,29,57,63,86,336,514,5,2764,153,0,2,3,1,0
32754,28,1596,466,257,367,18,25,50,484,7,126,86,171,133,257,898,1813,4,8612,478,0,2,22,2,0
32755,101,2611,773,422,505,30,103,129,803,14,77,46,83,91,129,535,839,7,6334,351,0,2,9,2,0
32756,101,2611,773,422,505,30,103,129,803,14,77,46,83,91,129,535,839,7,6334,351,0,2,9,2,0
32757,52,625,647,139,84,35,284,233,682,0,0,0,0,0,0,0,0,0,0,0,0,2,2,1,0
32758,75,1617,53,23,39,0,0,13,53,2,8,4,8,10,12,26,39,1,39,2,0,2,8,1,0
32759,75,1617,515,298,307,33,80,99,548,12,63,44,77,75,121,419,753,7,5527,307,0,2,8,1,0
32760,85,4936,1296,573,1062,40,33,157,1336,8,201,118,231,209,349,1561,2689,4,12365,686,0,2,18,0,0
32761,112,2106,477,336,357,30,23,73,507,16,194,134,250,210,384,1538,2962,10,30538,1696,0,2,9,9,0
32762,78,1824,996,429,845,24,10,117,1020,7,76,50,88,83,138,494,879,4,3565,198,0,2,1,1,0
32763,78,1824,456,277,329,12,42,72,468,13,85,50,97,98,147,592,972,7,7212,400,0,2,1,1,0
32764,248,5737,4293,999,3693,19,54,507,4312,9,155,88,170,164,258,1156,1898,4,9368,520,0,2,1,1,0
32765,248,5737,1482,859,1002,125,135,219,1607,16,219,134,251,235,385,1766,3032,9,27804,1544,1,2,1,1,0
32766,101,2612,773,422,505,30,103,129,803,14,77,46,83,91,129,535,839,7,6334,351,0,2,1,1,0
32767,103,5544,1943,715,1694,26,18,214,1969,12,185,120,237,197,357,1436,2721,7,20915,1161,0,2,10,9,0
32768,113,2116,477,336,357,30,23,73,507,16,194,134,250,210,384,1538,2962,10,30538,1696,0,2,34,24,0
32769,126,4991,1450,624,1228,12,26,181,1462,14,306,186,354,320,540,2580,4493,8,36391,2021,1,2,11,0,0
32770,313,6885,72,33,56,0,4,12,72,1,1,1,1,2,2,0,2,0,1,0,0,2,18,1,0
32771,313,6885,1454,835,1044,76,110,219,1530,17,275,158,296,292,454,2297,3718,9,34017,1889,1,2,18,1,0
32772,313,6885,72,33,56,0,4,12,72,1,1,1,1,2,2,0,2,0,1,0,0,2,2,2,0
32773,313,6885,1454,835,1044,76,110,219,1530,17,275,158,296,292,454,2297,3718,9,34017,1889,1,2,2,2,0
32774,67,1570,773,419,590,28,0,166,801,10,204,113,217,214,330,1598,2554,5,13587,754,0,2,3,1,0
32775,67,1570,421,273,302,44,34,57,465,17,81,59,107,98,166,583,1098,11,12329,684,0,2,3,1,0
32776,69,1499,402,202,227,24,74,80,426,12,52,33,61,64,94,339,564,7,3969,220,0,2,1,1,0
32777,69,3122,1020,354,843,12,15,144,1032,8,134,77,144,142,221,970,1580,4,6792,377,0,2,25,10,0
32778,313,6885,72,33,56,0,4,12,72,1,1,1,1,2,2,0,2,0,1,0,0,2,18,1,0
32779,313,6885,1454,835,1044,76,110,219,1530,17,275,158,296,292,454,2297,3718,9,34017,1889,1,2,18,1,0
32780,72,1466,1178,367,1042,6,15,115,1184,9,94,51,95,103,146,644,976,4,4439,246,0,2,19,11,0
32781,72,1466,177,108,140,8,0,27,185,6,30,16,32,36,48,162,248,3,794,44,0,2,19,11,0
32782,67,1570,773,419,590,28,0,166,801,10,204,113,217,214,330,1598,2554,5,13587,754,0,2,3,1,0
32783,67,1570,421,273,302,44,34,57,465,17,81,59,107,98,166,583,1098,11,12329,684,0,2,3,1,0
32784,69,1499,402,202,227,24,74,80,426,12,52,33,61,64,94,339,564,7,3969,220,0,2,1,1,0
32785,69,3122,1020,354,843,12,15,144,1032,8,134,77,144,142,221,970,1580,4,6792,377,0,2,25,10,0
32786,247,5945,722,423,573,19,0,135,741,12,172,101,199,184,300,1320,2257,6,15668,870,0,2,9,0,1
32787,247,5945,1508,847,911,44,250,301,1552,14,148,88,169,162,257,1120,1886,7,15077,837,0,2,9,0,1
32788,92,4888,1457,730,1242,11,6,188,1468,10,292,166,329,302,495,2424,4078,5,22973,1276,1,2,8,16,1
32789,28,1833,384,251,317,7,8,52,391,11,70,44,84,81,128,467,811,6,5355,297,0,2,6,7,1
32790,247,5945,722,423,573,19,0,135,741,12,172,101,199,184,300,1320,2257,6,15668,870,0,2,9,0,0
32791,247,5945,1508,847,911,44,250,301,1552,14,148,88,169,162,257,1120,1886,7,15077,837,0,2,9,0,0
32792,92,4888,1457,730,1242,11,6,188,1468,10,292,166,329,302,495,2424,4078,5,22973,1276,1,2,8,16,0
32793,28,1833,384,251,317,7,8,52,391,11,70,44,84,81,128,467,811,6,5355,297,0,2,6,7,0
32794,164,3436,1513,682,1277,25,13,200,1538,11,199,116,219,210,335,1557,2584,6,15641,868,0,2,18,0,0
32795,164,3436,819,519,539,24,98,155,843,15,96,57,106,111,163,690,1107,8,9171,509,0,2,18,0,0
32796,50,1389,339,213,244,17,9,65,356,10,42,26,48,52,74,259,421,5,2410,133,0,2,25,6,0
32797,69,3465,1293,570,1093,25,15,163,1318,10,195,123,241,205,364,1516,2795,6,17273,959,0,2,49,0,0
32798,50,1396,339,213,244,17,9,65,356,10,42,26,48,52,74,259,421,5,2410,133,0,2,8,5,0
32799,69,3468,1293,570,1093,25,15,163,1318,10,195,123,241,205,364,1516,2795,6,17273,959,0,2,2,1,0
32800,73,3679,1293,570,1093,25,15,163,1318,10,195,123,241,205,364,1516,2795,6,17273,959,0,2,51,0,0
32801,164,3417,1513,682,1277,25,13,200,1538,11,199,116,219,210,335,1557,2584,6,15641,868,0,2,3,5,0
32802,164,3417,819,519,539,24,98,155,843,15,96,57,106,111,163,690,1107,8,9171,509,0,2,3,5,0
32803,72,3663,1293,570,1093,25,15,163,1318,10,195,123,241,205,364,1516,2795,6,17273,959,0,2,58,17,0
32804,50,1402,339,213,244,17,9,65,356,10,42,26,48,52,74,259,421,5,2410,133,0,2,11,9,0
32805,54,657,647,139,84,35,284,233,682,0,0,0,0,0,0,0,0,0,0,0,0,2,3,3,0
32806,66,1714,466,257,367,18,25,50,484,7,126,86,171,133,257,898,1813,4,8612,478,0,2,2,2,0
32807,66,1714,507,281,342,29,59,88,536,10,53,29,57,63,86,336,514,5,2764,153,0,2,2,2,0
32808,28,1596,466,257,367,18,25,50,484,7,126,86,171,133,257,898,1813,4,8612,478,0,2,6,6,0
32809,235,4919,2,2,2,0,0,0,2,0,0,0,0,0,0,0,0,0,0,0,0,2,1,0,0
32810,235,4919,99,48,90,1,3,5,100,0,0,0,0,0,0,0,0,0,0,0,0,2,1,0,0
32811,235,4919,8,5,5,2,0,1,10,0,0,0,0,0,0,0,0,0,0,0,0,2,1,0,0
32812,235,4919,1217,716,841,84,126,174,1301,14,185,118,215,199,333,1446,2542,8,20687,1149,0,2,1,0,0
32813,235,4919,160,89,115,0,13,31,160,7,15,11,17,22,28,78,124,3,495,27,0,2,1,0,0
32814,235,4919,10,10,9,9,0,0,19,0,0,0,0,0,0,0,0,0,0,0,0,2,1,0,0
32815,235,4919,173,84,99,8,29,36,181,5,12,7,13,17,20,54,81,2,221,12,0,2,1,0,0
32816,235,4919,3,1,1,3,0,0,6,0,0,0,0,0,0,0,0,0,0,0,0,2,1,0,0
32817,54,657,647,139,84,35,284,233,682,0,0,0,0,0,0,0,0,0,0,0,0,2,35,0,0
32818,66,1714,466,257,367,18,25,50,484,7,126,86,171,133,257,898,1813,4,8612,478,0,2,153,0,0
32819,66,1714,507,281,342,29,59,88,536,10,53,29,57,63,86,336,514,5,2764,153,0,2,153,0,0
32820,28,1596,466,257,367,18,25,50,484,7,126,86,171,133,257,898,1813,4,8612,478,0,0,313,0,0
32821,28,452,219,78,157,11,5,46,230,3,24,20,34,27,54,114,256,2,545,30,0,2,14,2,0
32822,28,452,108,64,79,9,0,20,117,5,15,11,19,20,30,70,129,3,410,22,0,2,14,2,0
32823,52,625,647,139,84,35,284,233,682,0,0,0,0,0,0,0,0,0,0,0,0,2,2,2,0
32824,164,3417,1513,682,1277,25,13,200,1538,11,199,116,219,210,335,1557,2584,6,15641,868,0,2,21,5,0
32825,164,3417,819,519,539,24,98,155,843,15,96,57,106,111,163,690,1107,8,9171,509,0,2,21,5,0
32826,50,1402,339,213,244,17,9,65,356,10,42,26,48,52,74,259,421,5,2410,133,0,2,33,9,0
32827,72,3663,1293,570,1093,25,15,163,1318,10,195,123,241,205,364,1516,2795,6,17273,959,0,2,143,1,0
32828,52,625,647,139,84,35,284,233,682,0,0,0,0,0,0,0,0,0,0,0,0,2,2,2,0
32829,55,770,167,116,138,4,5,22,171,8,48,30,56,56,86,292,499,4,2330,129,0,2,6,6,0
32830,101,5285,1457,730,1242,11,6,188,1468,10,292,166,329,302,495,2424,4078,5,22973,1276,1,2,16,0,0
32831,51,1410,339,213,244,17,9,65,356,10,42,26,48,52,74,259,421,5,2410,133,0,2,8,1,0
32832,72,3697,1293,570,1093,25,15,163,1318,10,195,123,241,205,364,1516,2795,6,17273,959,0,2,12,3,0
32833,54,657,647,139,84,35,284,233,682,0,0,0,0,0,0,0,0,0,0,0,0,2,2,1,0
32834,233,5825,722,423,573,19,0,135,741,12,172,101,199,184,300,1320,2257,6,15668,870,0,2,9,0,0
32835,233,5825,1508,847,911,44,250,301,1552,14,148,88,169,162,257,1120,1886,7,15077,837,0,2,9,0,0
32836,100,5205,1457,730,1242,11,6,188,1468,10,292,166,329,302,495,2424,4078,5,22973,1276,1,2,8,16,0
32837,29,1873,384,251,317,7,8,52,391,11,70,44,84,81,128,467,811,6,5355,297,0,2,6,7,0
32838,52,1439,339,213,244,17,9,65,356,10,42,26,48,52,74,259,421,5,2410,133,0,2,10,0,0
32839,73,3713,1293,570,1093,25,15,163,1318,10,195,123,241,205,364,1516,2795,6,17273,959,0,2,14,0,0
32840,55,770,167,116,138,4,5,22,171,8,48,30,56,56,86,292,499,4,2330,129,0,2,6,6,0
32841,101,5285,1457,730,1242,11,6,188,1468,10,292,166,329,302,495,2424,4078,5,22973,1276,1,2,16,0,0
32842,54,657,647,139,84,35,284,233,682,0,0,0,0,0,0,0,0,0,0,0,0,2,2,1,0
32843,233,5825,722,423,573,19,0,135,741,12,172,101,199,184,300,1320,2257,6,15668,870,0,2,9,0,0
32844,233,5825,1508,847,911,44,250,301,1552,14,148,88,169,162,257,1120,1886,7,15077,837,0,2,9,0,0
32845,101,5261,1457,730,1242,11,6,188,1468,10,292,166,329,302,495,2424,4078,5,22973,1276,1,2,8,16,0
32846,29,1873,384,251,317,7,8,52,391,11,70,44,84,81,128,467,811,6,5355,297,0,2,6,7,0
32847,51,1410,339,213,244,17,9,65,356,10,42,26,48,52,74,259,421,5,2410,133,0,2,8,1,0
32848,72,3697,1293,570,1093,25,15,163,1318,10,195,123,241,205,364,1516,2795,6,17273,959,0,2,12,3,0
32849,69,1499,402,202,227,24,74,80,426,12,52,33,61,64,94,339,564,7,3969,220,0,2,2,2,0
32850,233,5835,722,423,573,19,0,135,741,12,172,101,199,184,300,1320,2257,6,15668,870,0,2,6,0,0
32851,233,5835,1508,847,911,44,250,301,1552,14,148,88,169,162,257,1120,1886,7,15077,837,0,2,6,0,0
32852,171,7601,4293,999,3693,19,54,507,4312,9,155,88,170,164,258,1156,1898,4,9368,520,0,2,4,4,0
32853,171,7601,1482,859,1002,125,135,219,1607,16,219,134,251,235,385,1766,3032,9,27804,1544,1,2,4,4,0
32854,33,1007,465,148,393,5,8,60,470,4,31,20,31,35,51,161,261,2,523,29,0,2,1,1,0
32855,33,1007,16,12,9,0,0,6,16,1,2,1,2,3,3,2,4,0,2,0,0,2,1,1,0
32856,126,5666,1782,648,1425,9,47,279,1791,8,171,97,189,179,286,1292,2140,4,9462,525,0,2,18,18,0
32857,125,5401,1513,682,1277,25,13,200,1538,11,199,116,219,210,335,1557,2584,6,15641,868,0,2,1,1,0
32858,43,2679,652,304,544,16,6,88,668,6,89,51,101,95,152,591,998,3,3399,188,0,2,1,1,0
32859,69,3128,1020,354,843,12,15,144,1032,8,134,77,144,142,221,970,1580,4,6792,377,0,2,2,2,0
32860,1,94,42,7,35,4,0,5,46,1,2,1,2,3,3,2,4,0,2,0,0,2,2,2,0
32861,1,94,11,6,10,0,0,1,11,2,4,2,4,6,6,10,15,1,15,0,0,2,2,2,0
32862,230,4977,182,127,129,0,0,53,182,5,39,21,42,44,63,217,343,2,926,51,0,2,8,12,0
32863,230,4977,1165,710,800,67,119,181,1232,18,243,153,282,261,435,2000,3492,10,36473,2026,1,2,8,12,0
32864,67,1570,773,419,590,28,0,166,801,10,204,113,217,214,330,1598,2554,5,13587,754,0,2,3,1,0
32865,67,1570,421,273,302,44,34,57,465,17,81,59,107,98,166,583,1098,11,12329,684,0,2,3,1,0
32866,183,5553,1660,832,1314,41,38,274,1701,20,312,209,395,332,604,2671,5058,12,64042,3557,1,2,3,3,0
32867,183,5553,1057,646,719,113,100,145,1170,18,215,134,248,233,382,1740,3004,10,31186,1732,1,2,3,3,0
32868,113,2116,477,336,357,30,23,73,507,16,194,134,250,210,384,1538,2962,10,30538,1696,0,2,43,33,0
32869,78,1824,996,429,845,24,10,117,1020,7,76,50,88,83,138,494,879,4,3565,198,0,2,11,15,0
32870,78,1824,456,277,329,12,42,72,468,13,85,50,97,98,147,592,972,7,7212,400,0,2,11,15,0
32871,164,3417,1513,682,1277,25,13,200,1538,11,199,116,219,210,335,1557,2584,6,15641,868,0,2,69,44,0
32872,164,3417,819,519,539,24,98,155,843,15,96,57,106,111,163,690,1107,8,9171,509,0,2,69,44,0
32873,235,4919,2,2,2,0,0,0,2,0,0,0,0,0,0,0,0,0,0,0,0,2,39,14,0
32874,235,4919,99,48,90,1,3,5,100,0,0,0,0,0,0,0,0,0,0,0,0,2,39,14,0
32875,235,4919,8,5,5,2,0,1,10,0,0,0,0,0,0,0,0,0,0,0,0,2,39,14,0
32876,235,4919,1217,716,841,84,126,174,1301,14,185,118,215,199,333,1446,2542,8,20687,1149,0,2,39,14,0
32877,235,4919,160,89,115,0,13,31,160,7,15,11,17,22,28,78,124,3,495,27,0,2,39,14,0
32878,235,4919,10,10,9,9,0,0,19,0,0,0,0,0,0,0,0,0,0,0,0,2,39,14,0
32879,235,4919,173,84,99,8,29,36,181,5,12,7,13,17,20,54,81,2,221,12,0,2,39,14,0
32880,235,4919,3,1,1,3,0,0,6,0,0,0,0,0,0,0,0,0,0,0,0,2,39,14,0
32881,55,770,167,116,138,4,5,22,171,8,48,30,56,56,86,292,499,4,2330,129,0,2,6,6,0
32882,51,1410,339,213,244,17,9,65,356,10,42,26,48,52,74,259,421,5,2410,133,0,2,78,28,0
32883,95,2385,1455,414,1257,16,76,112,1471,5,41,23,46,46,69,231,381,2,1069,59,0,2,3,0,0
32884,95,2385,669,365,481,22,61,110,691,15,103,63,122,118,185,747,1273,8,11311,628,0,2,3,0,0
32885,248,5737,4293,999,3693,19,54,507,4312,9,155,88,170,164,258,1156,1898,4,9368,520,0,2,18,6,0
32886,248,5737,1482,859,1002,125,135,219,1607,16,219,134,251,235,385,1766,3032,9,27804,1544,1,2,18,6,0
32887,28,978,74,35,59,1,0,14,75,3,14,7,14,17,21,58,85,1,128,7,0,2,1,1,0
32888,28,978,245,125,200,5,7,34,250,7,30,17,34,37,51,166,265,3,1053,58,0,2,1,1,0
32889,54,657,647,139,84,35,284,233,682,0,0,0,0,0,0,0,0,0,0,0,0,2,35,0,0
32890,101,2612,773,422,505,30,103,129,803,14,77,46,83,91,129,535,839,7,6334,351,0,2,10,3,0
32891,159,3781,77,34,69,0,0,8,77,3,24,16,29,27,45,114,213,1,387,21,0,2,11,2,0
32892,159,3781,712,438,573,51,9,84,763,14,102,71,128,116,199,733,1364,8,11988,666,0,2,11,2,0
32893,69,1499,402,202,227,24,74,80,426,12,52,33,61,64,94,339,564,7,3969,220,0,2,1,1,0
32894,54,1156,447,308,343,6,5,95,453,7,96,59,111,103,170,651,1136,4,4600,255,0,2,5,0,0
32895,54,1156,322,174,179,16,74,51,338,10,41,26,46,51,72,252,408,5,2291,127,0,2,5,0,0
32896,75,1617,53,23,39,0,0,13,53,2,8,4,8,10,12,26,39,1,39,2,0,2,8,1,0
32897,75,1617,515,298,307,33,80,99,548,12,63,44,77,75,121,419,753,7,5527,307,0,2,8,1,0
32898,21,541,205,80,86,16,53,53,221,7,18,10,19,25,29,94,134,3,497,27,0,2,5,1,0
32899,233,5825,722,423,573,19,0,135,741,12,172,101,199,184,300,1320,2257,6,15668,870,0,2,23,49,0
32900,233,5825,1508,847,911,44,250,301,1552,14,148,88,169,162,257,1120,1886,7,15077,837,0,2,23,49,0
32901,313,6885,72,33,56,0,4,12,72,1,1,1,1,2,2,0,2,0,1,0,0,2,32,23,0
32902,313,6885,1454,835,1044,76,110,219,1530,17,275,158,296,292,454,2297,3718,9,34017,1889,1,2,32,23,0
32903,66,1714,466,257,367,18,25,50,484,7,126,86,171,133,257,898,1813,4,8612,478,0,2,237,1,0
32904,66,1714,507,281,342,29,59,88,536,10,53,29,57,63,86,336,514,5,2764,153,0,2,237,1,0
32905,89,1902,1043,504,840,53,9,147,1096,9,180,112,198,189,310,1377,2344,4,11604,644,0,2,4,40,0
32906,89,1902,383,288,292,26,6,62,409,11,65,38,67,76,105,429,656,5,3719,206,0,2,4,40,0
32907,72,1466,1178,367,1042,6,15,115,1184,9,94,51,95,103,146,644,976,4,4439,246,0,2,19,11,0
32908,72,1466,177,108,140,8,0,27,185,6,30,16,32,36,48,162,248,3,794,44,0,2,19,11,0
32909,28,452,219,78,157,11,5,46,230,3,24,20,34,27,54,114,256,2,545,30,0,2,14,2,0
32910,28,452,108,64,79,9,0,20,117,5,15,11,19,20,30,70,129,3,410,22,0,2,14,2,0
32911,248,5121,1943,715,1694,26,18,214,1969,12,185,120,237,197,357,1436,2721,7,20915,1161,0,2,38,28,0
32912,248,5121,1168,838,957,57,25,144,1225,19,348,224,416,367,640,3018,5452,11,61921,3440,1,2,38,28,0
32913,29,743,601,196,481,2,23,85,603,8,63,36,72,71,108,400,664,4,3036,168,0,2,2,1,0
32914,29,743,156,79,106,5,16,28,161,5,14,8,15,19,23,64,97,2,261,14,0,2,2,1,0
32915,112,4514,1289,550,1043,56,32,155,1345,10,167,93,185,177,278,1266,2075,5,11498,638,0,2,87,2,0
32916,36,1120,182,127,129,0,0,53,182,5,39,21,42,44,63,217,343,2,926,51,0,2,4,0,0
32917,14,845,75,38,59,1,3,12,76,2,4,2,4,6,6,10,15,1,15,0,0,2,1,1,0
32918,36,2427,1157,318,931,29,22,177,1186,6,104,63,125,110,188,712,1274,3,4596,255,0,2,12,12,0
32919,90,3974,1338,495,1086,10,64,173,1348,11,122,82,157,133,239,883,1686,7,11934,663,0,2,9,11,0
32920,171,7589,4293,999,3693,19,54,507,4312,9,155,88,170,164,258,1156,1898,4,9368,520,0,3,43,5,0
32921,171,7589,1482,859,1002,125,135,219,1607,16,219,134,251,235,385,1766,3032,9,27804,1544,1,3,43,5,0
32922,126,4991,1450,624,1228,12,26,181,1462,14,306,186,354,320,540,2580,4493,8,36391,2021,1,2,11,0,0
32923,176,5286,1660,832,1314,41,38,274,1701,20,312,209,395,332,604,2671,5058,12,64042,3557,1,2,60,25,0
32924,47,3469,996,429,845,24,10,117,1020,7,76,50,88,83,138,494,879,4,3565,198,0,2,8,8,0
32925,125,5398,1513,682,1277,25,13,200,1538,11,199,116,219,210,335,1557,2584,6,15641,868,0,2,2,2,0
32926,85,4936,1296,573,1062,40,33,157,1336,8,201,118,231,209,349,1561,2689,4,12365,686,0,2,22,4,0
32927,21,500,207,111,150,11,0,50,218,5,26,19,36,31,55,133,272,3,943,52,0,2,13,8,0
32928,101,5261,1457,730,1242,11,6,188,1468,10,292,166,329,302,495,2424,4078,5,22973,1276,1,2,96,5,0
32929,72,3310,1455,414,1257,16,76,112,1471,5,41,23,46,46,69,231,381,2,1069,59,0,2,13,1,0
32930,100,4747,1523,757,1297,19,12,193,1542,12,193,117,230,205,347,1508,2664,7,19053,1058,0,2,0,3,0
32931,69,3122,1020,354,843,12,15,144,1032,8,134,77,144,142,221,970,1580,4,6792,377,0,2,25,10,0
32932,47,2152,447,308,343,6,5,95,453,7,96,59,111,103,170,651,1136,4,4600,255,0,2,25,0,0
32933,21,655,424,94,331,4,0,89,428,1,5,5,5,6,10,11,25,0,12,0,0,2,1,1,0
32934,72,3697,1293,570,1093,25,15,163,1318,10,195,123,241,205,364,1516,2795,6,17273,959,0,2,174,7,0
32935,29,1873,384,251,317,7,8,52,391,11,70,44,84,81,128,467,811,6,5355,297,0,2,14,5,0
32936,49,2385,722,423,573,19,0,135,741,12,172,101,199,184,300,1320,2257,6,15668,870,0,2,16,0,0
32937,28,1596,466,257,367,18,25,50,484,7,126,86,171,133,257,898,1813,4,8612,478,0,0,313,0,0
32938,83,3328,1043,504,840,53,9,147,1096,9,180,112,198,189,310,1377,2344,4,11604,644,0,2,5,5,0
32939,29,1324,373,158,315,8,0,51,381,5,76,44,79,81,123,486,779,2,2026,112,0,2,5,7,0
32940,81,3287,1178,367,1042,6,15,115,1184,9,94,51,95,103,146,644,976,4,4439,246,0,2,9,7,0
32941,103,5544,1943,715,1694,26,18,214,1969,12,185,120,237,197,357,1436,2721,7,20915,1161,0,2,76,16,0
32942,37,1527,442,244,305,14,16,103,456,11,68,45,75,79,120,452,756,6,4588,254,0,2,1,1,0
32943,52,1994,1098,241,925,5,10,155,1103,7,46,25,49,53,74,273,423,3,1580,87,0,2,2,2,0
32944,69,1499,402,202,227,24,74,80,426,12,52,33,61,64,94,339,564,7,3969,220,0,2,2,2,0
32945,233,5835,722,423,573,19,0,135,741,12,172,101,199,184,300,1320,2257,6,15668,870,0,2,6,0,0
32946,233,5835,1508,847,911,44,250,301,1552,14,148,88,169,162,257,1120,1886,7,15077,837,0,2,6,0,0
32947,171,7601,4293,999,3693,19,54,507,4312,9,155,88,170,164,258,1156,1898,4,9368,520,0,2,4,4,0
32948,171,7601,1482,859,1002,125,135,219,1607,16,219,134,251,235,385,1766,3032,9,27804,1544,1,2,4,4,0
32949,33,1007,465,148,393,5,8,60,470,4,31,20,31,35,51,161,261,2,523,29,0,2,1,1,0
32950,33,1007,16,12,9,0,0,6,16,1,2,1,2,3,3,2,4,0,2,0,0,2,1,1,0
32951,126,5666,1782,648,1425,9,47,279,1791,8,171,97,189,179,286,1292,2140,4,9462,525,0,2,18,18,0
32952,125,5401,1513,682,1277,25,13,200,1538,11,199,116,219,210,335,1557,2584,6,15641,868,0,2,1,1,0
32953,43,2679,652,304,544,16,6,88,668,6,89,51,101,95,152,591,998,3,3399,188,0,2,1,1,0
32954,69,3128,1020,354,843,12,15,144,1032,8,134,77,144,142,221,970,1580,4,6792,377,0,2,2,2,0
32955,23,607,2,2,2,0,0,0,2,0,0,0,0,0,0,0,0,0,0,0,0,2,1,2,1
32956,23,607,99,48,90,1,3,5,100,0,0,0,0,0,0,0,0,0,0,0,0,2,1,2,1
32957,23,607,8,5,5,2,0,1,10,0,0,0,0,0,0,0,0,0,0,0,0,2,1,2,1
32958,23,607,1217,716,841,84,126,174,1301,14,185,118,215,199,333,1446,2542,8,20687,1149,0,2,1,2,1
32959,23,607,160,89,115,0,13,31,160,7,15,11,17,22,28,78,124,3,495,27,0,2,1,2,1
32960,23,607,10,10,9,9,0,0,19,0,0,0,0,0,0,0,0,0,0,0,0,2,1,2,1
32961,23,607,173,84,99,8,29,36,181,5,12,7,13,17,20,54,81,2,221,12,0,2,1,2,1
32962,23,607,3,1,1,3,0,0,6,0,0,0,0,0,0,0,0,0,0,0,0,2,1,2,1
32963,69,1509,402,202,227,24,74,80,426,12,52,33,61,64,94,339,564,7,3969,220,0,2,24,14,1
32964,69,1509,402,202,227,24,74,80,426,12,52,33,61,64,94,339,564,7,3969,220,0,2,5,5,0
32965,2,121,37,13,25,0,6,6,37,1,2,1,2,3,3,2,4,0,2,0,0,2,9,0,0
32966,2,121,133,47,40,1,43,49,134,0,0,0,0,0,0,0,0,0,0,0,0,2,9,0,0
32967,68,1497,402,202,227,24,74,80,426,12,52,33,61,64,94,339,564,7,3969,220,0,2,20,19,0
32968,23,607,2,2,2,0,0,0,2,0,0,0,0,0,0,0,0,0,0,0,0,2,1,2,0
32969,23,607,99,48,90,1,3,5,100,0,0,0,0,0,0,0,0,0,0,0,0,2,1,2,0
32970,23,607,8,5,5,2,0,1,10,0,0,0,0,0,0,0,0,0,0,0,0,2,1,2,0
32971,23,607,1217,716,841,84,126,174,1301,14,185,118,215,199,333,1446,2542,8,20687,1149,0,2,1,2,0
32972,23,607,160,89,115,0,13,31,160,7,15,11,17,22,28,78,124,3,495,27,0,2,1,2,0
32973,23,607,10,10,9,9,0,0,19,0,0,0,0,0,0,0,0,0,0,0,0,2,1,2,0
32974,23,607,173,84,99,8,29,36,181,5,12,7,13,17,20,54,81,2,221,12,0,2,1,2,0
32975,23,607,3,1,1,3,0,0,6,0,0,0,0,0,0,0,0,0,0,0,0,2,1,2,0
32976,68,1497,402,202,227,24,74,80,426,12,52,33,61,64,94,339,564,7,3969,220,0,2,27,16,0
32977,2,121,37,13,25,0,6,6,37,1,2,1,2,3,3,2,4,0,2,0,0,2,9,0,0
32978,2,121,133,47,40,1,43,49,134,0,0,0,0,0,0,0,0,0,0,0,0,2,9,0,0
32979,162,3389,1513,682,1277,25,13,200,1538,11,199,116,219,210,335,1557,2584,6,15641,868,0,2,0,7,0
32980,162,3389,819,519,539,24,98,155,843,15,96,57,106,111,163,690,1107,8,9171,509,0,2,0,7,0
32981,236,4937,2,2,2,0,0,0,2,0,0,0,0,0,0,0,0,0,0,0,0,2,10,4,0
32982,236,4937,99,48,90,1,3,5,100,0,0,0,0,0,0,0,0,0,0,0,0,2,10,4,0
32983,236,4937,8,5,5,2,0,1,10,0,0,0,0,0,0,0,0,0,0,0,0,2,10,4,0
32984,236,4937,1217,716,841,84,126,174,1301,14,185,118,215,199,333,1446,2542,8,20687,1149,0,2,10,4,0
32985,236,4937,160,89,115,0,13,31,160,7,15,11,17,22,28,78,124,3,495,27,0,2,10,4,0
32986,236,4937,10,10,9,9,0,0,19,0,0,0,0,0,0,0,0,0,0,0,0,2,10,4,0
32987,236,4937,173,84,99,8,29,36,181,5,12,7,13,17,20,54,81,2,221,12,0,2,10,4,0
32988,236,4937,3,1,1,3,0,0,6,0,0,0,0,0,0,0,0,0,0,0,0,2,10,4,0
32989,248,5130,1943,715,1694,26,18,214,1969,12,185,120,237,197,357,1436,2721,7,20915,1161,0,2,1,0,0
32990,248,5130,1168,838,957,57,25,144,1225,19,348,224,416,367,640,3018,5452,11,61921,3440,1,2,1,0,0
32991,103,5260,1457,730,1242,11,6,188,1468,10,292,166,329,302,495,2424,4078,5,22973,1276,1,2,10,16,0
32992,29,1903,384,251,317,7,8,52,391,11,70,44,84,81,128,467,811,6,5355,297,0,2,4,0,0
32993,236,4937,2,2,2,0,0,0,2,0,0,0,0,0,0,0,0,0,0,0,0,2,10,4,0
32994,236,4937,99,48,90,1,3,5,100,0,0,0,0,0,0,0,0,0,0,0,0,2,10,4,0
32995,236,4937,8,5,5,2,0,1,10,0,0,0,0,0,0,0,0,0,0,0,0,2,10,4,0
32996,236,4937,1217,716,841,84,126,174,1301,14,185,118,215,199,333,1446,2542,8,20687,1149,0,2,10,4,0
32997,236,4937,160,89,115,0,13,31,160,7,15,11,17,22,28,78,124,3,495,27,0,2,10,4,0
32998,236,4937,10,10,9,9,0,0,19,0,0,0,0,0,0,0,0,0,0,0,0,2,10,4,0
32999,236,4937,173,84,99,8,29,36,181,5,12,7,13,17,20,54,81,2,221,12,0,2,10,4,0
33000,236,4937,3,1,1,3,0,0,6,0,0,0,0,0,0,0,0,0,0,0,0,2,10,4,0
33001,248,5130,1943,715,1694,26,18,214,1969,12,185,120,237,197,357,1436,2721,7,20915,1161,0,2,1,0,0
33002,248,5130,1168,838,957,57,25,144,1225,19,348,224,416,367,640,3018,5452,11,61921,3440,1,2,1,0,0
33003,103,5260,1457,730,1242,11,6,188,1468,10,292,166,329,302,495,2424,4078,5,22973,1276,1,2,10,16,0
33004,29,1903,384,251,317,7,8,52,391,11,70,44,84,81,128,467,811,6,5355,297,0,2,4,0,0
33005,162,3389,1513,682,1277,25,13,200,1538,11,199,116,219,210,335,1557,2584,6,15641,868,0,2,0,7,0
33006,162,3389,819,519,539,24,98,155,843,15,96,57,106,111,163,690,1107,8,9171,509,0,2,0,7,0
33007,159,3782,77,34,69,0,0,8,77,3,24,16,29,27,45,114,213,1,387,21,0,2,5,2,1
33008,159,3782,712,438,573,51,9,84,763,14,102,71,128,116,199,733,1364,8,11988,666,0,2,5,2,1
33009,72,3698,1293,570,1093,25,15,163,1318,10,195,123,241,205,364,1516,2795,6,17273,959,0,2,2,1,1
33010,83,3389,1043,504,840,53,9,147,1096,9,180,112,198,189,310,1377,2344,4,11604,644,0,2,16,0,1
33011,248,5737,4293,999,3693,19,54,507,4312,9,155,88,170,164,258,1156,1898,4,9368,520,0,2,1,0,0
33012,248,5737,1482,859,1002,125,135,219,1607,16,219,134,251,235,385,1766,3032,9,27804,1544,1,2,1,0,0
33013,18,312,424,94,331,4,0,89,428,1,5,5,5,6,10,11,25,0,12,0,0,2,2,1,0
33014,18,312,38,23,23,6,0,8,44,3,11,7,11,14,18,42,68,1,102,5,0,2,2,1,0
33015,89,1894,1043,504,840,53,9,147,1096,9,180,112,198,189,310,1377,2344,4,11604,644,0,2,1,2,0
33016,89,1894,383,288,292,26,6,62,409,11,65,38,67,76,105,429,656,5,3719,206,0,2,1,2,0
33017,248,5737,4293,999,3693,19,54,507,4312,9,155,88,170,164,258,1156,1898,4,9368,520,0,2,1,0,0
33018,248,5737,1482,859,1002,125,135,219,1607,16,219,134,251,235,385,1766,3032,9,27804,1544,1,2,1,0,0
33019,18,312,424,94,331,4,0,89,428,1,5,5,5,6,10,11,25,0,12,0,0,2,2,1,0
33020,18,312,38,23,23,6,0,8,44,3,11,7,11,14,18,42,68,1,102,5,0,2,2,1,0
33021,89,1894,1043,504,840,53,9,147,1096,9,180,112,198,189,310,1377,2344,4,11604,644,0,2,1,2,0
33022,89,1894,383,288,292,26,6,62,409,11,65,38,67,76,105,429,656,5,3719,206,0,2,1,2,0
33023,233,5831,722,423,573,19,0,135,741,12,172,101,199,184,300,1320,2257,6,15668,870,0,2,13,9,1
33024,233,5831,1508,847,911,44,250,301,1552,14,148,88,169,162,257,1120,1886,7,15077,837,0,2,13,9,1
33025,51,2434,722,423,573,19,0,135,741,12,172,101,199,184,300,1320,2257,6,15668,870,0,2,13,0,1
33026,233,5831,722,423,573,19,0,135,741,12,172,101,199,184,300,1320,2257,6,15668,870,0,2,13,9,0
33027,233,5831,1508,847,911,44,250,301,1552,14,148,88,169,162,257,1120,1886,7,15077,837,0,2,13,9,0
33028,51,2434,722,423,573,19,0,135,741,12,172,101,199,184,300,1320,2257,6,15668,870,0,2,13,0,0
33029,77,1854,996,429,845,24,10,117,1020,7,76,50,88,83,138,494,879,4,3565,198,0,2,30,21,0
33030,77,1854,456,277,329,12,42,72,468,13,85,50,97,98,147,592,972,7,7212,400,0,2,30,21,0
33031,47,3494,996,429,845,24,10,117,1020,7,76,50,88,83,138,494,879,4,3565,198,0,2,23,3,0
33032,233,5841,722,423,573,19,0,135,741,12,172,101,199,184,300,1320,2257,6,15668,870,0,2,13,9,0
33033,233,5841,1508,847,911,44,250,301,1552,14,148,88,169,162,257,1120,1886,7,15077,837,0,2,13,9,0
33034,51,2434,722,423,573,19,0,135,741,12,172,101,199,184,300,1320,2257,6,15668,870,0,2,13,0,0
33035,53,1447,339,213,244,17,9,65,356,10,42,26,48,52,74,259,421,5,2410,133,0,2,10,0,0
33036,73,3747,1293,570,1093,25,15,163,1318,10,195,123,241,205,364,1516,2795,6,17273,959,0,2,14,0,0
33037,52,1451,339,213,244,17,9,65,356,10,42,26,48,52,74,259,421,5,2410,133,0,2,23,17,1
33038,73,3779,1293,570,1093,25,15,163,1318,10,195,123,241,205,364,1516,2795,6,17273,959,0,2,37,7,1
33039,52,1451,339,213,244,17,9,65,356,10,42,26,48,52,74,259,421,5,2410,133,0,2,23,17,0
33040,73,3779,1293,570,1093,25,15,163,1318,10,195,123,241,205,364,1516,2795,6,17273,959,0,2,37,7,0
33041,159,3782,77,34,69,0,0,8,77,3,24,16,29,27,45,114,213,1,387,21,0,2,5,2,0
33042,159,3782,712,438,573,51,9,84,763,14,102,71,128,116,199,733,1364,8,11988,666,0,2,5,2,0
33043,73,3748,1293,570,1093,25,15,163,1318,10,195,123,241,205,364,1516,2795,6,17273,959,0,2,2,1,0
33044,83,3389,1043,504,840,53,9,147,1096,9,180,112,198,189,310,1377,2344,4,11604,644,0,2,16,0,0
33045,77,1854,996,429,845,24,10,117,1020,7,76,50,88,83,138,494,879,4,3565,198,0,2,30,21,0
33046,77,1854,456,277,329,12,42,72,468,13,85,50,97,98,147,592,972,7,7212,400,0,2,30,21,0
33047,47,3494,996,429,845,24,10,117,1020,7,76,50,88,83,138,494,879,4,3565,198,0,2,23,3,0
33048,176,5309,1660,832,1314,41,38,274,1701,20,312,209,395,332,604,2671,5058,12,64042,3557,1,2,3,0,0
33049,233,5841,722,423,573,19,0,135,741,12,172,101,199,184,300,1320,2257,6,15668,870,0,2,13,9,0
33050,233,5841,1508,847,911,44,250,301,1552,14,148,88,169,162,257,1120,1886,7,15077,837,0,2,13,9,0
33051,51,2434,722,423,573,19,0,135,741,12,172,101,199,184,300,1320,2257,6,15668,870,0,2,13,0,0
33052,113,2119,477,336,357,30,23,73,507,16,194,134,250,210,384,1538,2962,10,30538,1696,0,2,10,7,0
33053,113,2123,477,336,357,30,23,73,507,16,194,134,250,210,384,1538,2962,10,30538,1696,0,2,7,5,0
33054,117,2176,477,336,357,30,23,73,507,16,194,134,250,210,384,1538,2962,10,30538,1696,0,2,29,14,1
33055,128,5170,1450,624,1228,12,26,181,1462,14,306,186,354,320,540,2580,4493,8,36391,2021,1,2,44,0,1
33056,78,1883,996,429,845,24,10,117,1020,7,76,50,88,83,138,494,879,4,3565,198,0,2,15,6,0
33057,78,1883,456,277,329,12,42,72,468,13,85,50,97,98,147,592,972,7,7212,400,0,2,15,6,0
33058,47,3558,996,429,845,24,10,117,1020,7,76,50,88,83,138,494,879,4,3565,198,0,2,26,6,0
33059,75,1547,1178,367,1042,6,15,115,1184,9,94,51,95,103,146,644,976,4,4439,246,0,2,19,1,0
33060,75,1547,177,108,140,8,0,27,185,6,30,16,32,36,48,162,248,3,794,44,0,2,19,1,0
33061,112,4514,1289,550,1043,56,32,155,1345,10,167,93,185,177,278,1266,2075,5,11498,638,0,2,3,1,0
33062,81,3287,1178,367,1042,6,15,115,1184,9,94,51,95,103,146,644,976,4,4439,246,0,2,1,1,0
33063,103,5555,1943,715,1694,26,18,214,1969,12,185,120,237,197,357,1436,2721,7,20915,1161,0,2,9,3,0
33064,78,1611,1178,367,1042,6,15,115,1184,9,94,51,95,103,146,644,976,4,4439,246,0,2,38,20,0
33065,78,1611,177,108,140,8,0,27,185,6,30,16,32,36,48,162,248,3,794,44,0,2,38,20,0
33066,84,3507,1178,367,1042,6,15,115,1184,9,94,51,95,103,146,644,976,4,4439,246,0,2,44,0,0
33067,103,5555,1943,715,1694,26,18,214,1969,12,185,120,237,197,357,1436,2721,7,20915,1161,0,2,1,1,0
33068,110,2979,1523,757,1297,19,12,193,1542,12,193,117,230,205,347,1508,2664,7,19053,1058,0,2,12,0,0
33069,110,2979,701,378,504,33,58,109,734,13,110,68,126,123,194,794,1346,7,10027,557,0,2,12,0,0
33070,101,4811,1523,757,1297,19,12,193,1542,12,193,117,230,205,347,1508,2664,7,19053,1058,0,2,27,0,0
33071,78,1883,996,429,845,24,10,117,1020,7,76,50,88,83,138,494,879,4,3565,198,0,2,15,6,0
33072,78,1883,456,277,329,12,42,72,468,13,85,50,97,98,147,592,972,7,7212,400,0,2,15,6,0
33073,47,3558,996,429,845,24,10,117,1020,7,76,50,88,83,138,494,879,4,3565,198,0,2,26,6,0
33074,44,2727,652,304,544,16,6,88,668,6,89,51,101,95,152,591,998,3,3399,188,0,2,22,11,1
33075,44,2733,652,304,544,16,6,88,668,6,89,51,101,95,152,591,998,3,3399,188,0,2,2,2,0
33076,234,5861,722,423,573,19,0,135,741,12,172,101,199,184,300,1320,2257,6,15668,870,0,2,9,0,0
33077,234,5861,1508,847,911,44,250,301,1552,14,148,88,169,162,257,1120,1886,7,15077,837,0,2,9,0,0
33078,112,4516,1289,550,1043,56,32,155,1345,10,167,93,185,177,278,1266,2075,5,11498,638,0,2,1,1,0
33079,153,7223,1392,870,1177,35,17,170,1427,14,494,280,531,508,811,4473,7289,7,54850,3047,2,2,1,1,0
33080,95,2931,773,419,590,28,0,166,801,10,204,113,217,214,330,1598,2554,5,13587,754,0,2,1,1,0
33081,101,5269,1457,730,1242,11,6,188,1468,10,292,166,329,302,495,2424,4078,5,22973,1276,1,2,4,4,0
33082,43,2695,652,304,544,16,6,88,668,6,89,51,101,95,152,591,998,3,3399,188,0,2,2,12,0
33083,116,2173,477,336,357,30,23,73,507,16,194,134,250,210,384,1538,2962,10,30538,1696,0,2,1,1,0
33084,78,1607,1178,367,1042,6,15,115,1184,9,94,51,95,103,146,644,976,4,4439,246,0,2,6,10,0
33085,78,1607,177,108,140,8,0,27,185,6,30,16,32,36,48,162,248,3,794,44,0,2,6,10,0
33086,84,3507,1178,367,1042,6,15,115,1184,9,94,51,95,103,146,644,976,4,4439,246,0,2,10,10,0
33087,103,5555,1943,715,1694,26,18,214,1969,12,185,120,237,197,357,1436,2721,7,20915,1161,0,2,1,1,0
33088,116,2173,477,336,357,30,23,73,507,16,194,134,250,210,384,1538,2962,10,30538,1696,0,2,38,18,0
33089,128,5170,1450,624,1228,12,26,181,1462,14,306,186,354,320,540,2580,4493,8,36391,2021,1,2,44,0,0
33090,28,981,74,35,59,1,0,14,75,3,14,7,14,17,21,58,85,1,128,7,0,2,2,1,0
33091,28,981,245,125,200,5,7,34,250,7,30,17,34,37,51,166,265,3,1053,58,0,2,2,1,0
33092,84,3547,1178,367,1042,6,15,115,1184,9,94,51,95,103,146,644,976,4,4439,246,0,2,8,0,0
33093,28,981,74,35,59,1,0,14,75,3,14,7,14,17,21,58,85,1,128,7,0,2,2,1,0
33094,28,981,245,125,200,5,7,34,250,7,30,17,34,37,51,166,265,3,1053,58,0,2,2,1,0
33095,1,96,42,7,35,4,0,5,46,1,2,1,2,3,3,2,4,0,2,0,0,2,1,0,1
33096,1,96,11,6,10,0,0,1,11,2,4,2,4,6,6,10,15,1,15,0,0,2,1,0,1
33097,79,1627,1178,367,1042,6,15,115,1184,9,94,51,95,103,146,644,976,4,4439,246,0,2,9,3,1
33098,79,1627,177,108,140,8,0,27,185,6,30,16,32,36,48,162,248,3,794,44,0,2,9,3,1
33099,87,3601,1178,367,1042,6,15,115,1184,9,94,51,95,103,146,644,976,4,4439,246,0,2,45,28,1
33100,54,1488,339,213,244,17,9,65,356,10,42,26,48,52,74,259,421,5,2410,133,0,2,23,17,0
33101,74,3830,1293,570,1093,25,15,163,1318,10,195,123,241,205,364,1516,2795,6,17273,959,0,2,37,7,0
33102,54,1488,339,213,244,17,9,65,356,10,42,26,48,52,74,259,421,5,2410,133,0,2,23,17,0
33103,74,3830,1293,570,1093,25,15,163,1318,10,195,123,241,205,364,1516,2795,6,17273,959,0,2,37,7,0
33104,239,5959,722,423,573,19,0,135,741,12,172,101,199,184,300,1320,2257,6,15668,870,0,2,32,6,1
33105,239,5959,1508,847,911,44,250,301,1552,14,148,88,169,162,257,1120,1886,7,15077,837,0,2,32,6,1
33106,54,2723,722,423,573,19,0,135,741,12,172,101,199,184,300,1320,2257,6,15668,870,0,2,58,0,1
33107,235,5967,722,423,573,19,0,135,741,12,172,101,199,184,300,1320,2257,6,15668,870,0,2,8,1,1
33108,235,5967,1508,847,911,44,250,301,1552,14,148,88,169,162,257,1120,1886,7,15077,837,0,2,8,1,1
33109,55,2800,722,423,573,19,0,135,741,12,172,101,199,184,300,1320,2257,6,15668,870,0,2,19,0,1
33110,87,3622,1178,367,1042,6,15,115,1184,9,94,51,95,103,146,644,976,4,4439,246,0,2,15,12,0
33111,87,3625,1178,367,1042,6,15,115,1184,9,94,51,95,103,146,644,976,4,4439,246,0,2,1,0,0
33112,248,5130,1943,715,1694,26,18,214,1969,12,185,120,237,197,357,1436,2721,7,20915,1161,0,2,4,4,0
33113,248,5130,1168,838,957,57,25,144,1225,19,348,224,416,367,640,3018,5452,11,61921,3440,1,2,4,4,0
33114,248,5135,1943,715,1694,26,18,214,1969,12,185,120,237,197,357,1436,2721,7,20915,1161,0,2,7,4,0
33115,248,5135,1168,838,957,57,25,144,1225,19,348,224,416,367,640,3018,5452,11,61921,3440,1,2,7,4,0
33116,103,5558,1943,715,1694,26,18,214,1969,12,185,120,237,197,357,1436,2721,7,20915,1161,0,2,3,0,0
33117,103,5579,1943,715,1694,26,18,214,1969,12,185,120,237,197,357,1436,2721,7,20915,1161,0,2,8,2,0
33118,41,821,1178,367,1042,6,15,115,1184,9,94,51,95,103,146,644,976,4,4439,246,0,2,0,125,0
33119,41,821,177,108,140,8,0,27,185,6,30,16,32,36,48,162,248,3,794,44,0,2,0,125,0
33120,279,5775,1943,715,1694,26,18,214,1969,12,185,120,237,197,357,1436,2721,7,20915,1161,0,2,122,0,0
33121,279,5775,1168,838,957,57,25,144,1225,19,348,224,416,367,640,3018,5452,11,61921,3440,1,2,122,0,0
33122,80,3144,1178,367,1042,6,15,115,1184,9,94,51,95,103,146,644,976,4,4439,246,0,2,0,35,0
33123,104,5687,1943,715,1694,26,18,214,1969,12,185,120,237,197,357,1436,2721,7,20915,1161,0,2,35,0,0
33124,7,107,127,75,83,2,11,30,129,4,14,7,14,18,21,61,87,2,175,9,0,0,26,0,1
33125,7,107,652,304,544,16,6,88,668,6,89,51,101,95,152,591,998,3,3399,188,0,0,26,0,1
33126,7,107,2,2,2,0,0,0,2,0,0,0,0,0,0,0,0,0,0,0,0,0,26,0,1
33127,7,107,8,5,5,0,0,3,8,0,0,0,0,0,0,0,0,0,0,0,0,0,26,0,1
33128,7,107,2,2,2,0,0,0,2,0,0,0,0,0,0,0,0,0,0,0,0,0,26,0,1
33129,7,107,14,8,8,0,0,6,14,0,0,0,0,0,0,0,0,0,0,0,0,0,26,0,1
33130,7,107,6,4,4,0,0,2,6,0,0,0,0,0,0,0,0,0,0,0,0,0,26,0,1
33131,7,107,6,4,4,0,0,2,6,1,2,1,2,3,3,2,4,0,2,0,0,0,26,0,1
33132,7,107,6,4,4,0,0,2,6,0,0,0,0,0,0,0,0,0,0,0,0,0,26,0,1
33133,7,107,7,5,5,0,0,2,7,0,0,0,0,0,0,0,0,0,0,0,0,0,26,0,1
33134,7,107,6,4,4,0,0,2,6,0,0,0,0,0,0,0,0,0,0,0,0,0,26,0,1
33135,7,107,10,6,6,0,0,4,10,0,0,0,0,0,0,0,0,0,0,0,0,0,26,0,1
33136,7,107,1,1,1,0,0,0,1,0,0,0,0,0,0,0,0,0,0,0,0,0,26,0,1
33137,7,107,1,1,1,0,0,0,1,0,0,0,0,0,0,0,0,0,0,0,0,0,26,0,1
33138,7,107,14,10,10,0,0,4,14,1,1,1,1,2,2,0,2,0,1,0,0,0,26,0,1
33139,7,107,46,26,30,3,0,12,49,3,6,3,6,9,9,20,28,1,42,2,0,0,26,0,1
33140,280,5752,1943,715,1694,26,18,214,1969,12,185,120,237,197,357,1436,2721,7,20915,1161,0,2,94,101,0
33141,280,5752,1168,838,957,57,25,144,1225,19,348,224,416,367,640,3018,5452,11,61921,3440,1,2,94,101,0
33142,104,5687,1943,715,1694,26,18,214,1969,12,185,120,237,197,357,1436,2721,7,20915,1161,0,2,2,2,0
33143,278,5743,1943,715,1694,26,18,214,1969,12,185,120,237,197,357,1436,2721,7,20915,1161,0,2,6,11,0
33144,278,5743,1168,838,957,57,25,144,1225,19,348,224,416,367,640,3018,5452,11,61921,3440,1,2,6,11,0
33145,275,5744,1943,715,1694,26,18,214,1969,12,185,120,237,197,357,1436,2721,7,20915,1161,0,2,33,41,1
33146,275,5744,1168,838,957,57,25,144,1225,19,348,224,416,367,640,3018,5452,11,61921,3440,1,2,33,41,1
33147,54,1488,339,213,244,17,9,65,356,10,42,26,48,52,74,259,421,5,2410,133,0,2,1,1,1
33148,74,3867,1293,570,1093,25,15,163,1318,10,195,123,241,205,364,1516,2795,6,17273,959,0,2,13,2,1
33149,248,5130,1943,715,1694,26,18,214,1969,12,185,120,237,197,357,1436,2721,7,20915,1161,0,2,1,1,0
33150,248,5130,1168,838,957,57,25,144,1225,19,348,224,416,367,640,3018,5452,11,61921,3440,1,2,1,1,0
33151,249,5128,1943,715,1694,26,18,214,1969,12,185,120,237,197,357,1436,2721,7,20915,1161,0,2,11,8,0
33152,249,5128,1168,838,957,57,25,144,1225,19,348,224,416,367,640,3018,5452,11,61921,3440,1,2,11,8,0
33153,54,1488,339,213,244,17,9,65,356,10,42,26,48,52,74,259,421,5,2410,133,0,2,1,1,0
33154,74,3867,1293,570,1093,25,15,163,1318,10,195,123,241,205,364,1516,2795,6,17273,959,0,2,13,2,0
33155,235,5973,722,423,573,19,0,135,741,12,172,101,199,184,300,1320,2257,6,15668,870,0,2,5,5,0
33156,235,5973,1508,847,911,44,250,301,1552,14,148,88,169,162,257,1120,1886,7,15077,837,0,2,5,5,0
33157,234,5944,722,423,573,19,0,135,741,12,172,101,199,184,300,1320,2257,6,15668,870,0,2,1,6,0
33158,234,5944,1508,847,911,44,250,301,1552,14,148,88,169,162,257,1120,1886,7,15077,837,0,2,1,6,0
33159,55,2800,722,423,573,19,0,135,741,12,172,101,199,184,300,1320,2257,6,15668,870,0,2,1,1,0
33160,7,107,127,75,83,2,11,30,129,4,14,7,14,18,21,61,87,2,175,9,0,0,26,0,0
33161,7,107,652,304,544,16,6,88,668,6,89,51,101,95,152,591,998,3,3399,188,0,0,26,0,0
33162,7,107,2,2,2,0,0,0,2,0,0,0,0,0,0,0,0,0,0,0,0,0,26,0,0
33163,7,107,8,5,5,0,0,3,8,0,0,0,0,0,0,0,0,0,0,0,0,0,26,0,0
33164,7,107,2,2,2,0,0,0,2,0,0,0,0,0,0,0,0,0,0,0,0,0,26,0,0
33165,7,107,14,8,8,0,0,6,14,0,0,0,0,0,0,0,0,0,0,0,0,0,26,0,0
33166,7,107,6,4,4,0,0,2,6,0,0,0,0,0,0,0,0,0,0,0,0,0,26,0,0
33167,7,107,6,4,4,0,0,2,6,1,2,1,2,3,3,2,4,0,2,0,0,0,26,0,0
33168,7,107,6,4,4,0,0,2,6,0,0,0,0,0,0,0,0,0,0,0,0,0,26,0,0
33169,7,107,7,5,5,0,0,2,7,0,0,0,0,0,0,0,0,0,0,0,0,0,26,0,0
33170,7,107,6,4,4,0,0,2,6,0,0,0,0,0,0,0,0,0,0,0,0,0,26,0,0
33171,7,107,10,6,6,0,0,4,10,0,0,0,0,0,0,0,0,0,0,0,0,0,26,0,0
33172,7,107,1,1,1,0,0,0,1,0,0,0,0,0,0,0,0,0,0,0,0,0,26,0,0
33173,7,107,1,1,1,0,0,0,1,0,0,0,0,0,0,0,0,0,0,0,0,0,26,0,0
33174,7,107,14,10,10,0,0,4,14,1,1,1,1,2,2,0,2,0,1,0,0,0,26,0,0
33175,7,107,46,26,30,3,0,12,49,3,6,3,6,9,9,20,28,1,42,2,0,0,26,0,0
33176,249,5128,1943,715,1694,26,18,214,1969,12,185,120,237,197,357,1436,2721,7,20915,1161,0,2,11,8,0
33177,249,5128,1168,838,957,57,25,144,1225,19,348,224,416,367,640,3018,5452,11,61921,3440,1,2,11,8,0
33178,249,5128,1943,715,1694,26,18,214,1969,12,185,120,237,197,357,1436,2721,7,20915,1161,0,2,1,1,0
33179,249,5128,1168,838,957,57,25,144,1225,19,348,224,416,367,640,3018,5452,11,61921,3440,1,2,1,1,0
33180,234,5944,722,423,573,19,0,135,741,12,172,101,199,184,300,1320,2257,6,15668,870,0,2,34,6,0
33181,234,5944,1508,847,911,44,250,301,1552,14,148,88,169,162,257,1120,1886,7,15077,837,0,2,34,6,0
33182,55,2800,722,423,573,19,0,135,741,12,172,101,199,184,300,1320,2257,6,15668,870,0,2,77,0,0
33183,233,5970,722,423,573,19,0,135,741,12,172,101,199,184,300,1320,2257,6,15668,870,0,2,16,9,0
33184,233,5970,1508,847,911,44,250,301,1552,14,148,88,169,162,257,1120,1886,7,15077,837,0,2,16,9,0
33185,125,5397,1513,682,1277,25,13,200,1538,11,199,116,219,210,335,1557,2584,6,15641,868,0,2,3,3,0
33186,234,5861,722,423,573,19,0,135,741,12,172,101,199,184,300,1320,2257,6,15668,870,0,2,9,0,0
33187,234,5861,1508,847,911,44,250,301,1552,14,148,88,169,162,257,1120,1886,7,15077,837,0,2,9,0,0
33188,112,4516,1289,550,1043,56,32,155,1345,10,167,93,185,177,278,1266,2075,5,11498,638,0,2,1,1,0
33189,153,7223,1392,870,1177,35,17,170,1427,14,494,280,531,508,811,4473,7289,7,54850,3047,2,2,1,1,0
33190,95,2931,773,419,590,28,0,166,801,10,204,113,217,214,330,1598,2554,5,13587,754,0,2,1,1,0
33191,101,5269,1457,730,1242,11,6,188,1468,10,292,166,329,302,495,2424,4078,5,22973,1276,1,2,4,4,0
33192,43,2695,652,304,544,16,6,88,668,6,89,51,101,95,152,591,998,3,3399,188,0,2,15,14,0
33193,41,821,1178,367,1042,6,15,115,1184,9,94,51,95,103,146,644,976,4,4439,246,0,2,0,125,0
33194,41,821,177,108,140,8,0,27,185,6,30,16,32,36,48,162,248,3,794,44,0,2,0,125,0
33195,276,5742,1943,715,1694,26,18,214,1969,12,185,120,237,197,357,1436,2721,7,20915,1161,0,2,102,0,0
33196,276,5742,1168,838,957,57,25,144,1225,19,348,224,416,367,640,3018,5452,11,61921,3440,1,2,102,0,0
33197,80,3144,1178,367,1042,6,15,115,1184,9,94,51,95,103,146,644,976,4,4439,246,0,2,0,35,0
33198,104,5687,1943,715,1694,26,18,214,1969,12,185,120,237,197,357,1436,2721,7,20915,1161,0,2,35,0,0
33199,233,5970,722,423,573,19,0,135,741,12,172,101,199,184,300,1320,2257,6,15668,870,0,2,16,9,0
33200,233,5970,1508,847,911,44,250,301,1552,14,148,88,169,162,257,1120,1886,7,15077,837,0,2,16,9,0
33201,125,5397,1513,682,1277,25,13,200,1538,11,199,116,219,210,335,1557,2584,6,15641,868,0,2,3,3,0
33202,234,6000,722,423,573,19,0,135,741,12,172,101,199,184,300,1320,2257,6,15668,870,0,2,9,0,0
33203,234,6000,1508,847,911,44,250,301,1552,14,148,88,169,162,257,1120,1886,7,15077,837,0,2,9,0,0
33204,112,4516,1289,550,1043,56,32,155,1345,10,167,93,185,177,278,1266,2075,5,11498,638,0,2,1,1,0
33205,153,7223,1392,870,1177,35,17,170,1427,14,494,280,531,508,811,4473,7289,7,54850,3047,2,2,1,1,0
33206,95,2931,773,419,590,28,0,166,801,10,204,113,217,214,330,1598,2554,5,13587,754,0,2,1,1,0
33207,103,5268,1457,730,1242,11,6,188,1468,10,292,166,329,302,495,2424,4078,5,22973,1276,1,2,4,4,0
33208,43,2698,652,304,544,16,6,88,668,6,89,51,101,95,152,591,998,3,3399,188,0,2,15,14,0
33209,234,6000,722,423,573,19,0,135,741,12,172,101,199,184,300,1320,2257,6,15668,870,0,2,9,0,0
33210,234,6000,1508,847,911,44,250,301,1552,14,148,88,169,162,257,1120,1886,7,15077,837,0,2,9,0,0
33211,112,4516,1289,550,1043,56,32,155,1345,10,167,93,185,177,278,1266,2075,5,11498,638,0,2,1,1,0
33212,153,7223,1392,870,1177,35,17,170,1427,14,494,280,531,508,811,4473,7289,7,54850,3047,2,2,1,1,0
33213,95,2931,773,419,590,28,0,166,801,10,204,113,217,214,330,1598,2554,5,13587,754,0,2,1,1,0
33214,103,5268,1457,730,1242,11,6,188,1468,10,292,166,329,302,495,2424,4078,5,22973,1276,1,2,4,4,0
33215,43,2698,652,304,544,16,6,88,668,6,89,51,101,95,152,591,998,3,3399,188,0,2,15,14,0
33216,109,2961,1523,757,1297,19,12,193,1542,12,193,117,230,205,347,1508,2664,7,19053,1058,0,2,8,1,0
33217,109,2961,701,378,504,33,58,109,734,13,110,68,126,123,194,794,1346,7,10027,557,0,2,8,1,0
33218,101,4838,1523,757,1297,19,12,193,1542,12,193,117,230,205,347,1508,2664,7,19053,1058,0,2,19,1,0
33219,81,1651,1178,367,1042,6,15,115,1184,9,94,51,95,103,146,644,976,4,4439,246,0,2,11,0,0
33220,81,1651,177,108,140,8,0,27,185,6,30,16,32,36,48,162,248,3,794,44,0,2,11,0,0
33221,109,2961,1523,757,1297,19,12,193,1542,12,193,117,230,205,347,1508,2664,7,19053,1058,0,2,8,1,0
33222,109,2961,701,378,504,33,58,109,734,13,110,68,126,123,194,794,1346,7,10027,557,0,2,8,1,0
33223,101,4838,1523,757,1297,19,12,193,1542,12,193,117,230,205,347,1508,2664,7,19053,1058,0,2,19,1,0
33224,276,5747,1943,715,1694,26,18,214,1969,12,185,120,237,197,357,1436,2721,7,20915,1161,0,2,10,7,0
33225,276,5747,1168,838,957,57,25,144,1225,19,348,224,416,367,640,3018,5452,11,61921,3440,1,2,10,7,0
33226,104,5722,1943,715,1694,26,18,214,1969,12,185,120,237,197,357,1436,2721,7,20915,1161,0,2,11,2,0
33227,248,5739,4293,999,3693,19,54,507,4312,9,155,88,170,164,258,1156,1898,4,9368,520,0,2,3,1,1
33228,248,5739,1482,859,1002,125,135,219,1607,16,219,134,251,235,385,1766,3032,9,27804,1544,1,2,3,1,1
33229,234,5859,722,423,573,19,0,135,741,12,172,101,199,184,300,1320,2257,6,15668,870,0,2,1,1,1
33230,234,5859,1508,847,911,44,250,301,1552,14,148,88,169,162,257,1120,1886,7,15077,837,0,2,1,1,1
33231,171,7587,4293,999,3693,19,54,507,4312,9,155,88,170,164,258,1156,1898,4,9368,520,0,2,1,3,1
33232,171,7587,1482,859,1002,125,135,219,1607,16,219,134,251,235,385,1766,3032,9,27804,1544,1,2,1,3,1
33233,248,5739,4293,999,3693,19,54,507,4312,9,155,88,170,164,258,1156,1898,4,9368,520,0,2,3,1,0
33234,248,5739,1482,859,1002,125,135,219,1607,16,219,134,251,235,385,1766,3032,9,27804,1544,1,2,3,1,0
33235,234,5859,722,423,573,19,0,135,741,12,172,101,199,184,300,1320,2257,6,15668,870,0,2,1,1,0
33236,234,5859,1508,847,911,44,250,301,1552,14,148,88,169,162,257,1120,1886,7,15077,837,0,2,1,1,0
33237,171,7587,4293,999,3693,19,54,507,4312,9,155,88,170,164,258,1156,1898,4,9368,520,0,2,1,3,0
33238,171,7587,1482,859,1002,125,135,219,1607,16,219,134,251,235,385,1766,3032,9,27804,1544,1,2,1,3,0
33239,70,1528,402,202,227,24,74,80,426,12,52,33,61,64,94,339,564,7,3969,220,0,2,9,3,0
33240,20,531,205,80,86,16,53,53,221,7,18,10,19,25,29,94,134,3,497,27,0,2,1,2,0
33241,92,1890,757,253,292,73,244,162,830,13,61,38,67,74,105,409,651,7,4654,258,0,2,1,1,0
33242,70,3188,1020,354,843,12,15,144,1032,8,134,77,144,142,221,970,1580,4,6792,377,0,2,13,0,0
33243,70,1528,402,202,227,24,74,80,426,12,52,33,61,64,94,339,564,7,3969,220,0,2,9,3,0
33244,20,531,205,80,86,16,53,53,221,7,18,10,19,25,29,94,134,3,497,27,0,2,1,2,0
33245,92,1890,757,253,292,73,244,162,830,13,61,38,67,74,105,409,651,7,4654,258,0,2,1,1,0
33246,70,3188,1020,354,843,12,15,144,1032,8,134,77,144,142,221,970,1580,4,6792,377,0,2,13,0,0
33247,55,1174,447,308,343,6,5,95,453,7,96,59,111,103,170,651,1136,4,4600,255,0,2,12,0,0
33248,55,1174,322,174,179,16,74,51,338,10,41,26,46,51,72,252,408,5,2291,127,0,2,12,0,0
33249,232,5822,722,423,573,19,0,135,741,12,172,101,199,184,300,1320,2257,6,15668,870,0,2,1,18,0
33250,232,5822,1508,847,911,44,250,301,1552,14,148,88,169,162,257,1120,1886,7,15077,837,0,2,1,18,0
33251,47,2189,447,308,343,6,5,95,453,7,96,59,111,103,170,651,1136,4,4600,255,0,2,7,0,0
33252,55,1174,447,308,343,6,5,95,453,7,96,59,111,103,170,651,1136,4,4600,255,0,2,12,0,0
33253,55,1174,322,174,179,16,74,51,338,10,41,26,46,51,72,252,408,5,2291,127,0,2,12,0,0
33254,232,5822,722,423,573,19,0,135,741,12,172,101,199,184,300,1320,2257,6,15668,870,0,2,1,18,0
33255,232,5822,1508,847,911,44,250,301,1552,14,148,88,169,162,257,1120,1886,7,15077,837,0,2,1,18,0
33256,47,2189,447,308,343,6,5,95,453,7,96,59,111,103,170,651,1136,4,4600,255,0,2,7,0,0
33257,276,5755,1943,715,1694,26,18,214,1969,12,185,120,237,197,357,1436,2721,7,20915,1161,0,2,1,1,0
33258,276,5755,1168,838,957,57,25,144,1225,19,348,224,416,367,640,3018,5452,11,61921,3440,1,2,1,1,0
33259,24,612,2,2,2,0,0,0,2,0,0,0,0,0,0,0,0,0,0,0,0,2,3,0,0
33260,24,612,99,48,90,1,3,5,100,0,0,0,0,0,0,0,0,0,0,0,0,2,3,0,0
33261,24,612,8,5,5,2,0,1,10,0,0,0,0,0,0,0,0,0,0,0,0,2,3,0,0
33262,24,612,1217,716,841,84,126,174,1301,14,185,118,215,199,333,1446,2542,8,20687,1149,0,2,3,0,0
33263,24,612,160,89,115,0,13,31,160,7,15,11,17,22,28,78,124,3,495,27,0,2,3,0,0
33264,24,612,10,10,9,9,0,0,19,0,0,0,0,0,0,0,0,0,0,0,0,2,3,0,0
33265,24,612,173,84,99,8,29,36,181,5,12,7,13,17,20,54,81,2,221,12,0,2,3,0,0
33266,24,612,3,1,1,3,0,0,6,0,0,0,0,0,0,0,0,0,0,0,0,2,3,0,0
33267,86,3411,1043,504,840,53,9,147,1096,9,180,112,198,189,310,1377,2344,4,11604,644,0,2,8,1,1
33268,234,6000,722,423,573,19,0,135,741,12,172,101,199,184,300,1320,2257,6,15668,870,0,2,1,1,0
33269,234,6000,1508,847,911,44,250,301,1552,14,148,88,169,162,257,1120,1886,7,15077,837,0,2,1,1,0
33270,233,6008,722,423,573,19,0,135,741,12,172,101,199,184,300,1320,2257,6,15668,870,0,2,2,1,0
33271,233,6008,1508,847,911,44,250,301,1552,14,148,88,169,162,257,1120,1886,7,15077,837,0,2,2,1,0
33272,275,5744,1943,715,1694,26,18,214,1969,12,185,120,237,197,357,1436,2721,7,20915,1161,0,2,8,9,0
33273,275,5744,1168,838,957,57,25,144,1225,19,348,224,416,367,640,3018,5452,11,61921,3440,1,2,8,9,0
33274,274,5752,1943,715,1694,26,18,214,1969,12,185,120,237,197,357,1436,2721,7,20915,1161,0,2,2,1,1
33275,274,5752,1168,838,957,57,25,144,1225,19,348,224,416,367,640,3018,5452,11,61921,3440,1,2,2,1,1
33276,248,5739,4293,999,3693,19,54,507,4312,9,155,88,170,164,258,1156,1898,4,9368,520,0,2,3,1,0
33277,248,5739,1482,859,1002,125,135,219,1607,16,219,134,251,235,385,1766,3032,9,27804,1544,1,2,3,1,0
33278,69,1526,402,202,227,24,74,80,426,12,52,33,61,64,94,339,564,7,3969,220,0,2,9,3,0
33279,55,1174,447,308,343,6,5,95,453,7,96,59,111,103,170,651,1136,4,4600,255,0,2,12,0,0
33280,55,1174,322,174,179,16,74,51,338,10,41,26,46,51,72,252,408,5,2291,127,0,2,12,0,0
33281,20,531,205,80,86,16,53,53,221,7,18,10,19,25,29,94,134,3,497,27,0,2,1,2,0
33282,232,5961,722,423,573,19,0,135,741,12,172,101,199,184,300,1320,2257,6,15668,870,0,2,2,19,0
33283,232,5961,1508,847,911,44,250,301,1552,14,148,88,169,162,257,1120,1886,7,15077,837,0,2,2,19,0
33284,92,1890,757,253,292,73,244,162,830,13,61,38,67,74,105,409,651,7,4654,258,0,2,1,1,0
33285,171,7599,4293,999,3693,19,54,507,4312,9,155,88,170,164,258,1156,1898,4,9368,520,0,2,1,3,0
33286,171,7599,1482,859,1002,125,135,219,1607,16,219,134,251,235,385,1766,3032,9,27804,1544,1,2,1,3,0
33287,70,3194,1020,354,843,12,15,144,1032,8,134,77,144,142,221,970,1580,4,6792,377,0,2,13,0,0
33288,47,2189,447,308,343,6,5,95,453,7,96,59,111,103,170,651,1136,4,4600,255,0,2,7,0,0
33289,86,3411,1043,504,840,53,9,147,1096,9,180,112,198,189,310,1377,2344,4,11604,644,0,2,1,1,0
33290,78,1883,996,429,845,24,10,117,1020,7,76,50,88,83,138,494,879,4,3565,198,0,2,37,37,0
33291,78,1883,456,277,329,12,42,72,468,13,85,50,97,98,147,592,972,7,7212,400,0,2,37,37,0
33292,68,1497,402,202,227,24,74,80,426,12,52,33,61,64,94,339,564,7,3969,220,0,2,1,1,0
33293,276,5747,1943,715,1694,26,18,214,1969,12,185,120,237,197,357,1436,2721,7,20915,1161,0,2,2,2,0
33294,276,5747,1168,838,957,57,25,144,1225,19,348,224,416,367,640,3018,5452,11,61921,3440,1,2,2,2,0
33295,236,4937,2,2,2,0,0,0,2,0,0,0,0,0,0,0,0,0,0,0,0,2,0,1,0
33296,236,4937,99,48,90,1,3,5,100,0,0,0,0,0,0,0,0,0,0,0,0,2,0,1,0
33297,236,4937,8,5,5,2,0,1,10,0,0,0,0,0,0,0,0,0,0,0,0,2,0,1,0
33298,236,4937,1217,716,841,84,126,174,1301,14,185,118,215,199,333,1446,2542,8,20687,1149,0,2,0,1,0
33299,236,4937,160,89,115,0,13,31,160,7,15,11,17,22,28,78,124,3,495,27,0,2,0,1,0
33300,236,4937,10,10,9,9,0,0,19,0,0,0,0,0,0,0,0,0,0,0,0,2,0,1,0
33301,236,4937,173,84,99,8,29,36,181,5,12,7,13,17,20,54,81,2,221,12,0,2,0,1,0
33302,236,4937,3,1,1,3,0,0,6,0,0,0,0,0,0,0,0,0,0,0,0,2,0,1,0
33303,54,657,647,139,84,35,284,233,682,0,0,0,0,0,0,0,0,0,0,0,0,2,1,1,0
33304,66,1720,466,257,367,18,25,50,484,7,126,86,171,133,257,898,1813,4,8612,478,0,2,2,1,0
33305,66,1720,507,281,342,29,59,88,536,10,53,29,57,63,86,336,514,5,2764,153,0,2,2,1,0
33306,277,5779,1943,715,1694,26,18,214,1969,12,185,120,237,197,357,1436,2721,7,20915,1161,0,2,11,6,0
33307,277,5779,1168,838,957,57,25,144,1225,19,348,224,416,367,640,3018,5452,11,61921,3440,1,2,11,6,0
33308,68,1497,402,202,227,24,74,80,426,12,52,33,61,64,94,339,564,7,3969,220,0,2,1,1,0
33309,69,3128,1020,354,843,12,15,144,1032,8,134,77,144,142,221,970,1580,4,6792,377,0,2,1,1,0
33310,248,5739,4293,999,3693,19,54,507,4312,9,155,88,170,164,258,1156,1898,4,9368,520,0,2,3,1,0
33311,248,5739,1482,859,1002,125,135,219,1607,16,219,134,251,235,385,1766,3032,9,27804,1544,1,2,3,1,0
33312,69,1526,402,202,227,24,74,80,426,12,52,33,61,64,94,339,564,7,3969,220,0,2,9,3,0
33313,55,1174,447,308,343,6,5,95,453,7,96,59,111,103,170,651,1136,4,4600,255,0,2,12,0,0
33314,55,1174,322,174,179,16,74,51,338,10,41,26,46,51,72,252,408,5,2291,127,0,2,12,0,0
33315,20,531,205,80,86,16,53,53,221,7,18,10,19,25,29,94,134,3,497,27,0,2,1,2,0
33316,232,5961,722,423,573,19,0,135,741,12,172,101,199,184,300,1320,2257,6,15668,870,0,2,2,19,0
33317,232,5961,1508,847,911,44,250,301,1552,14,148,88,169,162,257,1120,1886,7,15077,837,0,2,2,19,0
33318,92,1890,757,253,292,73,244,162,830,13,61,38,67,74,105,409,651,7,4654,258,0,2,1,1,0
33319,171,7599,4293,999,3693,19,54,507,4312,9,155,88,170,164,258,1156,1898,4,9368,520,0,2,1,3,0
33320,171,7599,1482,859,1002,125,135,219,1607,16,219,134,251,235,385,1766,3032,9,27804,1544,1,2,1,3,0
33321,70,3194,1020,354,843,12,15,144,1032,8,134,77,144,142,221,970,1580,4,6792,377,0,2,13,0,0
33322,47,2189,447,308,343,6,5,95,453,7,96,59,111,103,170,651,1136,4,4600,255,0,2,7,0,0
33323,69,1526,402,202,227,24,74,80,426,12,52,33,61,64,94,339,564,7,3969,220,0,2,1,1,0
33324,70,3194,1020,354,843,12,15,144,1032,8,134,77,144,142,221,970,1580,4,6792,377,0,2,1,1,0
33325,86,3411,1043,504,840,53,9,147,1096,9,180,112,198,189,310,1377,2344,4,11604,644,0,2,8,1,0
33326,66,1720,466,257,367,18,25,50,484,7,126,86,171,133,257,898,1813,4,8612,478,0,2,2,1,0
33327,66,1720,507,281,342,29,59,88,536,10,53,29,57,63,86,336,514,5,2764,153,0,2,2,1,0
33328,277,5779,1943,715,1694,26,18,214,1969,12,185,120,237,197,357,1436,2721,7,20915,1161,0,2,11,6,0
33329,277,5779,1168,838,957,57,25,144,1225,19,348,224,416,367,640,3018,5452,11,61921,3440,1,2,11,6,0
33330,276,5747,1943,715,1694,26,18,214,1969,12,185,120,237,197,357,1436,2721,7,20915,1161,0,2,1,1,0
33331,276,5747,1168,838,957,57,25,144,1225,19,348,224,416,367,640,3018,5452,11,61921,3440,1,2,1,1,0
33332,104,5724,1943,715,1694,26,18,214,1969,12,185,120,237,197,357,1436,2721,7,20915,1161,0,2,11,3,0
33333,78,1883,996,429,845,24,10,117,1020,7,76,50,88,83,138,494,879,4,3565,198,0,2,37,37,0
33334,78,1883,456,277,329,12,42,72,468,13,85,50,97,98,147,592,972,7,7212,400,0,2,37,37,0
33335,236,4937,2,2,2,0,0,0,2,0,0,0,0,0,0,0,0,0,0,0,0,2,0,1,0
33336,236,4937,99,48,90,1,3,5,100,0,0,0,0,0,0,0,0,0,0,0,0,2,0,1,0
33337,236,4937,8,5,5,2,0,1,10,0,0,0,0,0,0,0,0,0,0,0,0,2,0,1,0
33338,236,4937,1217,716,841,84,126,174,1301,14,185,118,215,199,333,1446,2542,8,20687,1149,0,2,0,1,0
33339,236,4937,160,89,115,0,13,31,160,7,15,11,17,22,28,78,124,3,495,27,0,2,0,1,0
33340,236,4937,10,10,9,9,0,0,19,0,0,0,0,0,0,0,0,0,0,0,0,2,0,1,0
33341,236,4937,173,84,99,8,29,36,181,5,12,7,13,17,20,54,81,2,221,12,0,2,0,1,0
33342,236,4937,3,1,1,3,0,0,6,0,0,0,0,0,0,0,0,0,0,0,0,2,0,1,0
33343,54,657,647,139,84,35,284,233,682,0,0,0,0,0,0,0,0,0,0,0,0,2,1,1,0
33344,69,1526,402,202,227,24,74,80,426,12,52,33,61,64,94,339,564,7,3969,220,0,2,1,1,0
33345,277,5779,1943,715,1694,26,18,214,1969,12,185,120,237,197,357,1436,2721,7,20915,1161,0,2,2,2,0
33346,277,5779,1168,838,957,57,25,144,1225,19,348,224,416,367,640,3018,5452,11,61921,3440,1,2,2,2,0
33347,276,5746,1943,715,1694,26,18,214,1969,12,185,120,237,197,357,1436,2721,7,20915,1161,0,2,4,4,0
33348,276,5746,1168,838,957,57,25,144,1225,19,348,224,416,367,640,3018,5452,11,61921,3440,1,2,4,4,0
33349,67,1744,466,257,367,18,25,50,484,7,126,86,171,133,257,898,1813,4,8612,478,0,2,6,0,0
33350,67,1744,507,281,342,29,59,88,536,10,53,29,57,63,86,336,514,5,2764,153,0,2,6,0,0
33351,275,5715,1943,715,1694,26,18,214,1969,12,185,120,237,197,357,1436,2721,7,20915,1161,0,2,4,10,0
33352,275,5715,1168,838,957,57,25,144,1225,19,348,224,416,367,640,3018,5452,11,61921,3440,1,2,4,10,0
33353,277,5778,1943,715,1694,26,18,214,1969,12,185,120,237,197,357,1436,2721,7,20915,1161,0,2,4,4,0
33354,277,5778,1168,838,957,57,25,144,1225,19,348,224,416,367,640,3018,5452,11,61921,3440,1,2,4,4,0
33355,277,5778,1943,715,1694,26,18,214,1969,12,185,120,237,197,357,1436,2721,7,20915,1161,0,2,1,1,0
33356,277,5778,1168,838,957,57,25,144,1225,19,348,224,416,367,640,3018,5452,11,61921,3440,1,2,1,1,0
33357,104,5724,1943,715,1694,26,18,214,1969,12,185,120,237,197,357,1436,2721,7,20915,1161,0,2,11,3,0
33358,231,5969,722,423,573,19,0,135,741,12,172,101,199,184,300,1320,2257,6,15668,870,0,2,3,2,0
33359,231,5969,1508,847,911,44,250,301,1552,14,148,88,169,162,257,1120,1886,7,15077,837,0,2,3,2,0
33360,273,5733,1943,715,1694,26,18,214,1969,12,185,120,237,197,357,1436,2721,7,20915,1161,0,2,1,4,0
33361,273,5733,1168,838,957,57,25,144,1225,19,348,224,416,367,640,3018,5452,11,61921,3440,1,2,1,4,0
33362,274,5764,1943,715,1694,26,18,214,1969,12,185,120,237,197,357,1436,2721,7,20915,1161,0,2,10,13,0
33363,274,5764,1168,838,957,57,25,144,1225,19,348,224,416,367,640,3018,5452,11,61921,3440,1,2,10,13,0
33364,183,5551,1660,832,1314,41,38,274,1701,20,312,209,395,332,604,2671,5058,12,64042,3557,1,2,7,7,0
33365,183,5551,1057,646,719,113,100,145,1170,18,215,134,248,233,382,1740,3004,10,31186,1732,1,2,7,7,0
33366,67,1750,466,257,367,18,25,50,484,7,126,86,171,133,257,898,1813,4,8612,478,0,2,6,0,0
33367,67,1750,507,281,342,29,59,88,536,10,53,29,57,63,86,336,514,5,2764,153,0,2,6,0,0
33368,273,5732,1943,715,1694,26,18,214,1969,12,185,120,237,197,357,1436,2721,7,20915,1161,0,2,4,10,0
33369,273,5732,1168,838,957,57,25,144,1225,19,348,224,416,367,640,3018,5452,11,61921,3440,1,2,4,10,0
33370,116,2173,477,336,357,30,23,73,507,16,194,134,250,210,384,1538,2962,10,30538,1696,0,2,38,18,0
33371,78,1883,996,429,845,24,10,117,1020,7,76,50,88,83,138,494,879,4,3565,198,0,2,52,43,0
33372,78,1883,456,277,329,12,42,72,468,13,85,50,97,98,147,592,972,7,7212,400,0,2,52,43,0
33373,236,4937,2,2,2,0,0,0,2,0,0,0,0,0,0,0,0,0,0,0,0,2,0,1,0
33374,236,4937,99,48,90,1,3,5,100,0,0,0,0,0,0,0,0,0,0,0,0,2,0,1,0
33375,236,4937,8,5,5,2,0,1,10,0,0,0,0,0,0,0,0,0,0,0,0,2,0,1,0
33376,236,4937,1217,716,841,84,126,174,1301,14,185,118,215,199,333,1446,2542,8,20687,1149,0,2,0,1,0
33377,236,4937,160,89,115,0,13,31,160,7,15,11,17,22,28,78,124,3,495,27,0,2,0,1,0
33378,236,4937,10,10,9,9,0,0,19,0,0,0,0,0,0,0,0,0,0,0,0,2,0,1,0
33379,236,4937,173,84,99,8,29,36,181,5,12,7,13,17,20,54,81,2,221,12,0,2,0,1,0
33380,236,4937,3,1,1,3,0,0,6,0,0,0,0,0,0,0,0,0,0,0,0,2,0,1,0
33381,54,1488,339,213,244,17,9,65,356,10,42,26,48,52,74,259,421,5,2410,133,0,2,24,18,0
33382,248,5739,4293,999,3693,19,54,507,4312,9,155,88,170,164,258,1156,1898,4,9368,520,0,2,3,1,0
33383,248,5739,1482,859,1002,125,135,219,1607,16,219,134,251,235,385,1766,3032,9,27804,1544,1,2,3,1,0
33384,28,981,74,35,59,1,0,14,75,3,14,7,14,17,21,58,85,1,128,7,0,2,2,1,0
33385,28,981,245,125,200,5,7,34,250,7,30,17,34,37,51,166,265,3,1053,58,0,2,2,1,0
33386,54,657,647,139,84,35,284,233,682,0,0,0,0,0,0,0,0,0,0,0,0,2,1,1,0
33387,109,2961,1523,757,1297,19,12,193,1542,12,193,117,230,205,347,1508,2664,7,19053,1058,0,2,8,1,0
33388,109,2961,701,378,504,33,58,109,734,13,110,68,126,123,194,794,1346,7,10027,557,0,2,8,1,0
33389,69,1526,402,202,227,24,74,80,426,12,52,33,61,64,94,339,564,7,3969,220,0,2,11,5,0
33390,55,1174,447,308,343,6,5,95,453,7,96,59,111,103,170,651,1136,4,4600,255,0,2,12,0,0
33391,55,1174,322,174,179,16,74,51,338,10,41,26,46,51,72,252,408,5,2291,127,0,2,12,0,0
33392,20,531,205,80,86,16,53,53,221,7,18,10,19,25,29,94,134,3,497,27,0,2,1,2,0
33393,231,5969,722,423,573,19,0,135,741,12,172,101,199,184,300,1320,2257,6,15668,870,0,2,64,36,0
33394,231,5969,1508,847,911,44,250,301,1552,14,148,88,169,162,257,1120,1886,7,15077,837,0,2,64,36,0
33395,92,1890,757,253,292,73,244,162,830,13,61,38,67,74,105,409,651,7,4654,258,0,2,1,1,0
33396,67,1750,466,257,367,18,25,50,484,7,126,86,171,133,257,898,1813,4,8612,478,0,2,8,1,0
33397,67,1750,507,281,342,29,59,88,536,10,53,29,57,63,86,336,514,5,2764,153,0,2,8,1,0
33398,41,821,1178,367,1042,6,15,115,1184,9,94,51,95,103,146,644,976,4,4439,246,0,2,0,173,0
33399,41,821,177,108,140,8,0,27,185,6,30,16,32,36,48,162,248,3,794,44,0,2,0,173,0
33400,283,5921,1943,715,1694,26,18,214,1969,12,185,120,237,197,357,1436,2721,7,20915,1161,0,2,190,36,0
33401,283,5921,1168,838,957,57,25,144,1225,19,348,224,416,367,640,3018,5452,11,61921,3440,1,2,190,36,0
33402,112,4516,1289,550,1043,56,32,155,1345,10,167,93,185,177,278,1266,2075,5,11498,638,0,2,1,1,0
33403,153,7223,1392,870,1177,35,17,170,1427,14,494,280,531,508,811,4473,7289,7,54850,3047,2,2,1,1,0
33404,95,2931,773,419,590,28,0,166,801,10,204,113,217,214,330,1598,2554,5,13587,754,0,2,1,1,0
33405,7,107,127,75,83,2,11,30,129,4,14,7,14,18,21,61,87,2,175,9,0,0,26,0,0
33406,7,107,652,304,544,16,6,88,668,6,89,51,101,95,152,591,998,3,3399,188,0,0,26,0,0
33407,7,107,2,2,2,0,0,0,2,0,0,0,0,0,0,0,0,0,0,0,0,0,26,0,0
33408,7,107,8,5,5,0,0,3,8,0,0,0,0,0,0,0,0,0,0,0,0,0,26,0,0
33409,7,107,2,2,2,0,0,0,2,0,0,0,0,0,0,0,0,0,0,0,0,0,26,0,0
33410,7,107,14,8,8,0,0,6,14,0,0,0,0,0,0,0,0,0,0,0,0,0,26,0,0
33411,7,107,6,4,4,0,0,2,6,0,0,0,0,0,0,0,0,0,0,0,0,0,26,0,0
33412,7,107,6,4,4,0,0,2,6,1,2,1,2,3,3,2,4,0,2,0,0,0,26,0,0
33413,7,107,6,4,4,0,0,2,6,0,0,0,0,0,0,0,0,0,0,0,0,0,26,0,0
33414,7,107,7,5,5,0,0,2,7,0,0,0,0,0,0,0,0,0,0,0,0,0,26,0,0
33415,7,107,6,4,4,0,0,2,6,0,0,0,0,0,0,0,0,0,0,0,0,0,26,0,0
33416,7,107,10,6,6,0,0,4,10,0,0,0,0,0,0,0,0,0,0,0,0,0,26,0,0
33417,7,107,1,1,1,0,0,0,1,0,0,0,0,0,0,0,0,0,0,0,0,0,26,0,0
33418,7,107,1,1,1,0,0,0,1,0,0,0,0,0,0,0,0,0,0,0,0,0,26,0,0
33419,7,107,14,10,10,0,0,4,14,1,1,1,1,2,2,0,2,0,1,0,0,0,26,0,0
33420,7,107,46,26,30,3,0,12,49,3,6,3,6,9,9,20,28,1,42,2,0,0,26,0,0
33421,171,7599,4293,999,3693,19,54,507,4312,9,155,88,170,164,258,1156,1898,4,9368,520,0,2,1,3,0
33422,171,7599,1482,859,1002,125,135,219,1607,16,219,134,251,235,385,1766,3032,9,27804,1544,1,2,1,3,0
33423,128,5170,1450,624,1228,12,26,181,1462,14,306,186,354,320,540,2580,4493,8,36391,2021,1,2,44,0,0
33424,47,3558,996,429,845,24,10,117,1020,7,76,50,88,83,138,494,879,4,3565,198,0,2,26,6,0
33425,125,5397,1513,682,1277,25,13,200,1538,11,199,116,219,210,335,1557,2584,6,15641,868,0,2,3,3,0
33426,103,5268,1457,730,1242,11,6,188,1468,10,292,166,329,302,495,2424,4078,5,22973,1276,1,2,4,4,0
33427,43,2698,652,304,544,16,6,88,668,6,89,51,101,95,152,591,998,3,3399,188,0,2,15,14,0
33428,101,4838,1523,757,1297,19,12,193,1542,12,193,117,230,205,347,1508,2664,7,19053,1058,0,2,19,1,0
33429,70,3194,1020,354,843,12,15,144,1032,8,134,77,144,142,221,970,1580,4,6792,377,0,2,14,1,0
33430,47,2189,447,308,343,6,5,95,453,7,96,59,111,103,170,651,1136,4,4600,255,0,2,7,0,0
33431,74,3867,1293,570,1093,25,15,163,1318,10,195,123,241,205,364,1516,2795,6,17273,959,0,2,48,7,0
33432,55,2800,722,423,573,19,0,135,741,12,172,101,199,184,300,1320,2257,6,15668,870,0,2,77,0,0
33433,86,3411,1043,504,840,53,9,147,1096,9,180,112,198,189,310,1377,2344,4,11604,644,0,2,8,1,0
33434,86,3482,1178,367,1042,6,15,115,1184,9,94,51,95,103,146,644,976,4,4439,246,0,2,0,35,0
33435,104,5735,1943,715,1694,26,18,214,1969,12,185,120,237,197,357,1436,2721,7,20915,1161,0,2,57,5,0
33436,80,3144,1178,367,1042,6,15,115,1184,9,94,51,95,103,146,644,976,4,4439,246,0,2,0,72,1
33437,110,6063,1943,715,1694,26,18,214,1969,12,185,120,237,197,357,1436,2721,7,20915,1161,0,2,70,0,1
33438,235,4924,2,2,2,0,0,0,2,0,0,0,0,0,0,0,0,0,0,0,0,2,1,1,1
33439,235,4924,99,48,90,1,3,5,100,0,0,0,0,0,0,0,0,0,0,0,0,2,1,1,1
33440,235,4924,8,5,5,2,0,1,10,0,0,0,0,0,0,0,0,0,0,0,0,2,1,1,1
33441,235,4924,1217,716,841,84,126,174,1301,14,185,118,215,199,333,1446,2542,8,20687,1149,0,2,1,1,1
33442,235,4924,160,89,115,0,13,31,160,7,15,11,17,22,28,78,124,3,495,27,0,2,1,1,1
33443,235,4924,10,10,9,9,0,0,19,0,0,0,0,0,0,0,0,0,0,0,0,2,1,1,1
33444,235,4924,173,84,99,8,29,36,181,5,12,7,13,17,20,54,81,2,221,12,0,2,1,1,1
33445,235,4924,3,1,1,3,0,0,6,0,0,0,0,0,0,0,0,0,0,0,0,2,1,1,1
33446,75,1629,53,23,39,0,0,13,53,2,8,4,8,10,12,26,39,1,39,2,0,2,4,4,1
33447,75,1629,515,298,307,33,80,99,548,12,63,44,77,75,121,419,753,7,5527,307,0,2,4,4,1
33448,313,6894,72,33,56,0,4,12,72,1,1,1,1,2,2,0,2,0,1,0,0,2,3,3,1
33449,313,6894,1454,835,1044,76,110,219,1530,17,275,158,296,292,454,2297,3718,9,34017,1889,1,2,3,3,1
33450,66,1717,466,257,367,18,25,50,484,7,126,86,171,133,257,898,1813,4,8612,478,0,2,1,1,1
33451,66,1717,507,281,342,29,59,88,536,10,53,29,57,63,86,336,514,5,2764,153,0,2,1,1,1
33452,101,5325,1457,730,1242,11,6,188,1468,10,292,166,329,302,495,2424,4078,5,22973,1276,1,2,9,2,1
33453,183,5551,1660,832,1314,41,38,274,1701,20,312,209,395,332,604,2671,5058,12,64042,3557,1,2,7,7,0
33454,183,5551,1057,646,719,113,100,145,1170,18,215,134,248,233,382,1740,3004,10,31186,1732,1,2,7,7,0
33455,24,612,2,2,2,0,0,0,2,0,0,0,0,0,0,0,0,0,0,0,0,2,3,0,0
33456,24,612,99,48,90,1,3,5,100,0,0,0,0,0,0,0,0,0,0,0,0,2,3,0,0
33457,24,612,8,5,5,2,0,1,10,0,0,0,0,0,0,0,0,0,0,0,0,2,3,0,0
33458,24,612,1217,716,841,84,126,174,1301,14,185,118,215,199,333,1446,2542,8,20687,1149,0,2,3,0,0
33459,24,612,160,89,115,0,13,31,160,7,15,11,17,22,28,78,124,3,495,27,0,2,3,0,0
33460,24,612,10,10,9,9,0,0,19,0,0,0,0,0,0,0,0,0,0,0,0,2,3,0,0
33461,24,612,173,84,99,8,29,36,181,5,12,7,13,17,20,54,81,2,221,12,0,2,3,0,0
33462,24,612,3,1,1,3,0,0,6,0,0,0,0,0,0,0,0,0,0,0,0,2,3,0,0
33463,235,4924,2,2,2,0,0,0,2,0,0,0,0,0,0,0,0,0,0,0,0,2,1,1,0
33464,235,4924,99,48,90,1,3,5,100,0,0,0,0,0,0,0,0,0,0,0,0,2,1,1,0
33465,235,4924,8,5,5,2,0,1,10,0,0,0,0,0,0,0,0,0,0,0,0,2,1,1,0
33466,235,4924,1217,716,841,84,126,174,1301,14,185,118,215,199,333,1446,2542,8,20687,1149,0,2,1,1,0
33467,235,4924,160,89,115,0,13,31,160,7,15,11,17,22,28,78,124,3,495,27,0,2,1,1,0
33468,235,4924,10,10,9,9,0,0,19,0,0,0,0,0,0,0,0,0,0,0,0,2,1,1,0
33469,235,4924,173,84,99,8,29,36,181,5,12,7,13,17,20,54,81,2,221,12,0,2,1,1,0
33470,235,4924,3,1,1,3,0,0,6,0,0,0,0,0,0,0,0,0,0,0,0,2,1,1,0
33471,75,1629,53,23,39,0,0,13,53,2,8,4,8,10,12,26,39,1,39,2,0,2,4,4,0
33472,75,1629,515,298,307,33,80,99,548,12,63,44,77,75,121,419,753,7,5527,307,0,2,4,4,0
33473,313,6894,72,33,56,0,4,12,72,1,1,1,1,2,2,0,2,0,1,0,0,2,3,3,0
33474,313,6894,1454,835,1044,76,110,219,1530,17,275,158,296,292,454,2297,3718,9,34017,1889,1,2,3,3,0
33475,66,1717,466,257,367,18,25,50,484,7,126,86,171,133,257,898,1813,4,8612,478,0,2,1,1,0
33476,66,1717,507,281,342,29,59,88,536,10,53,29,57,63,86,336,514,5,2764,153,0,2,1,1,0
33477,101,5325,1457,730,1242,11,6,188,1468,10,292,166,329,302,495,2424,4078,5,22973,1276,1,2,9,2,0
33478,159,3787,77,34,69,0,0,8,77,3,24,16,29,27,45,114,213,1,387,21,0,2,1,0,0
33479,159,3787,712,438,573,51,9,84,763,14,102,71,128,116,199,733,1364,8,11988,666,0,2,1,0,0
33480,112,4538,1289,550,1043,56,32,155,1345,10,167,93,185,177,278,1266,2075,5,11498,638,0,2,11,0,0
33481,163,3497,1513,682,1277,25,13,200,1538,11,199,116,219,210,335,1557,2584,6,15641,868,0,2,33,4,0
33482,163,3497,819,519,539,24,98,155,843,15,96,57,106,111,163,690,1107,8,9171,509,0,2,33,4,0
33483,125,5397,1513,682,1277,25,13,200,1538,11,199,116,219,210,335,1557,2584,6,15641,868,0,2,4,5,0
33484,7,123,127,75,83,2,11,30,129,4,14,7,14,18,21,61,87,2,175,9,0,2,11,1,0
33485,7,123,652,304,544,16,6,88,668,6,89,51,101,95,152,591,998,3,3399,188,0,2,11,1,0
33486,7,123,2,2,2,0,0,0,2,0,0,0,0,0,0,0,0,0,0,0,0,2,11,1,0
33487,7,123,8,5,5,0,0,3,8,0,0,0,0,0,0,0,0,0,0,0,0,2,11,1,0
33488,7,123,2,2,2,0,0,0,2,0,0,0,0,0,0,0,0,0,0,0,0,2,11,1,0
33489,7,123,14,8,8,0,0,6,14,0,0,0,0,0,0,0,0,0,0,0,0,2,11,1,0
33490,7,123,6,4,4,0,0,2,6,0,0,0,0,0,0,0,0,0,0,0,0,2,11,1,0
33491,7,123,6,4,4,0,0,2,6,1,2,1,2,3,3,2,4,0,2,0,0,2,11,1,0
33492,7,123,6,4,4,0,0,2,6,0,0,0,0,0,0,0,0,0,0,0,0,2,11,1,0
33493,7,123,7,5,5,0,0,2,7,0,0,0,0,0,0,0,0,0,0,0,0,2,11,1,0
33494,7,123,6,4,4,0,0,2,6,0,0,0,0,0,0,0,0,0,0,0,0,2,11,1,0
33495,7,123,10,6,6,0,0,4,10,0,0,0,0,0,0,0,0,0,0,0,0,2,11,1,0
33496,7,123,1,1,1,0,0,0,1,0,0,0,0,0,0,0,0,0,0,0,0,2,11,1,0
33497,7,123,1,1,1,0,0,0,1,0,0,0,0,0,0,0,0,0,0,0,0,2,11,1,0
33498,7,123,14,10,10,0,0,4,14,1,1,1,1,2,2,0,2,0,1,0,0,2,11,1,0
33499,7,123,46,26,30,3,0,12,49,3,6,3,6,9,9,20,28,1,42,2,0,2,11,1,0
33500,7,123,127,75,83,2,11,30,129,4,14,7,14,18,21,61,87,2,175,9,0,2,11,1,0
33501,7,123,652,304,544,16,6,88,668,6,89,51,101,95,152,591,998,3,3399,188,0,2,11,1,0
33502,7,123,2,2,2,0,0,0,2,0,0,0,0,0,0,0,0,0,0,0,0,2,11,1,0
33503,7,123,8,5,5,0,0,3,8,0,0,0,0,0,0,0,0,0,0,0,0,2,11,1,0
33504,7,123,2,2,2,0,0,0,2,0,0,0,0,0,0,0,0,0,0,0,0,2,11,1,0
33505,7,123,14,8,8,0,0,6,14,0,0,0,0,0,0,0,0,0,0,0,0,2,11,1,0
33506,7,123,6,4,4,0,0,2,6,0,0,0,0,0,0,0,0,0,0,0,0,2,11,1,0
33507,7,123,6,4,4,0,0,2,6,1,2,1,2,3,3,2,4,0,2,0,0,2,11,1,0
33508,7,123,6,4,4,0,0,2,6,0,0,0,0,0,0,0,0,0,0,0,0,2,11,1,0
33509,7,123,7,5,5,0,0,2,7,0,0,0,0,0,0,0,0,0,0,0,0,2,11,1,0
33510,7,123,6,4,4,0,0,2,6,0,0,0,0,0,0,0,0,0,0,0,0,2,11,1,0
33511,7,123,10,6,6,0,0,4,10,0,0,0,0,0,0,0,0,0,0,0,0,2,11,1,0
33512,7,123,1,1,1,0,0,0,1,0,0,0,0,0,0,0,0,0,0,0,0,2,11,1,0
33513,7,123,1,1,1,0,0,0,1,0,0,0,0,0,0,0,0,0,0,0,0,2,11,1,0
33514,7,123,14,10,10,0,0,4,14,1,1,1,1,2,2,0,2,0,1,0,0,2,11,1,0
33515,7,123,46,26,30,3,0,12,49,3,6,3,6,9,9,20,28,1,42,2,0,2,11,1,0
33516,159,3787,77,34,69,0,0,8,77,3,24,16,29,27,45,114,213,1,387,21,0,2,1,0,0
33517,159,3787,712,438,573,51,9,84,763,14,102,71,128,116,199,733,1364,8,11988,666,0,2,1,0,0
33518,112,4538,1289,550,1043,56,32,155,1345,10,167,93,185,177,278,1266,2075,5,11498,638,0,2,11,0,0
33519,163,3497,1513,682,1277,25,13,200,1538,11,199,116,219,210,335,1557,2584,6,15641,868,0,2,33,4,0
33520,163,3497,819,519,539,24,98,155,843,15,96,57,106,111,163,690,1107,8,9171,509,0,2,33,4,0
33521,125,5397,1513,682,1277,25,13,200,1538,11,199,116,219,210,335,1557,2584,6,15641,868,0,2,4,5,0
33522,229,4964,182,127,129,0,0,53,182,5,39,21,42,44,63,217,343,2,926,51,0,2,4,7,1
33523,229,4964,1165,710,800,67,119,181,1232,18,243,153,282,261,435,2000,3492,10,36473,2026,1,2,4,7,1
33524,14,411,149,95,105,2,0,41,151,8,54,28,55,62,83,334,494,4,2013,111,0,2,33,23,1
33525,14,411,82,56,54,0,13,15,82,4,13,8,16,17,24,56,98,2,241,13,0,2,33,23,1
33526,158,7390,1392,870,1177,35,17,170,1427,14,494,280,531,508,811,4473,7289,7,54850,3047,2,2,29,0,1
33527,30,1440,373,158,315,8,0,51,381,5,76,44,79,81,123,486,779,2,2026,112,0,2,24,0,1
33528,229,4964,182,127,129,0,0,53,182,5,39,21,42,44,63,217,343,2,926,51,0,2,4,7,0
33529,229,4964,1165,710,800,67,119,181,1232,18,243,153,282,261,435,2000,3492,10,36473,2026,1,2,4,7,0
33530,14,411,149,95,105,2,0,41,151,8,54,28,55,62,83,334,494,4,2013,111,0,2,33,23,0
33531,14,411,82,56,54,0,13,15,82,4,13,8,16,17,24,56,98,2,241,13,0,2,33,23,0
33532,158,7390,1392,870,1177,35,17,170,1427,14,494,280,531,508,811,4473,7289,7,54850,3047,2,2,29,0,0
33533,30,1440,373,158,315,8,0,51,381,5,76,44,79,81,123,486,779,2,2026,112,0,2,24,0,0
33534,159,3778,77,34,69,0,0,8,77,3,24,16,29,27,45,114,213,1,387,21,0,2,1,1,0
33535,159,3778,712,438,573,51,9,84,763,14,102,71,128,116,199,733,1364,8,11988,666,0,2,1,1,0
33536,273,5728,1943,715,1694,26,18,214,1969,12,185,120,237,197,357,1436,2721,7,20915,1161,0,2,1,1,0
33537,273,5728,1168,838,957,57,25,144,1225,19,348,224,416,367,640,3018,5452,11,61921,3440,1,2,1,1,0
33538,229,4964,182,127,129,0,0,53,182,5,39,21,42,44,63,217,343,2,926,51,0,2,4,7,0
33539,229,4964,1165,710,800,67,119,181,1232,18,243,153,282,261,435,2000,3492,10,36473,2026,1,2,4,7,0
33540,14,411,149,95,105,2,0,41,151,8,54,28,55,62,83,334,494,4,2013,111,0,2,33,23,0
33541,14,411,82,56,54,0,13,15,82,4,13,8,16,17,24,56,98,2,241,13,0,2,33,23,0
33542,236,4942,2,2,2,0,0,0,2,0,0,0,0,0,0,0,0,0,0,0,0,2,1,1,0
33543,236,4942,99,48,90,1,3,5,100,0,0,0,0,0,0,0,0,0,0,0,0,2,1,1,0
33544,236,4942,8,5,5,2,0,1,10,0,0,0,0,0,0,0,0,0,0,0,0,2,1,1,0
33545,236,4942,1217,716,841,84,126,174,1301,14,185,118,215,199,333,1446,2542,8,20687,1149,0,2,1,1,0
33546,236,4942,160,89,115,0,13,31,160,7,15,11,17,22,28,78,124,3,495,27,0,2,1,1,0
33547,236,4942,10,10,9,9,0,0,19,0,0,0,0,0,0,0,0,0,0,0,0,2,1,1,0
33548,236,4942,173,84,99,8,29,36,181,5,12,7,13,17,20,54,81,2,221,12,0,2,1,1,0
33549,236,4942,3,1,1,3,0,0,6,0,0,0,0,0,0,0,0,0,0,0,0,2,1,1,0
33550,75,1629,53,23,39,0,0,13,53,2,8,4,8,10,12,26,39,1,39,2,0,2,4,4,0
33551,75,1629,515,298,307,33,80,99,548,12,63,44,77,75,121,419,753,7,5527,307,0,2,4,4,0
33552,313,6894,72,33,56,0,4,12,72,1,1,1,1,2,2,0,2,0,1,0,0,2,3,3,0
33553,313,6894,1454,835,1044,76,110,219,1530,17,275,158,296,292,454,2297,3718,9,34017,1889,1,2,3,3,0
33554,67,1753,466,257,367,18,25,50,484,7,126,86,171,133,257,898,1813,4,8612,478,0,2,1,1,0
33555,67,1753,507,281,342,29,59,88,536,10,53,29,57,63,86,336,514,5,2764,153,0,2,1,1,0
33556,158,7390,1392,870,1177,35,17,170,1427,14,494,280,531,508,811,4473,7289,7,54850,3047,2,2,29,0,0
33557,103,5324,1457,730,1242,11,6,188,1468,10,292,166,329,302,495,2424,4078,5,22973,1276,1,2,9,2,0
33558,30,1440,373,158,315,8,0,51,381,5,76,44,79,81,123,486,779,2,2026,112,0,2,24,0,0
33559,229,4964,182,127,129,0,0,53,182,5,39,21,42,44,63,217,343,2,926,51,0,2,4,7,0
33560,229,4964,1165,710,800,67,119,181,1232,18,243,153,282,261,435,2000,3492,10,36473,2026,1,2,4,7,0
33561,14,411,149,95,105,2,0,41,151,8,54,28,55,62,83,334,494,4,2013,111,0,2,33,23,0
33562,14,411,82,56,54,0,13,15,82,4,13,8,16,17,24,56,98,2,241,13,0,2,33,23,0
33563,236,4942,2,2,2,0,0,0,2,0,0,0,0,0,0,0,0,0,0,0,0,2,1,1,0
33564,236,4942,99,48,90,1,3,5,100,0,0,0,0,0,0,0,0,0,0,0,0,2,1,1,0
33565,236,4942,8,5,5,2,0,1,10,0,0,0,0,0,0,0,0,0,0,0,0,2,1,1,0
33566,236,4942,1217,716,841,84,126,174,1301,14,185,118,215,199,333,1446,2542,8,20687,1149,0,2,1,1,0
33567,236,4942,160,89,115,0,13,31,160,7,15,11,17,22,28,78,124,3,495,27,0,2,1,1,0
33568,236,4942,10,10,9,9,0,0,19,0,0,0,0,0,0,0,0,0,0,0,0,2,1,1,0
33569,236,4942,173,84,99,8,29,36,181,5,12,7,13,17,20,54,81,2,221,12,0,2,1,1,0
33570,236,4942,3,1,1,3,0,0,6,0,0,0,0,0,0,0,0,0,0,0,0,2,1,1,0
33571,75,1629,53,23,39,0,0,13,53,2,8,4,8,10,12,26,39,1,39,2,0,2,4,4,0
33572,75,1629,515,298,307,33,80,99,548,12,63,44,77,75,121,419,753,7,5527,307,0,2,4,4,0
33573,313,6894,72,33,56,0,4,12,72,1,1,1,1,2,2,0,2,0,1,0,0,2,3,3,0
33574,313,6894,1454,835,1044,76,110,219,1530,17,275,158,296,292,454,2297,3718,9,34017,1889,1,2,3,3,0
33575,67,1753,466,257,367,18,25,50,484,7,126,86,171,133,257,898,1813,4,8612,478,0,2,1,1,0
33576,67,1753,507,281,342,29,59,88,536,10,53,29,57,63,86,336,514,5,2764,153,0,2,1,1,0
33577,158,7390,1392,870,1177,35,17,170,1427,14,494,280,531,508,811,4473,7289,7,54850,3047,2,2,29,0,0
33578,103,5324,1457,730,1242,11,6,188,1468,10,292,166,329,302,495,2424,4078,5,22973,1276,1,2,9,2,0
33579,30,1440,373,158,315,8,0,51,381,5,76,44,79,81,123,486,779,2,2026,112,0,2,24,0,0
33580,52,1451,339,213,244,17,9,65,356,10,42,26,48,52,74,259,421,5,2410,133,0,2,0,10,0
33581,73,3817,1293,570,1093,25,15,163,1318,10,195,123,241,205,364,1516,2795,6,17273,959,0,2,0,14,0
33582,52,1451,339,213,244,17,9,65,356,10,42,26,48,52,74,259,421,5,2410,133,0,2,0,10,0
33583,73,3817,1293,570,1093,25,15,163,1318,10,195,123,241,205,364,1516,2795,6,17273,959,0,2,0,14,0
33584,236,4942,2,2,2,0,0,0,2,0,0,0,0,0,0,0,0,0,0,0,0,2,1,1,0
33585,236,4942,99,48,90,1,3,5,100,0,0,0,0,0,0,0,0,0,0,0,0,2,1,1,0
33586,236,4942,8,5,5,2,0,1,10,0,0,0,0,0,0,0,0,0,0,0,0,2,1,1,0
33587,236,4942,1217,716,841,84,126,174,1301,14,185,118,215,199,333,1446,2542,8,20687,1149,0,2,1,1,0
33588,236,4942,160,89,115,0,13,31,160,7,15,11,17,22,28,78,124,3,495,27,0,2,1,1,0
33589,236,4942,10,10,9,9,0,0,19,0,0,0,0,0,0,0,0,0,0,0,0,2,1,1,0
33590,236,4942,173,84,99,8,29,36,181,5,12,7,13,17,20,54,81,2,221,12,0,2,1,1,0
33591,236,4942,3,1,1,3,0,0,6,0,0,0,0,0,0,0,0,0,0,0,0,2,1,1,0
33592,103,5336,1457,730,1242,11,6,188,1468,10,292,166,329,302,495,2424,4078,5,22973,1276,1,2,6,4,0
33593,236,4942,2,2,2,0,0,0,2,0,0,0,0,0,0,0,0,0,0,0,0,2,1,1,0
33594,236,4942,99,48,90,1,3,5,100,0,0,0,0,0,0,0,0,0,0,0,0,2,1,1,0
33595,236,4942,8,5,5,2,0,1,10,0,0,0,0,0,0,0,0,0,0,0,0,2,1,1,0
33596,236,4942,1217,716,841,84,126,174,1301,14,185,118,215,199,333,1446,2542,8,20687,1149,0,2,1,1,0
33597,236,4942,160,89,115,0,13,31,160,7,15,11,17,22,28,78,124,3,495,27,0,2,1,1,0
33598,236,4942,10,10,9,9,0,0,19,0,0,0,0,0,0,0,0,0,0,0,0,2,1,1,0
33599,236,4942,173,84,99,8,29,36,181,5,12,7,13,17,20,54,81,2,221,12,0,2,1,1,0
33600,236,4942,3,1,1,3,0,0,6,0,0,0,0,0,0,0,0,0,0,0,0,2,1,1,0
33601,103,5336,1457,730,1242,11,6,188,1468,10,292,166,329,302,495,2424,4078,5,22973,1276,1,2,6,4,0
33602,69,1526,402,202,227,24,74,80,426,12,52,33,61,64,94,339,564,7,3969,220,0,2,2,2,0
33603,2,121,37,13,25,0,6,6,37,1,2,1,2,3,3,2,4,0,2,0,0,2,1,1,0
33604,2,121,133,47,40,1,43,49,134,0,0,0,0,0,0,0,0,0,0,0,0,2,1,1,0
33605,183,5551,1660,832,1314,41,38,274,1701,20,312,209,395,332,604,2671,5058,12,64042,3557,1,2,10,6,0
33606,183,5551,1057,646,719,113,100,145,1170,18,215,134,248,233,382,1740,3004,10,31186,1732,1,2,10,6,0
33607,78,1883,996,429,845,24,10,117,1020,7,76,50,88,83,138,494,879,4,3565,198,0,2,2,2,0
33608,78,1883,456,277,329,12,42,72,468,13,85,50,97,98,147,592,972,7,7212,400,0,2,2,2,0
33609,236,4942,2,2,2,0,0,0,2,0,0,0,0,0,0,0,0,0,0,0,0,2,4,4,0
33610,236,4942,99,48,90,1,3,5,100,0,0,0,0,0,0,0,0,0,0,0,0,2,4,4,0
33611,236,4942,8,5,5,2,0,1,10,0,0,0,0,0,0,0,0,0,0,0,0,2,4,4,0
33612,236,4942,1217,716,841,84,126,174,1301,14,185,118,215,199,333,1446,2542,8,20687,1149,0,2,4,4,0
33613,236,4942,160,89,115,0,13,31,160,7,15,11,17,22,28,78,124,3,495,27,0,2,4,4,0
33614,236,4942,10,10,9,9,0,0,19,0,0,0,0,0,0,0,0,0,0,0,0,2,4,4,0
33615,236,4942,173,84,99,8,29,36,181,5,12,7,13,17,20,54,81,2,221,12,0,2,4,4,0
33616,236,4942,3,1,1,3,0,0,6,0,0,0,0,0,0,0,0,0,0,0,0,2,4,4,0
33617,109,2963,1523,757,1297,19,12,193,1542,12,193,117,230,205,347,1508,2664,7,19053,1058,0,2,4,2,0
33618,109,2963,701,378,504,33,58,109,734,13,110,68,126,123,194,794,1346,7,10027,557,0,2,4,2,0
33619,313,6900,72,33,56,0,4,12,72,1,1,1,1,2,2,0,2,0,1,0,0,2,7,6,0
33620,313,6900,1454,835,1044,76,110,219,1530,17,275,158,296,292,454,2297,3718,9,34017,1889,1,2,7,6,0
33621,2,156,37,13,25,0,6,6,37,1,2,1,2,3,3,2,4,0,2,0,0,2,51,9,0
33622,2,156,133,47,40,1,43,49,134,0,0,0,0,0,0,0,0,0,0,0,0,2,51,9,0
33623,53,1862,601,196,481,2,23,85,603,8,63,36,72,71,108,400,664,4,3036,168,0,2,1,1,0
33624,89,2050,996,429,845,24,10,117,1020,7,76,50,88,83,138,494,879,4,3565,198,0,2,39,2,1
33625,89,2050,456,277,329,12,42,72,468,13,85,50,97,98,147,592,972,7,7212,400,0,2,39,2,1
33626,48,3659,996,429,845,24,10,117,1020,7,76,50,88,83,138,494,879,4,3565,198,0,2,56,4,1
33627,89,2050,996,429,845,24,10,117,1020,7,76,50,88,83,138,494,879,4,3565,198,0,2,39,2,0
33628,89,2050,456,277,329,12,42,72,468,13,85,50,97,98,147,592,972,7,7212,400,0,2,39,2,0
33629,48,3659,996,429,845,24,10,117,1020,7,76,50,88,83,138,494,879,4,3565,198,0,2,56,4,0
33630,275,5732,1943,715,1694,26,18,214,1969,12,185,120,237,197,357,1436,2721,7,20915,1161,0,2,2,4,0
33631,275,5732,1168,838,957,57,25,144,1225,19,348,224,416,367,640,3018,5452,11,61921,3440,1,2,2,4,0
33632,105,5773,1943,715,1694,26,18,214,1969,12,185,120,237,197,357,1436,2721,7,20915,1161,0,2,31,0,0
33633,52,1451,339,213,244,17,9,65,356,10,42,26,48,52,74,259,421,5,2410,133,0,2,6,6,0
33634,272,5717,1943,715,1694,26,18,214,1969,12,185,120,237,197,357,1436,2721,7,20915,1161,0,2,2,4,0
33635,272,5717,1168,838,957,57,25,144,1225,19,348,224,416,367,640,3018,5452,11,61921,3440,1,2,2,4,0
33636,105,5775,1943,715,1694,26,18,214,1969,12,185,120,237,197,357,1436,2721,7,20915,1161,0,2,31,0,0
33637,183,5551,1660,832,1314,41,38,274,1701,20,312,209,395,332,604,2671,5058,12,64042,3557,1,2,10,6,0
33638,183,5551,1057,646,719,113,100,145,1170,18,215,134,248,233,382,1740,3004,10,31186,1732,1,2,10,6,0
33639,89,2050,996,429,845,24,10,117,1020,7,76,50,88,83,138,494,879,4,3565,198,0,2,2,2,0
33640,89,2050,456,277,329,12,42,72,468,13,85,50,97,98,147,592,972,7,7212,400,0,2,2,2,0
33641,236,4942,2,2,2,0,0,0,2,0,0,0,0,0,0,0,0,0,0,0,0,2,4,4,0
33642,236,4942,99,48,90,1,3,5,100,0,0,0,0,0,0,0,0,0,0,0,0,2,4,4,0
33643,236,4942,8,5,5,2,0,1,10,0,0,0,0,0,0,0,0,0,0,0,0,2,4,4,0
33644,236,4942,1217,716,841,84,126,174,1301,14,185,118,215,199,333,1446,2542,8,20687,1149,0,2,4,4,0
33645,236,4942,160,89,115,0,13,31,160,7,15,11,17,22,28,78,124,3,495,27,0,2,4,4,0
33646,236,4942,10,10,9,9,0,0,19,0,0,0,0,0,0,0,0,0,0,0,0,2,4,4,0
33647,236,4942,173,84,99,8,29,36,181,5,12,7,13,17,20,54,81,2,221,12,0,2,4,4,0
33648,236,4942,3,1,1,3,0,0,6,0,0,0,0,0,0,0,0,0,0,0,0,2,4,4,0
33649,109,2963,1523,757,1297,19,12,193,1542,12,193,117,230,205,347,1508,2664,7,19053,1058,0,2,4,2,0
33650,109,2963,701,378,504,33,58,109,734,13,110,68,126,123,194,794,1346,7,10027,557,0,2,4,2,0
33651,69,1526,402,202,227,24,74,80,426,12,52,33,61,64,94,339,564,7,3969,220,0,2,2,2,0
33652,313,6900,72,33,56,0,4,12,72,1,1,1,1,2,2,0,2,0,1,0,0,2,7,6,0
33653,313,6900,1454,835,1044,76,110,219,1530,17,275,158,296,292,454,2297,3718,9,34017,1889,1,2,7,6,0
33654,2,156,37,13,25,0,6,6,37,1,2,1,2,3,3,2,4,0,2,0,0,2,51,9,0
33655,2,156,133,47,40,1,43,49,134,0,0,0,0,0,0,0,0,0,0,0,0,2,51,9,0
33656,53,1862,601,196,481,2,23,85,603,8,63,36,72,71,108,400,664,4,3036,168,0,2,1,1,0
33657,52,1451,339,213,244,17,9,65,356,10,42,26,48,52,74,259,421,5,2410,133,0,2,6,6,0
33658,159,3783,77,34,69,0,0,8,77,3,24,16,29,27,45,114,213,1,387,21,0,2,1,1,0
33659,159,3783,712,438,573,51,9,84,763,14,102,71,128,116,199,733,1364,8,11988,666,0,2,1,1,0
33660,272,5713,1943,715,1694,26,18,214,1969,12,185,120,237,197,357,1436,2721,7,20915,1161,0,2,1,1,0
33661,272,5713,1168,838,957,57,25,144,1225,19,348,224,416,367,640,3018,5452,11,61921,3440,1,2,1,1,0
33662,72,1466,1178,367,1042,6,15,115,1184,9,94,51,95,103,146,644,976,4,4439,246,0,2,1,1,0
33663,72,1466,177,108,140,8,0,27,185,6,30,16,32,36,48,162,248,3,794,44,0,2,1,1,0
33664,72,1466,1178,367,1042,6,15,115,1184,9,94,51,95,103,146,644,976,4,4439,246,0,2,1,1,0
33665,72,1466,177,108,140,8,0,27,185,6,30,16,32,36,48,162,248,3,794,44,0,2,1,1,0
33666,54,657,647,139,84,35,284,233,682,0,0,0,0,0,0,0,0,0,0,0,0,2,7,4,0
33667,54,657,647,139,84,35,284,233,682,0,0,0,0,0,0,0,0,0,0,0,0,2,7,4,0
33668,272,5721,1943,715,1694,26,18,214,1969,12,185,120,237,197,357,1436,2721,7,20915,1161,0,2,1,1,0
33669,272,5721,1168,838,957,57,25,144,1225,19,348,224,416,367,640,3018,5452,11,61921,3440,1,2,1,1,0
33670,54,657,647,139,84,35,284,233,682,0,0,0,0,0,0,0,0,0,0,0,0,2,7,4,0
33671,41,821,1178,367,1042,6,15,115,1184,9,94,51,95,103,146,644,976,4,4439,246,0,2,1,1,0
33672,41,821,177,108,140,8,0,27,185,6,30,16,32,36,48,162,248,3,794,44,0,2,1,1,0
33673,54,657,647,139,84,35,284,233,682,0,0,0,0,0,0,0,0,0,0,0,0,2,7,4,0
33674,41,821,1178,367,1042,6,15,115,1184,9,94,51,95,103,146,644,976,4,4439,246,0,2,1,1,0
33675,41,821,177,108,140,8,0,27,185,6,30,16,32,36,48,162,248,3,794,44,0,2,1,1,0
33676,110,3013,1523,757,1297,19,12,193,1542,12,193,117,230,205,347,1508,2664,7,19053,1058,0,2,21,10,0
33677,110,3013,701,378,504,33,58,109,734,13,110,68,126,123,194,794,1346,7,10027,557,0,2,21,10,0
33678,103,4933,1523,757,1297,19,12,193,1542,12,193,117,230,205,347,1508,2664,7,19053,1058,0,2,36,14,0
33679,110,6063,1943,715,1694,26,18,214,1969,12,185,120,237,197,357,1436,2721,7,20915,1161,0,2,1,0,0
33680,283,5921,1943,715,1694,26,18,214,1969,12,185,120,237,197,357,1436,2721,7,20915,1161,0,2,1,0,0
33681,283,5921,1168,838,957,57,25,144,1225,19,348,224,416,367,640,3018,5452,11,61921,3440,1,2,1,0,0
33682,110,6071,1943,715,1694,26,18,214,1969,12,185,120,237,197,357,1436,2721,7,20915,1161,0,2,3,3,0
33683,110,3013,1523,757,1297,19,12,193,1542,12,193,117,230,205,347,1508,2664,7,19053,1058,0,2,21,10,0
33684,110,3013,701,378,504,33,58,109,734,13,110,68,126,123,194,794,1346,7,10027,557,0,2,21,10,0
33685,103,4933,1523,757,1297,19,12,193,1542,12,193,117,230,205,347,1508,2664,7,19053,1058,0,2,36,14,0
33686,92,1890,757,253,292,73,244,162,830,13,61,38,67,74,105,409,651,7,4654,258,0,2,2,1,0
33687,92,1890,757,253,292,73,244,162,830,13,61,38,67,74,105,409,651,7,4654,258,0,2,2,1,0
33688,92,1890,757,253,292,73,244,162,830,13,61,38,67,74,105,409,651,7,4654,258,0,2,7,1,0
33689,92,1890,757,253,292,73,244,162,830,13,61,38,67,74,105,409,651,7,4654,258,0,2,1,1,0
33690,92,1890,757,253,292,73,244,162,830,13,61,38,67,74,105,409,651,7,4654,258,0,2,5,5,0
33691,92,1890,757,253,292,73,244,162,830,13,61,38,67,74,105,409,651,7,4654,258,0,2,7,1,0
33692,60,1163,282,196,195,3,0,86,285,8,130,71,141,138,212,936,1507,4,6538,363,0,2,1,3,0
33693,229,4960,182,127,129,0,0,53,182,5,39,21,42,44,63,217,343,2,926,51,0,2,1,2,0
33694,229,4960,1165,710,800,67,119,181,1232,18,243,153,282,261,435,2000,3492,10,36473,2026,1,2,1,2,0
33695,183,5551,1660,832,1314,41,38,274,1701,20,312,209,395,332,604,2671,5058,12,64042,3557,1,2,1,1,0
33696,183,5551,1057,646,719,113,100,145,1170,18,215,134,248,233,382,1740,3004,10,31186,1732,1,2,1,1,0
33697,92,1886,757,253,292,73,244,162,830,13,61,38,67,74,105,409,651,7,4654,258,0,2,1,2,0
33698,45,953,386,256,301,16,9,68,402,4,59,35,69,63,104,355,621,2,1453,80,0,2,1,1,0
33699,45,953,264,131,164,11,41,46,275,6,38,22,40,44,62,214,338,3,1068,59,0,2,1,1,0
33700,95,2927,773,419,590,28,0,166,801,10,204,113,217,214,330,1598,2554,5,13587,754,0,2,2,2,0
33701,176,5284,1660,832,1314,41,38,274,1701,20,312,209,395,332,604,2671,5058,12,64042,3557,1,2,1,1,0
33702,176,5309,1660,832,1314,41,38,274,1701,20,312,209,395,332,604,2671,5058,12,64042,3557,1,2,3,0,0
33703,60,1163,282,196,195,3,0,86,285,8,130,71,141,138,212,936,1507,4,6538,363,0,2,1,3,0
33704,229,4960,182,127,129,0,0,53,182,5,39,21,42,44,63,217,343,2,926,51,0,2,1,2,0
33705,229,4960,1165,710,800,67,119,181,1232,18,243,153,282,261,435,2000,3492,10,36473,2026,1,2,1,2,0
33706,183,5551,1660,832,1314,41,38,274,1701,20,312,209,395,332,604,2671,5058,12,64042,3557,1,2,1,1,0
33707,183,5551,1057,646,719,113,100,145,1170,18,215,134,248,233,382,1740,3004,10,31186,1732,1,2,1,1,0
33708,92,1886,757,253,292,73,244,162,830,13,61,38,67,74,105,409,651,7,4654,258,0,2,1,2,0
33709,45,953,386,256,301,16,9,68,402,4,59,35,69,63,104,355,621,2,1453,80,0,2,1,1,0
33710,45,953,264,131,164,11,41,46,275,6,38,22,40,44,62,214,338,3,1068,59,0,2,1,1,0
33711,95,2927,773,419,590,28,0,166,801,10,204,113,217,214,330,1598,2554,5,13587,754,0,2,2,2,0
33712,176,5307,1660,832,1314,41,38,274,1701,20,312,209,395,332,604,2671,5058,12,64042,3557,1,2,1,1,0
33713,314,6930,72,33,56,0,4,12,72,1,1,1,1,2,2,0,2,0,1,0,0,2,6,4,0
33714,314,6930,1454,835,1044,76,110,219,1530,17,275,158,296,292,454,2297,3718,9,34017,1889,1,2,6,4,0
33715,171,7609,4293,999,3693,19,54,507,4312,9,155,88,170,164,258,1156,1898,4,9368,520,0,2,16,2,0
33716,171,7609,1482,859,1002,125,135,219,1607,16,219,134,251,235,385,1766,3032,9,27804,1544,1,2,16,2,0
33717,282,5913,1943,715,1694,26,18,214,1969,12,185,120,237,197,357,1436,2721,7,20915,1161,0,2,1,2,0
33718,282,5913,1168,838,957,57,25,144,1225,19,348,224,416,367,640,3018,5452,11,61921,3440,1,2,1,2,0
33719,314,6930,72,33,56,0,4,12,72,1,1,1,1,2,2,0,2,0,1,0,0,2,6,4,0
33720,314,6930,1454,835,1044,76,110,219,1530,17,275,158,296,292,454,2297,3718,9,34017,1889,1,2,6,4,0
33721,171,7609,4293,999,3693,19,54,507,4312,9,155,88,170,164,258,1156,1898,4,9368,520,0,2,16,2,0
33722,171,7609,1482,859,1002,125,135,219,1607,16,219,134,251,235,385,1766,3032,9,27804,1544,1,2,16,2,0
33723,1,94,42,7,35,4,0,5,46,1,2,1,2,3,3,2,4,0,2,0,0,2,1,1,0
33724,1,94,11,6,10,0,0,1,11,2,4,2,4,6,6,10,15,1,15,0,0,2,1,1,0
33725,1,94,42,7,35,4,0,5,46,1,2,1,2,3,3,2,4,0,2,0,0,2,1,1,0
33726,1,94,11,6,10,0,0,1,11,2,4,2,4,6,6,10,15,1,15,0,0,2,1,1,0
33727,101,2612,773,422,505,30,103,129,803,14,77,46,83,91,129,535,839,7,6334,351,0,2,1,1,0
33728,36,2427,1157,318,931,29,22,177,1186,6,104,63,125,110,188,712,1274,3,4596,255,0,2,7,7,0
33729,101,2612,773,422,505,30,103,129,803,14,77,46,83,91,129,535,839,7,6334,351,0,2,1,1,0
33730,36,2427,1157,318,931,29,22,177,1186,6,104,63,125,110,188,712,1274,3,4596,255,0,2,7,7,0
33731,1,96,42,7,35,4,0,5,46,1,2,1,2,3,3,2,4,0,2,0,0,2,1,0,0
33732,1,96,11,6,10,0,0,1,11,2,4,2,4,6,6,10,15,1,15,0,0,2,1,0,0
33733,41,821,1178,367,1042,6,15,115,1184,9,94,51,95,103,146,644,976,4,4439,246,0,2,1,0,0
33734,41,821,177,108,140,8,0,27,185,6,30,16,32,36,48,162,248,3,794,44,0,2,1,0,0
33735,281,5902,1943,715,1694,26,18,214,1969,12,185,120,237,197,357,1436,2721,7,20915,1161,0,2,57,7,0
33736,281,5902,1168,838,957,57,25,144,1225,19,348,224,416,367,640,3018,5452,11,61921,3440,1,2,57,7,0
33737,112,4538,1289,550,1043,56,32,155,1345,10,167,93,185,177,278,1266,2075,5,11498,638,0,2,3,1,0
33738,80,3144,1178,367,1042,6,15,115,1184,9,94,51,95,103,146,644,976,4,4439,246,0,2,2,1,0
33739,111,6122,1943,715,1694,26,18,214,1969,12,185,120,237,197,357,1436,2721,7,20915,1161,0,2,80,3,0
33740,1,94,42,7,35,4,0,5,46,1,2,1,2,3,3,2,4,0,2,0,0,2,1,1,0
33741,1,94,11,6,10,0,0,1,11,2,4,2,4,6,6,10,15,1,15,0,0,2,1,1,0
33742,52,1464,339,213,244,17,9,65,356,10,42,26,48,52,74,259,421,5,2410,133,0,2,8,2,0
33743,75,3895,1293,570,1093,25,15,163,1318,10,195,123,241,205,364,1516,2795,6,17273,959,0,2,30,2,0
33744,248,5737,4293,999,3693,19,54,507,4312,9,155,88,170,164,258,1156,1898,4,9368,520,0,2,2,4,0
33745,248,5737,1482,859,1002,125,135,219,1607,16,219,134,251,235,385,1766,3032,9,27804,1544,1,2,2,4,0
33746,1,94,42,7,35,4,0,5,46,1,2,1,2,3,3,2,4,0,2,0,0,2,1,1,0
33747,1,94,11,6,10,0,0,1,11,2,4,2,4,6,6,10,15,1,15,0,0,2,1,1,0
33748,52,1464,339,213,244,17,9,65,356,10,42,26,48,52,74,259,421,5,2410,133,0,2,8,2,0
33749,75,3895,1293,570,1093,25,15,163,1318,10,195,123,241,205,364,1516,2795,6,17273,959,0,2,30,2,0
33750,60,1163,282,196,195,3,0,86,285,8,130,71,141,138,212,936,1507,4,6538,363,0,2,1,3,0
33751,1,96,42,7,35,4,0,5,46,1,2,1,2,3,3,2,4,0,2,0,0,2,1,1,0
33752,1,96,11,6,10,0,0,1,11,2,4,2,4,6,6,10,15,1,15,0,0,2,1,1,0
33753,229,4960,182,127,129,0,0,53,182,5,39,21,42,44,63,217,343,2,926,51,0,2,1,2,0
33754,229,4960,1165,710,800,67,119,181,1232,18,243,153,282,261,435,2000,3492,10,36473,2026,1,2,1,2,0
33755,183,5549,1660,832,1314,41,38,274,1701,20,312,209,395,332,604,2671,5058,12,64042,3557,1,2,1,1,0
33756,183,5549,1057,646,719,113,100,145,1170,18,215,134,248,233,382,1740,3004,10,31186,1732,1,2,1,1,0
33757,92,1886,757,253,292,73,244,162,830,13,61,38,67,74,105,409,651,7,4654,258,0,2,10,4,0
33758,45,953,386,256,301,16,9,68,402,4,59,35,69,63,104,355,621,2,1453,80,0,2,1,1,0
33759,45,953,264,131,164,11,41,46,275,6,38,22,40,44,62,214,338,3,1068,59,0,2,1,1,0
33760,95,2927,773,419,590,28,0,166,801,10,204,113,217,214,330,1598,2554,5,13587,754,0,2,2,2,0
33761,176,5307,1660,832,1314,41,38,274,1701,20,312,209,395,332,604,2671,5058,12,64042,3557,1,2,4,1,0
33762,159,3785,77,34,69,0,0,8,77,3,24,16,29,27,45,114,213,1,387,21,0,2,2,6,0
33763,159,3785,712,438,573,51,9,84,763,14,102,71,128,116,199,733,1364,8,11988,666,0,2,2,6,0
33764,69,1527,402,202,227,24,74,80,426,12,52,33,61,64,94,339,564,7,3969,220,0,2,5,2,0
33765,70,3211,1020,354,843,12,15,144,1032,8,134,77,144,142,221,970,1580,4,6792,377,0,2,8,5,0
33766,9,449,219,78,157,11,5,46,230,3,24,20,34,27,54,114,256,2,545,30,0,2,21,8,0
33767,53,1862,601,196,481,2,23,85,603,8,63,36,72,71,108,400,664,4,3036,168,0,2,1,1,0
33768,171,7566,4293,999,3693,19,54,507,4312,9,155,88,170,164,258,1156,1898,4,9368,520,0,2,4,5,0
33769,171,7566,1482,859,1002,125,135,219,1607,16,219,134,251,235,385,1766,3032,9,27804,1544,1,2,4,5,0
33770,33,999,465,148,393,5,8,60,470,4,31,20,31,35,51,161,261,2,523,29,0,2,2,1,0
33771,33,999,16,12,9,0,0,6,16,1,2,1,2,3,3,2,4,0,2,0,0,2,2,1,0
33772,126,5520,1782,648,1425,9,47,279,1791,8,171,97,189,179,286,1292,2140,4,9462,525,0,2,26,18,0
33773,125,5389,1513,682,1277,25,13,200,1538,11,199,116,219,210,335,1557,2584,6,15641,868,0,2,1,1,0
33774,43,2690,652,304,544,16,6,88,668,6,89,51,101,95,152,591,998,3,3399,188,0,2,1,1,0
33775,70,3187,1020,354,843,12,15,144,1032,8,134,77,144,142,221,970,1580,4,6792,377,0,2,3,3,0
33776,45,1953,386,256,301,16,9,68,402,4,59,35,69,63,104,355,621,2,1453,80,0,2,1,1,0
33777,37,1519,442,244,305,14,16,103,456,11,68,45,75,79,120,452,756,6,4588,254,0,2,1,1,0
33778,52,1986,1098,241,925,5,10,155,1103,7,46,25,49,53,74,273,423,3,1580,87,0,2,1,1,0
33779,158,7384,1392,870,1177,35,17,170,1427,14,494,280,531,508,811,4473,7289,7,54850,3047,2,2,0,2,0
33780,95,2916,773,419,590,28,0,166,801,10,204,113,217,214,330,1598,2554,5,13587,754,0,2,0,4,0
33781,70,3187,1020,354,843,12,15,144,1032,8,134,77,144,142,221,970,1580,4,6792,377,0,2,8,8,0
33782,60,1163,282,196,195,3,0,86,285,8,130,71,141,138,212,936,1507,4,6538,363,0,2,1,3,0
33783,1,96,42,7,35,4,0,5,46,1,2,1,2,3,3,2,4,0,2,0,0,2,1,1,0
33784,1,96,11,6,10,0,0,1,11,2,4,2,4,6,6,10,15,1,15,0,0,2,1,1,0
33785,229,4960,182,127,129,0,0,53,182,5,39,21,42,44,63,217,343,2,926,51,0,2,1,2,0
33786,229,4960,1165,710,800,67,119,181,1232,18,243,153,282,261,435,2000,3492,10,36473,2026,1,2,1,2,0
33787,183,5549,1660,832,1314,41,38,274,1701,20,312,209,395,332,604,2671,5058,12,64042,3557,1,2,1,1,0
33788,183,5549,1057,646,719,113,100,145,1170,18,215,134,248,233,382,1740,3004,10,31186,1732,1,2,1,1,0
33789,92,1886,757,253,292,73,244,162,830,13,61,38,67,74,105,409,651,7,4654,258,0,2,10,4,0
33790,45,953,386,256,301,16,9,68,402,4,59,35,69,63,104,355,621,2,1453,80,0,2,1,1,0
33791,45,953,264,131,164,11,41,46,275,6,38,22,40,44,62,214,338,3,1068,59,0,2,1,1,0
33792,95,2927,773,419,590,28,0,166,801,10,204,113,217,214,330,1598,2554,5,13587,754,0,2,2,2,0
33793,176,5307,1660,832,1314,41,38,274,1701,20,312,209,395,332,604,2671,5058,12,64042,3557,1,2,4,1,0
33794,115,3128,1523,757,1297,19,12,193,1542,12,193,117,230,205,347,1508,2664,7,19053,1058,0,2,43,1,0
33795,115,3128,701,378,504,33,58,109,734,13,110,68,126,123,194,794,1346,7,10027,557,0,2,43,1,0
33796,107,5109,1523,757,1297,19,12,193,1542,12,193,117,230,205,347,1508,2664,7,19053,1058,0,2,47,0,0
33797,115,3128,1523,757,1297,19,12,193,1542,12,193,117,230,205,347,1508,2664,7,19053,1058,0,2,43,1,0
33798,115,3128,701,378,504,33,58,109,734,13,110,68,126,123,194,794,1346,7,10027,557,0,2,43,1,0
33799,107,5109,1523,757,1297,19,12,193,1542,12,193,117,230,205,347,1508,2664,7,19053,1058,0,2,47,0,0
33800,159,3785,77,34,69,0,0,8,77,3,24,16,29,27,45,114,213,1,387,21,0,2,2,6,0
33801,159,3785,712,438,573,51,9,84,763,14,102,71,128,116,199,733,1364,8,11988,666,0,2,2,6,0
33802,69,1527,402,202,227,24,74,80,426,12,52,33,61,64,94,339,564,7,3969,220,0,2,5,2,0
33803,158,7384,1392,870,1177,35,17,170,1427,14,494,280,531,508,811,4473,7289,7,54850,3047,2,2,0,2,0
33804,95,2912,773,419,590,28,0,166,801,10,204,113,217,214,330,1598,2554,5,13587,754,0,2,0,4,0
33805,171,7566,4293,999,3693,19,54,507,4312,9,155,88,170,164,258,1156,1898,4,9368,520,0,2,4,5,0
33806,171,7566,1482,859,1002,125,135,219,1607,16,219,134,251,235,385,1766,3032,9,27804,1544,1,2,4,5,0
33807,33,999,465,148,393,5,8,60,470,4,31,20,31,35,51,161,261,2,523,29,0,2,2,1,0
33808,33,999,16,12,9,0,0,6,16,1,2,1,2,3,3,2,4,0,2,0,0,2,2,1,0
33809,126,5520,1782,648,1425,9,47,279,1791,8,171,97,189,179,286,1292,2140,4,9462,525,0,2,26,18,0
33810,125,5389,1513,682,1277,25,13,200,1538,11,199,116,219,210,335,1557,2584,6,15641,868,0,2,1,1,0
33811,43,2690,652,304,544,16,6,88,668,6,89,51,101,95,152,591,998,3,3399,188,0,2,1,1,0
33812,70,3187,1020,354,843,12,15,144,1032,8,134,77,144,142,221,970,1580,4,6792,377,0,2,19,16,0
33813,45,1953,386,256,301,16,9,68,402,4,59,35,69,63,104,355,621,2,1453,80,0,2,1,1,0
33814,9,449,219,78,157,11,5,46,230,3,24,20,34,27,54,114,256,2,545,30,0,2,21,8,0
33815,37,1519,442,244,305,14,16,103,456,11,68,45,75,79,120,452,756,6,4588,254,0,2,1,1,0
33816,52,1986,1098,241,925,5,10,155,1103,7,46,25,49,53,74,273,423,3,1580,87,0,2,1,1,0
33817,53,1862,601,196,481,2,23,85,603,8,63,36,72,71,108,400,664,4,3036,168,0,2,1,1,0
33818,1,96,42,7,35,4,0,5,46,1,2,1,2,3,3,2,4,0,2,0,0,2,1,0,0
33819,1,96,11,6,10,0,0,1,11,2,4,2,4,6,6,10,15,1,15,0,0,2,1,0,0
33820,183,5549,1660,832,1314,41,38,274,1701,20,312,209,395,332,604,2671,5058,12,64042,3557,1,2,17,13,0
33821,183,5549,1057,646,719,113,100,145,1170,18,215,134,248,233,382,1740,3004,10,31186,1732,1,2,17,13,0
33822,116,2173,477,336,357,30,23,73,507,16,194,134,250,210,384,1538,2962,10,30538,1696,0,2,38,18,0
33823,89,2050,996,429,845,24,10,117,1020,7,76,50,88,83,138,494,879,4,3565,198,0,2,90,35,0
33824,89,2050,456,277,329,12,42,72,468,13,85,50,97,98,147,592,972,7,7212,400,0,2,90,35,0
33825,163,3497,1513,682,1277,25,13,200,1538,11,199,116,219,210,335,1557,2584,6,15641,868,0,2,33,11,0
33826,163,3497,819,519,539,24,98,155,843,15,96,57,106,111,163,690,1107,8,9171,509,0,2,33,11,0
33827,236,4942,2,2,2,0,0,0,2,0,0,0,0,0,0,0,0,0,0,0,0,2,14,9,0
33828,236,4942,99,48,90,1,3,5,100,0,0,0,0,0,0,0,0,0,0,0,0,2,14,9,0
33829,236,4942,8,5,5,2,0,1,10,0,0,0,0,0,0,0,0,0,0,0,0,2,14,9,0
33830,236,4942,1217,716,841,84,126,174,1301,14,185,118,215,199,333,1446,2542,8,20687,1149,0,2,14,9,0
33831,236,4942,160,89,115,0,13,31,160,7,15,11,17,22,28,78,124,3,495,27,0,2,14,9,0
33832,236,4942,10,10,9,9,0,0,19,0,0,0,0,0,0,0,0,0,0,0,0,2,14,9,0
33833,236,4942,173,84,99,8,29,36,181,5,12,7,13,17,20,54,81,2,221,12,0,2,14,9,0
33834,236,4942,3,1,1,3,0,0,6,0,0,0,0,0,0,0,0,0,0,0,0,2,14,9,0
33835,52,1464,339,213,244,17,9,65,356,10,42,26,48,52,74,259,421,5,2410,133,0,2,14,8,0
33836,248,5739,4293,999,3693,19,54,507,4312,9,155,88,170,164,258,1156,1898,4,9368,520,0,2,1,0,0
33837,248,5739,1482,859,1002,125,135,219,1607,16,219,134,251,235,385,1766,3032,9,27804,1544,1,2,1,0,0
33838,28,981,74,35,59,1,0,14,75,3,14,7,14,17,21,58,85,1,128,7,0,2,2,1,0
33839,28,981,245,125,200,5,7,34,250,7,30,17,34,37,51,166,265,3,1053,58,0,2,2,1,0
33840,54,657,647,139,84,35,284,233,682,0,0,0,0,0,0,0,0,0,0,0,0,2,1,1,0
33841,115,3128,1523,757,1297,19,12,193,1542,12,193,117,230,205,347,1508,2664,7,19053,1058,0,2,75,13,0
33842,115,3128,701,378,504,33,58,109,734,13,110,68,126,123,194,794,1346,7,10027,557,0,2,75,13,0
33843,101,2612,773,422,505,30,103,129,803,14,77,46,83,91,129,535,839,7,6334,351,0,2,1,1,0
33844,159,3785,77,34,69,0,0,8,77,3,24,16,29,27,45,114,213,1,387,21,0,2,9,9,0
33845,159,3785,712,438,573,51,9,84,763,14,102,71,128,116,199,733,1364,8,11988,666,0,2,9,9,0
33846,24,612,2,2,2,0,0,0,2,0,0,0,0,0,0,0,0,0,0,0,0,2,4,2,0
33847,24,612,99,48,90,1,3,5,100,0,0,0,0,0,0,0,0,0,0,0,0,2,4,2,0
33848,24,612,8,5,5,2,0,1,10,0,0,0,0,0,0,0,0,0,0,0,0,2,4,2,0
33849,24,612,1217,716,841,84,126,174,1301,14,185,118,215,199,333,1446,2542,8,20687,1149,0,2,4,2,0
33850,24,612,160,89,115,0,13,31,160,7,15,11,17,22,28,78,124,3,495,27,0,2,4,2,0
33851,24,612,10,10,9,9,0,0,19,0,0,0,0,0,0,0,0,0,0,0,0,2,4,2,0
33852,24,612,173,84,99,8,29,36,181,5,12,7,13,17,20,54,81,2,221,12,0,2,4,2,0
33853,24,612,3,1,1,3,0,0,6,0,0,0,0,0,0,0,0,0,0,0,0,2,4,2,0
33854,69,1527,402,202,227,24,74,80,426,12,52,33,61,64,94,339,564,7,3969,220,0,2,32,18,0
33855,18,312,424,94,331,4,0,89,428,1,5,5,5,6,10,11,25,0,12,0,0,2,2,1,0
33856,18,312,38,23,23,6,0,8,44,3,11,7,11,14,18,42,68,1,102,5,0,2,2,1,0
33857,231,5969,722,423,573,19,0,135,741,12,172,101,199,184,300,1320,2257,6,15668,870,0,2,59,17,0
33858,231,5969,1508,847,911,44,250,301,1552,14,148,88,169,162,257,1120,1886,7,15077,837,0,2,59,17,0
33859,314,6930,72,33,56,0,4,12,72,1,1,1,1,2,2,0,2,0,1,0,0,2,13,10,0
33860,314,6930,1454,835,1044,76,110,219,1530,17,275,158,296,292,454,2297,3718,9,34017,1889,1,2,13,10,0
33861,67,1753,466,257,367,18,25,50,484,7,126,86,171,133,257,898,1813,4,8612,478,0,2,8,1,0
33862,67,1753,507,281,342,29,59,88,536,10,53,29,57,63,86,336,514,5,2764,153,0,2,8,1,0
33863,89,1894,1043,504,840,53,9,147,1096,9,180,112,198,189,310,1377,2344,4,11604,644,0,2,1,2,0
33864,89,1894,383,288,292,26,6,62,409,11,65,38,67,76,105,429,656,5,3719,206,0,2,1,2,0
33865,41,821,1178,367,1042,6,15,115,1184,9,94,51,95,103,146,644,976,4,4439,246,0,2,1,125,0
33866,41,821,177,108,140,8,0,27,185,6,30,16,32,36,48,162,248,3,794,44,0,2,1,125,0
33867,281,5902,1943,715,1694,26,18,214,1969,12,185,120,237,197,357,1436,2721,7,20915,1161,0,2,195,42,0
33868,281,5902,1168,838,957,57,25,144,1225,19,348,224,416,367,640,3018,5452,11,61921,3440,1,2,195,42,0
33869,2,156,37,13,25,0,6,6,37,1,2,1,2,3,3,2,4,0,2,0,0,2,57,6,0
33870,2,156,133,47,40,1,43,49,134,0,0,0,0,0,0,0,0,0,0,0,0,2,57,6,0
33871,112,4538,1289,550,1043,56,32,155,1345,10,167,93,185,177,278,1266,2075,5,11498,638,0,2,14,1,0
33872,158,7384,1392,870,1177,35,17,170,1427,14,494,280,531,508,811,4473,7289,7,54850,3047,2,2,0,2,0
33873,95,2912,773,419,590,28,0,166,801,10,204,113,217,214,330,1598,2554,5,13587,754,0,2,0,4,0
33874,7,123,127,75,83,2,11,30,129,4,14,7,14,18,21,61,87,2,175,9,0,0,36,0,0
33875,7,123,652,304,544,16,6,88,668,6,89,51,101,95,152,591,998,3,3399,188,0,0,36,0,0
33876,7,123,2,2,2,0,0,0,2,0,0,0,0,0,0,0,0,0,0,0,0,0,36,0,0
33877,7,123,8,5,5,0,0,3,8,0,0,0,0,0,0,0,0,0,0,0,0,0,36,0,0
33878,7,123,2,2,2,0,0,0,2,0,0,0,0,0,0,0,0,0,0,0,0,0,36,0,0
33879,7,123,14,8,8,0,0,6,14,0,0,0,0,0,0,0,0,0,0,0,0,0,36,0,0
33880,7,123,6,4,4,0,0,2,6,0,0,0,0,0,0,0,0,0,0,0,0,0,36,0,0
33881,7,123,6,4,4,0,0,2,6,1,2,1,2,3,3,2,4,0,2,0,0,0,36,0,0
33882,7,123,6,4,4,0,0,2,6,0,0,0,0,0,0,0,0,0,0,0,0,0,36,0,0
33883,7,123,7,5,5,0,0,2,7,0,0,0,0,0,0,0,0,0,0,0,0,0,36,0,0
33884,7,123,6,4,4,0,0,2,6,0,0,0,0,0,0,0,0,0,0,0,0,0,36,0,0
33885,7,123,10,6,6,0,0,4,10,0,0,0,0,0,0,0,0,0,0,0,0,0,36,0,0
33886,7,123,1,1,1,0,0,0,1,0,0,0,0,0,0,0,0,0,0,0,0,0,36,0,0
33887,7,123,1,1,1,0,0,0,1,0,0,0,0,0,0,0,0,0,0,0,0,0,36,0,0
33888,7,123,14,10,10,0,0,4,14,1,1,1,1,2,2,0,2,0,1,0,0,0,36,0,0
33889,7,123,46,26,30,3,0,12,49,3,6,3,6,9,9,20,28,1,42,2,0,0,36,0,0
33890,36,2427,1157,318,931,29,22,177,1186,6,104,63,125,110,188,712,1274,3,4596,255,0,2,7,7,0
33891,171,7566,4293,999,3693,19,54,507,4312,9,155,88,170,164,258,1156,1898,4,9368,520,0,2,20,7,0
33892,171,7566,1482,859,1002,125,135,219,1607,16,219,134,251,235,385,1766,3032,9,27804,1544,1,2,20,7,0
33893,33,999,465,148,393,5,8,60,470,4,31,20,31,35,51,161,261,2,523,29,0,2,2,1,0
33894,33,999,16,12,9,0,0,6,16,1,2,1,2,3,3,2,4,0,2,0,0,2,2,1,0
33895,126,5520,1782,648,1425,9,47,279,1791,8,171,97,189,179,286,1292,2140,4,9462,525,0,2,26,18,0
33896,128,5170,1450,624,1228,12,26,181,1462,14,306,186,354,320,540,2580,4493,8,36391,2021,1,2,44,0,0
33897,48,3659,996,429,845,24,10,117,1020,7,76,50,88,83,138,494,879,4,3565,198,0,2,105,13,0
33898,125,5389,1513,682,1277,25,13,200,1538,11,199,116,219,210,335,1557,2584,6,15641,868,0,2,8,9,0
33899,103,5336,1457,730,1242,11,6,188,1468,10,292,166,329,302,495,2424,4078,5,22973,1276,1,2,8,12,0
33900,43,2690,652,304,544,16,6,88,668,6,89,51,101,95,152,591,998,3,3399,188,0,2,1,1,0
33901,107,5109,1523,757,1297,19,12,193,1542,12,193,117,230,205,347,1508,2664,7,19053,1058,0,2,102,15,0
33902,70,3187,1020,354,843,12,15,144,1032,8,134,77,144,142,221,970,1580,4,6792,377,0,2,19,16,0
33903,75,3895,1293,570,1093,25,15,163,1318,10,195,123,241,205,364,1516,2795,6,17273,959,0,2,45,5,0
33904,29,1903,384,251,317,7,8,52,391,11,70,44,84,81,128,467,811,6,5355,297,0,2,4,0,0
33905,55,2800,722,423,573,19,0,135,741,12,172,101,199,184,300,1320,2257,6,15668,870,0,2,77,0,0
33906,45,1953,386,256,301,16,9,68,402,4,59,35,69,63,104,355,621,2,1453,80,0,2,1,1,0
33907,86,3411,1043,504,840,53,9,147,1096,9,180,112,198,189,310,1377,2344,4,11604,644,0,2,23,0,0
33908,80,3144,1178,367,1042,6,15,115,1184,9,94,51,95,103,146,644,976,4,4439,246,0,2,2,36,0
33909,9,449,219,78,157,11,5,46,230,3,24,20,34,27,54,114,256,2,545,30,0,2,21,8,0
33910,111,6122,1943,715,1694,26,18,214,1969,12,185,120,237,197,357,1436,2721,7,20915,1161,0,2,168,8,0
33911,37,1519,442,244,305,14,16,103,456,11,68,45,75,79,120,452,756,6,4588,254,0,2,1,1,0
33912,52,1986,1098,241,925,5,10,155,1103,7,46,25,49,53,74,273,423,3,1580,87,0,2,1,1,0
33913,53,1862,601,196,481,2,23,85,603,8,63,36,72,71,108,400,664,4,3036,168,0,2,2,2,0
33914,76,3910,1293,570,1093,25,15,163,1318,10,195,123,241,205,364,1516,2795,6,17273,959,0,2,16,12,0
33915,125,5389,1513,682,1277,25,13,200,1538,11,199,116,219,210,335,1557,2584,6,15641,868,0,2,1,1,0
33916,75,3895,1293,570,1093,25,15,163,1318,10,195,123,241,205,364,1516,2795,6,17273,959,0,2,4,4,0
33917,30,1440,373,158,315,8,0,51,381,5,76,44,79,81,123,486,779,2,2026,112,0,2,1,1,0
33918,164,3518,1513,682,1277,25,13,200,1538,11,199,116,219,210,335,1557,2584,6,15641,868,0,2,4,0,0
33919,164,3518,819,519,539,24,98,155,843,15,96,57,106,111,163,690,1107,8,9171,509,0,2,4,0,0
33920,126,5406,1513,682,1277,25,13,200,1538,11,199,116,219,210,335,1557,2584,6,15641,868,0,2,3,0,0
33921,41,821,1178,367,1042,6,15,115,1184,9,94,51,95,103,146,644,976,4,4439,246,0,2,1,1,0
33922,41,821,177,108,140,8,0,27,185,6,30,16,32,36,48,162,248,3,794,44,0,2,1,1,0
33923,112,4538,1289,550,1043,56,32,155,1345,10,167,93,185,177,278,1266,2075,5,11498,638,0,2,1,1,0
33924,158,7384,1392,870,1177,35,17,170,1427,14,494,280,531,508,811,4473,7289,7,54850,3047,2,2,1,1,0
33925,95,2912,773,419,590,28,0,166,801,10,204,113,217,214,330,1598,2554,5,13587,754,0,2,1,1,0
33926,12,318,149,95,105,2,0,41,151,8,54,28,55,62,83,334,494,4,2013,111,0,2,1,1,0
33927,15,703,139,89,101,2,0,35,141,7,54,34,62,61,96,330,569,4,2287,127,0,2,1,1,0
33928,36,2427,1157,318,931,29,22,177,1186,6,104,63,125,110,188,712,1274,3,4596,255,0,2,2,2,0
33929,90,3974,1338,495,1086,10,64,173,1348,11,122,82,157,133,239,883,1686,7,11934,663,0,2,3,3,0
33930,171,7566,4293,999,3693,19,54,507,4312,9,155,88,170,164,258,1156,1898,4,9368,520,0,2,1,1,0
33931,171,7566,1482,859,1002,125,135,219,1607,16,219,134,251,235,385,1766,3032,9,27804,1544,1,2,1,1,0
33932,126,5520,1782,648,1425,9,47,279,1791,8,171,97,189,179,286,1292,2140,4,9462,525,0,2,1,1,0
33933,6,328,180,34,164,0,0,16,180,1,12,6,12,13,18,43,66,0,33,1,0,2,1,1,0
33934,128,5170,1450,624,1228,12,26,181,1462,14,306,186,354,320,540,2580,4493,8,36391,2021,1,2,2,2,0
33935,176,5307,1660,832,1314,41,38,274,1701,20,312,209,395,332,604,2671,5058,12,64042,3557,1,2,4,4,0
33936,125,5389,1513,682,1277,25,13,200,1538,11,199,116,219,210,335,1557,2584,6,15641,868,0,2,2,2,0
33937,72,3310,1455,414,1257,16,76,112,1471,5,41,23,46,46,69,231,381,2,1069,59,0,2,1,1,0
33938,107,5109,1523,757,1297,19,12,193,1542,12,193,117,230,205,347,1508,2664,7,19053,1058,0,2,1,1,0
33939,29,1903,384,251,317,7,8,52,391,11,70,44,84,81,128,467,811,6,5355,297,0,2,2,2,0
33940,55,2800,722,423,573,19,0,135,741,12,172,101,199,184,300,1320,2257,6,15668,870,0,2,1,1,0
33941,86,3411,1043,504,840,53,9,147,1096,9,180,112,198,189,310,1377,2344,4,11604,644,0,2,2,2,0
33942,80,3144,1178,367,1042,6,15,115,1184,9,94,51,95,103,146,644,976,4,4439,246,0,2,1,1,0
33943,53,1862,601,196,481,2,23,85,603,8,63,36,72,71,108,400,664,4,3036,168,0,2,4,4,0
33944,3,42,14,8,8,0,0,6,14,0,0,0,0,0,0,0,0,0,0,0,0,2,1,0,0
33945,2,40,9,6,6,0,0,3,9,0,0,0,0,0,0,0,0,0,0,0,0,2,1,0,0
33946,2,40,13,9,8,0,0,4,13,0,0,0,0,0,0,0,0,0,0,0,0,2,1,0,0
33947,60,1163,282,196,195,3,0,86,285,8,130,71,141,138,212,936,1507,4,6538,363,0,2,1,0,0
33948,4,77,127,75,83,2,11,30,129,4,14,7,14,18,21,61,87,2,175,9,0,2,1,0,0
33949,4,77,652,304,544,16,6,88,668,6,89,51,101,95,152,591,998,3,3399,188,0,2,1,0,0
33950,4,77,2,2,2,0,0,0,2,0,0,0,0,0,0,0,0,0,0,0,0,2,1,0,0
33951,4,77,8,5,5,0,0,3,8,0,0,0,0,0,0,0,0,0,0,0,0,2,1,0,0
33952,4,77,2,2,2,0,0,0,2,0,0,0,0,0,0,0,0,0,0,0,0,2,1,0,0
33953,4,77,14,8,8,0,0,6,14,0,0,0,0,0,0,0,0,0,0,0,0,2,1,0,0
33954,4,77,6,4,4,0,0,2,6,0,0,0,0,0,0,0,0,0,0,0,0,2,1,0,0
33955,4,77,6,4,4,0,0,2,6,1,2,1,2,3,3,2,4,0,2,0,0,2,1,0,0
33956,4,77,6,4,4,0,0,2,6,0,0,0,0,0,0,0,0,0,0,0,0,2,1,0,0
33957,4,77,7,5,5,0,0,2,7,0,0,0,0,0,0,0,0,0,0,0,0,2,1,0,0
33958,4,77,6,4,4,0,0,2,6,0,0,0,0,0,0,0,0,0,0,0,0,2,1,0,0
33959,4,77,10,6,6,0,0,4,10,0,0,0,0,0,0,0,0,0,0,0,0,2,1,0,0
33960,4,77,1,1,1,0,0,0,1,0,0,0,0,0,0,0,0,0,0,0,0,2,1,0,0
33961,4,77,1,1,1,0,0,0,1,0,0,0,0,0,0,0,0,0,0,0,0,2,1,0,0
33962,4,77,14,10,10,0,0,4,14,1,1,1,1,2,2,0,2,0,1,0,0,2,1,0,0
33963,4,77,46,26,30,3,0,12,49,3,6,3,6,9,9,20,28,1,42,2,0,2,1,0,0
33964,1,9,5,3,3,0,0,2,5,0,0,0,0,0,0,0,0,0,0,0,0,2,1,0,0
33965,1,90,13,10,10,0,0,3,13,1,2,1,2,3,3,2,4,0,2,0,0,2,1,0,0
33966,7,114,44,19,17,0,16,11,44,3,14,7,14,17,21,58,85,1,128,7,0,2,1,0,0
33967,3,66,127,75,83,2,11,30,129,4,14,7,14,18,21,61,87,2,175,9,0,2,1,0,0
33968,3,66,652,304,544,16,6,88,668,6,89,51,101,95,152,591,998,3,3399,188,0,2,1,0,0
33969,3,66,2,2,2,0,0,0,2,0,0,0,0,0,0,0,0,0,0,0,0,2,1,0,0
33970,3,66,8,5,5,0,0,3,8,0,0,0,0,0,0,0,0,0,0,0,0,2,1,0,0
33971,3,66,2,2,2,0,0,0,2,0,0,0,0,0,0,0,0,0,0,0,0,2,1,0,0
33972,3,66,14,8,8,0,0,6,14,0,0,0,0,0,0,0,0,0,0,0,0,2,1,0,0
33973,3,66,6,4,4,0,0,2,6,0,0,0,0,0,0,0,0,0,0,0,0,2,1,0,0
33974,3,66,6,4,4,0,0,2,6,1,2,1,2,3,3,2,4,0,2,0,0,2,1,0,0
33975,3,66,6,4,4,0,0,2,6,0,0,0,0,0,0,0,0,0,0,0,0,2,1,0,0
33976,3,66,7,5,5,0,0,2,7,0,0,0,0,0,0,0,0,0,0,0,0,2,1,0,0
33977,3,66,6,4,4,0,0,2,6,0,0,0,0,0,0,0,0,0,0,0,0,2,1,0,0
33978,3,66,10,6,6,0,0,4,10,0,0,0,0,0,0,0,0,0,0,0,0,2,1,0,0
33979,3,66,1,1,1,0,0,0,1,0,0,0,0,0,0,0,0,0,0,0,0,2,1,0,0
33980,3,66,1,1,1,0,0,0,1,0,0,0,0,0,0,0,0,0,0,0,0,2,1,0,0
33981,3,66,14,10,10,0,0,4,14,1,1,1,1,2,2,0,2,0,1,0,0,2,1,0,0
33982,3,66,46,26,30,3,0,12,49,3,6,3,6,9,9,20,28,1,42,2,0,2,1,0,0
33983,7,296,72,33,56,0,4,12,72,1,1,1,1,2,2,0,2,0,1,0,0,2,1,0,0
33984,12,229,127,75,83,2,11,30,129,4,14,7,14,18,21,61,87,2,175,9,0,2,1,0,0
33985,12,229,652,304,544,16,6,88,668,6,89,51,101,95,152,591,998,3,3399,188,0,2,1,0,0
33986,12,229,2,2,2,0,0,0,2,0,0,0,0,0,0,0,0,0,0,0,0,2,1,0,0
33987,12,229,8,5,5,0,0,3,8,0,0,0,0,0,0,0,0,0,0,0,0,2,1,0,0
33988,12,229,2,2,2,0,0,0,2,0,0,0,0,0,0,0,0,0,0,0,0,2,1,0,0
33989,12,229,14,8,8,0,0,6,14,0,0,0,0,0,0,0,0,0,0,0,0,2,1,0,0
33990,12,229,6,4,4,0,0,2,6,0,0,0,0,0,0,0,0,0,0,0,0,2,1,0,0
33991,12,229,6,4,4,0,0,2,6,1,2,1,2,3,3,2,4,0,2,0,0,2,1,0,0
33992,12,229,6,4,4,0,0,2,6,0,0,0,0,0,0,0,0,0,0,0,0,2,1,0,0
33993,12,229,7,5,5,0,0,2,7,0,0,0,0,0,0,0,0,0,0,0,0,2,1,0,0
33994,12,229,6,4,4,0,0,2,6,0,0,0,0,0,0,0,0,0,0,0,0,2,1,0,0
33995,12,229,10,6,6,0,0,4,10,0,0,0,0,0,0,0,0,0,0,0,0,2,1,0,0
33996,12,229,1,1,1,0,0,0,1,0,0,0,0,0,0,0,0,0,0,0,0,2,1,0,0
33997,12,229,1,1,1,0,0,0,1,0,0,0,0,0,0,0,0,0,0,0,0,2,1,0,0
33998,12,229,14,10,10,0,0,4,14,1,1,1,1,2,2,0,2,0,1,0,0,2,1,0,0
33999,12,229,46,26,30,3,0,12,49,3,6,3,6,9,9,20,28,1,42,2,0,2,1,0,0
34000,6,71,127,75,83,2,11,30,129,4,14,7,14,18,21,61,87,2,175,9,0,2,1,0,0
34001,6,71,652,304,544,16,6,88,668,6,89,51,101,95,152,591,998,3,3399,188,0,2,1,0,0
34002,6,71,2,2,2,0,0,0,2,0,0,0,0,0,0,0,0,0,0,0,0,2,1,0,0
34003,6,71,8,5,5,0,0,3,8,0,0,0,0,0,0,0,0,0,0,0,0,2,1,0,0
34004,6,71,2,2,2,0,0,0,2,0,0,0,0,0,0,0,0,0,0,0,0,2,1,0,0
34005,6,71,14,8,8,0,0,6,14,0,0,0,0,0,0,0,0,0,0,0,0,2,1,0,0
34006,6,71,6,4,4,0,0,2,6,0,0,0,0,0,0,0,0,0,0,0,0,2,1,0,0
34007,6,71,6,4,4,0,0,2,6,1,2,1,2,3,3,2,4,0,2,0,0,2,1,0,0
34008,6,71,6,4,4,0,0,2,6,0,0,0,0,0,0,0,0,0,0,0,0,2,1,0,0
34009,6,71,7,5,5,0,0,2,7,0,0,0,0,0,0,0,0,0,0,0,0,2,1,0,0
34010,6,71,6,4,4,0,0,2,6,0,0,0,0,0,0,0,0,0,0,0,0,2,1,0,0
34011,6,71,10,6,6,0,0,4,10,0,0,0,0,0,0,0,0,0,0,0,0,2,1,0,0
34012,6,71,1,1,1,0,0,0,1,0,0,0,0,0,0,0,0,0,0,0,0,2,1,0,0
34013,6,71,1,1,1,0,0,0,1,0,0,0,0,0,0,0,0,0,0,0,0,2,1,0,0
34014,6,71,14,10,10,0,0,4,14,1,1,1,1,2,2,0,2,0,1,0,0,2,1,0,0
34015,6,71,46,26,30,3,0,12,49,3,6,3,6,9,9,20,28,1,42,2,0,2,1,0,0
34016,3,26,14,7,7,2,0,5,16,0,0,0,0,0,0,0,0,0,0,0,0,2,1,0,0
34017,7,103,38,23,23,0,0,15,38,0,0,0,0,0,0,0,0,0,0,0,0,2,1,0,0
34018,17,378,85,59,61,8,0,16,93,5,18,10,18,23,28,86,126,2,316,17,0,2,1,0,0
34019,12,515,124,78,88,2,3,26,126,4,13,7,13,17,20,56,81,2,163,9,0,2,1,0,0
34020,1,96,42,7,35,4,0,5,46,1,2,1,2,3,3,2,4,0,2,0,0,2,1,0,0
34021,1,96,11,6,10,0,0,1,11,2,4,2,4,6,6,10,15,1,15,0,0,2,1,0,0
34022,11,242,19,8,11,5,0,4,24,2,5,3,6,7,9,13,25,1,30,1,0,2,1,0,0
34023,11,242,102,59,69,5,3,24,107,6,22,15,28,28,43,113,206,3,789,43,0,2,1,0,0
34024,11,242,106,40,36,3,49,17,109,8,17,13,23,25,36,93,167,5,904,50,0,2,1,0,0
34025,229,4960,182,127,129,0,0,53,182,5,39,21,42,44,63,217,343,2,926,51,0,2,1,0,0
34026,229,4960,1165,710,800,67,119,181,1232,18,243,153,282,261,435,2000,3492,10,36473,2026,1,2,1,0,0
34027,67,1570,773,419,590,28,0,166,801,10,204,113,217,214,330,1598,2554,5,13587,754,0,2,1,0,0
34028,67,1570,421,273,302,44,34,57,465,17,81,59,107,98,166,583,1098,11,12329,684,0,2,1,0,0
34029,14,411,149,95,105,2,0,41,151,8,54,28,55,62,83,334,494,4,2013,111,0,2,1,0,0
34030,14,411,82,56,54,0,13,15,82,4,13,8,16,17,24,56,98,2,241,13,0,2,1,0,0
34031,26,529,2,2,2,0,0,0,2,0,0,0,0,0,0,0,0,0,0,0,0,2,1,0,0
34032,26,529,99,48,90,1,3,5,100,0,0,0,0,0,0,0,0,0,0,0,0,2,1,0,0
34033,26,529,8,5,5,2,0,1,10,0,0,0,0,0,0,0,0,0,0,0,0,2,1,0,0
34034,26,529,1217,716,841,84,126,174,1301,14,185,118,215,199,333,1446,2542,8,20687,1149,0,2,1,0,0
34035,26,529,160,89,115,0,13,31,160,7,15,11,17,22,28,78,124,3,495,27,0,2,1,0,0
34036,26,529,10,10,9,9,0,0,19,0,0,0,0,0,0,0,0,0,0,0,0,2,1,0,0
34037,26,529,173,84,99,8,29,36,181,5,12,7,13,17,20,54,81,2,221,12,0,2,1,0,0
34038,26,529,3,1,1,3,0,0,6,0,0,0,0,0,0,0,0,0,0,0,0,2,1,0,0
34039,183,5549,1660,832,1314,41,38,274,1701,20,312,209,395,332,604,2671,5058,12,64042,3557,1,2,1,0,0
34040,183,5549,1057,646,719,113,100,145,1170,18,215,134,248,233,382,1740,3004,10,31186,1732,1,2,1,0,0
34041,17,348,95,58,50,9,16,20,104,12,33,24,45,45,69,209,378,8,3100,172,0,2,1,0,0
34042,116,2173,477,336,357,30,23,73,507,16,194,134,250,210,384,1538,2962,10,30538,1696,0,2,1,0,0
34043,89,2050,996,429,845,24,10,117,1020,7,76,50,88,83,138,494,879,4,3565,198,0,2,1,0,0
34044,89,2050,456,277,329,12,42,72,468,13,85,50,97,98,147,592,972,7,7212,400,0,2,1,0,0
34045,163,3497,1513,682,1277,25,13,200,1538,11,199,116,219,210,335,1557,2584,6,15641,868,0,2,1,0,0
34046,163,3497,819,519,539,24,98,155,843,15,96,57,106,111,163,690,1107,8,9171,509,0,2,1,0,0
34047,73,1518,207,111,150,11,0,50,218,5,26,19,36,31,55,133,272,3,943,52,0,2,1,0,0
34048,73,1518,410,198,237,31,55,97,441,11,63,38,72,74,110,414,683,6,4293,238,0,2,1,0,0
34049,236,4942,2,2,2,0,0,0,2,0,0,0,0,0,0,0,0,0,0,0,0,2,1,0,0
34050,236,4942,99,48,90,1,3,5,100,0,0,0,0,0,0,0,0,0,0,0,0,2,1,0,0
34051,236,4942,8,5,5,2,0,1,10,0,0,0,0,0,0,0,0,0,0,0,0,2,1,0,0
34052,236,4942,1217,716,841,84,126,174,1301,14,185,118,215,199,333,1446,2542,8,20687,1149,0,2,1,0,0
34053,236,4942,160,89,115,0,13,31,160,7,15,11,17,22,28,78,124,3,495,27,0,2,1,0,0
34054,236,4942,10,10,9,9,0,0,19,0,0,0,0,0,0,0,0,0,0,0,0,2,1,0,0
34055,236,4942,173,84,99,8,29,36,181,5,12,7,13,17,20,54,81,2,221,12,0,2,1,0,0
34056,236,4942,3,1,1,3,0,0,6,0,0,0,0,0,0,0,0,0,0,0,0,2,1,0,0
34057,98,2019,463,295,324,28,62,57,491,12,134,82,154,146,236,989,1696,6,11700,650,0,2,1,0,0
34058,55,770,167,116,138,4,5,22,171,8,48,30,56,56,86,292,499,4,2330,129,0,2,1,0,0
34059,52,1464,339,213,244,17,9,65,356,10,42,26,48,52,74,259,421,5,2410,133,0,2,1,0,0
34060,95,2385,1455,414,1257,16,76,112,1471,5,41,23,46,46,69,231,381,2,1069,59,0,2,1,0,0
34061,95,2385,669,365,481,22,61,110,691,15,103,63,122,118,185,747,1273,8,11311,628,0,2,1,0,0
34062,248,5739,4293,999,3693,19,54,507,4312,9,155,88,170,164,258,1156,1898,4,9368,520,0,2,1,0,0
34063,248,5739,1482,859,1002,125,135,219,1607,16,219,134,251,235,385,1766,3032,9,27804,1544,1,2,1,0,0
34064,6,140,44,22,19,0,19,6,44,2,10,6,12,12,18,35,64,1,77,4,0,2,1,0,0
34065,28,981,74,35,59,1,0,14,75,3,14,7,14,17,21,58,85,1,128,7,0,2,1,0,0
34066,28,981,245,125,200,5,7,34,250,7,30,17,34,37,51,166,265,3,1053,58,0,2,1,0,0
34067,54,657,647,139,84,35,284,233,682,0,0,0,0,0,0,0,0,0,0,0,0,2,1,0,0
34068,115,3128,1523,757,1297,19,12,193,1542,12,193,117,230,205,347,1508,2664,7,19053,1058,0,2,1,0,0
34069,115,3128,701,378,504,33,58,109,734,13,110,68,126,123,194,794,1346,7,10027,557,0,2,1,0,0
34070,101,2612,773,422,505,30,103,129,803,14,77,46,83,91,129,535,839,7,6334,351,0,2,1,0,0
34071,159,3785,77,34,69,0,0,8,77,3,24,16,29,27,45,114,213,1,387,21,0,2,1,0,0
34072,159,3785,712,438,573,51,9,84,763,14,102,71,128,116,199,733,1364,8,11988,666,0,2,1,0,0
34073,24,612,2,2,2,0,0,0,2,0,0,0,0,0,0,0,0,0,0,0,0,2,1,0,0
34074,24,612,99,48,90,1,3,5,100,0,0,0,0,0,0,0,0,0,0,0,0,2,1,0,0
34075,24,612,8,5,5,2,0,1,10,0,0,0,0,0,0,0,0,0,0,0,0,2,1,0,0
34076,24,612,1217,716,841,84,126,174,1301,14,185,118,215,199,333,1446,2542,8,20687,1149,0,2,1,0,0
34077,24,612,160,89,115,0,13,31,160,7,15,11,17,22,28,78,124,3,495,27,0,2,1,0,0
34078,24,612,10,10,9,9,0,0,19,0,0,0,0,0,0,0,0,0,0,0,0,2,1,0,0
34079,24,612,173,84,99,8,29,36,181,5,12,7,13,17,20,54,81,2,221,12,0,2,1,0,0
34080,24,612,3,1,1,3,0,0,6,0,0,0,0,0,0,0,0,0,0,0,0,2,1,0,0
34081,30,664,125,97,103,3,0,19,128,9,25,17,27,34,44,144,223,4,1087,60,0,2,1,0,0
34082,22,373,102,57,55,5,16,25,107,5,17,10,18,22,28,81,124,2,330,18,0,2,1,0,0
34083,69,1527,402,202,227,24,74,80,426,12,52,33,61,64,94,339,564,7,3969,220,0,2,1,0,0
34084,55,1174,447,308,343,6,5,95,453,7,96,59,111,103,170,651,1136,4,4600,255,0,2,1,0,0
34085,55,1174,322,174,179,16,74,51,338,10,41,26,46,51,72,252,408,5,2291,127,0,2,1,0,0
34086,75,1629,53,23,39,0,0,13,53,2,8,4,8,10,12,26,39,1,39,2,0,2,1,0,0
34087,75,1629,515,298,307,33,80,99,548,12,63,44,77,75,121,419,753,7,5527,307,0,2,1,0,0
34088,18,312,424,94,331,4,0,89,428,1,5,5,5,6,10,11,25,0,12,0,0,2,1,0,0
34089,18,312,38,23,23,6,0,8,44,3,11,7,11,14,18,42,68,1,102,5,0,2,1,0,0
34090,20,531,205,80,86,16,53,53,221,7,18,10,19,25,29,94,134,3,497,27,0,2,1,0,0
34091,17,523,184,100,137,2,15,30,186,6,38,20,39,44,59,214,322,3,991,55,0,2,1,0,0
34092,17,523,103,65,74,8,5,16,111,7,17,9,17,24,26,89,119,3,417,23,0,2,1,0,0
34093,59,1228,91,45,69,0,3,18,91,3,9,6,10,12,16,33,57,1,95,5,0,2,1,0,0
34094,59,1228,367,234,237,17,34,68,384,16,55,34,61,71,95,381,584,8,5183,287,0,2,1,0,0
34095,231,5969,722,423,573,19,0,135,741,12,172,101,199,184,300,1320,2257,6,15668,870,0,2,1,0,0
34096,231,5969,1508,847,911,44,250,301,1552,14,148,88,169,162,257,1120,1886,7,15077,837,0,2,1,0,0
34097,314,6930,72,33,56,0,4,12,72,1,1,1,1,2,2,0,2,0,1,0,0,2,1,0,0
34098,314,6930,1454,835,1044,76,110,219,1530,17,275,158,296,292,454,2297,3718,9,34017,1889,1,2,1,0,0
34099,92,1886,757,253,292,73,244,162,830,13,61,38,67,74,105,409,651,7,4654,258,0,2,1,0,0
34100,45,953,386,256,301,16,9,68,402,4,59,35,69,63,104,355,621,2,1453,80,0,2,1,0,0
34101,45,953,264,131,164,11,41,46,275,6,38,22,40,44,62,214,338,3,1068,59,0,2,1,0,0
34102,67,1753,466,257,367,18,25,50,484,7,126,86,171,133,257,898,1813,4,8612,478,0,2,1,0,0
34103,67,1753,507,281,342,29,59,88,536,10,53,29,57,63,86,336,514,5,2764,153,0,2,1,0,0
34104,25,552,215,129,180,6,0,29,221,8,65,43,72,73,115,415,711,4,3153,175,0,2,1,0,0
34105,25,552,97,69,77,3,3,16,100,6,22,13,23,28,36,113,173,3,542,30,0,2,1,0,0
34106,89,1894,1043,504,840,53,9,147,1096,9,180,112,198,189,310,1377,2344,4,11604,644,0,2,1,0,0
34107,89,1894,383,288,292,26,6,62,409,11,65,38,67,76,105,429,656,5,3719,206,0,2,1,0,0
34108,20,420,294,64,250,0,0,43,294,1,20,10,20,21,30,86,131,0,65,3,0,2,1,0,0
34109,20,420,78,46,62,3,0,14,81,3,8,4,8,11,12,28,41,1,62,3,0,2,1,0,0
34110,5,123,110,30,77,3,13,16,113,4,21,15,30,25,45,100,208,2,597,33,0,2,1,0,0
34111,5,123,28,15,21,1,0,6,29,0,0,0,0,0,0,0,0,0,0,0,0,2,1,0,0
34112,41,821,1178,367,1042,6,15,115,1184,9,94,51,95,103,146,644,976,4,4439,246,0,2,1,1,0
34113,41,821,177,108,140,8,0,27,185,6,30,16,32,36,48,162,248,3,794,44,0,2,1,1,0
34114,28,452,219,78,157,11,5,46,230,3,24,20,34,27,54,114,256,2,545,30,0,2,1,0,0
34115,28,452,108,64,79,9,0,20,117,5,15,11,19,20,30,70,129,3,410,22,0,2,1,0,0
34116,281,5902,1943,715,1694,26,18,214,1969,12,185,120,237,197,357,1436,2721,7,20915,1161,0,2,1,1,0
34117,281,5902,1168,838,957,57,25,144,1225,19,348,224,416,367,640,3018,5452,11,61921,3440,1,2,1,1,0
34118,19,720,442,244,305,14,16,103,456,11,68,45,75,79,120,452,756,6,4588,254,0,2,1,0,0
34119,19,720,182,102,99,11,40,35,193,3,11,6,11,14,17,42,64,1,97,5,0,2,1,0,0
34120,69,1323,1098,241,925,5,10,155,1103,7,46,25,49,53,74,273,423,3,1580,87,0,2,1,0,0
34121,69,1323,282,202,222,14,2,44,296,8,42,24,43,50,67,250,378,4,1548,86,0,2,1,0,0
34122,2,156,37,13,25,0,6,6,37,1,2,1,2,3,3,2,4,0,2,0,0,2,1,0,0
34123,2,156,133,47,40,1,43,49,134,0,0,0,0,0,0,0,0,0,0,0,0,2,1,0,0
34124,29,743,601,196,481,2,23,85,603,8,63,36,72,71,108,400,664,4,3036,168,0,2,1,0,0
34125,29,743,156,79,106,5,16,28,161,5,14,8,15,19,23,64,97,2,261,14,0,2,1,0,0
34126,112,4538,1289,550,1043,56,32,155,1345,10,167,93,185,177,278,1266,2075,5,11498,638,0,2,1,1,0
34127,36,1120,182,127,129,0,0,53,182,5,39,21,42,44,63,217,343,2,926,51,0,2,1,1,0
34128,158,7384,1392,870,1177,35,17,170,1427,14,494,280,531,508,811,4473,7289,7,54850,3047,2,2,1,1,0
34129,95,2912,773,419,590,28,0,166,801,10,204,113,217,214,330,1598,2554,5,13587,754,0,2,1,1,0
34130,7,123,127,75,83,2,11,30,129,4,14,7,14,18,21,61,87,2,175,9,0,2,1,0,0
34131,7,123,652,304,544,16,6,88,668,6,89,51,101,95,152,591,998,3,3399,188,0,2,1,0,0
34132,7,123,2,2,2,0,0,0,2,0,0,0,0,0,0,0,0,0,0,0,0,2,1,0,0
34133,7,123,8,5,5,0,0,3,8,0,0,0,0,0,0,0,0,0,0,0,0,2,1,0,0
34134,7,123,2,2,2,0,0,0,2,0,0,0,0,0,0,0,0,0,0,0,0,2,1,0,0
34135,7,123,14,8,8,0,0,6,14,0,0,0,0,0,0,0,0,0,0,0,0,2,1,0,0
34136,7,123,6,4,4,0,0,2,6,0,0,0,0,0,0,0,0,0,0,0,0,2,1,0,0
34137,7,123,6,4,4,0,0,2,6,1,2,1,2,3,3,2,4,0,2,0,0,2,1,0,0
34138,7,123,6,4,4,0,0,2,6,0,0,0,0,0,0,0,0,0,0,0,0,2,1,0,0
34139,7,123,7,5,5,0,0,2,7,0,0,0,0,0,0,0,0,0,0,0,0,2,1,0,0
34140,7,123,6,4,4,0,0,2,6,0,0,0,0,0,0,0,0,0,0,0,0,2,1,0,0
34141,7,123,10,6,6,0,0,4,10,0,0,0,0,0,0,0,0,0,0,0,0,2,1,0,0
34142,7,123,1,1,1,0,0,0,1,0,0,0,0,0,0,0,0,0,0,0,0,2,1,0,0
34143,7,123,1,1,1,0,0,0,1,0,0,0,0,0,0,0,0,0,0,0,0,2,1,0,0
34144,7,123,14,10,10,0,0,4,14,1,1,1,1,2,2,0,2,0,1,0,0,2,1,0,0
34145,7,123,46,26,30,3,0,12,49,3,6,3,6,9,9,20,28,1,42,2,0,2,1,0,0
34146,14,845,75,38,59,1,3,12,76,2,4,2,4,6,6,10,15,1,15,0,0,2,1,0,0
34147,2,67,16,12,9,0,0,6,16,1,2,1,2,3,3,2,4,0,2,0,0,2,1,0,0
34148,1,6,2,2,2,0,0,0,2,0,0,0,0,0,0,0,0,0,0,0,0,2,1,0,0
34149,1,6,99,48,90,1,3,5,100,0,0,0,0,0,0,0,0,0,0,0,0,2,1,0,0
34150,1,6,8,5,5,2,0,1,10,0,0,0,0,0,0,0,0,0,0,0,0,2,1,0,0
34151,1,6,1217,716,841,84,126,174,1301,14,185,118,215,199,333,1446,2542,8,20687,1149,0,2,1,0,0
34152,1,6,160,89,115,0,13,31,160,7,15,11,17,22,28,78,124,3,495,27,0,2,1,0,0
34153,1,6,10,10,9,9,0,0,19,0,0,0,0,0,0,0,0,0,0,0,0,2,1,0,0
34154,1,6,173,84,99,8,29,36,181,5,12,7,13,17,20,54,81,2,221,12,0,2,1,0,0
34155,1,6,3,1,1,3,0,0,6,0,0,0,0,0,0,0,0,0,0,0,0,2,1,0,0
34156,1,6,2,2,2,0,0,0,2,0,0,0,0,0,0,0,0,0,0,0,0,2,1,0,0
34157,1,6,2,2,2,0,0,0,2,0,0,0,0,0,0,0,0,0,0,0,0,2,1,0,0
34158,1,6,2,2,2,0,0,0,2,0,0,0,0,0,0,0,0,0,0,0,0,2,1,0,0
34159,1,6,2,2,2,0,0,0,2,0,0,0,0,0,0,0,0,0,0,0,0,2,1,0,0
34160,1,8,127,75,83,2,11,30,129,4,14,7,14,18,21,61,87,2,175,9,0,2,1,0,0
34161,1,8,652,304,544,16,6,88,668,6,89,51,101,95,152,591,998,3,3399,188,0,2,1,0,0
34162,1,8,2,2,2,0,0,0,2,0,0,0,0,0,0,0,0,0,0,0,0,2,1,0,0
34163,1,8,8,5,5,0,0,3,8,0,0,0,0,0,0,0,0,0,0,0,0,2,1,0,0
34164,1,8,2,2,2,0,0,0,2,0,0,0,0,0,0,0,0,0,0,0,0,2,1,0,0
34165,1,8,14,8,8,0,0,6,14,0,0,0,0,0,0,0,0,0,0,0,0,2,1,0,0
34166,1,8,6,4,4,0,0,2,6,0,0,0,0,0,0,0,0,0,0,0,0,2,1,0,0
34167,1,8,6,4,4,0,0,2,6,1,2,1,2,3,3,2,4,0,2,0,0,2,1,0,0
34168,1,8,6,4,4,0,0,2,6,0,0,0,0,0,0,0,0,0,0,0,0,2,1,0,0
34169,1,8,7,5,5,0,0,2,7,0,0,0,0,0,0,0,0,0,0,0,0,2,1,0,0
34170,1,8,6,4,4,0,0,2,6,0,0,0,0,0,0,0,0,0,0,0,0,2,1,0,0
34171,1,8,10,6,6,0,0,4,10,0,0,0,0,0,0,0,0,0,0,0,0,2,1,0,0
34172,1,8,1,1,1,0,0,0,1,0,0,0,0,0,0,0,0,0,0,0,0,2,1,0,0
34173,1,8,1,1,1,0,0,0,1,0,0,0,0,0,0,0,0,0,0,0,0,2,1,0,0
34174,1,8,14,10,10,0,0,4,14,1,1,1,1,2,2,0,2,0,1,0,0,2,1,0,0
34175,1,8,46,26,30,3,0,12,49,3,6,3,6,9,9,20,28,1,42,2,0,2,1,0,0
34176,1,6,2,2,2,0,0,0,2,0,0,0,0,0,0,0,0,0,0,0,0,2,1,0,0
34177,1,6,2,2,2,0,0,0,2,0,0,0,0,0,0,0,0,0,0,0,0,2,1,0,0
34178,1,6,2,2,2,0,0,0,2,0,0,0,0,0,0,0,0,0,0,0,0,2,1,0,0
34179,1,6,2,2,2,0,0,0,2,0,0,0,0,0,0,0,0,0,0,0,0,2,1,0,0
34180,1,6,2,2,2,0,0,0,2,0,0,0,0,0,0,0,0,0,0,0,0,2,1,0,0
34181,1,6,2,2,2,0,0,0,2,0,0,0,0,0,0,0,0,0,0,0,0,2,1,0,0
34182,1,6,2,2,2,0,0,0,2,0,0,0,0,0,0,0,0,0,0,0,0,2,1,0,0
34183,1,6,2,2,2,0,0,0,2,0,0,0,0,0,0,0,0,0,0,0,0,2,1,0,0
34184,1,6,2,2,2,0,0,0,2,0,0,0,0,0,0,0,0,0,0,0,0,2,1,0,0
34185,2,25,127,75,83,2,11,30,129,4,14,7,14,18,21,61,87,2,175,9,0,2,1,0,0
34186,2,25,652,304,544,16,6,88,668,6,89,51,101,95,152,591,998,3,3399,188,0,2,1,0,0
34187,2,25,2,2,2,0,0,0,2,0,0,0,0,0,0,0,0,0,0,0,0,2,1,0,0
34188,2,25,8,5,5,0,0,3,8,0,0,0,0,0,0,0,0,0,0,0,0,2,1,0,0
34189,2,25,2,2,2,0,0,0,2,0,0,0,0,0,0,0,0,0,0,0,0,2,1,0,0
34190,2,25,14,8,8,0,0,6,14,0,0,0,0,0,0,0,0,0,0,0,0,2,1,0,0
34191,2,25,6,4,4,0,0,2,6,0,0,0,0,0,0,0,0,0,0,0,0,2,1,0,0
34192,2,25,6,4,4,0,0,2,6,1,2,1,2,3,3,2,4,0,2,0,0,2,1,0,0
34193,2,25,6,4,4,0,0,2,6,0,0,0,0,0,0,0,0,0,0,0,0,2,1,0,0
34194,2,25,7,5,5,0,0,2,7,0,0,0,0,0,0,0,0,0,0,0,0,2,1,0,0
34195,2,25,6,4,4,0,0,2,6,0,0,0,0,0,0,0,0,0,0,0,0,2,1,0,0
34196,2,25,10,6,6,0,0,4,10,0,0,0,0,0,0,0,0,0,0,0,0,2,1,0,0
34197,2,25,1,1,1,0,0,0,1,0,0,0,0,0,0,0,0,0,0,0,0,2,1,0,0
34198,2,25,1,1,1,0,0,0,1,0,0,0,0,0,0,0,0,0,0,0,0,2,1,0,0
34199,2,25,14,10,10,0,0,4,14,1,1,1,1,2,2,0,2,0,1,0,0,2,1,0,0
34200,2,25,46,26,30,3,0,12,49,3,6,3,6,9,9,20,28,1,42,2,0,2,1,0,0
34201,1,55,14,12,10,0,0,4,14,1,2,1,2,3,3,2,4,0,2,0,0,2,1,0,0
34202,1,58,14,12,10,0,0,4,14,1,2,1,2,3,3,2,4,0,2,0,0,2,1,0,0
34203,1,55,14,12,10,0,0,4,14,1,2,1,2,3,3,2,4,0,2,0,0,2,1,0,0
34204,1,77,19,18,14,0,0,5,19,1,2,1,2,3,3,2,4,0,2,0,0,2,1,0,0
34205,2,18,10,6,6,0,0,4,10,0,0,0,0,0,0,0,0,0,0,0,0,2,1,0,0
34206,2,36,127,75,83,2,11,30,129,4,14,7,14,18,21,61,87,2,175,9,0,2,1,0,0
34207,2,36,652,304,544,16,6,88,668,6,89,51,101,95,152,591,998,3,3399,188,0,2,1,0,0
34208,2,36,2,2,2,0,0,0,2,0,0,0,0,0,0,0,0,0,0,0,0,2,1,0,0
34209,2,36,8,5,5,0,0,3,8,0,0,0,0,0,0,0,0,0,0,0,0,2,1,0,0
34210,2,36,2,2,2,0,0,0,2,0,0,0,0,0,0,0,0,0,0,0,0,2,1,0,0
34211,2,36,14,8,8,0,0,6,14,0,0,0,0,0,0,0,0,0,0,0,0,2,1,0,0
34212,2,36,6,4,4,0,0,2,6,0,0,0,0,0,0,0,0,0,0,0,0,2,1,0,0
34213,2,36,6,4,4,0,0,2,6,1,2,1,2,3,3,2,4,0,2,0,0,2,1,0,0
34214,2,36,6,4,4,0,0,2,6,0,0,0,0,0,0,0,0,0,0,0,0,2,1,0,0
34215,2,36,7,5,5,0,0,2,7,0,0,0,0,0,0,0,0,0,0,0,0,2,1,0,0
34216,2,36,6,4,4,0,0,2,6,0,0,0,0,0,0,0,0,0,0,0,0,2,1,0,0
34217,2,36,10,6,6,0,0,4,10,0,0,0,0,0,0,0,0,0,0,0,0,2,1,0,0
34218,2,36,1,1,1,0,0,0,1,0,0,0,0,0,0,0,0,0,0,0,0,2,1,0,0
34219,2,36,1,1,1,0,0,0,1,0,0,0,0,0,0,0,0,0,0,0,0,2,1,0,0
34220,2,36,14,10,10,0,0,4,14,1,1,1,1,2,2,0,2,0,1,0,0,2,1,0,0
34221,2,36,46,26,30,3,0,12,49,3,6,3,6,9,9,20,28,1,42,2,0,2,1,0,0
34222,1,6,2,2,2,0,0,0,2,0,0,0,0,0,0,0,0,0,0,0,0,2,1,0,0
34223,1,6,2,2,2,0,0,0,2,0,0,0,0,0,0,0,0,0,0,0,0,2,1,0,0
34224,1,6,2,2,2,0,0,0,2,0,0,0,0,0,0,0,0,0,0,0,0,2,1,0,0
34225,1,6,2,2,2,0,0,0,2,0,0,0,0,0,0,0,0,0,0,0,0,2,1,0,0
34226,1,26,127,75,83,2,11,30,129,4,14,7,14,18,21,61,87,2,175,9,0,2,1,0,0
34227,1,26,652,304,544,16,6,88,668,6,89,51,101,95,152,591,998,3,3399,188,0,2,1,0,0
34228,1,26,2,2,2,0,0,0,2,0,0,0,0,0,0,0,0,0,0,0,0,2,1,0,0
34229,1,26,8,5,5,0,0,3,8,0,0,0,0,0,0,0,0,0,0,0,0,2,1,0,0
34230,1,26,2,2,2,0,0,0,2,0,0,0,0,0,0,0,0,0,0,0,0,2,1,0,0
34231,1,26,14,8,8,0,0,6,14,0,0,0,0,0,0,0,0,0,0,0,0,2,1,0,0
34232,1,26,6,4,4,0,0,2,6,0,0,0,0,0,0,0,0,0,0,0,0,2,1,0,0
34233,1,26,6,4,4,0,0,2,6,1,2,1,2,3,3,2,4,0,2,0,0,2,1,0,0
34234,1,26,6,4,4,0,0,2,6,0,0,0,0,0,0,0,0,0,0,0,0,2,1,0,0
34235,1,26,7,5,5,0,0,2,7,0,0,0,0,0,0,0,0,0,0,0,0,2,1,0,0
34236,1,26,6,4,4,0,0,2,6,0,0,0,0,0,0,0,0,0,0,0,0,2,1,0,0
34237,1,26,10,6,6,0,0,4,10,0,0,0,0,0,0,0,0,0,0,0,0,2,1,0,0
34238,1,26,1,1,1,0,0,0,1,0,0,0,0,0,0,0,0,0,0,0,0,2,1,0,0
34239,1,26,1,1,1,0,0,0,1,0,0,0,0,0,0,0,0,0,0,0,0,2,1,0,0
34240,1,26,14,10,10,0,0,4,14,1,1,1,1,2,2,0,2,0,1,0,0,2,1,0,0
34241,1,26,46,26,30,3,0,12,49,3,6,3,6,9,9,20,28,1,42,2,0,2,1,0,0
34242,1,7,2,2,2,0,0,0,2,0,0,0,0,0,0,0,0,0,0,0,0,2,1,0,0
34243,1,24,127,75,83,2,11,30,129,4,14,7,14,18,21,61,87,2,175,9,0,2,1,0,0
34244,1,24,652,304,544,16,6,88,668,6,89,51,101,95,152,591,998,3,3399,188,0,2,1,0,0
34245,1,24,2,2,2,0,0,0,2,0,0,0,0,0,0,0,0,0,0,0,0,2,1,0,0
34246,1,24,8,5,5,0,0,3,8,0,0,0,0,0,0,0,0,0,0,0,0,2,1,0,0
34247,1,24,2,2,2,0,0,0,2,0,0,0,0,0,0,0,0,0,0,0,0,2,1,0,0
34248,1,24,14,8,8,0,0,6,14,0,0,0,0,0,0,0,0,0,0,0,0,2,1,0,0
34249,1,24,6,4,4,0,0,2,6,0,0,0,0,0,0,0,0,0,0,0,0,2,1,0,0
34250,1,24,6,4,4,0,0,2,6,1,2,1,2,3,3,2,4,0,2,0,0,2,1,0,0
34251,1,24,6,4,4,0,0,2,6,0,0,0,0,0,0,0,0,0,0,0,0,2,1,0,0
34252,1,24,7,5,5,0,0,2,7,0,0,0,0,0,0,0,0,0,0,0,0,2,1,0,0
34253,1,24,6,4,4,0,0,2,6,0,0,0,0,0,0,0,0,0,0,0,0,2,1,0,0
34254,1,24,10,6,6,0,0,4,10,0,0,0,0,0,0,0,0,0,0,0,0,2,1,0,0
34255,1,24,1,1,1,0,0,0,1,0,0,0,0,0,0,0,0,0,0,0,0,2,1,0,0
34256,1,24,1,1,1,0,0,0,1,0,0,0,0,0,0,0,0,0,0,0,0,2,1,0,0
34257,1,24,14,10,10,0,0,4,14,1,1,1,1,2,2,0,2,0,1,0,0,2,1,0,0
34258,1,24,46,26,30,3,0,12,49,3,6,3,6,9,9,20,28,1,42,2,0,2,1,0,0
34259,1,7,2,2,2,0,0,0,2,0,0,0,0,0,0,0,0,0,0,0,0,2,1,0,0
34260,3,33,15,9,9,0,0,6,15,0,0,0,0,0,0,0,0,0,0,0,0,2,1,0,0
34261,1,13,127,75,83,2,11,30,129,4,14,7,14,18,21,61,87,2,175,9,0,2,1,0,0
34262,1,13,652,304,544,16,6,88,668,6,89,51,101,95,152,591,998,3,3399,188,0,2,1,0,0
34263,1,13,2,2,2,0,0,0,2,0,0,0,0,0,0,0,0,0,0,0,0,2,1,0,0
34264,1,13,8,5,5,0,0,3,8,0,0,0,0,0,0,0,0,0,0,0,0,2,1,0,0
34265,1,13,2,2,2,0,0,0,2,0,0,0,0,0,0,0,0,0,0,0,0,2,1,0,0
34266,1,13,14,8,8,0,0,6,14,0,0,0,0,0,0,0,0,0,0,0,0,2,1,0,0
34267,1,13,6,4,4,0,0,2,6,0,0,0,0,0,0,0,0,0,0,0,0,2,1,0,0
34268,1,13,6,4,4,0,0,2,6,1,2,1,2,3,3,2,4,0,2,0,0,2,1,0,0
34269,1,13,6,4,4,0,0,2,6,0,0,0,0,0,0,0,0,0,0,0,0,2,1,0,0
34270,1,13,7,5,5,0,0,2,7,0,0,0,0,0,0,0,0,0,0,0,0,2,1,0,0
34271,1,13,6,4,4,0,0,2,6,0,0,0,0,0,0,0,0,0,0,0,0,2,1,0,0
34272,1,13,10,6,6,0,0,4,10,0,0,0,0,0,0,0,0,0,0,0,0,2,1,0,0
34273,1,13,1,1,1,0,0,0,1,0,0,0,0,0,0,0,0,0,0,0,0,2,1,0,0
34274,1,13,1,1,1,0,0,0,1,0,0,0,0,0,0,0,0,0,0,0,0,2,1,0,0
34275,1,13,14,10,10,0,0,4,14,1,1,1,1,2,2,0,2,0,1,0,0,2,1,0,0
34276,1,13,46,26,30,3,0,12,49,3,6,3,6,9,9,20,28,1,42,2,0,2,1,0,0
34277,1,16,127,75,83,2,11,30,129,4,14,7,14,18,21,61,87,2,175,9,0,2,1,0,0
34278,1,16,652,304,544,16,6,88,668,6,89,51,101,95,152,591,998,3,3399,188,0,2,1,0,0
34279,1,16,2,2,2,0,0,0,2,0,0,0,0,0,0,0,0,0,0,0,0,2,1,0,0
34280,1,16,8,5,5,0,0,3,8,0,0,0,0,0,0,0,0,0,0,0,0,2,1,0,0
34281,1,16,2,2,2,0,0,0,2,0,0,0,0,0,0,0,0,0,0,0,0,2,1,0,0
34282,1,16,14,8,8,0,0,6,14,0,0,0,0,0,0,0,0,0,0,0,0,2,1,0,0
34283,1,16,6,4,4,0,0,2,6,0,0,0,0,0,0,0,0,0,0,0,0,2,1,0,0
34284,1,16,6,4,4,0,0,2,6,1,2,1,2,3,3,2,4,0,2,0,0,2,1,0,0
34285,1,16,6,4,4,0,0,2,6,0,0,0,0,0,0,0,0,0,0,0,0,2,1,0,0
34286,1,16,7,5,5,0,0,2,7,0,0,0,0,0,0,0,0,0,0,0,0,2,1,0,0
34287,1,16,6,4,4,0,0,2,6,0,0,0,0,0,0,0,0,0,0,0,0,2,1,0,0
34288,1,16,10,6,6,0,0,4,10,0,0,0,0,0,0,0,0,0,0,0,0,2,1,0,0
34289,1,16,1,1,1,0,0,0,1,0,0,0,0,0,0,0,0,0,0,0,0,2,1,0,0
34290,1,16,1,1,1,0,0,0,1,0,0,0,0,0,0,0,0,0,0,0,0,2,1,0,0
34291,1,16,14,10,10,0,0,4,14,1,1,1,1,2,2,0,2,0,1,0,0,2,1,0,0
34292,1,16,46,26,30,3,0,12,49,3,6,3,6,9,9,20,28,1,42,2,0,2,1,0,0
34293,1,10,2,2,2,0,0,0,2,1,2,1,2,3,3,2,4,0,2,0,0,2,1,0,0
34294,1,13,127,75,83,2,11,30,129,4,14,7,14,18,21,61,87,2,175,9,0,2,1,0,0
34295,1,13,652,304,544,16,6,88,668,6,89,51,101,95,152,591,998,3,3399,188,0,2,1,0,0
34296,1,13,2,2,2,0,0,0,2,0,0,0,0,0,0,0,0,0,0,0,0,2,1,0,0
34297,1,13,8,5,5,0,0,3,8,0,0,0,0,0,0,0,0,0,0,0,0,2,1,0,0
34298,1,13,2,2,2,0,0,0,2,0,0,0,0,0,0,0,0,0,0,0,0,2,1,0,0
34299,1,13,14,8,8,0,0,6,14,0,0,0,0,0,0,0,0,0,0,0,0,2,1,0,0
34300,1,13,6,4,4,0,0,2,6,0,0,0,0,0,0,0,0,0,0,0,0,2,1,0,0
34301,1,13,6,4,4,0,0,2,6,1,2,1,2,3,3,2,4,0,2,0,0,2,1,0,0
34302,1,13,6,4,4,0,0,2,6,0,0,0,0,0,0,0,0,0,0,0,0,2,1,0,0
34303,1,13,7,5,5,0,0,2,7,0,0,0,0,0,0,0,0,0,0,0,0,2,1,0,0
34304,1,13,6,4,4,0,0,2,6,0,0,0,0,0,0,0,0,0,0,0,0,2,1,0,0
34305,1,13,10,6,6,0,0,4,10,0,0,0,0,0,0,0,0,0,0,0,0,2,1,0,0
34306,1,13,1,1,1,0,0,0,1,0,0,0,0,0,0,0,0,0,0,0,0,2,1,0,0
34307,1,13,1,1,1,0,0,0,1,0,0,0,0,0,0,0,0,0,0,0,0,2,1,0,0
34308,1,13,14,10,10,0,0,4,14,1,1,1,1,2,2,0,2,0,1,0,0,2,1,0,0
34309,1,13,46,26,30,3,0,12,49,3,6,3,6,9,9,20,28,1,42,2,0,2,1,0,0
34310,2,26,10,6,6,0,0,4,10,2,4,2,4,6,6,10,15,1,15,0,0,2,1,0,0
34311,3,47,15,10,10,0,0,5,15,2,4,2,4,6,6,10,15,1,15,0,0,2,1,0,0
34312,3,39,15,9,9,0,0,6,15,0,0,0,0,0,0,0,0,0,0,0,0,2,1,0,0
34313,2,36,10,7,7,0,0,3,10,1,2,1,2,3,3,2,4,0,2,0,0,2,1,0,0
34314,3,46,15,9,9,0,0,6,15,1,4,2,4,5,6,8,13,0,6,0,0,2,1,0,0
34315,2,21,10,6,6,0,0,4,10,0,0,0,0,0,0,0,0,0,0,0,0,2,1,0,0
34316,4,61,20,12,12,0,0,8,20,1,2,1,2,3,3,2,4,0,2,0,0,2,1,0,0
34317,2,51,127,75,83,2,11,30,129,4,14,7,14,18,21,61,87,2,175,9,0,2,1,0,0
34318,2,51,652,304,544,16,6,88,668,6,89,51,101,95,152,591,998,3,3399,188,0,2,1,0,0
34319,2,51,2,2,2,0,0,0,2,0,0,0,0,0,0,0,0,0,0,0,0,2,1,0,0
34320,2,51,8,5,5,0,0,3,8,0,0,0,0,0,0,0,0,0,0,0,0,2,1,0,0
34321,2,51,2,2,2,0,0,0,2,0,0,0,0,0,0,0,0,0,0,0,0,2,1,0,0
34322,2,51,14,8,8,0,0,6,14,0,0,0,0,0,0,0,0,0,0,0,0,2,1,0,0
34323,2,51,6,4,4,0,0,2,6,0,0,0,0,0,0,0,0,0,0,0,0,2,1,0,0
34324,2,51,6,4,4,0,0,2,6,1,2,1,2,3,3,2,4,0,2,0,0,2,1,0,0
34325,2,51,6,4,4,0,0,2,6,0,0,0,0,0,0,0,0,0,0,0,0,2,1,0,0
34326,2,51,7,5,5,0,0,2,7,0,0,0,0,0,0,0,0,0,0,0,0,2,1,0,0
34327,2,51,6,4,4,0,0,2,6,0,0,0,0,0,0,0,0,0,0,0,0,2,1,0,0
34328,2,51,10,6,6,0,0,4,10,0,0,0,0,0,0,0,0,0,0,0,0,2,1,0,0
34329,2,51,1,1,1,0,0,0,1,0,0,0,0,0,0,0,0,0,0,0,0,2,1,0,0
34330,2,51,1,1,1,0,0,0,1,0,0,0,0,0,0,0,0,0,0,0,0,2,1,0,0
34331,2,51,14,10,10,0,0,4,14,1,1,1,1,2,2,0,2,0,1,0,0,2,1,0,0
34332,2,51,46,26,30,3,0,12,49,3,6,3,6,9,9,20,28,1,42,2,0,2,1,0,0
34333,1,6,2,2,2,0,0,0,2,0,0,0,0,0,0,0,0,0,0,0,0,2,1,0,0
34334,8,263,51,25,36,0,0,15,51,3,11,6,12,14,18,42,68,1,112,6,0,2,1,0,0
34335,1,14,6,4,4,0,0,2,6,0,0,0,0,0,0,0,0,0,0,0,0,2,1,0,0
34336,4,163,27,21,21,0,0,6,27,3,6,3,6,9,9,20,28,1,42,2,0,2,1,0,0
34337,1,6,2,2,2,0,0,0,2,0,0,0,0,0,0,0,0,0,0,0,0,2,1,0,0
34338,1,41,7,5,5,0,0,2,7,1,2,1,2,3,3,2,4,0,2,0,0,2,1,0,0
34339,2,51,14,9,9,0,0,5,14,0,0,0,0,0,0,0,0,0,0,0,0,2,1,0,0
34340,2,40,13,9,8,0,0,4,13,0,0,0,0,0,0,0,0,0,0,0,0,2,1,0,0
34341,2,42,14,10,9,0,0,4,14,0,0,0,0,0,0,0,0,0,0,0,0,2,1,0,0
34342,2,33,12,8,7,0,0,4,12,0,0,0,0,0,0,0,0,0,0,0,0,2,1,0,0
34343,3,49,16,9,9,0,0,7,16,0,0,0,0,0,0,0,0,0,0,0,0,2,1,0,0
34344,1,18,3,3,3,0,0,0,3,0,0,0,0,0,0,0,0,0,0,0,0,2,1,0,0
34345,2,26,6,4,4,0,0,2,6,1,4,2,4,5,6,8,13,0,6,0,0,2,1,0,0
34346,12,318,149,95,105,2,0,41,151,8,54,28,55,62,83,334,494,4,2013,111,0,2,1,1,0
34347,15,703,139,89,101,2,0,35,141,7,54,34,62,61,96,330,569,4,2287,127,0,2,1,1,0
34348,1,134,149,67,118,4,0,27,153,1,17,14,28,18,42,69,175,0,144,8,0,2,1,0,0
34349,36,2427,1157,318,931,29,22,177,1186,6,104,63,125,110,188,712,1274,3,4596,255,0,2,2,2,0
34350,66,4392,520,294,400,33,13,81,553,10,261,204,367,271,571,2128,4614,7,32445,1802,1,2,1,1,0
34351,90,3974,1338,495,1086,10,64,173,1348,11,122,82,157,133,239,883,1686,7,11934,663,0,2,3,3,0
34352,171,7566,4293,999,3693,19,54,507,4312,9,155,88,170,164,258,1156,1898,4,9368,520,0,2,1,1,0
34353,171,7566,1482,859,1002,125,135,219,1607,16,219,134,251,235,385,1766,3032,9,27804,1544,1,2,1,1,0
34354,33,999,465,148,393,5,8,60,470,4,31,20,31,35,51,161,261,2,523,29,0,2,1,0,0
34355,33,999,16,12,9,0,0,6,16,1,2,1,2,3,3,2,4,0,2,0,0,2,1,0,0
34356,126,5520,1782,648,1425,9,47,279,1791,8,171,97,189,179,286,1292,2140,4,9462,525,0,2,1,1,0
34357,33,1041,256,139,192,9,7,47,265,4,23,12,24,27,36,112,171,2,357,19,0,2,1,0,0
34358,6,328,180,34,164,0,0,16,180,1,12,6,12,13,18,43,66,0,33,1,0,2,1,1,0
34359,23,613,102,59,69,5,3,24,107,6,22,15,28,28,43,113,206,3,789,43,0,2,1,0,0
34360,128,5170,1450,624,1228,12,26,181,1462,14,306,186,354,320,540,2580,4493,8,36391,2021,1,2,2,2,0
34361,176,5307,1660,832,1314,41,38,274,1701,20,312,209,395,332,604,2671,5058,12,64042,3557,1,2,4,4,0
34362,48,3659,996,429,845,24,10,117,1020,7,76,50,88,83,138,494,879,4,3565,198,0,2,1,0,0
34363,125,5389,1513,682,1277,25,13,200,1538,11,199,116,219,210,335,1557,2584,6,15641,868,0,2,2,2,0
34364,85,4936,1296,573,1062,40,33,157,1336,8,201,118,231,209,349,1561,2689,4,12365,686,0,2,1,0,0
34365,21,500,207,111,150,11,0,50,218,5,26,19,36,31,55,133,272,3,943,52,0,2,1,0,0
34366,103,5336,1457,730,1242,11,6,188,1468,10,292,166,329,302,495,2424,4078,5,22973,1276,1,2,1,0,0
34367,43,2690,652,304,544,16,6,88,668,6,89,51,101,95,152,591,998,3,3399,188,0,2,1,0,0
34368,72,3310,1455,414,1257,16,76,112,1471,5,41,23,46,46,69,231,381,2,1069,59,0,2,3,3,0
34369,2,79,7,6,5,0,0,2,7,1,1,1,2,2,3,0,3,1,3,0,0,2,1,0,0
34370,8,275,74,35,59,1,0,14,75,3,14,7,14,17,21,58,85,1,128,7,0,2,1,0,0
34371,107,5109,1523,757,1297,19,12,193,1542,12,193,117,230,205,347,1508,2664,7,19053,1058,0,2,1,1,0
34372,70,3187,1020,354,843,12,15,144,1032,8,134,77,144,142,221,970,1580,4,6792,377,0,2,1,0,0
34373,47,2189,447,308,343,6,5,95,453,7,96,59,111,103,170,651,1136,4,4600,255,0,2,1,0,0
34374,3,229,53,23,39,0,0,13,53,2,8,4,8,10,12,26,39,1,39,2,0,2,1,0,0
34375,21,655,424,94,331,4,0,89,428,1,5,5,5,6,10,11,25,0,12,0,0,2,2,2,0
34376,38,2327,334,251,279,10,4,40,344,5,127,74,143,132,217,899,1528,2,4303,239,0,2,1,0,0
34377,12,497,184,100,137,2,15,30,186,6,38,20,39,44,59,214,322,3,991,55,0,2,2,2,0
34378,8,377,91,45,69,0,3,18,91,3,9,6,10,12,16,33,57,1,95,5,0,2,1,0,0
34379,75,3895,1293,570,1093,25,15,163,1318,10,195,123,241,205,364,1516,2795,6,17273,959,0,2,1,0,0
34380,29,1903,384,251,317,7,8,52,391,11,70,44,84,81,128,467,811,6,5355,297,0,2,2,2,0
34381,55,2800,722,423,573,19,0,135,741,12,172,101,199,184,300,1320,2257,6,15668,870,0,2,1,1,0
34382,45,1953,386,256,301,16,9,68,402,4,59,35,69,63,104,355,621,2,1453,80,0,2,1,0,0
34383,28,1596,466,257,367,18,25,50,484,7,126,86,171,133,257,898,1813,4,8612,478,0,2,1,0,0
34384,15,1066,215,129,180,6,0,29,221,8,65,43,72,73,115,415,711,4,3153,175,0,2,1,0,0
34385,86,3411,1043,504,840,53,9,147,1096,9,180,112,198,189,310,1377,2344,4,11604,644,0,2,3,3,0
34386,12,478,295,56,236,0,4,54,295,2,9,5,10,11,15,30,51,1,57,3,0,2,1,0,0
34387,30,1440,373,158,315,8,0,51,381,5,76,44,79,81,123,486,779,2,2026,112,0,2,1,0,0
34388,80,3144,1178,367,1042,6,15,115,1184,9,94,51,95,103,146,644,976,4,4439,246,0,2,1,1,0
34389,9,449,219,78,157,11,5,46,230,3,24,20,34,27,54,114,256,2,545,30,0,2,1,0,0
34390,111,6122,1943,715,1694,26,18,214,1969,12,185,120,237,197,357,1436,2721,7,20915,1161,0,2,1,1,0
34391,37,1519,442,244,305,14,16,103,456,11,68,45,75,79,120,452,756,6,4588,254,0,2,1,0,0
34392,52,1986,1098,241,925,5,10,155,1103,7,46,25,49,53,74,273,423,3,1580,87,0,2,1,0,0
34393,53,1862,601,196,481,2,23,85,603,8,63,36,72,71,108,400,664,4,3036,168,0,2,4,4,0
34394,164,3518,1513,682,1277,25,13,200,1538,11,199,116,219,210,335,1557,2584,6,15641,868,0,2,4,0,0
34395,164,3518,819,519,539,24,98,155,843,15,96,57,106,111,163,690,1107,8,9171,509,0,2,4,0,0
34396,126,5406,1513,682,1277,25,13,200,1538,11,199,116,219,210,335,1557,2584,6,15641,868,0,2,3,0,0
34397,282,5915,1943,715,1694,26,18,214,1969,12,185,120,237,197,357,1436,2721,7,20915,1161,0,2,9,1,0
34398,282,5915,1168,838,957,57,25,144,1225,19,348,224,416,367,640,3018,5452,11,61921,3440,1,2,9,1,0
34399,282,5915,1943,715,1694,26,18,214,1969,12,185,120,237,197,357,1436,2721,7,20915,1161,0,2,9,1,0
34400,282,5915,1168,838,957,57,25,144,1225,19,348,224,416,367,640,3018,5452,11,61921,3440,1,2,9,1,0
34401,164,3518,1513,682,1277,25,13,200,1538,11,199,116,219,210,335,1557,2584,6,15641,868,0,2,4,0,0
34402,164,3518,819,519,539,24,98,155,843,15,96,57,106,111,163,690,1107,8,9171,509,0,2,4,0,0
34403,282,5915,1943,715,1694,26,18,214,1969,12,185,120,237,197,357,1436,2721,7,20915,1161,0,2,9,1,0
34404,282,5915,1168,838,957,57,25,144,1225,19,348,224,416,367,640,3018,5452,11,61921,3440,1,2,9,1,0
34405,126,5406,1513,682,1277,25,13,200,1538,11,199,116,219,210,335,1557,2584,6,15641,868,0,2,3,0,0
34406,164,3518,1513,682,1277,25,13,200,1538,11,199,116,219,210,335,1557,2584,6,15641,868,0,2,4,0,0
34407,164,3518,819,519,539,24,98,155,843,15,96,57,106,111,163,690,1107,8,9171,509,0,2,4,0,0
34408,282,5915,1943,715,1694,26,18,214,1969,12,185,120,237,197,357,1436,2721,7,20915,1161,0,2,9,1,0
34409,282,5915,1168,838,957,57,25,144,1225,19,348,224,416,367,640,3018,5452,11,61921,3440,1,2,9,1,0
34410,126,5406,1513,682,1277,25,13,200,1538,11,199,116,219,210,335,1557,2584,6,15641,868,0,2,3,0,0
34411,129,5191,1450,624,1228,12,26,181,1462,14,306,186,354,320,540,2580,4493,8,36391,2021,1,2,4,1,0
34412,184,5563,1660,832,1314,41,38,274,1701,20,312,209,395,332,604,2671,5058,12,64042,3557,1,2,4,1,0
34413,184,5563,1057,646,719,113,100,145,1170,18,215,134,248,233,382,1740,3004,10,31186,1732,1,2,4,1,0
34414,236,4942,2,2,2,0,0,0,2,0,0,0,0,0,0,0,0,0,0,0,0,2,3,3,0
34415,236,4942,99,48,90,1,3,5,100,0,0,0,0,0,0,0,0,0,0,0,0,2,3,3,0
34416,236,4942,8,5,5,2,0,1,10,0,0,0,0,0,0,0,0,0,0,0,0,2,3,3,0
34417,236,4942,1217,716,841,84,126,174,1301,14,185,118,215,199,333,1446,2542,8,20687,1149,0,2,3,3,0
34418,236,4942,160,89,115,0,13,31,160,7,15,11,17,22,28,78,124,3,495,27,0,2,3,3,0
34419,236,4942,10,10,9,9,0,0,19,0,0,0,0,0,0,0,0,0,0,0,0,2,3,3,0
34420,236,4942,173,84,99,8,29,36,181,5,12,7,13,17,20,54,81,2,221,12,0,2,3,3,0
34421,236,4942,3,1,1,3,0,0,6,0,0,0,0,0,0,0,0,0,0,0,0,2,3,3,0
34422,249,5765,4293,999,3693,19,54,507,4312,9,155,88,170,164,258,1156,1898,4,9368,520,0,2,9,0,0
34423,249,5765,1482,859,1002,125,135,219,1607,16,219,134,251,235,385,1766,3032,9,27804,1544,1,2,9,0,0
34424,314,6910,72,33,56,0,4,12,72,1,1,1,1,2,2,0,2,0,1,0,0,2,1,6,0
34425,314,6910,1454,835,1044,76,110,219,1530,17,275,158,296,292,454,2297,3718,9,34017,1889,1,2,1,6,0
34426,104,5361,1457,730,1242,11,6,188,1468,10,292,166,329,302,495,2424,4078,5,22973,1276,1,2,11,0,0
34427,229,4960,182,127,129,0,0,53,182,5,39,21,42,44,63,217,343,2,926,51,0,2,5,4,0
34428,229,4960,1165,710,800,67,119,181,1232,18,243,153,282,261,435,2000,3492,10,36473,2026,1,2,5,4,0
34429,92,1886,757,253,292,73,244,162,830,13,61,38,67,74,105,409,651,7,4654,258,0,2,1,1,0
34430,229,4960,182,127,129,0,0,53,182,5,39,21,42,44,63,217,343,2,926,51,0,2,5,4,0
34431,229,4960,1165,710,800,67,119,181,1232,18,243,153,282,261,435,2000,3492,10,36473,2026,1,2,5,4,0
34432,92,1886,757,253,292,73,244,162,830,13,61,38,67,74,105,409,651,7,4654,258,0,2,1,1,0
34433,20,534,205,80,86,16,53,53,221,7,18,10,19,25,29,94,134,3,497,27,0,2,5,5,0
34434,81,3172,1178,367,1042,6,15,115,1184,9,94,51,95,103,146,644,976,4,4439,246,0,2,8,0,0
34435,314,6932,72,33,56,0,4,12,72,1,1,1,1,2,2,0,2,0,1,0,0,2,1,1,0
34436,314,6932,1454,835,1044,76,110,219,1530,17,275,158,296,292,454,2297,3718,9,34017,1889,1,2,1,1,0
34437,144,5944,1782,648,1425,9,47,279,1791,8,171,97,189,179,286,1292,2140,4,9462,525,0,2,96,0,0
34438,314,6932,72,33,56,0,4,12,72,1,1,1,1,2,2,0,2,0,1,0,0,2,1,1,0
34439,314,6932,1454,835,1044,76,110,219,1530,17,275,158,296,292,454,2297,3718,9,34017,1889,1,2,1,1,0
34440,144,5944,1782,648,1425,9,47,279,1791,8,171,97,189,179,286,1292,2140,4,9462,525,0,2,96,0,0
34441,51,1442,339,213,244,17,9,65,356,10,42,26,48,52,74,259,421,5,2410,133,0,2,12,15,0
34442,77,3944,1293,570,1093,25,15,163,1318,10,195,123,241,205,364,1516,2795,6,17273,959,0,2,15,5,0
34443,166,3529,1513,682,1277,25,13,200,1538,11,199,116,219,210,335,1557,2584,6,15641,868,0,2,5,4,0
34444,166,3529,819,519,539,24,98,155,843,15,96,57,106,111,163,690,1107,8,9171,509,0,2,5,4,0
34445,31,1087,74,35,59,1,0,14,75,3,14,7,14,17,21,58,85,1,128,7,0,2,28,4,0
34446,31,1087,245,125,200,5,7,34,250,7,30,17,34,37,51,166,265,3,1053,58,0,2,28,4,0
34447,282,5915,1943,715,1694,26,18,214,1969,12,185,120,237,197,357,1436,2721,7,20915,1161,0,2,1,1,0
34448,282,5915,1168,838,957,57,25,144,1225,19,348,224,416,367,640,3018,5452,11,61921,3440,1,2,1,1,0
34449,111,6122,1943,715,1694,26,18,214,1969,12,185,120,237,197,357,1436,2721,7,20915,1161,0,2,1,1,0
34450,184,5563,1660,832,1314,41,38,274,1701,20,312,209,395,332,604,2671,5058,12,64042,3557,1,2,4,1,0
34451,184,5563,1057,646,719,113,100,145,1170,18,215,134,248,233,382,1740,3004,10,31186,1732,1,2,4,1,0
34452,236,4942,2,2,2,0,0,0,2,0,0,0,0,0,0,0,0,0,0,0,0,2,3,3,0
34453,236,4942,99,48,90,1,3,5,100,0,0,0,0,0,0,0,0,0,0,0,0,2,3,3,0
34454,236,4942,8,5,5,2,0,1,10,0,0,0,0,0,0,0,0,0,0,0,0,2,3,3,0
34455,236,4942,1217,716,841,84,126,174,1301,14,185,118,215,199,333,1446,2542,8,20687,1149,0,2,3,3,0
34456,236,4942,160,89,115,0,13,31,160,7,15,11,17,22,28,78,124,3,495,27,0,2,3,3,0
34457,236,4942,10,10,9,9,0,0,19,0,0,0,0,0,0,0,0,0,0,0,0,2,3,3,0
34458,236,4942,173,84,99,8,29,36,181,5,12,7,13,17,20,54,81,2,221,12,0,2,3,3,0
34459,236,4942,3,1,1,3,0,0,6,0,0,0,0,0,0,0,0,0,0,0,0,2,3,3,0
34460,249,5765,4293,999,3693,19,54,507,4312,9,155,88,170,164,258,1156,1898,4,9368,520,0,2,9,0,0
34461,249,5765,1482,859,1002,125,135,219,1607,16,219,134,251,235,385,1766,3032,9,27804,1544,1,2,9,0,0
34462,314,6912,72,33,56,0,4,12,72,1,1,1,1,2,2,0,2,0,1,0,0,2,1,6,0
34463,314,6912,1454,835,1044,76,110,219,1530,17,275,158,296,292,454,2297,3718,9,34017,1889,1,2,1,6,0
34464,104,5361,1457,730,1242,11,6,188,1468,10,292,166,329,302,495,2424,4078,5,22973,1276,1,2,11,0,0
34465,20,534,205,80,86,16,53,53,221,7,18,10,19,25,29,94,134,3,497,27,0,2,5,5,0
34466,81,3172,1178,367,1042,6,15,115,1184,9,94,51,95,103,146,644,976,4,4439,246,0,2,8,0,0
34467,76,3910,1293,570,1093,25,15,163,1318,10,195,123,241,205,364,1516,2795,6,17273,959,0,2,16,12,0
34468,3,42,14,8,8,0,0,6,14,0,0,0,0,0,0,0,0,0,0,0,0,2,1,0,0
34469,2,40,9,6,6,0,0,3,9,0,0,0,0,0,0,0,0,0,0,0,0,2,1,0,0
34470,2,40,13,9,8,0,0,4,13,0,0,0,0,0,0,0,0,0,0,0,0,2,1,0,0
34471,60,1163,282,196,195,3,0,86,285,8,130,71,141,138,212,936,1507,4,6538,363,0,2,1,0,0
34472,4,77,127,75,83,2,11,30,129,4,14,7,14,18,21,61,87,2,175,9,0,2,1,0,0
34473,4,77,652,304,544,16,6,88,668,6,89,51,101,95,152,591,998,3,3399,188,0,2,1,0,0
34474,4,77,2,2,2,0,0,0,2,0,0,0,0,0,0,0,0,0,0,0,0,2,1,0,0
34475,4,77,8,5,5,0,0,3,8,0,0,0,0,0,0,0,0,0,0,0,0,2,1,0,0
34476,4,77,2,2,2,0,0,0,2,0,0,0,0,0,0,0,0,0,0,0,0,2,1,0,0
34477,4,77,14,8,8,0,0,6,14,0,0,0,0,0,0,0,0,0,0,0,0,2,1,0,0
34478,4,77,6,4,4,0,0,2,6,0,0,0,0,0,0,0,0,0,0,0,0,2,1,0,0
34479,4,77,6,4,4,0,0,2,6,1,2,1,2,3,3,2,4,0,2,0,0,2,1,0,0
34480,4,77,6,4,4,0,0,2,6,0,0,0,0,0,0,0,0,0,0,0,0,2,1,0,0
34481,4,77,7,5,5,0,0,2,7,0,0,0,0,0,0,0,0,0,0,0,0,2,1,0,0
34482,4,77,6,4,4,0,0,2,6,0,0,0,0,0,0,0,0,0,0,0,0,2,1,0,0
34483,4,77,10,6,6,0,0,4,10,0,0,0,0,0,0,0,0,0,0,0,0,2,1,0,0
34484,4,77,1,1,1,0,0,0,1,0,0,0,0,0,0,0,0,0,0,0,0,2,1,0,0
34485,4,77,1,1,1,0,0,0,1,0,0,0,0,0,0,0,0,0,0,0,0,2,1,0,0
34486,4,77,14,10,10,0,0,4,14,1,1,1,1,2,2,0,2,0,1,0,0,2,1,0,0
34487,4,77,46,26,30,3,0,12,49,3,6,3,6,9,9,20,28,1,42,2,0,2,1,0,0
34488,1,9,5,3,3,0,0,2,5,0,0,0,0,0,0,0,0,0,0,0,0,2,1,0,0
34489,1,90,13,10,10,0,0,3,13,1,2,1,2,3,3,2,4,0,2,0,0,2,1,0,0
34490,7,114,44,19,17,0,16,11,44,3,14,7,14,17,21,58,85,1,128,7,0,2,1,0,0
34491,3,66,127,75,83,2,11,30,129,4,14,7,14,18,21,61,87,2,175,9,0,2,1,0,0
34492,3,66,652,304,544,16,6,88,668,6,89,51,101,95,152,591,998,3,3399,188,0,2,1,0,0
34493,3,66,2,2,2,0,0,0,2,0,0,0,0,0,0,0,0,0,0,0,0,2,1,0,0
34494,3,66,8,5,5,0,0,3,8,0,0,0,0,0,0,0,0,0,0,0,0,2,1,0,0
34495,3,66,2,2,2,0,0,0,2,0,0,0,0,0,0,0,0,0,0,0,0,2,1,0,0
34496,3,66,14,8,8,0,0,6,14,0,0,0,0,0,0,0,0,0,0,0,0,2,1,0,0
34497,3,66,6,4,4,0,0,2,6,0,0,0,0,0,0,0,0,0,0,0,0,2,1,0,0
34498,3,66,6,4,4,0,0,2,6,1,2,1,2,3,3,2,4,0,2,0,0,2,1,0,0
34499,3,66,6,4,4,0,0,2,6,0,0,0,0,0,0,0,0,0,0,0,0,2,1,0,0
34500,3,66,7,5,5,0,0,2,7,0,0,0,0,0,0,0,0,0,0,0,0,2,1,0,0
34501,3,66,6,4,4,0,0,2,6,0,0,0,0,0,0,0,0,0,0,0,0,2,1,0,0
34502,3,66,10,6,6,0,0,4,10,0,0,0,0,0,0,0,0,0,0,0,0,2,1,0,0
34503,3,66,1,1,1,0,0,0,1,0,0,0,0,0,0,0,0,0,0,0,0,2,1,0,0
34504,3,66,1,1,1,0,0,0,1,0,0,0,0,0,0,0,0,0,0,0,0,2,1,0,0
34505,3,66,14,10,10,0,0,4,14,1,1,1,1,2,2,0,2,0,1,0,0,2,1,0,0
34506,3,66,46,26,30,3,0,12,49,3,6,3,6,9,9,20,28,1,42,2,0,2,1,0,0
34507,7,296,72,33,56,0,4,12,72,1,1,1,1,2,2,0,2,0,1,0,0,2,1,0,0
34508,12,229,127,75,83,2,11,30,129,4,14,7,14,18,21,61,87,2,175,9,0,2,1,0,0
34509,12,229,652,304,544,16,6,88,668,6,89,51,101,95,152,591,998,3,3399,188,0,2,1,0,0
34510,12,229,2,2,2,0,0,0,2,0,0,0,0,0,0,0,0,0,0,0,0,2,1,0,0
34511,12,229,8,5,5,0,0,3,8,0,0,0,0,0,0,0,0,0,0,0,0,2,1,0,0
34512,12,229,2,2,2,0,0,0,2,0,0,0,0,0,0,0,0,0,0,0,0,2,1,0,0
34513,12,229,14,8,8,0,0,6,14,0,0,0,0,0,0,0,0,0,0,0,0,2,1,0,0
34514,12,229,6,4,4,0,0,2,6,0,0,0,0,0,0,0,0,0,0,0,0,2,1,0,0
34515,12,229,6,4,4,0,0,2,6,1,2,1,2,3,3,2,4,0,2,0,0,2,1,0,0
34516,12,229,6,4,4,0,0,2,6,0,0,0,0,0,0,0,0,0,0,0,0,2,1,0,0
34517,12,229,7,5,5,0,0,2,7,0,0,0,0,0,0,0,0,0,0,0,0,2,1,0,0
34518,12,229,6,4,4,0,0,2,6,0,0,0,0,0,0,0,0,0,0,0,0,2,1,0,0
34519,12,229,10,6,6,0,0,4,10,0,0,0,0,0,0,0,0,0,0,0,0,2,1,0,0
34520,12,229,1,1,1,0,0,0,1,0,0,0,0,0,0,0,0,0,0,0,0,2,1,0,0
34521,12,229,1,1,1,0,0,0,1,0,0,0,0,0,0,0,0,0,0,0,0,2,1,0,0
34522,12,229,14,10,10,0,0,4,14,1,1,1,1,2,2,0,2,0,1,0,0,2,1,0,0
34523,12,229,46,26,30,3,0,12,49,3,6,3,6,9,9,20,28,1,42,2,0,2,1,0,0
34524,6,71,127,75,83,2,11,30,129,4,14,7,14,18,21,61,87,2,175,9,0,2,1,0,0
34525,6,71,652,304,544,16,6,88,668,6,89,51,101,95,152,591,998,3,3399,188,0,2,1,0,0
34526,6,71,2,2,2,0,0,0,2,0,0,0,0,0,0,0,0,0,0,0,0,2,1,0,0
34527,6,71,8,5,5,0,0,3,8,0,0,0,0,0,0,0,0,0,0,0,0,2,1,0,0
34528,6,71,2,2,2,0,0,0,2,0,0,0,0,0,0,0,0,0,0,0,0,2,1,0,0
34529,6,71,14,8,8,0,0,6,14,0,0,0,0,0,0,0,0,0,0,0,0,2,1,0,0
34530,6,71,6,4,4,0,0,2,6,0,0,0,0,0,0,0,0,0,0,0,0,2,1,0,0
34531,6,71,6,4,4,0,0,2,6,1,2,1,2,3,3,2,4,0,2,0,0,2,1,0,0
34532,6,71,6,4,4,0,0,2,6,0,0,0,0,0,0,0,0,0,0,0,0,2,1,0,0
34533,6,71,7,5,5,0,0,2,7,0,0,0,0,0,0,0,0,0,0,0,0,2,1,0,0
34534,6,71,6,4,4,0,0,2,6,0,0,0,0,0,0,0,0,0,0,0,0,2,1,0,0
34535,6,71,10,6,6,0,0,4,10,0,0,0,0,0,0,0,0,0,0,0,0,2,1,0,0
34536,6,71,1,1,1,0,0,0,1,0,0,0,0,0,0,0,0,0,0,0,0,2,1,0,0
34537,6,71,1,1,1,0,0,0,1,0,0,0,0,0,0,0,0,0,0,0,0,2,1,0,0
34538,6,71,14,10,10,0,0,4,14,1,1,1,1,2,2,0,2,0,1,0,0,2,1,0,0
34539,6,71,46,26,30,3,0,12,49,3,6,3,6,9,9,20,28,1,42,2,0,2,1,0,0
34540,3,26,14,7,7,2,0,5,16,0,0,0,0,0,0,0,0,0,0,0,0,2,1,0,0
34541,7,103,38,23,23,0,0,15,38,0,0,0,0,0,0,0,0,0,0,0,0,2,1,0,0
34542,17,378,85,59,61,8,0,16,93,5,18,10,18,23,28,86,126,2,316,17,0,2,1,0,0
34543,12,515,124,78,88,2,3,26,126,4,13,7,13,17,20,56,81,2,163,9,0,2,1,0,0
34544,1,96,42,7,35,4,0,5,46,1,2,1,2,3,3,2,4,0,2,0,0,2,1,0,0
34545,1,96,11,6,10,0,0,1,11,2,4,2,4,6,6,10,15,1,15,0,0,2,1,0,0
34546,11,242,19,8,11,5,0,4,24,2,5,3,6,7,9,13,25,1,30,1,0,2,1,0,0
34547,11,242,102,59,69,5,3,24,107,6,22,15,28,28,43,113,206,3,789,43,0,2,1,0,0
34548,11,242,106,40,36,3,49,17,109,8,17,13,23,25,36,93,167,5,904,50,0,2,1,0,0
34549,229,4960,182,127,129,0,0,53,182,5,39,21,42,44,63,217,343,2,926,51,0,2,1,0,0
34550,229,4960,1165,710,800,67,119,181,1232,18,243,153,282,261,435,2000,3492,10,36473,2026,1,2,1,0,0
34551,67,1570,773,419,590,28,0,166,801,10,204,113,217,214,330,1598,2554,5,13587,754,0,2,1,0,0
34552,67,1570,421,273,302,44,34,57,465,17,81,59,107,98,166,583,1098,11,12329,684,0,2,1,0,0
34553,14,411,149,95,105,2,0,41,151,8,54,28,55,62,83,334,494,4,2013,111,0,2,1,0,0
34554,14,411,82,56,54,0,13,15,82,4,13,8,16,17,24,56,98,2,241,13,0,2,1,0,0
34555,26,529,2,2,2,0,0,0,2,0,0,0,0,0,0,0,0,0,0,0,0,2,1,0,0
34556,26,529,99,48,90,1,3,5,100,0,0,0,0,0,0,0,0,0,0,0,0,2,1,0,0
34557,26,529,8,5,5,2,0,1,10,0,0,0,0,0,0,0,0,0,0,0,0,2,1,0,0
34558,26,529,1217,716,841,84,126,174,1301,14,185,118,215,199,333,1446,2542,8,20687,1149,0,2,1,0,0
34559,26,529,160,89,115,0,13,31,160,7,15,11,17,22,28,78,124,3,495,27,0,2,1,0,0
34560,26,529,10,10,9,9,0,0,19,0,0,0,0,0,0,0,0,0,0,0,0,2,1,0,0
34561,26,529,173,84,99,8,29,36,181,5,12,7,13,17,20,54,81,2,221,12,0,2,1,0,0
34562,26,529,3,1,1,3,0,0,6,0,0,0,0,0,0,0,0,0,0,0,0,2,1,0,0
34563,184,5563,1660,832,1314,41,38,274,1701,20,312,209,395,332,604,2671,5058,12,64042,3557,1,2,1,0,0
34564,184,5563,1057,646,719,113,100,145,1170,18,215,134,248,233,382,1740,3004,10,31186,1732,1,2,1,0,0
34565,17,348,95,58,50,9,16,20,104,12,33,24,45,45,69,209,378,8,3100,172,0,2,1,0,0
34566,116,2173,477,336,357,30,23,73,507,16,194,134,250,210,384,1538,2962,10,30538,1696,0,2,1,0,0
34567,89,2050,996,429,845,24,10,117,1020,7,76,50,88,83,138,494,879,4,3565,198,0,2,1,0,0
34568,89,2050,456,277,329,12,42,72,468,13,85,50,97,98,147,592,972,7,7212,400,0,2,1,0,0
34569,164,3518,1513,682,1277,25,13,200,1538,11,199,116,219,210,335,1557,2584,6,15641,868,0,2,1,0,0
34570,164,3518,819,519,539,24,98,155,843,15,96,57,106,111,163,690,1107,8,9171,509,0,2,1,0,0
34571,73,1518,207,111,150,11,0,50,218,5,26,19,36,31,55,133,272,3,943,52,0,2,1,0,0
34572,73,1518,410,198,237,31,55,97,441,11,63,38,72,74,110,414,683,6,4293,238,0,2,1,0,0
34573,236,4942,2,2,2,0,0,0,2,0,0,0,0,0,0,0,0,0,0,0,0,2,1,0,0
34574,236,4942,99,48,90,1,3,5,100,0,0,0,0,0,0,0,0,0,0,0,0,2,1,0,0
34575,236,4942,8,5,5,2,0,1,10,0,0,0,0,0,0,0,0,0,0,0,0,2,1,0,0
34576,236,4942,1217,716,841,84,126,174,1301,14,185,118,215,199,333,1446,2542,8,20687,1149,0,2,1,0,0
34577,236,4942,160,89,115,0,13,31,160,7,15,11,17,22,28,78,124,3,495,27,0,2,1,0,0
34578,236,4942,10,10,9,9,0,0,19,0,0,0,0,0,0,0,0,0,0,0,0,2,1,0,0
34579,236,4942,173,84,99,8,29,36,181,5,12,7,13,17,20,54,81,2,221,12,0,2,1,0,0
34580,236,4942,3,1,1,3,0,0,6,0,0,0,0,0,0,0,0,0,0,0,0,2,1,0,0
34581,98,2019,463,295,324,28,62,57,491,12,134,82,154,146,236,989,1696,6,11700,650,0,2,1,0,0
34582,55,770,167,116,138,4,5,22,171,8,48,30,56,56,86,292,499,4,2330,129,0,2,1,0,0
34583,52,1464,339,213,244,17,9,65,356,10,42,26,48,52,74,259,421,5,2410,133,0,2,1,0,0
34584,95,2385,1455,414,1257,16,76,112,1471,5,41,23,46,46,69,231,381,2,1069,59,0,2,1,0,0
34585,95,2385,669,365,481,22,61,110,691,15,103,63,122,118,185,747,1273,8,11311,628,0,2,1,0,0
34586,249,5765,4293,999,3693,19,54,507,4312,9,155,88,170,164,258,1156,1898,4,9368,520,0,2,1,0,0
34587,249,5765,1482,859,1002,125,135,219,1607,16,219,134,251,235,385,1766,3032,9,27804,1544,1,2,1,0,0
34588,6,140,44,22,19,0,19,6,44,2,10,6,12,12,18,35,64,1,77,4,0,2,1,0,0
34589,28,981,74,35,59,1,0,14,75,3,14,7,14,17,21,58,85,1,128,7,0,2,1,0,0
34590,28,981,245,125,200,5,7,34,250,7,30,17,34,37,51,166,265,3,1053,58,0,2,1,0,0
34591,54,657,647,139,84,35,284,233,682,0,0,0,0,0,0,0,0,0,0,0,0,2,1,0,0
34592,115,3128,1523,757,1297,19,12,193,1542,12,193,117,230,205,347,1508,2664,7,19053,1058,0,2,1,0,0
34593,115,3128,701,378,504,33,58,109,734,13,110,68,126,123,194,794,1346,7,10027,557,0,2,1,0,0
34594,101,2612,773,422,505,30,103,129,803,14,77,46,83,91,129,535,839,7,6334,351,0,2,1,0,0
34595,159,3785,77,34,69,0,0,8,77,3,24,16,29,27,45,114,213,1,387,21,0,2,1,0,0
34596,159,3785,712,438,573,51,9,84,763,14,102,71,128,116,199,733,1364,8,11988,666,0,2,1,0,0
34597,24,612,2,2,2,0,0,0,2,0,0,0,0,0,0,0,0,0,0,0,0,2,1,0,0
34598,24,612,99,48,90,1,3,5,100,0,0,0,0,0,0,0,0,0,0,0,0,2,1,0,0
34599,24,612,8,5,5,2,0,1,10,0,0,0,0,0,0,0,0,0,0,0,0,2,1,0,0
34600,24,612,1217,716,841,84,126,174,1301,14,185,118,215,199,333,1446,2542,8,20687,1149,0,2,1,0,0
34601,24,612,160,89,115,0,13,31,160,7,15,11,17,22,28,78,124,3,495,27,0,2,1,0,0
34602,24,612,10,10,9,9,0,0,19,0,0,0,0,0,0,0,0,0,0,0,0,2,1,0,0
34603,24,612,173,84,99,8,29,36,181,5,12,7,13,17,20,54,81,2,221,12,0,2,1,0,0
34604,24,612,3,1,1,3,0,0,6,0,0,0,0,0,0,0,0,0,0,0,0,2,1,0,0
34605,30,664,125,97,103,3,0,19,128,9,25,17,27,34,44,144,223,4,1087,60,0,2,1,0,0
34606,22,373,102,57,55,5,16,25,107,5,17,10,18,22,28,81,124,2,330,18,0,2,1,0,0
34607,69,1527,402,202,227,24,74,80,426,12,52,33,61,64,94,339,564,7,3969,220,0,2,1,0,0
34608,55,1174,447,308,343,6,5,95,453,7,96,59,111,103,170,651,1136,4,4600,255,0,2,1,0,0
34609,55,1174,322,174,179,16,74,51,338,10,41,26,46,51,72,252,408,5,2291,127,0,2,1,0,0
34610,75,1629,53,23,39,0,0,13,53,2,8,4,8,10,12,26,39,1,39,2,0,2,1,0,0
34611,75,1629,515,298,307,33,80,99,548,12,63,44,77,75,121,419,753,7,5527,307,0,2,1,0,0
34612,18,312,424,94,331,4,0,89,428,1,5,5,5,6,10,11,25,0,12,0,0,2,1,0,0
34613,18,312,38,23,23,6,0,8,44,3,11,7,11,14,18,42,68,1,102,5,0,2,1,0,0
34614,20,531,205,80,86,16,53,53,221,7,18,10,19,25,29,94,134,3,497,27,0,2,1,0,0
34615,17,523,184,100,137,2,15,30,186,6,38,20,39,44,59,214,322,3,991,55,0,2,1,0,0
34616,17,523,103,65,74,8,5,16,111,7,17,9,17,24,26,89,119,3,417,23,0,2,1,0,0
34617,59,1228,91,45,69,0,3,18,91,3,9,6,10,12,16,33,57,1,95,5,0,2,1,0,0
34618,59,1228,367,234,237,17,34,68,384,16,55,34,61,71,95,381,584,8,5183,287,0,2,1,0,0
34619,231,5969,722,423,573,19,0,135,741,12,172,101,199,184,300,1320,2257,6,15668,870,0,2,1,0,0
34620,231,5969,1508,847,911,44,250,301,1552,14,148,88,169,162,257,1120,1886,7,15077,837,0,2,1,0,0
34621,314,6912,72,33,56,0,4,12,72,1,1,1,1,2,2,0,2,0,1,0,0,2,1,0,0
34622,314,6912,1454,835,1044,76,110,219,1530,17,275,158,296,292,454,2297,3718,9,34017,1889,1,2,1,0,0
34623,92,1886,757,253,292,73,244,162,830,13,61,38,67,74,105,409,651,7,4654,258,0,2,1,0,0
34624,45,953,386,256,301,16,9,68,402,4,59,35,69,63,104,355,621,2,1453,80,0,2,1,0,0
34625,45,953,264,131,164,11,41,46,275,6,38,22,40,44,62,214,338,3,1068,59,0,2,1,0,0
34626,67,1753,466,257,367,18,25,50,484,7,126,86,171,133,257,898,1813,4,8612,478,0,2,1,0,0
34627,67,1753,507,281,342,29,59,88,536,10,53,29,57,63,86,336,514,5,2764,153,0,2,1,0,0
34628,25,552,215,129,180,6,0,29,221,8,65,43,72,73,115,415,711,4,3153,175,0,2,1,0,0
34629,25,552,97,69,77,3,3,16,100,6,22,13,23,28,36,113,173,3,542,30,0,2,1,0,0
34630,89,1894,1043,504,840,53,9,147,1096,9,180,112,198,189,310,1377,2344,4,11604,644,0,2,1,0,0
34631,89,1894,383,288,292,26,6,62,409,11,65,38,67,76,105,429,656,5,3719,206,0,2,1,0,0
34632,20,420,294,64,250,0,0,43,294,1,20,10,20,21,30,86,131,0,65,3,0,2,1,0,0
34633,20,420,78,46,62,3,0,14,81,3,8,4,8,11,12,28,41,1,62,3,0,2,1,0,0
34634,5,123,110,30,77,3,13,16,113,4,21,15,30,25,45,100,208,2,597,33,0,2,1,0,0
34635,5,123,28,15,21,1,0,6,29,0,0,0,0,0,0,0,0,0,0,0,0,2,1,0,0
34636,41,821,1178,367,1042,6,15,115,1184,9,94,51,95,103,146,644,976,4,4439,246,0,2,1,1,0
34637,41,821,177,108,140,8,0,27,185,6,30,16,32,36,48,162,248,3,794,44,0,2,1,1,0
34638,28,452,219,78,157,11,5,46,230,3,24,20,34,27,54,114,256,2,545,30,0,2,1,0,0
34639,28,452,108,64,79,9,0,20,117,5,15,11,19,20,30,70,129,3,410,22,0,2,1,0,0
34640,282,5915,1943,715,1694,26,18,214,1969,12,185,120,237,197,357,1436,2721,7,20915,1161,0,2,1,1,0
34641,282,5915,1168,838,957,57,25,144,1225,19,348,224,416,367,640,3018,5452,11,61921,3440,1,2,1,1,0
34642,19,720,442,244,305,14,16,103,456,11,68,45,75,79,120,452,756,6,4588,254,0,2,1,0,0
34643,19,720,182,102,99,11,40,35,193,3,11,6,11,14,17,42,64,1,97,5,0,2,1,0,0
34644,69,1323,1098,241,925,5,10,155,1103,7,46,25,49,53,74,273,423,3,1580,87,0,2,1,0,0
34645,69,1323,282,202,222,14,2,44,296,8,42,24,43,50,67,250,378,4,1548,86,0,2,1,0,0
34646,2,156,37,13,25,0,6,6,37,1,2,1,2,3,3,2,4,0,2,0,0,2,1,0,0
34647,2,156,133,47,40,1,43,49,134,0,0,0,0,0,0,0,0,0,0,0,0,2,1,0,0
34648,29,743,601,196,481,2,23,85,603,8,63,36,72,71,108,400,664,4,3036,168,0,2,1,0,0
34649,29,743,156,79,106,5,16,28,161,5,14,8,15,19,23,64,97,2,261,14,0,2,1,0,0
34650,36,1120,182,127,129,0,0,53,182,5,39,21,42,44,63,217,343,2,926,51,0,2,1,1,0
34651,7,123,127,75,83,2,11,30,129,4,14,7,14,18,21,61,87,2,175,9,0,2,1,0,0
34652,7,123,652,304,544,16,6,88,668,6,89,51,101,95,152,591,998,3,3399,188,0,2,1,0,0
34653,7,123,2,2,2,0,0,0,2,0,0,0,0,0,0,0,0,0,0,0,0,2,1,0,0
34654,7,123,8,5,5,0,0,3,8,0,0,0,0,0,0,0,0,0,0,0,0,2,1,0,0
34655,7,123,2,2,2,0,0,0,2,0,0,0,0,0,0,0,0,0,0,0,0,2,1,0,0
34656,7,123,14,8,8,0,0,6,14,0,0,0,0,0,0,0,0,0,0,0,0,2,1,0,0
34657,7,123,6,4,4,0,0,2,6,0,0,0,0,0,0,0,0,0,0,0,0,2,1,0,0
34658,7,123,6,4,4,0,0,2,6,1,2,1,2,3,3,2,4,0,2,0,0,2,1,0,0
34659,7,123,6,4,4,0,0,2,6,0,0,0,0,0,0,0,0,0,0,0,0,2,1,0,0
34660,7,123,7,5,5,0,0,2,7,0,0,0,0,0,0,0,0,0,0,0,0,2,1,0,0
34661,7,123,6,4,4,0,0,2,6,0,0,0,0,0,0,0,0,0,0,0,0,2,1,0,0
34662,7,123,10,6,6,0,0,4,10,0,0,0,0,0,0,0,0,0,0,0,0,2,1,0,0
34663,7,123,1,1,1,0,0,0,1,0,0,0,0,0,0,0,0,0,0,0,0,2,1,0,0
34664,7,123,1,1,1,0,0,0,1,0,0,0,0,0,0,0,0,0,0,0,0,2,1,0,0
34665,7,123,14,10,10,0,0,4,14,1,1,1,1,2,2,0,2,0,1,0,0,2,1,0,0
34666,7,123,46,26,30,3,0,12,49,3,6,3,6,9,9,20,28,1,42,2,0,2,1,0,0
34667,14,845,75,38,59,1,3,12,76,2,4,2,4,6,6,10,15,1,15,0,0,2,1,0,0
34668,2,67,16,12,9,0,0,6,16,1,2,1,2,3,3,2,4,0,2,0,0,2,1,0,0
34669,1,6,2,2,2,0,0,0,2,0,0,0,0,0,0,0,0,0,0,0,0,2,1,0,0
34670,1,6,99,48,90,1,3,5,100,0,0,0,0,0,0,0,0,0,0,0,0,2,1,0,0
34671,1,6,8,5,5,2,0,1,10,0,0,0,0,0,0,0,0,0,0,0,0,2,1,0,0
34672,1,6,1217,716,841,84,126,174,1301,14,185,118,215,199,333,1446,2542,8,20687,1149,0,2,1,0,0
34673,1,6,160,89,115,0,13,31,160,7,15,11,17,22,28,78,124,3,495,27,0,2,1,0,0
34674,1,6,10,10,9,9,0,0,19,0,0,0,0,0,0,0,0,0,0,0,0,2,1,0,0
34675,1,6,173,84,99,8,29,36,181,5,12,7,13,17,20,54,81,2,221,12,0,2,1,0,0
34676,1,6,3,1,1,3,0,0,6,0,0,0,0,0,0,0,0,0,0,0,0,2,1,0,0
34677,1,6,2,2,2,0,0,0,2,0,0,0,0,0,0,0,0,0,0,0,0,2,1,0,0
34678,1,6,2,2,2,0,0,0,2,0,0,0,0,0,0,0,0,0,0,0,0,2,1,0,0
34679,1,6,2,2,2,0,0,0,2,0,0,0,0,0,0,0,0,0,0,0,0,2,1,0,0
34680,1,6,2,2,2,0,0,0,2,0,0,0,0,0,0,0,0,0,0,0,0,2,1,0,0
34681,1,8,127,75,83,2,11,30,129,4,14,7,14,18,21,61,87,2,175,9,0,2,1,0,0
34682,1,8,652,304,544,16,6,88,668,6,89,51,101,95,152,591,998,3,3399,188,0,2,1,0,0
34683,1,8,2,2,2,0,0,0,2,0,0,0,0,0,0,0,0,0,0,0,0,2,1,0,0
34684,1,8,8,5,5,0,0,3,8,0,0,0,0,0,0,0,0,0,0,0,0,2,1,0,0
34685,1,8,2,2,2,0,0,0,2,0,0,0,0,0,0,0,0,0,0,0,0,2,1,0,0
34686,1,8,14,8,8,0,0,6,14,0,0,0,0,0,0,0,0,0,0,0,0,2,1,0,0
34687,1,8,6,4,4,0,0,2,6,0,0,0,0,0,0,0,0,0,0,0,0,2,1,0,0
34688,1,8,6,4,4,0,0,2,6,1,2,1,2,3,3,2,4,0,2,0,0,2,1,0,0
34689,1,8,6,4,4,0,0,2,6,0,0,0,0,0,0,0,0,0,0,0,0,2,1,0,0
34690,1,8,7,5,5,0,0,2,7,0,0,0,0,0,0,0,0,0,0,0,0,2,1,0,0
34691,1,8,6,4,4,0,0,2,6,0,0,0,0,0,0,0,0,0,0,0,0,2,1,0,0
34692,1,8,10,6,6,0,0,4,10,0,0,0,0,0,0,0,0,0,0,0,0,2,1,0,0
34693,1,8,1,1,1,0,0,0,1,0,0,0,0,0,0,0,0,0,0,0,0,2,1,0,0
34694,1,8,1,1,1,0,0,0,1,0,0,0,0,0,0,0,0,0,0,0,0,2,1,0,0
34695,1,8,14,10,10,0,0,4,14,1,1,1,1,2,2,0,2,0,1,0,0,2,1,0,0
34696,1,8,46,26,30,3,0,12,49,3,6,3,6,9,9,20,28,1,42,2,0,2,1,0,0
34697,1,6,2,2,2,0,0,0,2,0,0,0,0,0,0,0,0,0,0,0,0,2,1,0,0
34698,1,6,2,2,2,0,0,0,2,0,0,0,0,0,0,0,0,0,0,0,0,2,1,0,0
34699,1,6,2,2,2,0,0,0,2,0,0,0,0,0,0,0,0,0,0,0,0,2,1,0,0
34700,1,6,2,2,2,0,0,0,2,0,0,0,0,0,0,0,0,0,0,0,0,2,1,0,0
34701,1,6,2,2,2,0,0,0,2,0,0,0,0,0,0,0,0,0,0,0,0,2,1,0,0
34702,1,6,2,2,2,0,0,0,2,0,0,0,0,0,0,0,0,0,0,0,0,2,1,0,0
34703,1,6,2,2,2,0,0,0,2,0,0,0,0,0,0,0,0,0,0,0,0,2,1,0,0
34704,1,6,2,2,2,0,0,0,2,0,0,0,0,0,0,0,0,0,0,0,0,2,1,0,0
34705,1,6,2,2,2,0,0,0,2,0,0,0,0,0,0,0,0,0,0,0,0,2,1,0,0
34706,2,25,127,75,83,2,11,30,129,4,14,7,14,18,21,61,87,2,175,9,0,2,1,0,0
34707,2,25,652,304,544,16,6,88,668,6,89,51,101,95,152,591,998,3,3399,188,0,2,1,0,0
34708,2,25,2,2,2,0,0,0,2,0,0,0,0,0,0,0,0,0,0,0,0,2,1,0,0
34709,2,25,8,5,5,0,0,3,8,0,0,0,0,0,0,0,0,0,0,0,0,2,1,0,0
34710,2,25,2,2,2,0,0,0,2,0,0,0,0,0,0,0,0,0,0,0,0,2,1,0,0
34711,2,25,14,8,8,0,0,6,14,0,0,0,0,0,0,0,0,0,0,0,0,2,1,0,0
34712,2,25,6,4,4,0,0,2,6,0,0,0,0,0,0,0,0,0,0,0,0,2,1,0,0
34713,2,25,6,4,4,0,0,2,6,1,2,1,2,3,3,2,4,0,2,0,0,2,1,0,0
34714,2,25,6,4,4,0,0,2,6,0,0,0,0,0,0,0,0,0,0,0,0,2,1,0,0
34715,2,25,7,5,5,0,0,2,7,0,0,0,0,0,0,0,0,0,0,0,0,2,1,0,0
34716,2,25,6,4,4,0,0,2,6,0,0,0,0,0,0,0,0,0,0,0,0,2,1,0,0
34717,2,25,10,6,6,0,0,4,10,0,0,0,0,0,0,0,0,0,0,0,0,2,1,0,0
34718,2,25,1,1,1,0,0,0,1,0,0,0,0,0,0,0,0,0,0,0,0,2,1,0,0
34719,2,25,1,1,1,0,0,0,1,0,0,0,0,0,0,0,0,0,0,0,0,2,1,0,0
34720,2,25,14,10,10,0,0,4,14,1,1,1,1,2,2,0,2,0,1,0,0,2,1,0,0
34721,2,25,46,26,30,3,0,12,49,3,6,3,6,9,9,20,28,1,42,2,0,2,1,0,0
34722,1,55,14,12,10,0,0,4,14,1,2,1,2,3,3,2,4,0,2,0,0,2,1,0,0
34723,1,58,14,12,10,0,0,4,14,1,2,1,2,3,3,2,4,0,2,0,0,2,1,0,0
34724,1,55,14,12,10,0,0,4,14,1,2,1,2,3,3,2,4,0,2,0,0,2,1,0,0
34725,1,77,19,18,14,0,0,5,19,1,2,1,2,3,3,2,4,0,2,0,0,2,1,0,0
34726,2,18,10,6,6,0,0,4,10,0,0,0,0,0,0,0,0,0,0,0,0,2,1,0,0
34727,2,36,127,75,83,2,11,30,129,4,14,7,14,18,21,61,87,2,175,9,0,2,1,0,0
34728,2,36,652,304,544,16,6,88,668,6,89,51,101,95,152,591,998,3,3399,188,0,2,1,0,0
34729,2,36,2,2,2,0,0,0,2,0,0,0,0,0,0,0,0,0,0,0,0,2,1,0,0
34730,2,36,8,5,5,0,0,3,8,0,0,0,0,0,0,0,0,0,0,0,0,2,1,0,0
34731,2,36,2,2,2,0,0,0,2,0,0,0,0,0,0,0,0,0,0,0,0,2,1,0,0
34732,2,36,14,8,8,0,0,6,14,0,0,0,0,0,0,0,0,0,0,0,0,2,1,0,0
34733,2,36,6,4,4,0,0,2,6,0,0,0,0,0,0,0,0,0,0,0,0,2,1,0,0
34734,2,36,6,4,4,0,0,2,6,1,2,1,2,3,3,2,4,0,2,0,0,2,1,0,0
34735,2,36,6,4,4,0,0,2,6,0,0,0,0,0,0,0,0,0,0,0,0,2,1,0,0
34736,2,36,7,5,5,0,0,2,7,0,0,0,0,0,0,0,0,0,0,0,0,2,1,0,0
34737,2,36,6,4,4,0,0,2,6,0,0,0,0,0,0,0,0,0,0,0,0,2,1,0,0
34738,2,36,10,6,6,0,0,4,10,0,0,0,0,0,0,0,0,0,0,0,0,2,1,0,0
34739,2,36,1,1,1,0,0,0,1,0,0,0,0,0,0,0,0,0,0,0,0,2,1,0,0
34740,2,36,1,1,1,0,0,0,1,0,0,0,0,0,0,0,0,0,0,0,0,2,1,0,0
34741,2,36,14,10,10,0,0,4,14,1,1,1,1,2,2,0,2,0,1,0,0,2,1,0,0
34742,2,36,46,26,30,3,0,12,49,3,6,3,6,9,9,20,28,1,42,2,0,2,1,0,0
34743,1,6,2,2,2,0,0,0,2,0,0,0,0,0,0,0,0,0,0,0,0,2,1,0,0
34744,1,6,2,2,2,0,0,0,2,0,0,0,0,0,0,0,0,0,0,0,0,2,1,0,0
34745,1,6,2,2,2,0,0,0,2,0,0,0,0,0,0,0,0,0,0,0,0,2,1,0,0
34746,1,6,2,2,2,0,0,0,2,0,0,0,0,0,0,0,0,0,0,0,0,2,1,0,0
34747,1,26,127,75,83,2,11,30,129,4,14,7,14,18,21,61,87,2,175,9,0,2,1,0,0
34748,1,26,652,304,544,16,6,88,668,6,89,51,101,95,152,591,998,3,3399,188,0,2,1,0,0
34749,1,26,2,2,2,0,0,0,2,0,0,0,0,0,0,0,0,0,0,0,0,2,1,0,0
34750,1,26,8,5,5,0,0,3,8,0,0,0,0,0,0,0,0,0,0,0,0,2,1,0,0
34751,1,26,2,2,2,0,0,0,2,0,0,0,0,0,0,0,0,0,0,0,0,2,1,0,0
34752,1,26,14,8,8,0,0,6,14,0,0,0,0,0,0,0,0,0,0,0,0,2,1,0,0
34753,1,26,6,4,4,0,0,2,6,0,0,0,0,0,0,0,0,0,0,0,0,2,1,0,0
34754,1,26,6,4,4,0,0,2,6,1,2,1,2,3,3,2,4,0,2,0,0,2,1,0,0
34755,1,26,6,4,4,0,0,2,6,0,0,0,0,0,0,0,0,0,0,0,0,2,1,0,0
34756,1,26,7,5,5,0,0,2,7,0,0,0,0,0,0,0,0,0,0,0,0,2,1,0,0
34757,1,26,6,4,4,0,0,2,6,0,0,0,0,0,0,0,0,0,0,0,0,2,1,0,0
34758,1,26,10,6,6,0,0,4,10,0,0,0,0,0,0,0,0,0,0,0,0,2,1,0,0
34759,1,26,1,1,1,0,0,0,1,0,0,0,0,0,0,0,0,0,0,0,0,2,1,0,0
34760,1,26,1,1,1,0,0,0,1,0,0,0,0,0,0,0,0,0,0,0,0,2,1,0,0
34761,1,26,14,10,10,0,0,4,14,1,1,1,1,2,2,0,2,0,1,0,0,2,1,0,0
34762,1,26,46,26,30,3,0,12,49,3,6,3,6,9,9,20,28,1,42,2,0,2,1,0,0
34763,1,7,2,2,2,0,0,0,2,0,0,0,0,0,0,0,0,0,0,0,0,2,1,0,0
34764,1,24,127,75,83,2,11,30,129,4,14,7,14,18,21,61,87,2,175,9,0,2,1,0,0
34765,1,24,652,304,544,16,6,88,668,6,89,51,101,95,152,591,998,3,3399,188,0,2,1,0,0
34766,1,24,2,2,2,0,0,0,2,0,0,0,0,0,0,0,0,0,0,0,0,2,1,0,0
34767,1,24,8,5,5,0,0,3,8,0,0,0,0,0,0,0,0,0,0,0,0,2,1,0,0
34768,1,24,2,2,2,0,0,0,2,0,0,0,0,0,0,0,0,0,0,0,0,2,1,0,0
34769,1,24,14,8,8,0,0,6,14,0,0,0,0,0,0,0,0,0,0,0,0,2,1,0,0
34770,1,24,6,4,4,0,0,2,6,0,0,0,0,0,0,0,0,0,0,0,0,2,1,0,0
34771,1,24,6,4,4,0,0,2,6,1,2,1,2,3,3,2,4,0,2,0,0,2,1,0,0
34772,1,24,6,4,4,0,0,2,6,0,0,0,0,0,0,0,0,0,0,0,0,2,1,0,0
34773,1,24,7,5,5,0,0,2,7,0,0,0,0,0,0,0,0,0,0,0,0,2,1,0,0
34774,1,24,6,4,4,0,0,2,6,0,0,0,0,0,0,0,0,0,0,0,0,2,1,0,0
34775,1,24,10,6,6,0,0,4,10,0,0,0,0,0,0,0,0,0,0,0,0,2,1,0,0
34776,1,24,1,1,1,0,0,0,1,0,0,0,0,0,0,0,0,0,0,0,0,2,1,0,0
34777,1,24,1,1,1,0,0,0,1,0,0,0,0,0,0,0,0,0,0,0,0,2,1,0,0
34778,1,24,14,10,10,0,0,4,14,1,1,1,1,2,2,0,2,0,1,0,0,2,1,0,0
34779,1,24,46,26,30,3,0,12,49,3,6,3,6,9,9,20,28,1,42,2,0,2,1,0,0
34780,1,7,2,2,2,0,0,0,2,0,0,0,0,0,0,0,0,0,0,0,0,2,1,0,0
34781,3,33,15,9,9,0,0,6,15,0,0,0,0,0,0,0,0,0,0,0,0,2,1,0,0
34782,1,13,127,75,83,2,11,30,129,4,14,7,14,18,21,61,87,2,175,9,0,2,1,0,0
34783,1,13,652,304,544,16,6,88,668,6,89,51,101,95,152,591,998,3,3399,188,0,2,1,0,0
34784,1,13,2,2,2,0,0,0,2,0,0,0,0,0,0,0,0,0,0,0,0,2,1,0,0
34785,1,13,8,5,5,0,0,3,8,0,0,0,0,0,0,0,0,0,0,0,0,2,1,0,0
34786,1,13,2,2,2,0,0,0,2,0,0,0,0,0,0,0,0,0,0,0,0,2,1,0,0
34787,1,13,14,8,8,0,0,6,14,0,0,0,0,0,0,0,0,0,0,0,0,2,1,0,0
34788,1,13,6,4,4,0,0,2,6,0,0,0,0,0,0,0,0,0,0,0,0,2,1,0,0
34789,1,13,6,4,4,0,0,2,6,1,2,1,2,3,3,2,4,0,2,0,0,2,1,0,0
34790,1,13,6,4,4,0,0,2,6,0,0,0,0,0,0,0,0,0,0,0,0,2,1,0,0
34791,1,13,7,5,5,0,0,2,7,0,0,0,0,0,0,0,0,0,0,0,0,2,1,0,0
34792,1,13,6,4,4,0,0,2,6,0,0,0,0,0,0,0,0,0,0,0,0,2,1,0,0
34793,1,13,10,6,6,0,0,4,10,0,0,0,0,0,0,0,0,0,0,0,0,2,1,0,0
34794,1,13,1,1,1,0,0,0,1,0,0,0,0,0,0,0,0,0,0,0,0,2,1,0,0
34795,1,13,1,1,1,0,0,0,1,0,0,0,0,0,0,0,0,0,0,0,0,2,1,0,0
34796,1,13,14,10,10,0,0,4,14,1,1,1,1,2,2,0,2,0,1,0,0,2,1,0,0
34797,1,13,46,26,30,3,0,12,49,3,6,3,6,9,9,20,28,1,42,2,0,2,1,0,0
34798,1,16,127,75,83,2,11,30,129,4,14,7,14,18,21,61,87,2,175,9,0,2,1,0,0
34799,1,16,652,304,544,16,6,88,668,6,89,51,101,95,152,591,998,3,3399,188,0,2,1,0,0
34800,1,16,2,2,2,0,0,0,2,0,0,0,0,0,0,0,0,0,0,0,0,2,1,0,0
34801,1,16,8,5,5,0,0,3,8,0,0,0,0,0,0,0,0,0,0,0,0,2,1,0,0
34802,1,16,2,2,2,0,0,0,2,0,0,0,0,0,0,0,0,0,0,0,0,2,1,0,0
34803,1,16,14,8,8,0,0,6,14,0,0,0,0,0,0,0,0,0,0,0,0,2,1,0,0
34804,1,16,6,4,4,0,0,2,6,0,0,0,0,0,0,0,0,0,0,0,0,2,1,0,0
34805,1,16,6,4,4,0,0,2,6,1,2,1,2,3,3,2,4,0,2,0,0,2,1,0,0
34806,1,16,6,4,4,0,0,2,6,0,0,0,0,0,0,0,0,0,0,0,0,2,1,0,0
34807,1,16,7,5,5,0,0,2,7,0,0,0,0,0,0,0,0,0,0,0,0,2,1,0,0
34808,1,16,6,4,4,0,0,2,6,0,0,0,0,0,0,0,0,0,0,0,0,2,1,0,0
34809,1,16,10,6,6,0,0,4,10,0,0,0,0,0,0,0,0,0,0,0,0,2,1,0,0
34810,1,16,1,1,1,0,0,0,1,0,0,0,0,0,0,0,0,0,0,0,0,2,1,0,0
34811,1,16,1,1,1,0,0,0,1,0,0,0,0,0,0,0,0,0,0,0,0,2,1,0,0
34812,1,16,14,10,10,0,0,4,14,1,1,1,1,2,2,0,2,0,1,0,0,2,1,0,0
34813,1,16,46,26,30,3,0,12,49,3,6,3,6,9,9,20,28,1,42,2,0,2,1,0,0
34814,1,10,2,2,2,0,0,0,2,1,2,1,2,3,3,2,4,0,2,0,0,2,1,0,0
34815,1,13,127,75,83,2,11,30,129,4,14,7,14,18,21,61,87,2,175,9,0,2,1,0,0
34816,1,13,652,304,544,16,6,88,668,6,89,51,101,95,152,591,998,3,3399,188,0,2,1,0,0
34817,1,13,2,2,2,0,0,0,2,0,0,0,0,0,0,0,0,0,0,0,0,2,1,0,0
34818,1,13,8,5,5,0,0,3,8,0,0,0,0,0,0,0,0,0,0,0,0,2,1,0,0
34819,1,13,2,2,2,0,0,0,2,0,0,0,0,0,0,0,0,0,0,0,0,2,1,0,0
34820,1,13,14,8,8,0,0,6,14,0,0,0,0,0,0,0,0,0,0,0,0,2,1,0,0
34821,1,13,6,4,4,0,0,2,6,0,0,0,0,0,0,0,0,0,0,0,0,2,1,0,0
34822,1,13,6,4,4,0,0,2,6,1,2,1,2,3,3,2,4,0,2,0,0,2,1,0,0
34823,1,13,6,4,4,0,0,2,6,0,0,0,0,0,0,0,0,0,0,0,0,2,1,0,0
34824,1,13,7,5,5,0,0,2,7,0,0,0,0,0,0,0,0,0,0,0,0,2,1,0,0
34825,1,13,6,4,4,0,0,2,6,0,0,0,0,0,0,0,0,0,0,0,0,2,1,0,0
34826,1,13,10,6,6,0,0,4,10,0,0,0,0,0,0,0,0,0,0,0,0,2,1,0,0
34827,1,13,1,1,1,0,0,0,1,0,0,0,0,0,0,0,0,0,0,0,0,2,1,0,0
34828,1,13,1,1,1,0,0,0,1,0,0,0,0,0,0,0,0,0,0,0,0,2,1,0,0
34829,1,13,14,10,10,0,0,4,14,1,1,1,1,2,2,0,2,0,1,0,0,2,1,0,0
34830,1,13,46,26,30,3,0,12,49,3,6,3,6,9,9,20,28,1,42,2,0,2,1,0,0
34831,2,26,10,6,6,0,0,4,10,2,4,2,4,6,6,10,15,1,15,0,0,2,1,0,0
34832,3,47,15,10,10,0,0,5,15,2,4,2,4,6,6,10,15,1,15,0,0,2,1,0,0
34833,3,39,15,9,9,0,0,6,15,0,0,0,0,0,0,0,0,0,0,0,0,2,1,0,0
34834,2,36,10,7,7,0,0,3,10,1,2,1,2,3,3,2,4,0,2,0,0,2,1,0,0
34835,3,46,15,9,9,0,0,6,15,1,4,2,4,5,6,8,13,0,6,0,0,2,1,0,0
34836,2,21,10,6,6,0,0,4,10,0,0,0,0,0,0,0,0,0,0,0,0,2,1,0,0
34837,4,61,20,12,12,0,0,8,20,1,2,1,2,3,3,2,4,0,2,0,0,2,1,0,0
34838,2,51,127,75,83,2,11,30,129,4,14,7,14,18,21,61,87,2,175,9,0,2,1,0,0
34839,2,51,652,304,544,16,6,88,668,6,89,51,101,95,152,591,998,3,3399,188,0,2,1,0,0
34840,2,51,2,2,2,0,0,0,2,0,0,0,0,0,0,0,0,0,0,0,0,2,1,0,0
34841,2,51,8,5,5,0,0,3,8,0,0,0,0,0,0,0,0,0,0,0,0,2,1,0,0
34842,2,51,2,2,2,0,0,0,2,0,0,0,0,0,0,0,0,0,0,0,0,2,1,0,0
34843,2,51,14,8,8,0,0,6,14,0,0,0,0,0,0,0,0,0,0,0,0,2,1,0,0
34844,2,51,6,4,4,0,0,2,6,0,0,0,0,0,0,0,0,0,0,0,0,2,1,0,0
34845,2,51,6,4,4,0,0,2,6,1,2,1,2,3,3,2,4,0,2,0,0,2,1,0,0
34846,2,51,6,4,4,0,0,2,6,0,0,0,0,0,0,0,0,0,0,0,0,2,1,0,0
34847,2,51,7,5,5,0,0,2,7,0,0,0,0,0,0,0,0,0,0,0,0,2,1,0,0
34848,2,51,6,4,4,0,0,2,6,0,0,0,0,0,0,0,0,0,0,0,0,2,1,0,0
34849,2,51,10,6,6,0,0,4,10,0,0,0,0,0,0,0,0,0,0,0,0,2,1,0,0
34850,2,51,1,1,1,0,0,0,1,0,0,0,0,0,0,0,0,0,0,0,0,2,1,0,0
34851,2,51,1,1,1,0,0,0,1,0,0,0,0,0,0,0,0,0,0,0,0,2,1,0,0
34852,2,51,14,10,10,0,0,4,14,1,1,1,1,2,2,0,2,0,1,0,0,2,1,0,0
34853,2,51,46,26,30,3,0,12,49,3,6,3,6,9,9,20,28,1,42,2,0,2,1,0,0
34854,1,6,2,2,2,0,0,0,2,0,0,0,0,0,0,0,0,0,0,0,0,2,1,0,0
34855,8,263,51,25,36,0,0,15,51,3,11,6,12,14,18,42,68,1,112,6,0,2,1,0,0
34856,1,14,6,4,4,0,0,2,6,0,0,0,0,0,0,0,0,0,0,0,0,2,1,0,0
34857,4,163,27,21,21,0,0,6,27,3,6,3,6,9,9,20,28,1,42,2,0,2,1,0,0
34858,1,6,2,2,2,0,0,0,2,0,0,0,0,0,0,0,0,0,0,0,0,2,1,0,0
34859,1,41,7,5,5,0,0,2,7,1,2,1,2,3,3,2,4,0,2,0,0,2,1,0,0
34860,2,51,14,9,9,0,0,5,14,0,0,0,0,0,0,0,0,0,0,0,0,2,1,0,0
34861,2,40,13,9,8,0,0,4,13,0,0,0,0,0,0,0,0,0,0,0,0,2,1,0,0
34862,2,42,14,10,9,0,0,4,14,0,0,0,0,0,0,0,0,0,0,0,0,2,1,0,0
34863,2,33,12,8,7,0,0,4,12,0,0,0,0,0,0,0,0,0,0,0,0,2,1,0,0
34864,3,49,16,9,9,0,0,7,16,0,0,0,0,0,0,0,0,0,0,0,0,2,1,0,0
34865,1,18,3,3,3,0,0,0,3,0,0,0,0,0,0,0,0,0,0,0,0,2,1,0,0
34866,2,26,6,4,4,0,0,2,6,1,4,2,4,5,6,8,13,0,6,0,0,2,1,0,0
34867,1,134,149,67,118,4,0,27,153,1,17,14,28,18,42,69,175,0,144,8,0,2,1,0,0
34868,66,4392,520,294,400,33,13,81,553,10,261,204,367,271,571,2128,4614,7,32445,1802,1,2,1,1,0
34869,90,3974,1338,495,1086,10,64,173,1348,11,122,82,157,133,239,883,1686,7,11934,663,0,2,1,1,0
34870,33,999,465,148,393,5,8,60,470,4,31,20,31,35,51,161,261,2,523,29,0,2,1,0,0
34871,33,999,16,12,9,0,0,6,16,1,2,1,2,3,3,2,4,0,2,0,0,2,1,0,0
34872,33,1041,256,139,192,9,7,47,265,4,23,12,24,27,36,112,171,2,357,19,0,2,1,0,0
34873,23,613,102,59,69,5,3,24,107,6,22,15,28,28,43,113,206,3,789,43,0,2,1,0,0
34874,48,3659,996,429,845,24,10,117,1020,7,76,50,88,83,138,494,879,4,3565,198,0,2,1,0,0
34875,126,5406,1513,682,1277,25,13,200,1538,11,199,116,219,210,335,1557,2584,6,15641,868,0,2,1,1,0
34876,85,4936,1296,573,1062,40,33,157,1336,8,201,118,231,209,349,1561,2689,4,12365,686,0,2,1,0,0
34877,21,500,207,111,150,11,0,50,218,5,26,19,36,31,55,133,272,3,943,52,0,2,1,0,0
34878,104,5361,1457,730,1242,11,6,188,1468,10,292,166,329,302,495,2424,4078,5,22973,1276,1,2,1,0,0
34879,43,2690,652,304,544,16,6,88,668,6,89,51,101,95,152,591,998,3,3399,188,0,2,1,0,0
34880,72,3310,1455,414,1257,16,76,112,1471,5,41,23,46,46,69,231,381,2,1069,59,0,2,3,3,0
34881,2,79,7,6,5,0,0,2,7,1,1,1,2,2,3,0,3,1,3,0,0,2,1,0,0
34882,8,275,74,35,59,1,0,14,75,3,14,7,14,17,21,58,85,1,128,7,0,2,1,0,0
34883,70,3187,1020,354,843,12,15,144,1032,8,134,77,144,142,221,970,1580,4,6792,377,0,2,1,0,0
34884,47,2189,447,308,343,6,5,95,453,7,96,59,111,103,170,651,1136,4,4600,255,0,2,1,0,0
34885,3,229,53,23,39,0,0,13,53,2,8,4,8,10,12,26,39,1,39,2,0,2,1,0,0
34886,21,655,424,94,331,4,0,89,428,1,5,5,5,6,10,11,25,0,12,0,0,2,2,2,0
34887,38,2327,334,251,279,10,4,40,344,5,127,74,143,132,217,899,1528,2,4303,239,0,2,1,0,0
34888,12,497,184,100,137,2,15,30,186,6,38,20,39,44,59,214,322,3,991,55,0,2,2,2,0
34889,8,377,91,45,69,0,3,18,91,3,9,6,10,12,16,33,57,1,95,5,0,2,1,0,0
34890,75,3895,1293,570,1093,25,15,163,1318,10,195,123,241,205,364,1516,2795,6,17273,959,0,2,1,0,0
34891,29,1903,384,251,317,7,8,52,391,11,70,44,84,81,128,467,811,6,5355,297,0,2,2,2,0
34892,45,1953,386,256,301,16,9,68,402,4,59,35,69,63,104,355,621,2,1453,80,0,2,1,0,0
34893,28,1596,466,257,367,18,25,50,484,7,126,86,171,133,257,898,1813,4,8612,478,0,2,1,0,0
34894,15,1066,215,129,180,6,0,29,221,8,65,43,72,73,115,415,711,4,3153,175,0,2,1,0,0
34895,86,3411,1043,504,840,53,9,147,1096,9,180,112,198,189,310,1377,2344,4,11604,644,0,2,1,1,0
34896,12,478,295,56,236,0,4,54,295,2,9,5,10,11,15,30,51,1,57,3,0,2,1,0,0
34897,30,1440,373,158,315,8,0,51,381,5,76,44,79,81,123,486,779,2,2026,112,0,2,1,0,0
34898,80,3144,1178,367,1042,6,15,115,1184,9,94,51,95,103,146,644,976,4,4439,246,0,2,1,1,0
34899,9,449,219,78,157,11,5,46,230,3,24,20,34,27,54,114,256,2,545,30,0,2,1,0,0
34900,111,6122,1943,715,1694,26,18,214,1969,12,185,120,237,197,357,1436,2721,7,20915,1161,0,2,1,1,0
34901,37,1519,442,244,305,14,16,103,456,11,68,45,75,79,120,452,756,6,4588,254,0,2,1,0,0
34902,52,1986,1098,241,925,5,10,155,1103,7,46,25,49,53,74,273,423,3,1580,87,0,2,1,0,0
34903,53,1862,601,196,481,2,23,85,603,8,63,36,72,71,108,400,664,4,3036,168,0,2,4,4,0
34904,166,3529,1513,682,1277,25,13,200,1538,11,199,116,219,210,335,1557,2584,6,15641,868,0,2,5,4,0
34905,166,3529,819,519,539,24,98,155,843,15,96,57,106,111,163,690,1107,8,9171,509,0,2,5,4,0
34906,51,1442,339,213,244,17,9,65,356,10,42,26,48,52,74,259,421,5,2410,133,0,2,12,15,0
34907,77,3944,1293,570,1093,25,15,163,1318,10,195,123,241,205,364,1516,2795,6,17273,959,0,2,15,5,0
34908,129,5191,1450,624,1228,12,26,181,1462,14,306,186,354,320,540,2580,4493,8,36391,2021,1,2,4,1,0
34909,31,1087,74,35,59,1,0,14,75,3,14,7,14,17,21,58,85,1,128,7,0,2,28,4,0
34910,31,1087,245,125,200,5,7,34,250,7,30,17,34,37,51,166,265,3,1053,58,0,2,28,4,0
34911,104,2698,773,422,505,30,103,129,803,14,77,46,83,91,129,535,839,7,6334,351,0,2,15,0,0
34912,101,2612,773,422,505,30,103,129,803,14,77,46,83,91,129,535,839,7,6334,351,0,2,0,15,0
34913,282,5915,1943,715,1694,26,18,214,1969,12,185,120,237,197,357,1436,2721,7,20915,1161,0,2,1,1,0
34914,282,5915,1168,838,957,57,25,144,1225,19,348,224,416,367,640,3018,5452,11,61921,3440,1,2,1,1,0
34915,111,6122,1943,715,1694,26,18,214,1969,12,185,120,237,197,357,1436,2721,7,20915,1161,0,2,1,1,0
34916,179,5318,1660,832,1314,41,38,274,1701,20,312,209,395,332,604,2671,5058,12,64042,3557,1,2,6,0,0
34917,186,5684,1660,832,1314,41,38,274,1701,20,312,209,395,332,604,2671,5058,12,64042,3557,1,2,18,0,0
34918,186,5684,1057,646,719,113,100,145,1170,18,215,134,248,233,382,1740,3004,10,31186,1732,1,2,18,0,0
34919,186,5709,1660,832,1314,41,38,274,1701,20,312,209,395,332,604,2671,5058,12,64042,3557,1,2,11,6,0
34920,186,5709,1057,646,719,113,100,145,1170,18,215,134,248,233,382,1740,3004,10,31186,1732,1,2,11,6,0
34921,182,5417,1660,832,1314,41,38,274,1701,20,312,209,395,332,604,2671,5058,12,64042,3557,1,2,47,0,0
34922,277,5793,1943,715,1694,26,18,214,1969,12,185,120,237,197,357,1436,2721,7,20915,1161,0,2,6,0,0
34923,277,5793,1168,838,957,57,25,144,1225,19,348,224,416,367,640,3018,5452,11,61921,3440,1,2,6,0,0
34924,105,5755,1943,715,1694,26,18,214,1969,12,185,120,237,197,357,1436,2721,7,20915,1161,0,2,9,0,0
34925,105,5753,1943,715,1694,26,18,214,1969,12,185,120,237,197,357,1436,2721,7,20915,1161,0,2,1,1,0
34926,276,5747,1943,715,1694,26,18,214,1969,12,185,120,237,197,357,1436,2721,7,20915,1161,0,2,0,6,0
34927,276,5747,1168,838,957,57,25,144,1225,19,348,224,416,367,640,3018,5452,11,61921,3440,1,2,0,6,0
34928,104,5722,1943,715,1694,26,18,214,1969,12,185,120,237,197,357,1436,2721,7,20915,1161,0,2,0,9,0
34929,187,5720,1660,832,1314,41,38,274,1701,20,312,209,395,332,604,2671,5058,12,64042,3557,1,2,1,1,0
34930,187,5720,1057,646,719,113,100,145,1170,18,215,134,248,233,382,1740,3004,10,31186,1732,1,2,1,1,0
34931,187,5730,1660,832,1314,41,38,274,1701,20,312,209,395,332,604,2671,5058,12,64042,3557,1,2,2,2,0
34932,187,5730,1057,646,719,113,100,145,1170,18,215,134,248,233,382,1740,3004,10,31186,1732,1,2,2,2,0
34933,182,5417,1660,832,1314,41,38,274,1701,20,312,209,395,332,604,2671,5058,12,64042,3557,1,2,2,2,0
34934,182,5417,1660,832,1314,41,38,274,1701,20,312,209,395,332,604,2671,5058,12,64042,3557,1,2,2,2,0
34935,187,5730,1660,832,1314,41,38,274,1701,20,312,209,395,332,604,2671,5058,12,64042,3557,1,2,2,2,0
34936,187,5730,1057,646,719,113,100,145,1170,18,215,134,248,233,382,1740,3004,10,31186,1732,1,2,2,2,0
34937,187,5730,1660,832,1314,41,38,274,1701,20,312,209,395,332,604,2671,5058,12,64042,3557,1,2,1,1,0
34938,187,5730,1057,646,719,113,100,145,1170,18,215,134,248,233,382,1740,3004,10,31186,1732,1,2,1,1,0
34939,189,5757,1660,832,1314,41,38,274,1701,20,312,209,395,332,604,2671,5058,12,64042,3557,1,2,2,0,0
34940,189,5757,1057,646,719,113,100,145,1170,18,215,134,248,233,382,1740,3004,10,31186,1732,1,2,2,0,0
34941,248,5737,4293,999,3693,19,54,507,4312,9,155,88,170,164,258,1156,1898,4,9368,520,0,2,2,4,0
34942,248,5737,1482,859,1002,125,135,219,1607,16,219,134,251,235,385,1766,3032,9,27804,1544,1,2,2,4,0
34943,76,3910,1293,570,1093,25,15,163,1318,10,195,123,241,205,364,1516,2795,6,17273,959,0,2,4,4,0
34944,30,1440,373,158,315,8,0,51,381,5,76,44,79,81,123,486,779,2,2026,112,0,2,1,1,0
34945,52,1442,339,213,244,17,9,65,356,10,42,26,48,52,74,259,421,5,2410,133,0,2,33,29,0
34946,77,3947,1293,570,1093,25,15,163,1318,10,195,123,241,205,364,1516,2795,6,17273,959,0,2,4,3,0
34947,1,98,42,7,35,4,0,5,46,1,2,1,2,3,3,2,4,0,2,0,0,2,3,2,1
34948,1,98,11,6,10,0,0,1,11,2,4,2,4,6,6,10,15,1,15,0,0,2,3,2,1
34949,181,5514,1660,832,1314,41,38,274,1701,20,312,209,395,332,604,2671,5058,12,64042,3557,1,2,0,19,1
34950,181,5514,1057,646,719,113,100,145,1170,18,215,134,248,233,382,1740,3004,10,31186,1732,1,2,0,19,1
34951,237,4939,2,2,2,0,0,0,2,0,0,0,0,0,0,0,0,0,0,0,0,2,7,14,1
34952,237,4939,99,48,90,1,3,5,100,0,0,0,0,0,0,0,0,0,0,0,0,2,7,14,1
34953,237,4939,8,5,5,2,0,1,10,0,0,0,0,0,0,0,0,0,0,0,0,2,7,14,1
34954,237,4939,1217,716,841,84,126,174,1301,14,185,118,215,199,333,1446,2542,8,20687,1149,0,2,7,14,1
34955,237,4939,160,89,115,0,13,31,160,7,15,11,17,22,28,78,124,3,495,27,0,2,7,14,1
34956,237,4939,10,10,9,9,0,0,19,0,0,0,0,0,0,0,0,0,0,0,0,2,7,14,1
34957,237,4939,173,84,99,8,29,36,181,5,12,7,13,17,20,54,81,2,221,12,0,2,7,14,1
34958,237,4939,3,1,1,3,0,0,6,0,0,0,0,0,0,0,0,0,0,0,0,2,7,14,1
34959,19,513,205,80,86,16,53,53,221,7,18,10,19,25,29,94,134,3,497,27,0,2,3,9,1
34960,106,4498,1289,550,1043,56,32,155,1345,10,167,93,185,177,278,1266,2075,5,11498,638,0,2,10,21,1
34961,129,5167,1450,624,1228,12,26,181,1462,14,306,186,354,320,540,2580,4493,8,36391,2021,1,2,20,36,1
34962,97,5225,1457,730,1242,11,6,188,1468,10,292,166,329,302,495,2424,4078,5,22973,1276,1,2,47,74,1
34963,2,56,7,6,5,0,0,2,7,1,1,1,2,2,3,0,3,1,3,0,0,2,4,10,1
34964,1,98,42,7,35,4,0,5,46,1,2,1,2,3,3,2,4,0,2,0,0,2,3,2,0
34965,1,98,11,6,10,0,0,1,11,2,4,2,4,6,6,10,15,1,15,0,0,2,3,2,0
34966,181,5514,1660,832,1314,41,38,274,1701,20,312,209,395,332,604,2671,5058,12,64042,3557,1,2,0,19,0
34967,181,5514,1057,646,719,113,100,145,1170,18,215,134,248,233,382,1740,3004,10,31186,1732,1,2,0,19,0
34968,237,4939,2,2,2,0,0,0,2,0,0,0,0,0,0,0,0,0,0,0,0,2,7,14,0
34969,237,4939,99,48,90,1,3,5,100,0,0,0,0,0,0,0,0,0,0,0,0,2,7,14,0
34970,237,4939,8,5,5,2,0,1,10,0,0,0,0,0,0,0,0,0,0,0,0,2,7,14,0
34971,237,4939,1217,716,841,84,126,174,1301,14,185,118,215,199,333,1446,2542,8,20687,1149,0,2,7,14,0
34972,237,4939,160,89,115,0,13,31,160,7,15,11,17,22,28,78,124,3,495,27,0,2,7,14,0
34973,237,4939,10,10,9,9,0,0,19,0,0,0,0,0,0,0,0,0,0,0,0,2,7,14,0
34974,237,4939,173,84,99,8,29,36,181,5,12,7,13,17,20,54,81,2,221,12,0,2,7,14,0
34975,237,4939,3,1,1,3,0,0,6,0,0,0,0,0,0,0,0,0,0,0,0,2,7,14,0
34976,19,513,205,80,86,16,53,53,221,7,18,10,19,25,29,94,134,3,497,27,0,2,3,9,0
34977,106,4498,1289,550,1043,56,32,155,1345,10,167,93,185,177,278,1266,2075,5,11498,638,0,2,10,21,0
34978,129,5167,1450,624,1228,12,26,181,1462,14,306,186,354,320,540,2580,4493,8,36391,2021,1,2,20,36,0
34979,97,5225,1457,730,1242,11,6,188,1468,10,292,166,329,302,495,2424,4078,5,22973,1276,1,2,47,74,0
34980,2,56,7,6,5,0,0,2,7,1,1,1,2,2,3,0,3,1,3,0,0,2,4,10,0
34981,187,5718,1660,832,1314,41,38,274,1701,20,312,209,395,332,604,2671,5058,12,64042,3557,1,2,25,0,0
34982,187,5718,1057,646,719,113,100,145,1170,18,215,134,248,233,382,1740,3004,10,31186,1732,1,2,25,0,0
34983,182,5438,1660,832,1314,41,38,274,1701,20,312,209,395,332,604,2671,5058,12,64042,3557,1,2,53,0,0
34984,52,1442,339,213,244,17,9,65,356,10,42,26,48,52,74,259,421,5,2410,133,0,2,33,29,0
34985,77,3947,1293,570,1093,25,15,163,1318,10,195,123,241,205,364,1516,2795,6,17273,959,0,2,4,3,0
34986,3,42,14,8,8,0,0,6,14,0,0,0,0,0,0,0,0,0,0,0,0,2,1,0,0
34987,2,40,9,6,6,0,0,3,9,0,0,0,0,0,0,0,0,0,0,0,0,2,1,0,0
34988,2,40,13,9,8,0,0,4,13,0,0,0,0,0,0,0,0,0,0,0,0,2,1,0,0
34989,60,1163,282,196,195,3,0,86,285,8,130,71,141,138,212,936,1507,4,6538,363,0,2,1,0,0
34990,4,77,127,75,83,2,11,30,129,4,14,7,14,18,21,61,87,2,175,9,0,2,1,0,0
34991,4,77,652,304,544,16,6,88,668,6,89,51,101,95,152,591,998,3,3399,188,0,2,1,0,0
34992,4,77,2,2,2,0,0,0,2,0,0,0,0,0,0,0,0,0,0,0,0,2,1,0,0
34993,4,77,8,5,5,0,0,3,8,0,0,0,0,0,0,0,0,0,0,0,0,2,1,0,0
34994,4,77,2,2,2,0,0,0,2,0,0,0,0,0,0,0,0,0,0,0,0,2,1,0,0
34995,4,77,14,8,8,0,0,6,14,0,0,0,0,0,0,0,0,0,0,0,0,2,1,0,0
34996,4,77,6,4,4,0,0,2,6,0,0,0,0,0,0,0,0,0,0,0,0,2,1,0,0
34997,4,77,6,4,4,0,0,2,6,1,2,1,2,3,3,2,4,0,2,0,0,2,1,0,0
34998,4,77,6,4,4,0,0,2,6,0,0,0,0,0,0,0,0,0,0,0,0,2,1,0,0
34999,4,77,7,5,5,0,0,2,7,0,0,0,0,0,0,0,0,0,0,0,0,2,1,0,0
35000,4,77,6,4,4,0,0,2,6,0,0,0,0,0,0,0,0,0,0,0,0,2,1,0,0
35001,4,77,10,6,6,0,0,4,10,0,0,0,0,0,0,0,0,0,0,0,0,2,1,0,0
35002,4,77,1,1,1,0,0,0,1,0,0,0,0,0,0,0,0,0,0,0,0,2,1,0,0
35003,4,77,1,1,1,0,0,0,1,0,0,0,0,0,0,0,0,0,0,0,0,2,1,0,0
35004,4,77,14,10,10,0,0,4,14,1,1,1,1,2,2,0,2,0,1,0,0,2,1,0,0
35005,4,77,46,26,30,3,0,12,49,3,6,3,6,9,9,20,28,1,42,2,0,2,1,0,0
35006,1,9,5,3,3,0,0,2,5,0,0,0,0,0,0,0,0,0,0,0,0,2,1,0,0
35007,1,90,13,10,10,0,0,3,13,1,2,1,2,3,3,2,4,0,2,0,0,2,1,0,0
35008,7,114,44,19,17,0,16,11,44,3,14,7,14,17,21,58,85,1,128,7,0,2,1,0,0
35009,3,66,127,75,83,2,11,30,129,4,14,7,14,18,21,61,87,2,175,9,0,2,1,0,0
35010,3,66,652,304,544,16,6,88,668,6,89,51,101,95,152,591,998,3,3399,188,0,2,1,0,0
35011,3,66,2,2,2,0,0,0,2,0,0,0,0,0,0,0,0,0,0,0,0,2,1,0,0
35012,3,66,8,5,5,0,0,3,8,0,0,0,0,0,0,0,0,0,0,0,0,2,1,0,0
35013,3,66,2,2,2,0,0,0,2,0,0,0,0,0,0,0,0,0,0,0,0,2,1,0,0
35014,3,66,14,8,8,0,0,6,14,0,0,0,0,0,0,0,0,0,0,0,0,2,1,0,0
35015,3,66,6,4,4,0,0,2,6,0,0,0,0,0,0,0,0,0,0,0,0,2,1,0,0
35016,3,66,6,4,4,0,0,2,6,1,2,1,2,3,3,2,4,0,2,0,0,2,1,0,0
35017,3,66,6,4,4,0,0,2,6,0,0,0,0,0,0,0,0,0,0,0,0,2,1,0,0
35018,3,66,7,5,5,0,0,2,7,0,0,0,0,0,0,0,0,0,0,0,0,2,1,0,0
35019,3,66,6,4,4,0,0,2,6,0,0,0,0,0,0,0,0,0,0,0,0,2,1,0,0
35020,3,66,10,6,6,0,0,4,10,0,0,0,0,0,0,0,0,0,0,0,0,2,1,0,0
35021,3,66,1,1,1,0,0,0,1,0,0,0,0,0,0,0,0,0,0,0,0,2,1,0,0
35022,3,66,1,1,1,0,0,0,1,0,0,0,0,0,0,0,0,0,0,0,0,2,1,0,0
35023,3,66,14,10,10,0,0,4,14,1,1,1,1,2,2,0,2,0,1,0,0,2,1,0,0
35024,3,66,46,26,30,3,0,12,49,3,6,3,6,9,9,20,28,1,42,2,0,2,1,0,0
35025,7,296,72,33,56,0,4,12,72,1,1,1,1,2,2,0,2,0,1,0,0,2,1,0,0
35026,12,229,127,75,83,2,11,30,129,4,14,7,14,18,21,61,87,2,175,9,0,2,1,0,0
35027,12,229,652,304,544,16,6,88,668,6,89,51,101,95,152,591,998,3,3399,188,0,2,1,0,0
35028,12,229,2,2,2,0,0,0,2,0,0,0,0,0,0,0,0,0,0,0,0,2,1,0,0
35029,12,229,8,5,5,0,0,3,8,0,0,0,0,0,0,0,0,0,0,0,0,2,1,0,0
35030,12,229,2,2,2,0,0,0,2,0,0,0,0,0,0,0,0,0,0,0,0,2,1,0,0
35031,12,229,14,8,8,0,0,6,14,0,0,0,0,0,0,0,0,0,0,0,0,2,1,0,0
35032,12,229,6,4,4,0,0,2,6,0,0,0,0,0,0,0,0,0,0,0,0,2,1,0,0
35033,12,229,6,4,4,0,0,2,6,1,2,1,2,3,3,2,4,0,2,0,0,2,1,0,0
35034,12,229,6,4,4,0,0,2,6,0,0,0,0,0,0,0,0,0,0,0,0,2,1,0,0
35035,12,229,7,5,5,0,0,2,7,0,0,0,0,0,0,0,0,0,0,0,0,2,1,0,0
35036,12,229,6,4,4,0,0,2,6,0,0,0,0,0,0,0,0,0,0,0,0,2,1,0,0
35037,12,229,10,6,6,0,0,4,10,0,0,0,0,0,0,0,0,0,0,0,0,2,1,0,0
35038,12,229,1,1,1,0,0,0,1,0,0,0,0,0,0,0,0,0,0,0,0,2,1,0,0
35039,12,229,1,1,1,0,0,0,1,0,0,0,0,0,0,0,0,0,0,0,0,2,1,0,0
35040,12,229,14,10,10,0,0,4,14,1,1,1,1,2,2,0,2,0,1,0,0,2,1,0,0
35041,12,229,46,26,30,3,0,12,49,3,6,3,6,9,9,20,28,1,42,2,0,2,1,0,0
35042,6,71,127,75,83,2,11,30,129,4,14,7,14,18,21,61,87,2,175,9,0,2,1,0,0
35043,6,71,652,304,544,16,6,88,668,6,89,51,101,95,152,591,998,3,3399,188,0,2,1,0,0
35044,6,71,2,2,2,0,0,0,2,0,0,0,0,0,0,0,0,0,0,0,0,2,1,0,0
35045,6,71,8,5,5,0,0,3,8,0,0,0,0,0,0,0,0,0,0,0,0,2,1,0,0
35046,6,71,2,2,2,0,0,0,2,0,0,0,0,0,0,0,0,0,0,0,0,2,1,0,0
35047,6,71,14,8,8,0,0,6,14,0,0,0,0,0,0,0,0,0,0,0,0,2,1,0,0
35048,6,71,6,4,4,0,0,2,6,0,0,0,0,0,0,0,0,0,0,0,0,2,1,0,0
35049,6,71,6,4,4,0,0,2,6,1,2,1,2,3,3,2,4,0,2,0,0,2,1,0,0
35050,6,71,6,4,4,0,0,2,6,0,0,0,0,0,0,0,0,0,0,0,0,2,1,0,0
35051,6,71,7,5,5,0,0,2,7,0,0,0,0,0,0,0,0,0,0,0,0,2,1,0,0
35052,6,71,6,4,4,0,0,2,6,0,0,0,0,0,0,0,0,0,0,0,0,2,1,0,0
35053,6,71,10,6,6,0,0,4,10,0,0,0,0,0,0,0,0,0,0,0,0,2,1,0,0
35054,6,71,1,1,1,0,0,0,1,0,0,0,0,0,0,0,0,0,0,0,0,2,1,0,0
35055,6,71,1,1,1,0,0,0,1,0,0,0,0,0,0,0,0,0,0,0,0,2,1,0,0
35056,6,71,14,10,10,0,0,4,14,1,1,1,1,2,2,0,2,0,1,0,0,2,1,0,0
35057,6,71,46,26,30,3,0,12,49,3,6,3,6,9,9,20,28,1,42,2,0,2,1,0,0
35058,3,26,14,7,7,2,0,5,16,0,0,0,0,0,0,0,0,0,0,0,0,2,1,0,0
35059,7,103,38,23,23,0,0,15,38,0,0,0,0,0,0,0,0,0,0,0,0,2,1,0,0
35060,17,378,85,59,61,8,0,16,93,5,18,10,18,23,28,86,126,2,316,17,0,2,1,0,0
35061,12,515,124,78,88,2,3,26,126,4,13,7,13,17,20,56,81,2,163,9,0,2,1,0,0
35062,1,98,42,7,35,4,0,5,46,1,2,1,2,3,3,2,4,0,2,0,0,2,1,0,0
35063,1,98,11,6,10,0,0,1,11,2,4,2,4,6,6,10,15,1,15,0,0,2,1,0,0
35064,11,242,19,8,11,5,0,4,24,2,5,3,6,7,9,13,25,1,30,1,0,2,1,0,0
35065,11,242,102,59,69,5,3,24,107,6,22,15,28,28,43,113,206,3,789,43,0,2,1,0,0
35066,11,242,106,40,36,3,49,17,109,8,17,13,23,25,36,93,167,5,904,50,0,2,1,0,0
35067,229,4960,182,127,129,0,0,53,182,5,39,21,42,44,63,217,343,2,926,51,0,2,6,4,0
35068,229,4960,1165,710,800,67,119,181,1232,18,243,153,282,261,435,2000,3492,10,36473,2026,1,2,6,4,0
35069,67,1570,773,419,590,28,0,166,801,10,204,113,217,214,330,1598,2554,5,13587,754,0,2,1,0,0
35070,67,1570,421,273,302,44,34,57,465,17,81,59,107,98,166,583,1098,11,12329,684,0,2,1,0,0
35071,14,411,149,95,105,2,0,41,151,8,54,28,55,62,83,334,494,4,2013,111,0,2,1,0,0
35072,14,411,82,56,54,0,13,15,82,4,13,8,16,17,24,56,98,2,241,13,0,2,1,0,0
35073,26,529,2,2,2,0,0,0,2,0,0,0,0,0,0,0,0,0,0,0,0,2,1,0,0
35074,26,529,99,48,90,1,3,5,100,0,0,0,0,0,0,0,0,0,0,0,0,2,1,0,0
35075,26,529,8,5,5,2,0,1,10,0,0,0,0,0,0,0,0,0,0,0,0,2,1,0,0
35076,26,529,1217,716,841,84,126,174,1301,14,185,118,215,199,333,1446,2542,8,20687,1149,0,2,1,0,0
35077,26,529,160,89,115,0,13,31,160,7,15,11,17,22,28,78,124,3,495,27,0,2,1,0,0
35078,26,529,10,10,9,9,0,0,19,0,0,0,0,0,0,0,0,0,0,0,0,2,1,0,0
35079,26,529,173,84,99,8,29,36,181,5,12,7,13,17,20,54,81,2,221,12,0,2,1,0,0
35080,26,529,3,1,1,3,0,0,6,0,0,0,0,0,0,0,0,0,0,0,0,2,1,0,0
35081,188,5732,1660,832,1314,41,38,274,1701,20,312,209,395,332,604,2671,5058,12,64042,3557,1,2,5,1,0
35082,188,5732,1057,646,719,113,100,145,1170,18,215,134,248,233,382,1740,3004,10,31186,1732,1,2,5,1,0
35083,17,348,95,58,50,9,16,20,104,12,33,24,45,45,69,209,378,8,3100,172,0,2,1,0,0
35084,116,2173,477,336,357,30,23,73,507,16,194,134,250,210,384,1538,2962,10,30538,1696,0,2,1,0,0
35085,89,2050,996,429,845,24,10,117,1020,7,76,50,88,83,138,494,879,4,3565,198,0,2,1,0,0
35086,89,2050,456,277,329,12,42,72,468,13,85,50,97,98,147,592,972,7,7212,400,0,2,1,0,0
35087,166,3529,1513,682,1277,25,13,200,1538,11,199,116,219,210,335,1557,2584,6,15641,868,0,2,6,4,0
35088,166,3529,819,519,539,24,98,155,843,15,96,57,106,111,163,690,1107,8,9171,509,0,2,6,4,0
35089,73,1518,207,111,150,11,0,50,218,5,26,19,36,31,55,133,272,3,943,52,0,2,1,0,0
35090,73,1518,410,198,237,31,55,97,441,11,63,38,72,74,110,414,683,6,4293,238,0,2,1,0,0
35091,237,4939,2,2,2,0,0,0,2,0,0,0,0,0,0,0,0,0,0,0,0,2,4,3,0
35092,237,4939,99,48,90,1,3,5,100,0,0,0,0,0,0,0,0,0,0,0,0,2,4,3,0
35093,237,4939,8,5,5,2,0,1,10,0,0,0,0,0,0,0,0,0,0,0,0,2,4,3,0
35094,237,4939,1217,716,841,84,126,174,1301,14,185,118,215,199,333,1446,2542,8,20687,1149,0,2,4,3,0
35095,237,4939,160,89,115,0,13,31,160,7,15,11,17,22,28,78,124,3,495,27,0,2,4,3,0
35096,237,4939,10,10,9,9,0,0,19,0,0,0,0,0,0,0,0,0,0,0,0,2,4,3,0
35097,237,4939,173,84,99,8,29,36,181,5,12,7,13,17,20,54,81,2,221,12,0,2,4,3,0
35098,237,4939,3,1,1,3,0,0,6,0,0,0,0,0,0,0,0,0,0,0,0,2,4,3,0
35099,98,2019,463,295,324,28,62,57,491,12,134,82,154,146,236,989,1696,6,11700,650,0,2,1,0,0
35100,55,770,167,116,138,4,5,22,171,8,48,30,56,56,86,292,499,4,2330,129,0,2,1,0,0
35101,52,1442,339,213,244,17,9,65,356,10,42,26,48,52,74,259,421,5,2410,133,0,2,46,44,0
35102,95,2385,1455,414,1257,16,76,112,1471,5,41,23,46,46,69,231,381,2,1069,59,0,2,1,0,0
35103,95,2385,669,365,481,22,61,110,691,15,103,63,122,118,185,747,1273,8,11311,628,0,2,1,0,0
35104,249,5763,4293,999,3693,19,54,507,4312,9,155,88,170,164,258,1156,1898,4,9368,520,0,2,10,0,0
35105,249,5763,1482,859,1002,125,135,219,1607,16,219,134,251,235,385,1766,3032,9,27804,1544,1,2,10,0,0
35106,6,140,44,22,19,0,19,6,44,2,10,6,12,12,18,35,64,1,77,4,0,2,1,0,0
35107,31,1087,74,35,59,1,0,14,75,3,14,7,14,17,21,58,85,1,128,7,0,2,1,0,0
35108,31,1087,245,125,200,5,7,34,250,7,30,17,34,37,51,166,265,3,1053,58,0,2,1,0,0
35109,54,657,647,139,84,35,284,233,682,0,0,0,0,0,0,0,0,0,0,0,0,2,1,0,0
35110,115,3128,1523,757,1297,19,12,193,1542,12,193,117,230,205,347,1508,2664,7,19053,1058,0,2,1,0,0
35111,115,3128,701,378,504,33,58,109,734,13,110,68,126,123,194,794,1346,7,10027,557,0,2,1,0,0
35112,101,2612,773,422,505,30,103,129,803,14,77,46,83,91,129,535,839,7,6334,351,0,2,1,0,0
35113,159,3785,77,34,69,0,0,8,77,3,24,16,29,27,45,114,213,1,387,21,0,2,1,0,0
35114,159,3785,712,438,573,51,9,84,763,14,102,71,128,116,199,733,1364,8,11988,666,0,2,1,0,0
35115,24,612,2,2,2,0,0,0,2,0,0,0,0,0,0,0,0,0,0,0,0,2,1,0,0
35116,24,612,99,48,90,1,3,5,100,0,0,0,0,0,0,0,0,0,0,0,0,2,1,0,0
35117,24,612,8,5,5,2,0,1,10,0,0,0,0,0,0,0,0,0,0,0,0,2,1,0,0
35118,24,612,1217,716,841,84,126,174,1301,14,185,118,215,199,333,1446,2542,8,20687,1149,0,2,1,0,0
35119,24,612,160,89,115,0,13,31,160,7,15,11,17,22,28,78,124,3,495,27,0,2,1,0,0
35120,24,612,10,10,9,9,0,0,19,0,0,0,0,0,0,0,0,0,0,0,0,2,1,0,0
35121,24,612,173,84,99,8,29,36,181,5,12,7,13,17,20,54,81,2,221,12,0,2,1,0,0
35122,24,612,3,1,1,3,0,0,6,0,0,0,0,0,0,0,0,0,0,0,0,2,1,0,0
35123,30,664,125,97,103,3,0,19,128,9,25,17,27,34,44,144,223,4,1087,60,0,2,1,0,0
35124,22,373,102,57,55,5,16,25,107,5,17,10,18,22,28,81,124,2,330,18,0,2,1,0,0
35125,69,1527,402,202,227,24,74,80,426,12,52,33,61,64,94,339,564,7,3969,220,0,2,1,0,0
35126,55,1174,447,308,343,6,5,95,453,7,96,59,111,103,170,651,1136,4,4600,255,0,2,1,0,0
35127,55,1174,322,174,179,16,74,51,338,10,41,26,46,51,72,252,408,5,2291,127,0,2,1,0,0
35128,75,1629,53,23,39,0,0,13,53,2,8,4,8,10,12,26,39,1,39,2,0,2,1,0,0
35129,75,1629,515,298,307,33,80,99,548,12,63,44,77,75,121,419,753,7,5527,307,0,2,1,0,0
35130,18,312,424,94,331,4,0,89,428,1,5,5,5,6,10,11,25,0,12,0,0,2,1,0,0
35131,18,312,38,23,23,6,0,8,44,3,11,7,11,14,18,42,68,1,102,5,0,2,1,0,0
35132,19,513,205,80,86,16,53,53,221,7,18,10,19,25,29,94,134,3,497,27,0,2,1,0,0
35133,17,523,184,100,137,2,15,30,186,6,38,20,39,44,59,214,322,3,991,55,0,2,1,0,0
35134,17,523,103,65,74,8,5,16,111,7,17,9,17,24,26,89,119,3,417,23,0,2,1,0,0
35135,59,1228,91,45,69,0,3,18,91,3,9,6,10,12,16,33,57,1,95,5,0,2,1,0,0
35136,59,1228,367,234,237,17,34,68,384,16,55,34,61,71,95,381,584,8,5183,287,0,2,1,0,0
35137,231,5969,722,423,573,19,0,135,741,12,172,101,199,184,300,1320,2257,6,15668,870,0,2,1,0,0
35138,231,5969,1508,847,911,44,250,301,1552,14,148,88,169,162,257,1120,1886,7,15077,837,0,2,1,0,0
35139,314,6912,72,33,56,0,4,12,72,1,1,1,1,2,2,0,2,0,1,0,0,2,3,7,0
35140,314,6912,1454,835,1044,76,110,219,1530,17,275,158,296,292,454,2297,3718,9,34017,1889,1,2,3,7,0
35141,92,1886,757,253,292,73,244,162,830,13,61,38,67,74,105,409,651,7,4654,258,0,2,2,1,0
35142,45,953,386,256,301,16,9,68,402,4,59,35,69,63,104,355,621,2,1453,80,0,2,1,0,0
35143,45,953,264,131,164,11,41,46,275,6,38,22,40,44,62,214,338,3,1068,59,0,2,1,0,0
35144,67,1753,466,257,367,18,25,50,484,7,126,86,171,133,257,898,1813,4,8612,478,0,2,1,0,0
35145,67,1753,507,281,342,29,59,88,536,10,53,29,57,63,86,336,514,5,2764,153,0,2,1,0,0
35146,25,552,215,129,180,6,0,29,221,8,65,43,72,73,115,415,711,4,3153,175,0,2,1,0,0
35147,25,552,97,69,77,3,3,16,100,6,22,13,23,28,36,113,173,3,542,30,0,2,1,0,0
35148,89,1894,1043,504,840,53,9,147,1096,9,180,112,198,189,310,1377,2344,4,11604,644,0,2,1,0,0
35149,89,1894,383,288,292,26,6,62,409,11,65,38,67,76,105,429,656,5,3719,206,0,2,1,0,0
35150,20,420,294,64,250,0,0,43,294,1,20,10,20,21,30,86,131,0,65,3,0,2,1,0,0
35151,20,420,78,46,62,3,0,14,81,3,8,4,8,11,12,28,41,1,62,3,0,2,1,0,0
35152,5,123,110,30,77,3,13,16,113,4,21,15,30,25,45,100,208,2,597,33,0,2,1,0,0
35153,5,123,28,15,21,1,0,6,29,0,0,0,0,0,0,0,0,0,0,0,0,2,1,0,0
35154,41,821,1178,367,1042,6,15,115,1184,9,94,51,95,103,146,644,976,4,4439,246,0,2,1,1,0
35155,41,821,177,108,140,8,0,27,185,6,30,16,32,36,48,162,248,3,794,44,0,2,1,1,0
35156,28,452,219,78,157,11,5,46,230,3,24,20,34,27,54,114,256,2,545,30,0,2,1,0,0
35157,28,452,108,64,79,9,0,20,117,5,15,11,19,20,30,70,129,3,410,22,0,2,1,0,0
35158,282,5915,1943,715,1694,26,18,214,1969,12,185,120,237,197,357,1436,2721,7,20915,1161,0,2,1,1,0
35159,282,5915,1168,838,957,57,25,144,1225,19,348,224,416,367,640,3018,5452,11,61921,3440,1,2,1,1,0
35160,19,720,442,244,305,14,16,103,456,11,68,45,75,79,120,452,756,6,4588,254,0,2,1,0,0
35161,19,720,182,102,99,11,40,35,193,3,11,6,11,14,17,42,64,1,97,5,0,2,1,0,0
35162,69,1323,1098,241,925,5,10,155,1103,7,46,25,49,53,74,273,423,3,1580,87,0,2,1,0,0
35163,69,1323,282,202,222,14,2,44,296,8,42,24,43,50,67,250,378,4,1548,86,0,2,1,0,0
35164,2,156,37,13,25,0,6,6,37,1,2,1,2,3,3,2,4,0,2,0,0,2,1,0,0
35165,2,156,133,47,40,1,43,49,134,0,0,0,0,0,0,0,0,0,0,0,0,2,1,0,0
35166,29,743,601,196,481,2,23,85,603,8,63,36,72,71,108,400,664,4,3036,168,0,2,1,0,0
35167,29,743,156,79,106,5,16,28,161,5,14,8,15,19,23,64,97,2,261,14,0,2,1,0,0
35168,36,1120,182,127,129,0,0,53,182,5,39,21,42,44,63,217,343,2,926,51,0,2,1,1,0
35169,7,123,127,75,83,2,11,30,129,4,14,7,14,18,21,61,87,2,175,9,0,2,1,0,0
35170,7,123,652,304,544,16,6,88,668,6,89,51,101,95,152,591,998,3,3399,188,0,2,1,0,0
35171,7,123,2,2,2,0,0,0,2,0,0,0,0,0,0,0,0,0,0,0,0,2,1,0,0
35172,7,123,8,5,5,0,0,3,8,0,0,0,0,0,0,0,0,0,0,0,0,2,1,0,0
35173,7,123,2,2,2,0,0,0,2,0,0,0,0,0,0,0,0,0,0,0,0,2,1,0,0
35174,7,123,14,8,8,0,0,6,14,0,0,0,0,0,0,0,0,0,0,0,0,2,1,0,0
35175,7,123,6,4,4,0,0,2,6,0,0,0,0,0,0,0,0,0,0,0,0,2,1,0,0
35176,7,123,6,4,4,0,0,2,6,1,2,1,2,3,3,2,4,0,2,0,0,2,1,0,0
35177,7,123,6,4,4,0,0,2,6,0,0,0,0,0,0,0,0,0,0,0,0,2,1,0,0
35178,7,123,7,5,5,0,0,2,7,0,0,0,0,0,0,0,0,0,0,0,0,2,1,0,0
35179,7,123,6,4,4,0,0,2,6,0,0,0,0,0,0,0,0,0,0,0,0,2,1,0,0
35180,7,123,10,6,6,0,0,4,10,0,0,0,0,0,0,0,0,0,0,0,0,2,1,0,0
35181,7,123,1,1,1,0,0,0,1,0,0,0,0,0,0,0,0,0,0,0,0,2,1,0,0
35182,7,123,1,1,1,0,0,0,1,0,0,0,0,0,0,0,0,0,0,0,0,2,1,0,0
35183,7,123,14,10,10,0,0,4,14,1,1,1,1,2,2,0,2,0,1,0,0,2,1,0,0
35184,7,123,46,26,30,3,0,12,49,3,6,3,6,9,9,20,28,1,42,2,0,2,1,0,0
35185,14,845,75,38,59,1,3,12,76,2,4,2,4,6,6,10,15,1,15,0,0,2,1,0,0
35186,2,67,16,12,9,0,0,6,16,1,2,1,2,3,3,2,4,0,2,0,0,2,1,0,0
35187,1,6,2,2,2,0,0,0,2,0,0,0,0,0,0,0,0,0,0,0,0,2,1,0,0
35188,1,6,99,48,90,1,3,5,100,0,0,0,0,0,0,0,0,0,0,0,0,2,1,0,0
35189,1,6,8,5,5,2,0,1,10,0,0,0,0,0,0,0,0,0,0,0,0,2,1,0,0
35190,1,6,1217,716,841,84,126,174,1301,14,185,118,215,199,333,1446,2542,8,20687,1149,0,2,1,0,0
35191,1,6,160,89,115,0,13,31,160,7,15,11,17,22,28,78,124,3,495,27,0,2,1,0,0
35192,1,6,10,10,9,9,0,0,19,0,0,0,0,0,0,0,0,0,0,0,0,2,1,0,0
35193,1,6,173,84,99,8,29,36,181,5,12,7,13,17,20,54,81,2,221,12,0,2,1,0,0
35194,1,6,3,1,1,3,0,0,6,0,0,0,0,0,0,0,0,0,0,0,0,2,1,0,0
35195,1,6,2,2,2,0,0,0,2,0,0,0,0,0,0,0,0,0,0,0,0,2,1,0,0
35196,1,6,2,2,2,0,0,0,2,0,0,0,0,0,0,0,0,0,0,0,0,2,1,0,0
35197,1,6,2,2,2,0,0,0,2,0,0,0,0,0,0,0,0,0,0,0,0,2,1,0,0
35198,1,6,2,2,2,0,0,0,2,0,0,0,0,0,0,0,0,0,0,0,0,2,1,0,0
35199,1,8,127,75,83,2,11,30,129,4,14,7,14,18,21,61,87,2,175,9,0,2,1,0,0
35200,1,8,652,304,544,16,6,88,668,6,89,51,101,95,152,591,998,3,3399,188,0,2,1,0,0
35201,1,8,2,2,2,0,0,0,2,0,0,0,0,0,0,0,0,0,0,0,0,2,1,0,0
35202,1,8,8,5,5,0,0,3,8,0,0,0,0,0,0,0,0,0,0,0,0,2,1,0,0
35203,1,8,2,2,2,0,0,0,2,0,0,0,0,0,0,0,0,0,0,0,0,2,1,0,0
35204,1,8,14,8,8,0,0,6,14,0,0,0,0,0,0,0,0,0,0,0,0,2,1,0,0
35205,1,8,6,4,4,0,0,2,6,0,0,0,0,0,0,0,0,0,0,0,0,2,1,0,0
35206,1,8,6,4,4,0,0,2,6,1,2,1,2,3,3,2,4,0,2,0,0,2,1,0,0
35207,1,8,6,4,4,0,0,2,6,0,0,0,0,0,0,0,0,0,0,0,0,2,1,0,0
35208,1,8,7,5,5,0,0,2,7,0,0,0,0,0,0,0,0,0,0,0,0,2,1,0,0
35209,1,8,6,4,4,0,0,2,6,0,0,0,0,0,0,0,0,0,0,0,0,2,1,0,0
35210,1,8,10,6,6,0,0,4,10,0,0,0,0,0,0,0,0,0,0,0,0,2,1,0,0
35211,1,8,1,1,1,0,0,0,1,0,0,0,0,0,0,0,0,0,0,0,0,2,1,0,0
35212,1,8,1,1,1,0,0,0,1,0,0,0,0,0,0,0,0,0,0,0,0,2,1,0,0
35213,1,8,14,10,10,0,0,4,14,1,1,1,1,2,2,0,2,0,1,0,0,2,1,0,0
35214,1,8,46,26,30,3,0,12,49,3,6,3,6,9,9,20,28,1,42,2,0,2,1,0,0
35215,1,6,2,2,2,0,0,0,2,0,0,0,0,0,0,0,0,0,0,0,0,2,1,0,0
35216,1,6,2,2,2,0,0,0,2,0,0,0,0,0,0,0,0,0,0,0,0,2,1,0,0
35217,1,6,2,2,2,0,0,0,2,0,0,0,0,0,0,0,0,0,0,0,0,2,1,0,0
35218,1,6,2,2,2,0,0,0,2,0,0,0,0,0,0,0,0,0,0,0,0,2,1,0,0
35219,1,6,2,2,2,0,0,0,2,0,0,0,0,0,0,0,0,0,0,0,0,2,1,0,0
35220,1,6,2,2,2,0,0,0,2,0,0,0,0,0,0,0,0,0,0,0,0,2,1,0,0
35221,1,6,2,2,2,0,0,0,2,0,0,0,0,0,0,0,0,0,0,0,0,2,1,0,0
35222,1,6,2,2,2,0,0,0,2,0,0,0,0,0,0,0,0,0,0,0,0,2,1,0,0
35223,1,6,2,2,2,0,0,0,2,0,0,0,0,0,0,0,0,0,0,0,0,2,1,0,0
35224,2,25,127,75,83,2,11,30,129,4,14,7,14,18,21,61,87,2,175,9,0,2,1,0,0
35225,2,25,652,304,544,16,6,88,668,6,89,51,101,95,152,591,998,3,3399,188,0,2,1,0,0
35226,2,25,2,2,2,0,0,0,2,0,0,0,0,0,0,0,0,0,0,0,0,2,1,0,0
35227,2,25,8,5,5,0,0,3,8,0,0,0,0,0,0,0,0,0,0,0,0,2,1,0,0
35228,2,25,2,2,2,0,0,0,2,0,0,0,0,0,0,0,0,0,0,0,0,2,1,0,0
35229,2,25,14,8,8,0,0,6,14,0,0,0,0,0,0,0,0,0,0,0,0,2,1,0,0
35230,2,25,6,4,4,0,0,2,6,0,0,0,0,0,0,0,0,0,0,0,0,2,1,0,0
35231,2,25,6,4,4,0,0,2,6,1,2,1,2,3,3,2,4,0,2,0,0,2,1,0,0
35232,2,25,6,4,4,0,0,2,6,0,0,0,0,0,0,0,0,0,0,0,0,2,1,0,0
35233,2,25,7,5,5,0,0,2,7,0,0,0,0,0,0,0,0,0,0,0,0,2,1,0,0
35234,2,25,6,4,4,0,0,2,6,0,0,0,0,0,0,0,0,0,0,0,0,2,1,0,0
35235,2,25,10,6,6,0,0,4,10,0,0,0,0,0,0,0,0,0,0,0,0,2,1,0,0
35236,2,25,1,1,1,0,0,0,1,0,0,0,0,0,0,0,0,0,0,0,0,2,1,0,0
35237,2,25,1,1,1,0,0,0,1,0,0,0,0,0,0,0,0,0,0,0,0,2,1,0,0
35238,2,25,14,10,10,0,0,4,14,1,1,1,1,2,2,0,2,0,1,0,0,2,1,0,0
35239,2,25,46,26,30,3,0,12,49,3,6,3,6,9,9,20,28,1,42,2,0,2,1,0,0
35240,1,55,14,12,10,0,0,4,14,1,2,1,2,3,3,2,4,0,2,0,0,2,1,0,0
35241,1,58,14,12,10,0,0,4,14,1,2,1,2,3,3,2,4,0,2,0,0,2,1,0,0
35242,1,55,14,12,10,0,0,4,14,1,2,1,2,3,3,2,4,0,2,0,0,2,1,0,0
35243,1,77,19,18,14,0,0,5,19,1,2,1,2,3,3,2,4,0,2,0,0,2,1,0,0
35244,2,18,10,6,6,0,0,4,10,0,0,0,0,0,0,0,0,0,0,0,0,2,1,0,0
35245,2,36,127,75,83,2,11,30,129,4,14,7,14,18,21,61,87,2,175,9,0,2,1,0,0
35246,2,36,652,304,544,16,6,88,668,6,89,51,101,95,152,591,998,3,3399,188,0,2,1,0,0
35247,2,36,2,2,2,0,0,0,2,0,0,0,0,0,0,0,0,0,0,0,0,2,1,0,0
35248,2,36,8,5,5,0,0,3,8,0,0,0,0,0,0,0,0,0,0,0,0,2,1,0,0
35249,2,36,2,2,2,0,0,0,2,0,0,0,0,0,0,0,0,0,0,0,0,2,1,0,0
35250,2,36,14,8,8,0,0,6,14,0,0,0,0,0,0,0,0,0,0,0,0,2,1,0,0
35251,2,36,6,4,4,0,0,2,6,0,0,0,0,0,0,0,0,0,0,0,0,2,1,0,0
35252,2,36,6,4,4,0,0,2,6,1,2,1,2,3,3,2,4,0,2,0,0,2,1,0,0
35253,2,36,6,4,4,0,0,2,6,0,0,0,0,0,0,0,0,0,0,0,0,2,1,0,0
35254,2,36,7,5,5,0,0,2,7,0,0,0,0,0,0,0,0,0,0,0,0,2,1,0,0
35255,2,36,6,4,4,0,0,2,6,0,0,0,0,0,0,0,0,0,0,0,0,2,1,0,0
35256,2,36,10,6,6,0,0,4,10,0,0,0,0,0,0,0,0,0,0,0,0,2,1,0,0
35257,2,36,1,1,1,0,0,0,1,0,0,0,0,0,0,0,0,0,0,0,0,2,1,0,0
35258,2,36,1,1,1,0,0,0,1,0,0,0,0,0,0,0,0,0,0,0,0,2,1,0,0
35259,2,36,14,10,10,0,0,4,14,1,1,1,1,2,2,0,2,0,1,0,0,2,1,0,0
35260,2,36,46,26,30,3,0,12,49,3,6,3,6,9,9,20,28,1,42,2,0,2,1,0,0
35261,1,6,2,2,2,0,0,0,2,0,0,0,0,0,0,0,0,0,0,0,0,2,1,0,0
35262,1,6,2,2,2,0,0,0,2,0,0,0,0,0,0,0,0,0,0,0,0,2,1,0,0
35263,1,6,2,2,2,0,0,0,2,0,0,0,0,0,0,0,0,0,0,0,0,2,1,0,0
35264,1,6,2,2,2,0,0,0,2,0,0,0,0,0,0,0,0,0,0,0,0,2,1,0,0
35265,1,26,127,75,83,2,11,30,129,4,14,7,14,18,21,61,87,2,175,9,0,2,1,0,0
35266,1,26,652,304,544,16,6,88,668,6,89,51,101,95,152,591,998,3,3399,188,0,2,1,0,0
35267,1,26,2,2,2,0,0,0,2,0,0,0,0,0,0,0,0,0,0,0,0,2,1,0,0
35268,1,26,8,5,5,0,0,3,8,0,0,0,0,0,0,0,0,0,0,0,0,2,1,0,0
35269,1,26,2,2,2,0,0,0,2,0,0,0,0,0,0,0,0,0,0,0,0,2,1,0,0
35270,1,26,14,8,8,0,0,6,14,0,0,0,0,0,0,0,0,0,0,0,0,2,1,0,0
35271,1,26,6,4,4,0,0,2,6,0,0,0,0,0,0,0,0,0,0,0,0,2,1,0,0
35272,1,26,6,4,4,0,0,2,6,1,2,1,2,3,3,2,4,0,2,0,0,2,1,0,0
35273,1,26,6,4,4,0,0,2,6,0,0,0,0,0,0,0,0,0,0,0,0,2,1,0,0
35274,1,26,7,5,5,0,0,2,7,0,0,0,0,0,0,0,0,0,0,0,0,2,1,0,0
35275,1,26,6,4,4,0,0,2,6,0,0,0,0,0,0,0,0,0,0,0,0,2,1,0,0
35276,1,26,10,6,6,0,0,4,10,0,0,0,0,0,0,0,0,0,0,0,0,2,1,0,0
35277,1,26,1,1,1,0,0,0,1,0,0,0,0,0,0,0,0,0,0,0,0,2,1,0,0
35278,1,26,1,1,1,0,0,0,1,0,0,0,0,0,0,0,0,0,0,0,0,2,1,0,0
35279,1,26,14,10,10,0,0,4,14,1,1,1,1,2,2,0,2,0,1,0,0,2,1,0,0
35280,1,26,46,26,30,3,0,12,49,3,6,3,6,9,9,20,28,1,42,2,0,2,1,0,0
35281,1,7,2,2,2,0,0,0,2,0,0,0,0,0,0,0,0,0,0,0,0,2,1,0,0
35282,1,24,127,75,83,2,11,30,129,4,14,7,14,18,21,61,87,2,175,9,0,2,1,0,0
35283,1,24,652,304,544,16,6,88,668,6,89,51,101,95,152,591,998,3,3399,188,0,2,1,0,0
35284,1,24,2,2,2,0,0,0,2,0,0,0,0,0,0,0,0,0,0,0,0,2,1,0,0
35285,1,24,8,5,5,0,0,3,8,0,0,0,0,0,0,0,0,0,0,0,0,2,1,0,0
35286,1,24,2,2,2,0,0,0,2,0,0,0,0,0,0,0,0,0,0,0,0,2,1,0,0
35287,1,24,14,8,8,0,0,6,14,0,0,0,0,0,0,0,0,0,0,0,0,2,1,0,0
35288,1,24,6,4,4,0,0,2,6,0,0,0,0,0,0,0,0,0,0,0,0,2,1,0,0
35289,1,24,6,4,4,0,0,2,6,1,2,1,2,3,3,2,4,0,2,0,0,2,1,0,0
35290,1,24,6,4,4,0,0,2,6,0,0,0,0,0,0,0,0,0,0,0,0,2,1,0,0
35291,1,24,7,5,5,0,0,2,7,0,0,0,0,0,0,0,0,0,0,0,0,2,1,0,0
35292,1,24,6,4,4,0,0,2,6,0,0,0,0,0,0,0,0,0,0,0,0,2,1,0,0
35293,1,24,10,6,6,0,0,4,10,0,0,0,0,0,0,0,0,0,0,0,0,2,1,0,0
35294,1,24,1,1,1,0,0,0,1,0,0,0,0,0,0,0,0,0,0,0,0,2,1,0,0
35295,1,24,1,1,1,0,0,0,1,0,0,0,0,0,0,0,0,0,0,0,0,2,1,0,0
35296,1,24,14,10,10,0,0,4,14,1,1,1,1,2,2,0,2,0,1,0,0,2,1,0,0
35297,1,24,46,26,30,3,0,12,49,3,6,3,6,9,9,20,28,1,42,2,0,2,1,0,0
35298,1,7,2,2,2,0,0,0,2,0,0,0,0,0,0,0,0,0,0,0,0,2,1,0,0
35299,3,33,15,9,9,0,0,6,15,0,0,0,0,0,0,0,0,0,0,0,0,2,1,0,0
35300,1,13,127,75,83,2,11,30,129,4,14,7,14,18,21,61,87,2,175,9,0,2,1,0,0
35301,1,13,652,304,544,16,6,88,668,6,89,51,101,95,152,591,998,3,3399,188,0,2,1,0,0
35302,1,13,2,2,2,0,0,0,2,0,0,0,0,0,0,0,0,0,0,0,0,2,1,0,0
35303,1,13,8,5,5,0,0,3,8,0,0,0,0,0,0,0,0,0,0,0,0,2,1,0,0
35304,1,13,2,2,2,0,0,0,2,0,0,0,0,0,0,0,0,0,0,0,0,2,1,0,0
35305,1,13,14,8,8,0,0,6,14,0,0,0,0,0,0,0,0,0,0,0,0,2,1,0,0
35306,1,13,6,4,4,0,0,2,6,0,0,0,0,0,0,0,0,0,0,0,0,2,1,0,0
35307,1,13,6,4,4,0,0,2,6,1,2,1,2,3,3,2,4,0,2,0,0,2,1,0,0
35308,1,13,6,4,4,0,0,2,6,0,0,0,0,0,0,0,0,0,0,0,0,2,1,0,0
35309,1,13,7,5,5,0,0,2,7,0,0,0,0,0,0,0,0,0,0,0,0,2,1,0,0
35310,1,13,6,4,4,0,0,2,6,0,0,0,0,0,0,0,0,0,0,0,0,2,1,0,0
35311,1,13,10,6,6,0,0,4,10,0,0,0,0,0,0,0,0,0,0,0,0,2,1,0,0
35312,1,13,1,1,1,0,0,0,1,0,0,0,0,0,0,0,0,0,0,0,0,2,1,0,0
35313,1,13,1,1,1,0,0,0,1,0,0,0,0,0,0,0,0,0,0,0,0,2,1,0,0
35314,1,13,14,10,10,0,0,4,14,1,1,1,1,2,2,0,2,0,1,0,0,2,1,0,0
35315,1,13,46,26,30,3,0,12,49,3,6,3,6,9,9,20,28,1,42,2,0,2,1,0,0
35316,1,16,127,75,83,2,11,30,129,4,14,7,14,18,21,61,87,2,175,9,0,2,1,0,0
35317,1,16,652,304,544,16,6,88,668,6,89,51,101,95,152,591,998,3,3399,188,0,2,1,0,0
35318,1,16,2,2,2,0,0,0,2,0,0,0,0,0,0,0,0,0,0,0,0,2,1,0,0
35319,1,16,8,5,5,0,0,3,8,0,0,0,0,0,0,0,0,0,0,0,0,2,1,0,0
35320,1,16,2,2,2,0,0,0,2,0,0,0,0,0,0,0,0,0,0,0,0,2,1,0,0
35321,1,16,14,8,8,0,0,6,14,0,0,0,0,0,0,0,0,0,0,0,0,2,1,0,0
35322,1,16,6,4,4,0,0,2,6,0,0,0,0,0,0,0,0,0,0,0,0,2,1,0,0
35323,1,16,6,4,4,0,0,2,6,1,2,1,2,3,3,2,4,0,2,0,0,2,1,0,0
35324,1,16,6,4,4,0,0,2,6,0,0,0,0,0,0,0,0,0,0,0,0,2,1,0,0
35325,1,16,7,5,5,0,0,2,7,0,0,0,0,0,0,0,0,0,0,0,0,2,1,0,0
35326,1,16,6,4,4,0,0,2,6,0,0,0,0,0,0,0,0,0,0,0,0,2,1,0,0
35327,1,16,10,6,6,0,0,4,10,0,0,0,0,0,0,0,0,0,0,0,0,2,1,0,0
35328,1,16,1,1,1,0,0,0,1,0,0,0,0,0,0,0,0,0,0,0,0,2,1,0,0
35329,1,16,1,1,1,0,0,0,1,0,0,0,0,0,0,0,0,0,0,0,0,2,1,0,0
35330,1,16,14,10,10,0,0,4,14,1,1,1,1,2,2,0,2,0,1,0,0,2,1,0,0
35331,1,16,46,26,30,3,0,12,49,3,6,3,6,9,9,20,28,1,42,2,0,2,1,0,0
35332,1,10,2,2,2,0,0,0,2,1,2,1,2,3,3,2,4,0,2,0,0,2,1,0,0
35333,1,13,127,75,83,2,11,30,129,4,14,7,14,18,21,61,87,2,175,9,0,2,1,0,0
35334,1,13,652,304,544,16,6,88,668,6,89,51,101,95,152,591,998,3,3399,188,0,2,1,0,0
35335,1,13,2,2,2,0,0,0,2,0,0,0,0,0,0,0,0,0,0,0,0,2,1,0,0
35336,1,13,8,5,5,0,0,3,8,0,0,0,0,0,0,0,0,0,0,0,0,2,1,0,0
35337,1,13,2,2,2,0,0,0,2,0,0,0,0,0,0,0,0,0,0,0,0,2,1,0,0
35338,1,13,14,8,8,0,0,6,14,0,0,0,0,0,0,0,0,0,0,0,0,2,1,0,0
35339,1,13,6,4,4,0,0,2,6,0,0,0,0,0,0,0,0,0,0,0,0,2,1,0,0
35340,1,13,6,4,4,0,0,2,6,1,2,1,2,3,3,2,4,0,2,0,0,2,1,0,0
35341,1,13,6,4,4,0,0,2,6,0,0,0,0,0,0,0,0,0,0,0,0,2,1,0,0
35342,1,13,7,5,5,0,0,2,7,0,0,0,0,0,0,0,0,0,0,0,0,2,1,0,0
35343,1,13,6,4,4,0,0,2,6,0,0,0,0,0,0,0,0,0,0,0,0,2,1,0,0
35344,1,13,10,6,6,0,0,4,10,0,0,0,0,0,0,0,0,0,0,0,0,2,1,0,0
35345,1,13,1,1,1,0,0,0,1,0,0,0,0,0,0,0,0,0,0,0,0,2,1,0,0
35346,1,13,1,1,1,0,0,0,1,0,0,0,0,0,0,0,0,0,0,0,0,2,1,0,0
35347,1,13,14,10,10,0,0,4,14,1,1,1,1,2,2,0,2,0,1,0,0,2,1,0,0
35348,1,13,46,26,30,3,0,12,49,3,6,3,6,9,9,20,28,1,42,2,0,2,1,0,0
35349,2,26,10,6,6,0,0,4,10,2,4,2,4,6,6,10,15,1,15,0,0,2,1,0,0
35350,3,47,15,10,10,0,0,5,15,2,4,2,4,6,6,10,15,1,15,0,0,2,1,0,0
35351,3,39,15,9,9,0,0,6,15,0,0,0,0,0,0,0,0,0,0,0,0,2,1,0,0
35352,2,36,10,7,7,0,0,3,10,1,2,1,2,3,3,2,4,0,2,0,0,2,1,0,0
35353,3,46,15,9,9,0,0,6,15,1,4,2,4,5,6,8,13,0,6,0,0,2,1,0,0
35354,2,21,10,6,6,0,0,4,10,0,0,0,0,0,0,0,0,0,0,0,0,2,1,0,0
35355,4,61,20,12,12,0,0,8,20,1,2,1,2,3,3,2,4,0,2,0,0,2,1,0,0
35356,2,51,127,75,83,2,11,30,129,4,14,7,14,18,21,61,87,2,175,9,0,2,1,0,0
35357,2,51,652,304,544,16,6,88,668,6,89,51,101,95,152,591,998,3,3399,188,0,2,1,0,0
35358,2,51,2,2,2,0,0,0,2,0,0,0,0,0,0,0,0,0,0,0,0,2,1,0,0
35359,2,51,8,5,5,0,0,3,8,0,0,0,0,0,0,0,0,0,0,0,0,2,1,0,0
35360,2,51,2,2,2,0,0,0,2,0,0,0,0,0,0,0,0,0,0,0,0,2,1,0,0
35361,2,51,14,8,8,0,0,6,14,0,0,0,0,0,0,0,0,0,0,0,0,2,1,0,0
35362,2,51,6,4,4,0,0,2,6,0,0,0,0,0,0,0,0,0,0,0,0,2,1,0,0
35363,2,51,6,4,4,0,0,2,6,1,2,1,2,3,3,2,4,0,2,0,0,2,1,0,0
35364,2,51,6,4,4,0,0,2,6,0,0,0,0,0,0,0,0,0,0,0,0,2,1,0,0
35365,2,51,7,5,5,0,0,2,7,0,0,0,0,0,0,0,0,0,0,0,0,2,1,0,0
35366,2,51,6,4,4,0,0,2,6,0,0,0,0,0,0,0,0,0,0,0,0,2,1,0,0
35367,2,51,10,6,6,0,0,4,10,0,0,0,0,0,0,0,0,0,0,0,0,2,1,0,0
35368,2,51,1,1,1,0,0,0,1,0,0,0,0,0,0,0,0,0,0,0,0,2,1,0,0
35369,2,51,1,1,1,0,0,0,1,0,0,0,0,0,0,0,0,0,0,0,0,2,1,0,0
35370,2,51,14,10,10,0,0,4,14,1,1,1,1,2,2,0,2,0,1,0,0,2,1,0,0
35371,2,51,46,26,30,3,0,12,49,3,6,3,6,9,9,20,28,1,42,2,0,2,1,0,0
35372,1,6,2,2,2,0,0,0,2,0,0,0,0,0,0,0,0,0,0,0,0,2,1,0,0
35373,8,263,51,25,36,0,0,15,51,3,11,6,12,14,18,42,68,1,112,6,0,2,1,0,0
35374,1,14,6,4,4,0,0,2,6,0,0,0,0,0,0,0,0,0,0,0,0,2,1,0,0
35375,4,163,27,21,21,0,0,6,27,3,6,3,6,9,9,20,28,1,42,2,0,2,1,0,0
35376,1,6,2,2,2,0,0,0,2,0,0,0,0,0,0,0,0,0,0,0,0,2,1,0,0
35377,1,41,7,5,5,0,0,2,7,1,2,1,2,3,3,2,4,0,2,0,0,2,1,0,0
35378,2,51,14,9,9,0,0,5,14,0,0,0,0,0,0,0,0,0,0,0,0,2,1,0,0
35379,2,40,13,9,8,0,0,4,13,0,0,0,0,0,0,0,0,0,0,0,0,2,1,0,0
35380,2,42,14,10,9,0,0,4,14,0,0,0,0,0,0,0,0,0,0,0,0,2,1,0,0
35381,2,33,12,8,7,0,0,4,12,0,0,0,0,0,0,0,0,0,0,0,0,2,1,0,0
35382,3,49,16,9,9,0,0,7,16,0,0,0,0,0,0,0,0,0,0,0,0,2,1,0,0
35383,1,18,3,3,3,0,0,0,3,0,0,0,0,0,0,0,0,0,0,0,0,2,1,0,0
35384,2,26,6,4,4,0,0,2,6,1,4,2,4,5,6,8,13,0,6,0,0,2,1,0,0
35385,1,134,149,67,118,4,0,27,153,1,17,14,28,18,42,69,175,0,144,8,0,2,1,0,0
35386,66,4392,520,294,400,33,13,81,553,10,261,204,367,271,571,2128,4614,7,32445,1802,1,2,1,1,0
35387,90,3974,1338,495,1086,10,64,173,1348,11,122,82,157,133,239,883,1686,7,11934,663,0,2,1,1,0
35388,33,999,465,148,393,5,8,60,470,4,31,20,31,35,51,161,261,2,523,29,0,2,1,0,0
35389,33,999,16,12,9,0,0,6,16,1,2,1,2,3,3,2,4,0,2,0,0,2,1,0,0
35390,144,5944,1782,648,1425,9,47,279,1791,8,171,97,189,179,286,1292,2140,4,9462,525,0,2,96,0,0
35391,33,1041,256,139,192,9,7,47,265,4,23,12,24,27,36,112,171,2,357,19,0,2,1,0,0
35392,23,613,102,59,69,5,3,24,107,6,22,15,28,28,43,113,206,3,789,43,0,2,1,0,0
35393,48,3659,996,429,845,24,10,117,1020,7,76,50,88,83,138,494,879,4,3565,198,0,2,1,0,0
35394,126,5406,1513,682,1277,25,13,200,1538,11,199,116,219,210,335,1557,2584,6,15641,868,0,2,1,1,0
35395,85,4936,1296,573,1062,40,33,157,1336,8,201,118,231,209,349,1561,2689,4,12365,686,0,2,1,0,0
35396,21,500,207,111,150,11,0,50,218,5,26,19,36,31,55,133,272,3,943,52,0,2,1,0,0
35397,98,5250,1457,730,1242,11,6,188,1468,10,292,166,329,302,495,2424,4078,5,22973,1276,1,2,12,0,0
35398,43,2690,652,304,544,16,6,88,668,6,89,51,101,95,152,591,998,3,3399,188,0,2,1,0,0
35399,72,3310,1455,414,1257,16,76,112,1471,5,41,23,46,46,69,231,381,2,1069,59,0,2,3,3,0
35400,2,56,7,6,5,0,0,2,7,1,1,1,2,2,3,0,3,1,3,0,0,2,1,0,0
35401,8,275,74,35,59,1,0,14,75,3,14,7,14,17,21,58,85,1,128,7,0,2,1,0,0
35402,70,3187,1020,354,843,12,15,144,1032,8,134,77,144,142,221,970,1580,4,6792,377,0,2,1,0,0
35403,47,2189,447,308,343,6,5,95,453,7,96,59,111,103,170,651,1136,4,4600,255,0,2,1,0,0
35404,3,229,53,23,39,0,0,13,53,2,8,4,8,10,12,26,39,1,39,2,0,2,1,0,0
35405,21,655,424,94,331,4,0,89,428,1,5,5,5,6,10,11,25,0,12,0,0,2,2,2,0
35406,38,2327,334,251,279,10,4,40,344,5,127,74,143,132,217,899,1528,2,4303,239,0,2,1,0,0
35407,12,497,184,100,137,2,15,30,186,6,38,20,39,44,59,214,322,3,991,55,0,2,2,2,0
35408,8,377,91,45,69,0,3,18,91,3,9,6,10,12,16,33,57,1,95,5,0,2,1,0,0
35409,78,3962,1293,570,1093,25,15,163,1318,10,195,123,241,205,364,1516,2795,6,17273,959,0,2,20,8,0
35410,29,1903,384,251,317,7,8,52,391,11,70,44,84,81,128,467,811,6,5355,297,0,2,2,2,0
35411,45,1953,386,256,301,16,9,68,402,4,59,35,69,63,104,355,621,2,1453,80,0,2,1,0,0
35412,28,1596,466,257,367,18,25,50,484,7,126,86,171,133,257,898,1813,4,8612,478,0,2,1,0,0
35413,15,1066,215,129,180,6,0,29,221,8,65,43,72,73,115,415,711,4,3153,175,0,2,1,0,0
35414,86,3411,1043,504,840,53,9,147,1096,9,180,112,198,189,310,1377,2344,4,11604,644,0,2,1,1,0
35415,12,478,295,56,236,0,4,54,295,2,9,5,10,11,15,30,51,1,57,3,0,2,1,0,0
35416,30,1440,373,158,315,8,0,51,381,5,76,44,79,81,123,486,779,2,2026,112,0,2,1,0,0
35417,81,3172,1178,367,1042,6,15,115,1184,9,94,51,95,103,146,644,976,4,4439,246,0,2,1,1,0
35418,9,449,219,78,157,11,5,46,230,3,24,20,34,27,54,114,256,2,545,30,0,2,1,0,0
35419,111,6122,1943,715,1694,26,18,214,1969,12,185,120,237,197,357,1436,2721,7,20915,1161,0,2,1,1,0
35420,37,1519,442,244,305,14,16,103,456,11,68,45,75,79,120,452,756,6,4588,254,0,2,1,0,0
35421,52,1986,1098,241,925,5,10,155,1103,7,46,25,49,53,74,273,423,3,1580,87,0,2,1,0,0
35422,53,1862,601,196,481,2,23,85,603,8,63,36,72,71,108,400,664,4,3036,168,0,2,4,4,0
35423,3,42,14,8,8,0,0,6,14,0,0,0,0,0,0,0,0,0,0,0,0,2,1,0,0
35424,2,40,9,6,6,0,0,3,9,0,0,0,0,0,0,0,0,0,0,0,0,2,1,0,0
35425,2,40,13,9,8,0,0,4,13,0,0,0,0,0,0,0,0,0,0,0,0,2,1,0,0
35426,60,1163,282,196,195,3,0,86,285,8,130,71,141,138,212,936,1507,4,6538,363,0,2,1,0,0
35427,4,77,127,75,83,2,11,30,129,4,14,7,14,18,21,61,87,2,175,9,0,2,1,0,0
35428,4,77,652,304,544,16,6,88,668,6,89,51,101,95,152,591,998,3,3399,188,0,2,1,0,0
35429,4,77,2,2,2,0,0,0,2,0,0,0,0,0,0,0,0,0,0,0,0,2,1,0,0
35430,4,77,8,5,5,0,0,3,8,0,0,0,0,0,0,0,0,0,0,0,0,2,1,0,0
35431,4,77,2,2,2,0,0,0,2,0,0,0,0,0,0,0,0,0,0,0,0,2,1,0,0
35432,4,77,14,8,8,0,0,6,14,0,0,0,0,0,0,0,0,0,0,0,0,2,1,0,0
35433,4,77,6,4,4,0,0,2,6,0,0,0,0,0,0,0,0,0,0,0,0,2,1,0,0
35434,4,77,6,4,4,0,0,2,6,1,2,1,2,3,3,2,4,0,2,0,0,2,1,0,0
35435,4,77,6,4,4,0,0,2,6,0,0,0,0,0,0,0,0,0,0,0,0,2,1,0,0
35436,4,77,7,5,5,0,0,2,7,0,0,0,0,0,0,0,0,0,0,0,0,2,1,0,0
35437,4,77,6,4,4,0,0,2,6,0,0,0,0,0,0,0,0,0,0,0,0,2,1,0,0
35438,4,77,10,6,6,0,0,4,10,0,0,0,0,0,0,0,0,0,0,0,0,2,1,0,0
35439,4,77,1,1,1,0,0,0,1,0,0,0,0,0,0,0,0,0,0,0,0,2,1,0,0
35440,4,77,1,1,1,0,0,0,1,0,0,0,0,0,0,0,0,0,0,0,0,2,1,0,0
35441,4,77,14,10,10,0,0,4,14,1,1,1,1,2,2,0,2,0,1,0,0,2,1,0,0
35442,4,77,46,26,30,3,0,12,49,3,6,3,6,9,9,20,28,1,42,2,0,2,1,0,0
35443,1,9,5,3,3,0,0,2,5,0,0,0,0,0,0,0,0,0,0,0,0,2,1,0,0
35444,1,90,13,10,10,0,0,3,13,1,2,1,2,3,3,2,4,0,2,0,0,2,1,0,0
35445,7,114,44,19,17,0,16,11,44,3,14,7,14,17,21,58,85,1,128,7,0,2,1,0,0
35446,3,66,127,75,83,2,11,30,129,4,14,7,14,18,21,61,87,2,175,9,0,2,1,0,0
35447,3,66,652,304,544,16,6,88,668,6,89,51,101,95,152,591,998,3,3399,188,0,2,1,0,0
35448,3,66,2,2,2,0,0,0,2,0,0,0,0,0,0,0,0,0,0,0,0,2,1,0,0
35449,3,66,8,5,5,0,0,3,8,0,0,0,0,0,0,0,0,0,0,0,0,2,1,0,0
35450,3,66,2,2,2,0,0,0,2,0,0,0,0,0,0,0,0,0,0,0,0,2,1,0,0
35451,3,66,14,8,8,0,0,6,14,0,0,0,0,0,0,0,0,0,0,0,0,2,1,0,0
35452,3,66,6,4,4,0,0,2,6,0,0,0,0,0,0,0,0,0,0,0,0,2,1,0,0
35453,3,66,6,4,4,0,0,2,6,1,2,1,2,3,3,2,4,0,2,0,0,2,1,0,0
35454,3,66,6,4,4,0,0,2,6,0,0,0,0,0,0,0,0,0,0,0,0,2,1,0,0
35455,3,66,7,5,5,0,0,2,7,0,0,0,0,0,0,0,0,0,0,0,0,2,1,0,0
35456,3,66,6,4,4,0,0,2,6,0,0,0,0,0,0,0,0,0,0,0,0,2,1,0,0
35457,3,66,10,6,6,0,0,4,10,0,0,0,0,0,0,0,0,0,0,0,0,2,1,0,0
35458,3,66,1,1,1,0,0,0,1,0,0,0,0,0,0,0,0,0,0,0,0,2,1,0,0
35459,3,66,1,1,1,0,0,0,1,0,0,0,0,0,0,0,0,0,0,0,0,2,1,0,0
35460,3,66,14,10,10,0,0,4,14,1,1,1,1,2,2,0,2,0,1,0,0,2,1,0,0
35461,3,66,46,26,30,3,0,12,49,3,6,3,6,9,9,20,28,1,42,2,0,2,1,0,0
35462,7,296,72,33,56,0,4,12,72,1,1,1,1,2,2,0,2,0,1,0,0,2,1,0,0
35463,12,229,127,75,83,2,11,30,129,4,14,7,14,18,21,61,87,2,175,9,0,2,1,0,0
35464,12,229,652,304,544,16,6,88,668,6,89,51,101,95,152,591,998,3,3399,188,0,2,1,0,0
35465,12,229,2,2,2,0,0,0,2,0,0,0,0,0,0,0,0,0,0,0,0,2,1,0,0
35466,12,229,8,5,5,0,0,3,8,0,0,0,0,0,0,0,0,0,0,0,0,2,1,0,0
35467,12,229,2,2,2,0,0,0,2,0,0,0,0,0,0,0,0,0,0,0,0,2,1,0,0
35468,12,229,14,8,8,0,0,6,14,0,0,0,0,0,0,0,0,0,0,0,0,2,1,0,0
35469,12,229,6,4,4,0,0,2,6,0,0,0,0,0,0,0,0,0,0,0,0,2,1,0,0
35470,12,229,6,4,4,0,0,2,6,1,2,1,2,3,3,2,4,0,2,0,0,2,1,0,0
35471,12,229,6,4,4,0,0,2,6,0,0,0,0,0,0,0,0,0,0,0,0,2,1,0,0
35472,12,229,7,5,5,0,0,2,7,0,0,0,0,0,0,0,0,0,0,0,0,2,1,0,0
35473,12,229,6,4,4,0,0,2,6,0,0,0,0,0,0,0,0,0,0,0,0,2,1,0,0
35474,12,229,10,6,6,0,0,4,10,0,0,0,0,0,0,0,0,0,0,0,0,2,1,0,0
35475,12,229,1,1,1,0,0,0,1,0,0,0,0,0,0,0,0,0,0,0,0,2,1,0,0
35476,12,229,1,1,1,0,0,0,1,0,0,0,0,0,0,0,0,0,0,0,0,2,1,0,0
35477,12,229,14,10,10,0,0,4,14,1,1,1,1,2,2,0,2,0,1,0,0,2,1,0,0
35478,12,229,46,26,30,3,0,12,49,3,6,3,6,9,9,20,28,1,42,2,0,2,1,0,0
35479,6,71,127,75,83,2,11,30,129,4,14,7,14,18,21,61,87,2,175,9,0,2,1,0,0
35480,6,71,652,304,544,16,6,88,668,6,89,51,101,95,152,591,998,3,3399,188,0,2,1,0,0
35481,6,71,2,2,2,0,0,0,2,0,0,0,0,0,0,0,0,0,0,0,0,2,1,0,0
35482,6,71,8,5,5,0,0,3,8,0,0,0,0,0,0,0,0,0,0,0,0,2,1,0,0
35483,6,71,2,2,2,0,0,0,2,0,0,0,0,0,0,0,0,0,0,0,0,2,1,0,0
35484,6,71,14,8,8,0,0,6,14,0,0,0,0,0,0,0,0,0,0,0,0,2,1,0,0
35485,6,71,6,4,4,0,0,2,6,0,0,0,0,0,0,0,0,0,0,0,0,2,1,0,0
35486,6,71,6,4,4,0,0,2,6,1,2,1,2,3,3,2,4,0,2,0,0,2,1,0,0
35487,6,71,6,4,4,0,0,2,6,0,0,0,0,0,0,0,0,0,0,0,0,2,1,0,0
35488,6,71,7,5,5,0,0,2,7,0,0,0,0,0,0,0,0,0,0,0,0,2,1,0,0
35489,6,71,6,4,4,0,0,2,6,0,0,0,0,0,0,0,0,0,0,0,0,2,1,0,0
35490,6,71,10,6,6,0,0,4,10,0,0,0,0,0,0,0,0,0,0,0,0,2,1,0,0
35491,6,71,1,1,1,0,0,0,1,0,0,0,0,0,0,0,0,0,0,0,0,2,1,0,0
35492,6,71,1,1,1,0,0,0,1,0,0,0,0,0,0,0,0,0,0,0,0,2,1,0,0
35493,6,71,14,10,10,0,0,4,14,1,1,1,1,2,2,0,2,0,1,0,0,2,1,0,0
35494,6,71,46,26,30,3,0,12,49,3,6,3,6,9,9,20,28,1,42,2,0,2,1,0,0
35495,3,26,14,7,7,2,0,5,16,0,0,0,0,0,0,0,0,0,0,0,0,2,1,0,0
35496,7,103,38,23,23,0,0,15,38,0,0,0,0,0,0,0,0,0,0,0,0,2,1,0,0
35497,17,378,85,59,61,8,0,16,93,5,18,10,18,23,28,86,126,2,316,17,0,2,1,0,0
35498,12,515,124,78,88,2,3,26,126,4,13,7,13,17,20,56,81,2,163,9,0,2,1,0,0
35499,1,98,42,7,35,4,0,5,46,1,2,1,2,3,3,2,4,0,2,0,0,2,1,0,0
35500,1,98,11,6,10,0,0,1,11,2,4,2,4,6,6,10,15,1,15,0,0,2,1,0,0
35501,11,242,19,8,11,5,0,4,24,2,5,3,6,7,9,13,25,1,30,1,0,2,1,0,0
35502,11,242,102,59,69,5,3,24,107,6,22,15,28,28,43,113,206,3,789,43,0,2,1,0,0
35503,11,242,106,40,36,3,49,17,109,8,17,13,23,25,36,93,167,5,904,50,0,2,1,0,0
35504,229,4960,182,127,129,0,0,53,182,5,39,21,42,44,63,217,343,2,926,51,0,2,6,4,0
35505,229,4960,1165,710,800,67,119,181,1232,18,243,153,282,261,435,2000,3492,10,36473,2026,1,2,6,4,0
35506,67,1570,773,419,590,28,0,166,801,10,204,113,217,214,330,1598,2554,5,13587,754,0,2,1,0,0
35507,67,1570,421,273,302,44,34,57,465,17,81,59,107,98,166,583,1098,11,12329,684,0,2,1,0,0
35508,14,411,149,95,105,2,0,41,151,8,54,28,55,62,83,334,494,4,2013,111,0,2,1,0,0
35509,14,411,82,56,54,0,13,15,82,4,13,8,16,17,24,56,98,2,241,13,0,2,1,0,0
35510,26,529,2,2,2,0,0,0,2,0,0,0,0,0,0,0,0,0,0,0,0,2,1,0,0
35511,26,529,99,48,90,1,3,5,100,0,0,0,0,0,0,0,0,0,0,0,0,2,1,0,0
35512,26,529,8,5,5,2,0,1,10,0,0,0,0,0,0,0,0,0,0,0,0,2,1,0,0
35513,26,529,1217,716,841,84,126,174,1301,14,185,118,215,199,333,1446,2542,8,20687,1149,0,2,1,0,0
35514,26,529,160,89,115,0,13,31,160,7,15,11,17,22,28,78,124,3,495,27,0,2,1,0,0
35515,26,529,10,10,9,9,0,0,19,0,0,0,0,0,0,0,0,0,0,0,0,2,1,0,0
35516,26,529,173,84,99,8,29,36,181,5,12,7,13,17,20,54,81,2,221,12,0,2,1,0,0
35517,26,529,3,1,1,3,0,0,6,0,0,0,0,0,0,0,0,0,0,0,0,2,1,0,0
35518,188,5732,1660,832,1314,41,38,274,1701,20,312,209,395,332,604,2671,5058,12,64042,3557,1,2,5,1,0
35519,188,5732,1057,646,719,113,100,145,1170,18,215,134,248,233,382,1740,3004,10,31186,1732,1,2,5,1,0
35520,17,348,95,58,50,9,16,20,104,12,33,24,45,45,69,209,378,8,3100,172,0,2,1,0,0
35521,116,2173,477,336,357,30,23,73,507,16,194,134,250,210,384,1538,2962,10,30538,1696,0,2,1,0,0
35522,89,2050,996,429,845,24,10,117,1020,7,76,50,88,83,138,494,879,4,3565,198,0,2,1,0,0
35523,89,2050,456,277,329,12,42,72,468,13,85,50,97,98,147,592,972,7,7212,400,0,2,1,0,0
35524,166,3529,1513,682,1277,25,13,200,1538,11,199,116,219,210,335,1557,2584,6,15641,868,0,2,6,4,0
35525,166,3529,819,519,539,24,98,155,843,15,96,57,106,111,163,690,1107,8,9171,509,0,2,6,4,0
35526,73,1518,207,111,150,11,0,50,218,5,26,19,36,31,55,133,272,3,943,52,0,2,1,0,0
35527,73,1518,410,198,237,31,55,97,441,11,63,38,72,74,110,414,683,6,4293,238,0,2,1,0,0
35528,237,4939,2,2,2,0,0,0,2,0,0,0,0,0,0,0,0,0,0,0,0,2,4,3,0
35529,237,4939,99,48,90,1,3,5,100,0,0,0,0,0,0,0,0,0,0,0,0,2,4,3,0
35530,237,4939,8,5,5,2,0,1,10,0,0,0,0,0,0,0,0,0,0,0,0,2,4,3,0
35531,237,4939,1217,716,841,84,126,174,1301,14,185,118,215,199,333,1446,2542,8,20687,1149,0,2,4,3,0
35532,237,4939,160,89,115,0,13,31,160,7,15,11,17,22,28,78,124,3,495,27,0,2,4,3,0
35533,237,4939,10,10,9,9,0,0,19,0,0,0,0,0,0,0,0,0,0,0,0,2,4,3,0
35534,237,4939,173,84,99,8,29,36,181,5,12,7,13,17,20,54,81,2,221,12,0,2,4,3,0
35535,237,4939,3,1,1,3,0,0,6,0,0,0,0,0,0,0,0,0,0,0,0,2,4,3,0
35536,98,2019,463,295,324,28,62,57,491,12,134,82,154,146,236,989,1696,6,11700,650,0,2,1,0,0
35537,55,770,167,116,138,4,5,22,171,8,48,30,56,56,86,292,499,4,2330,129,0,2,1,0,0
35538,52,1442,339,213,244,17,9,65,356,10,42,26,48,52,74,259,421,5,2410,133,0,2,46,44,0
35539,95,2385,1455,414,1257,16,76,112,1471,5,41,23,46,46,69,231,381,2,1069,59,0,2,1,0,0
35540,95,2385,669,365,481,22,61,110,691,15,103,63,122,118,185,747,1273,8,11311,628,0,2,1,0,0
35541,249,5763,4293,999,3693,19,54,507,4312,9,155,88,170,164,258,1156,1898,4,9368,520,0,2,10,0,0
35542,249,5763,1482,859,1002,125,135,219,1607,16,219,134,251,235,385,1766,3032,9,27804,1544,1,2,10,0,0
35543,6,140,44,22,19,0,19,6,44,2,10,6,12,12,18,35,64,1,77,4,0,2,1,0,0
35544,31,1087,74,35,59,1,0,14,75,3,14,7,14,17,21,58,85,1,128,7,0,2,1,0,0
35545,31,1087,245,125,200,5,7,34,250,7,30,17,34,37,51,166,265,3,1053,58,0,2,1,0,0
35546,54,657,647,139,84,35,284,233,682,0,0,0,0,0,0,0,0,0,0,0,0,2,1,0,0
35547,115,3128,1523,757,1297,19,12,193,1542,12,193,117,230,205,347,1508,2664,7,19053,1058,0,2,1,0,0
35548,115,3128,701,378,504,33,58,109,734,13,110,68,126,123,194,794,1346,7,10027,557,0,2,1,0,0
35549,101,2612,773,422,505,30,103,129,803,14,77,46,83,91,129,535,839,7,6334,351,0,2,1,0,0
35550,159,3785,77,34,69,0,0,8,77,3,24,16,29,27,45,114,213,1,387,21,0,2,1,0,0
35551,159,3785,712,438,573,51,9,84,763,14,102,71,128,116,199,733,1364,8,11988,666,0,2,1,0,0
35552,24,612,2,2,2,0,0,0,2,0,0,0,0,0,0,0,0,0,0,0,0,2,1,0,0
35553,24,612,99,48,90,1,3,5,100,0,0,0,0,0,0,0,0,0,0,0,0,2,1,0,0
35554,24,612,8,5,5,2,0,1,10,0,0,0,0,0,0,0,0,0,0,0,0,2,1,0,0
35555,24,612,1217,716,841,84,126,174,1301,14,185,118,215,199,333,1446,2542,8,20687,1149,0,2,1,0,0
35556,24,612,160,89,115,0,13,31,160,7,15,11,17,22,28,78,124,3,495,27,0,2,1,0,0
35557,24,612,10,10,9,9,0,0,19,0,0,0,0,0,0,0,0,0,0,0,0,2,1,0,0
35558,24,612,173,84,99,8,29,36,181,5,12,7,13,17,20,54,81,2,221,12,0,2,1,0,0
35559,24,612,3,1,1,3,0,0,6,0,0,0,0,0,0,0,0,0,0,0,0,2,1,0,0
35560,30,664,125,97,103,3,0,19,128,9,25,17,27,34,44,144,223,4,1087,60,0,2,1,0,0
35561,22,373,102,57,55,5,16,25,107,5,17,10,18,22,28,81,124,2,330,18,0,2,1,0,0
35562,69,1527,402,202,227,24,74,80,426,12,52,33,61,64,94,339,564,7,3969,220,0,2,1,0,0
35563,55,1174,447,308,343,6,5,95,453,7,96,59,111,103,170,651,1136,4,4600,255,0,2,1,0,0
35564,55,1174,322,174,179,16,74,51,338,10,41,26,46,51,72,252,408,5,2291,127,0,2,1,0,0
35565,75,1629,53,23,39,0,0,13,53,2,8,4,8,10,12,26,39,1,39,2,0,2,1,0,0
35566,75,1629,515,298,307,33,80,99,548,12,63,44,77,75,121,419,753,7,5527,307,0,2,1,0,0
35567,18,312,424,94,331,4,0,89,428,1,5,5,5,6,10,11,25,0,12,0,0,2,1,0,0
35568,18,312,38,23,23,6,0,8,44,3,11,7,11,14,18,42,68,1,102,5,0,2,1,0,0
35569,19,513,205,80,86,16,53,53,221,7,18,10,19,25,29,94,134,3,497,27,0,2,1,0,0
35570,17,523,184,100,137,2,15,30,186,6,38,20,39,44,59,214,322,3,991,55,0,2,1,0,0
35571,17,523,103,65,74,8,5,16,111,7,17,9,17,24,26,89,119,3,417,23,0,2,1,0,0
35572,59,1228,91,45,69,0,3,18,91,3,9,6,10,12,16,33,57,1,95,5,0,2,1,0,0
35573,59,1228,367,234,237,17,34,68,384,16,55,34,61,71,95,381,584,8,5183,287,0,2,1,0,0
35574,231,5969,722,423,573,19,0,135,741,12,172,101,199,184,300,1320,2257,6,15668,870,0,2,1,0,0
35575,231,5969,1508,847,911,44,250,301,1552,14,148,88,169,162,257,1120,1886,7,15077,837,0,2,1,0,0
35576,314,6912,72,33,56,0,4,12,72,1,1,1,1,2,2,0,2,0,1,0,0,2,3,7,0
35577,314,6912,1454,835,1044,76,110,219,1530,17,275,158,296,292,454,2297,3718,9,34017,1889,1,2,3,7,0
35578,92,1886,757,253,292,73,244,162,830,13,61,38,67,74,105,409,651,7,4654,258,0,2,2,1,0
35579,45,953,386,256,301,16,9,68,402,4,59,35,69,63,104,355,621,2,1453,80,0,2,1,0,0
35580,45,953,264,131,164,11,41,46,275,6,38,22,40,44,62,214,338,3,1068,59,0,2,1,0,0
35581,67,1753,466,257,367,18,25,50,484,7,126,86,171,133,257,898,1813,4,8612,478,0,2,1,0,0
35582,67,1753,507,281,342,29,59,88,536,10,53,29,57,63,86,336,514,5,2764,153,0,2,1,0,0
35583,25,552,215,129,180,6,0,29,221,8,65,43,72,73,115,415,711,4,3153,175,0,2,1,0,0
35584,25,552,97,69,77,3,3,16,100,6,22,13,23,28,36,113,173,3,542,30,0,2,1,0,0
35585,89,1894,1043,504,840,53,9,147,1096,9,180,112,198,189,310,1377,2344,4,11604,644,0,2,1,0,0
35586,89,1894,383,288,292,26,6,62,409,11,65,38,67,76,105,429,656,5,3719,206,0,2,1,0,0
35587,20,420,294,64,250,0,0,43,294,1,20,10,20,21,30,86,131,0,65,3,0,2,1,0,0
35588,20,420,78,46,62,3,0,14,81,3,8,4,8,11,12,28,41,1,62,3,0,2,1,0,0
35589,5,123,110,30,77,3,13,16,113,4,21,15,30,25,45,100,208,2,597,33,0,2,1,0,0
35590,5,123,28,15,21,1,0,6,29,0,0,0,0,0,0,0,0,0,0,0,0,2,1,0,0
35591,41,821,1178,367,1042,6,15,115,1184,9,94,51,95,103,146,644,976,4,4439,246,0,2,1,1,0
35592,41,821,177,108,140,8,0,27,185,6,30,16,32,36,48,162,248,3,794,44,0,2,1,1,0
35593,28,452,219,78,157,11,5,46,230,3,24,20,34,27,54,114,256,2,545,30,0,2,1,0,0
35594,28,452,108,64,79,9,0,20,117,5,15,11,19,20,30,70,129,3,410,22,0,2,1,0,0
35595,282,5915,1943,715,1694,26,18,214,1969,12,185,120,237,197,357,1436,2721,7,20915,1161,0,2,1,1,0
35596,282,5915,1168,838,957,57,25,144,1225,19,348,224,416,367,640,3018,5452,11,61921,3440,1,2,1,1,0
35597,19,720,442,244,305,14,16,103,456,11,68,45,75,79,120,452,756,6,4588,254,0,2,1,0,0
35598,19,720,182,102,99,11,40,35,193,3,11,6,11,14,17,42,64,1,97,5,0,2,1,0,0
35599,69,1323,1098,241,925,5,10,155,1103,7,46,25,49,53,74,273,423,3,1580,87,0,2,1,0,0
35600,69,1323,282,202,222,14,2,44,296,8,42,24,43,50,67,250,378,4,1548,86,0,2,1,0,0
35601,2,156,37,13,25,0,6,6,37,1,2,1,2,3,3,2,4,0,2,0,0,2,1,0,0
35602,2,156,133,47,40,1,43,49,134,0,0,0,0,0,0,0,0,0,0,0,0,2,1,0,0
35603,29,743,601,196,481,2,23,85,603,8,63,36,72,71,108,400,664,4,3036,168,0,2,1,0,0
35604,29,743,156,79,106,5,16,28,161,5,14,8,15,19,23,64,97,2,261,14,0,2,1,0,0
35605,36,1120,182,127,129,0,0,53,182,5,39,21,42,44,63,217,343,2,926,51,0,2,1,1,0
35606,7,123,127,75,83,2,11,30,129,4,14,7,14,18,21,61,87,2,175,9,0,2,1,0,0
35607,7,123,652,304,544,16,6,88,668,6,89,51,101,95,152,591,998,3,3399,188,0,2,1,0,0
35608,7,123,2,2,2,0,0,0,2,0,0,0,0,0,0,0,0,0,0,0,0,2,1,0,0
35609,7,123,8,5,5,0,0,3,8,0,0,0,0,0,0,0,0,0,0,0,0,2,1,0,0
35610,7,123,2,2,2,0,0,0,2,0,0,0,0,0,0,0,0,0,0,0,0,2,1,0,0
35611,7,123,14,8,8,0,0,6,14,0,0,0,0,0,0,0,0,0,0,0,0,2,1,0,0
35612,7,123,6,4,4,0,0,2,6,0,0,0,0,0,0,0,0,0,0,0,0,2,1,0,0
35613,7,123,6,4,4,0,0,2,6,1,2,1,2,3,3,2,4,0,2,0,0,2,1,0,0
35614,7,123,6,4,4,0,0,2,6,0,0,0,0,0,0,0,0,0,0,0,0,2,1,0,0
35615,7,123,7,5,5,0,0,2,7,0,0,0,0,0,0,0,0,0,0,0,0,2,1,0,0
35616,7,123,6,4,4,0,0,2,6,0,0,0,0,0,0,0,0,0,0,0,0,2,1,0,0
35617,7,123,10,6,6,0,0,4,10,0,0,0,0,0,0,0,0,0,0,0,0,2,1,0,0
35618,7,123,1,1,1,0,0,0,1,0,0,0,0,0,0,0,0,0,0,0,0,2,1,0,0
35619,7,123,1,1,1,0,0,0,1,0,0,0,0,0,0,0,0,0,0,0,0,2,1,0,0
35620,7,123,14,10,10,0,0,4,14,1,1,1,1,2,2,0,2,0,1,0,0,2,1,0,0
35621,7,123,46,26,30,3,0,12,49,3,6,3,6,9,9,20,28,1,42,2,0,2,1,0,0
35622,14,845,75,38,59,1,3,12,76,2,4,2,4,6,6,10,15,1,15,0,0,2,1,0,0
35623,2,67,16,12,9,0,0,6,16,1,2,1,2,3,3,2,4,0,2,0,0,2,1,0,0
35624,1,6,2,2,2,0,0,0,2,0,0,0,0,0,0,0,0,0,0,0,0,2,1,0,0
35625,1,6,99,48,90,1,3,5,100,0,0,0,0,0,0,0,0,0,0,0,0,2,1,0,0
35626,1,6,8,5,5,2,0,1,10,0,0,0,0,0,0,0,0,0,0,0,0,2,1,0,0
35627,1,6,1217,716,841,84,126,174,1301,14,185,118,215,199,333,1446,2542,8,20687,1149,0,2,1,0,0
35628,1,6,160,89,115,0,13,31,160,7,15,11,17,22,28,78,124,3,495,27,0,2,1,0,0
35629,1,6,10,10,9,9,0,0,19,0,0,0,0,0,0,0,0,0,0,0,0,2,1,0,0
35630,1,6,173,84,99,8,29,36,181,5,12,7,13,17,20,54,81,2,221,12,0,2,1,0,0
35631,1,6,3,1,1,3,0,0,6,0,0,0,0,0,0,0,0,0,0,0,0,2,1,0,0
35632,1,6,2,2,2,0,0,0,2,0,0,0,0,0,0,0,0,0,0,0,0,2,1,0,0
35633,1,6,2,2,2,0,0,0,2,0,0,0,0,0,0,0,0,0,0,0,0,2,1,0,0
35634,1,6,2,2,2,0,0,0,2,0,0,0,0,0,0,0,0,0,0,0,0,2,1,0,0
35635,1,6,2,2,2,0,0,0,2,0,0,0,0,0,0,0,0,0,0,0,0,2,1,0,0
35636,1,8,127,75,83,2,11,30,129,4,14,7,14,18,21,61,87,2,175,9,0,2,1,0,0
35637,1,8,652,304,544,16,6,88,668,6,89,51,101,95,152,591,998,3,3399,188,0,2,1,0,0
35638,1,8,2,2,2,0,0,0,2,0,0,0,0,0,0,0,0,0,0,0,0,2,1,0,0
35639,1,8,8,5,5,0,0,3,8,0,0,0,0,0,0,0,0,0,0,0,0,2,1,0,0
35640,1,8,2,2,2,0,0,0,2,0,0,0,0,0,0,0,0,0,0,0,0,2,1,0,0
35641,1,8,14,8,8,0,0,6,14,0,0,0,0,0,0,0,0,0,0,0,0,2,1,0,0
35642,1,8,6,4,4,0,0,2,6,0,0,0,0,0,0,0,0,0,0,0,0,2,1,0,0
35643,1,8,6,4,4,0,0,2,6,1,2,1,2,3,3,2,4,0,2,0,0,2,1,0,0
35644,1,8,6,4,4,0,0,2,6,0,0,0,0,0,0,0,0,0,0,0,0,2,1,0,0
35645,1,8,7,5,5,0,0,2,7,0,0,0,0,0,0,0,0,0,0,0,0,2,1,0,0
35646,1,8,6,4,4,0,0,2,6,0,0,0,0,0,0,0,0,0,0,0,0,2,1,0,0
35647,1,8,10,6,6,0,0,4,10,0,0,0,0,0,0,0,0,0,0,0,0,2,1,0,0
35648,1,8,1,1,1,0,0,0,1,0,0,0,0,0,0,0,0,0,0,0,0,2,1,0,0
35649,1,8,1,1,1,0,0,0,1,0,0,0,0,0,0,0,0,0,0,0,0,2,1,0,0
35650,1,8,14,10,10,0,0,4,14,1,1,1,1,2,2,0,2,0,1,0,0,2,1,0,0
35651,1,8,46,26,30,3,0,12,49,3,6,3,6,9,9,20,28,1,42,2,0,2,1,0,0
35652,1,6,2,2,2,0,0,0,2,0,0,0,0,0,0,0,0,0,0,0,0,2,1,0,0
35653,1,6,2,2,2,0,0,0,2,0,0,0,0,0,0,0,0,0,0,0,0,2,1,0,0
35654,1,6,2,2,2,0,0,0,2,0,0,0,0,0,0,0,0,0,0,0,0,2,1,0,0
35655,1,6,2,2,2,0,0,0,2,0,0,0,0,0,0,0,0,0,0,0,0,2,1,0,0
35656,1,6,2,2,2,0,0,0,2,0,0,0,0,0,0,0,0,0,0,0,0,2,1,0,0
35657,1,6,2,2,2,0,0,0,2,0,0,0,0,0,0,0,0,0,0,0,0,2,1,0,0
35658,1,6,2,2,2,0,0,0,2,0,0,0,0,0,0,0,0,0,0,0,0,2,1,0,0
35659,1,6,2,2,2,0,0,0,2,0,0,0,0,0,0,0,0,0,0,0,0,2,1,0,0
35660,1,6,2,2,2,0,0,0,2,0,0,0,0,0,0,0,0,0,0,0,0,2,1,0,0
35661,2,25,127,75,83,2,11,30,129,4,14,7,14,18,21,61,87,2,175,9,0,2,1,0,0
35662,2,25,652,304,544,16,6,88,668,6,89,51,101,95,152,591,998,3,3399,188,0,2,1,0,0
35663,2,25,2,2,2,0,0,0,2,0,0,0,0,0,0,0,0,0,0,0,0,2,1,0,0
35664,2,25,8,5,5,0,0,3,8,0,0,0,0,0,0,0,0,0,0,0,0,2,1,0,0
35665,2,25,2,2,2,0,0,0,2,0,0,0,0,0,0,0,0,0,0,0,0,2,1,0,0
35666,2,25,14,8,8,0,0,6,14,0,0,0,0,0,0,0,0,0,0,0,0,2,1,0,0
35667,2,25,6,4,4,0,0,2,6,0,0,0,0,0,0,0,0,0,0,0,0,2,1,0,0
35668,2,25,6,4,4,0,0,2,6,1,2,1,2,3,3,2,4,0,2,0,0,2,1,0,0
35669,2,25,6,4,4,0,0,2,6,0,0,0,0,0,0,0,0,0,0,0,0,2,1,0,0
35670,2,25,7,5,5,0,0,2,7,0,0,0,0,0,0,0,0,0,0,0,0,2,1,0,0
35671,2,25,6,4,4,0,0,2,6,0,0,0,0,0,0,0,0,0,0,0,0,2,1,0,0
35672,2,25,10,6,6,0,0,4,10,0,0,0,0,0,0,0,0,0,0,0,0,2,1,0,0
35673,2,25,1,1,1,0,0,0,1,0,0,0,0,0,0,0,0,0,0,0,0,2,1,0,0
35674,2,25,1,1,1,0,0,0,1,0,0,0,0,0,0,0,0,0,0,0,0,2,1,0,0
35675,2,25,14,10,10,0,0,4,14,1,1,1,1,2,2,0,2,0,1,0,0,2,1,0,0
35676,2,25,46,26,30,3,0,12,49,3,6,3,6,9,9,20,28,1,42,2,0,2,1,0,0
35677,1,55,14,12,10,0,0,4,14,1,2,1,2,3,3,2,4,0,2,0,0,2,1,0,0
35678,1,58,14,12,10,0,0,4,14,1,2,1,2,3,3,2,4,0,2,0,0,2,1,0,0
35679,1,55,14,12,10,0,0,4,14,1,2,1,2,3,3,2,4,0,2,0,0,2,1,0,0
35680,1,77,19,18,14,0,0,5,19,1,2,1,2,3,3,2,4,0,2,0,0,2,1,0,0
35681,2,18,10,6,6,0,0,4,10,0,0,0,0,0,0,0,0,0,0,0,0,2,1,0,0
35682,2,36,127,75,83,2,11,30,129,4,14,7,14,18,21,61,87,2,175,9,0,2,1,0,0
35683,2,36,652,304,544,16,6,88,668,6,89,51,101,95,152,591,998,3,3399,188,0,2,1,0,0
35684,2,36,2,2,2,0,0,0,2,0,0,0,0,0,0,0,0,0,0,0,0,2,1,0,0
35685,2,36,8,5,5,0,0,3,8,0,0,0,0,0,0,0,0,0,0,0,0,2,1,0,0
35686,2,36,2,2,2,0,0,0,2,0,0,0,0,0,0,0,0,0,0,0,0,2,1,0,0
35687,2,36,14,8,8,0,0,6,14,0,0,0,0,0,0,0,0,0,0,0,0,2,1,0,0
35688,2,36,6,4,4,0,0,2,6,0,0,0,0,0,0,0,0,0,0,0,0,2,1,0,0
35689,2,36,6,4,4,0,0,2,6,1,2,1,2,3,3,2,4,0,2,0,0,2,1,0,0
35690,2,36,6,4,4,0,0,2,6,0,0,0,0,0,0,0,0,0,0,0,0,2,1,0,0
35691,2,36,7,5,5,0,0,2,7,0,0,0,0,0,0,0,0,0,0,0,0,2,1,0,0
35692,2,36,6,4,4,0,0,2,6,0,0,0,0,0,0,0,0,0,0,0,0,2,1,0,0
35693,2,36,10,6,6,0,0,4,10,0,0,0,0,0,0,0,0,0,0,0,0,2,1,0,0
35694,2,36,1,1,1,0,0,0,1,0,0,0,0,0,0,0,0,0,0,0,0,2,1,0,0
35695,2,36,1,1,1,0,0,0,1,0,0,0,0,0,0,0,0,0,0,0,0,2,1,0,0
35696,2,36,14,10,10,0,0,4,14,1,1,1,1,2,2,0,2,0,1,0,0,2,1,0,0
35697,2,36,46,26,30,3,0,12,49,3,6,3,6,9,9,20,28,1,42,2,0,2,1,0,0
35698,1,6,2,2,2,0,0,0,2,0,0,0,0,0,0,0,0,0,0,0,0,2,1,0,0
35699,1,6,2,2,2,0,0,0,2,0,0,0,0,0,0,0,0,0,0,0,0,2,1,0,0
35700,1,6,2,2,2,0,0,0,2,0,0,0,0,0,0,0,0,0,0,0,0,2,1,0,0
35701,1,6,2,2,2,0,0,0,2,0,0,0,0,0,0,0,0,0,0,0,0,2,1,0,0
35702,1,26,127,75,83,2,11,30,129,4,14,7,14,18,21,61,87,2,175,9,0,2,1,0,0
35703,1,26,652,304,544,16,6,88,668,6,89,51,101,95,152,591,998,3,3399,188,0,2,1,0,0
35704,1,26,2,2,2,0,0,0,2,0,0,0,0,0,0,0,0,0,0,0,0,2,1,0,0
35705,1,26,8,5,5,0,0,3,8,0,0,0,0,0,0,0,0,0,0,0,0,2,1,0,0
35706,1,26,2,2,2,0,0,0,2,0,0,0,0,0,0,0,0,0,0,0,0,2,1,0,0
35707,1,26,14,8,8,0,0,6,14,0,0,0,0,0,0,0,0,0,0,0,0,2,1,0,0
35708,1,26,6,4,4,0,0,2,6,0,0,0,0,0,0,0,0,0,0,0,0,2,1,0,0
35709,1,26,6,4,4,0,0,2,6,1,2,1,2,3,3,2,4,0,2,0,0,2,1,0,0
35710,1,26,6,4,4,0,0,2,6,0,0,0,0,0,0,0,0,0,0,0,0,2,1,0,0
35711,1,26,7,5,5,0,0,2,7,0,0,0,0,0,0,0,0,0,0,0,0,2,1,0,0
35712,1,26,6,4,4,0,0,2,6,0,0,0,0,0,0,0,0,0,0,0,0,2,1,0,0
35713,1,26,10,6,6,0,0,4,10,0,0,0,0,0,0,0,0,0,0,0,0,2,1,0,0
35714,1,26,1,1,1,0,0,0,1,0,0,0,0,0,0,0,0,0,0,0,0,2,1,0,0
35715,1,26,1,1,1,0,0,0,1,0,0,0,0,0,0,0,0,0,0,0,0,2,1,0,0
35716,1,26,14,10,10,0,0,4,14,1,1,1,1,2,2,0,2,0,1,0,0,2,1,0,0
35717,1,26,46,26,30,3,0,12,49,3,6,3,6,9,9,20,28,1,42,2,0,2,1,0,0
35718,1,7,2,2,2,0,0,0,2,0,0,0,0,0,0,0,0,0,0,0,0,2,1,0,0
35719,1,24,127,75,83,2,11,30,129,4,14,7,14,18,21,61,87,2,175,9,0,2,1,0,0
35720,1,24,652,304,544,16,6,88,668,6,89,51,101,95,152,591,998,3,3399,188,0,2,1,0,0
35721,1,24,2,2,2,0,0,0,2,0,0,0,0,0,0,0,0,0,0,0,0,2,1,0,0
35722,1,24,8,5,5,0,0,3,8,0,0,0,0,0,0,0,0,0,0,0,0,2,1,0,0
35723,1,24,2,2,2,0,0,0,2,0,0,0,0,0,0,0,0,0,0,0,0,2,1,0,0
35724,1,24,14,8,8,0,0,6,14,0,0,0,0,0,0,0,0,0,0,0,0,2,1,0,0
35725,1,24,6,4,4,0,0,2,6,0,0,0,0,0,0,0,0,0,0,0,0,2,1,0,0
35726,1,24,6,4,4,0,0,2,6,1,2,1,2,3,3,2,4,0,2,0,0,2,1,0,0
35727,1,24,6,4,4,0,0,2,6,0,0,0,0,0,0,0,0,0,0,0,0,2,1,0,0
35728,1,24,7,5,5,0,0,2,7,0,0,0,0,0,0,0,0,0,0,0,0,2,1,0,0
35729,1,24,6,4,4,0,0,2,6,0,0,0,0,0,0,0,0,0,0,0,0,2,1,0,0
35730,1,24,10,6,6,0,0,4,10,0,0,0,0,0,0,0,0,0,0,0,0,2,1,0,0
35731,1,24,1,1,1,0,0,0,1,0,0,0,0,0,0,0,0,0,0,0,0,2,1,0,0
35732,1,24,1,1,1,0,0,0,1,0,0,0,0,0,0,0,0,0,0,0,0,2,1,0,0
35733,1,24,14,10,10,0,0,4,14,1,1,1,1,2,2,0,2,0,1,0,0,2,1,0,0
35734,1,24,46,26,30,3,0,12,49,3,6,3,6,9,9,20,28,1,42,2,0,2,1,0,0
35735,1,7,2,2,2,0,0,0,2,0,0,0,0,0,0,0,0,0,0,0,0,2,1,0,0
35736,3,33,15,9,9,0,0,6,15,0,0,0,0,0,0,0,0,0,0,0,0,2,1,0,0
35737,1,13,127,75,83,2,11,30,129,4,14,7,14,18,21,61,87,2,175,9,0,2,1,0,0
35738,1,13,652,304,544,16,6,88,668,6,89,51,101,95,152,591,998,3,3399,188,0,2,1,0,0
35739,1,13,2,2,2,0,0,0,2,0,0,0,0,0,0,0,0,0,0,0,0,2,1,0,0
35740,1,13,8,5,5,0,0,3,8,0,0,0,0,0,0,0,0,0,0,0,0,2,1,0,0
35741,1,13,2,2,2,0,0,0,2,0,0,0,0,0,0,0,0,0,0,0,0,2,1,0,0
35742,1,13,14,8,8,0,0,6,14,0,0,0,0,0,0,0,0,0,0,0,0,2,1,0,0
35743,1,13,6,4,4,0,0,2,6,0,0,0,0,0,0,0,0,0,0,0,0,2,1,0,0
35744,1,13,6,4,4,0,0,2,6,1,2,1,2,3,3,2,4,0,2,0,0,2,1,0,0
35745,1,13,6,4,4,0,0,2,6,0,0,0,0,0,0,0,0,0,0,0,0,2,1,0,0
35746,1,13,7,5,5,0,0,2,7,0,0,0,0,0,0,0,0,0,0,0,0,2,1,0,0
35747,1,13,6,4,4,0,0,2,6,0,0,0,0,0,0,0,0,0,0,0,0,2,1,0,0
35748,1,13,10,6,6,0,0,4,10,0,0,0,0,0,0,0,0,0,0,0,0,2,1,0,0
35749,1,13,1,1,1,0,0,0,1,0,0,0,0,0,0,0,0,0,0,0,0,2,1,0,0
35750,1,13,1,1,1,0,0,0,1,0,0,0,0,0,0,0,0,0,0,0,0,2,1,0,0
35751,1,13,14,10,10,0,0,4,14,1,1,1,1,2,2,0,2,0,1,0,0,2,1,0,0
35752,1,13,46,26,30,3,0,12,49,3,6,3,6,9,9,20,28,1,42,2,0,2,1,0,0
35753,1,16,127,75,83,2,11,30,129,4,14,7,14,18,21,61,87,2,175,9,0,2,1,0,0
35754,1,16,652,304,544,16,6,88,668,6,89,51,101,95,152,591,998,3,3399,188,0,2,1,0,0
35755,1,16,2,2,2,0,0,0,2,0,0,0,0,0,0,0,0,0,0,0,0,2,1,0,0
35756,1,16,8,5,5,0,0,3,8,0,0,0,0,0,0,0,0,0,0,0,0,2,1,0,0
35757,1,16,2,2,2,0,0,0,2,0,0,0,0,0,0,0,0,0,0,0,0,2,1,0,0
35758,1,16,14,8,8,0,0,6,14,0,0,0,0,0,0,0,0,0,0,0,0,2,1,0,0
35759,1,16,6,4,4,0,0,2,6,0,0,0,0,0,0,0,0,0,0,0,0,2,1,0,0
35760,1,16,6,4,4,0,0,2,6,1,2,1,2,3,3,2,4,0,2,0,0,2,1,0,0
35761,1,16,6,4,4,0,0,2,6,0,0,0,0,0,0,0,0,0,0,0,0,2,1,0,0
35762,1,16,7,5,5,0,0,2,7,0,0,0,0,0,0,0,0,0,0,0,0,2,1,0,0
35763,1,16,6,4,4,0,0,2,6,0,0,0,0,0,0,0,0,0,0,0,0,2,1,0,0
35764,1,16,10,6,6,0,0,4,10,0,0,0,0,0,0,0,0,0,0,0,0,2,1,0,0
35765,1,16,1,1,1,0,0,0,1,0,0,0,0,0,0,0,0,0,0,0,0,2,1,0,0
35766,1,16,1,1,1,0,0,0,1,0,0,0,0,0,0,0,0,0,0,0,0,2,1,0,0
35767,1,16,14,10,10,0,0,4,14,1,1,1,1,2,2,0,2,0,1,0,0,2,1,0,0
35768,1,16,46,26,30,3,0,12,49,3,6,3,6,9,9,20,28,1,42,2,0,2,1,0,0
35769,1,10,2,2,2,0,0,0,2,1,2,1,2,3,3,2,4,0,2,0,0,2,1,0,0
35770,1,13,127,75,83,2,11,30,129,4,14,7,14,18,21,61,87,2,175,9,0,2,1,0,0
35771,1,13,652,304,544,16,6,88,668,6,89,51,101,95,152,591,998,3,3399,188,0,2,1,0,0
35772,1,13,2,2,2,0,0,0,2,0,0,0,0,0,0,0,0,0,0,0,0,2,1,0,0
35773,1,13,8,5,5,0,0,3,8,0,0,0,0,0,0,0,0,0,0,0,0,2,1,0,0
35774,1,13,2,2,2,0,0,0,2,0,0,0,0,0,0,0,0,0,0,0,0,2,1,0,0
35775,1,13,14,8,8,0,0,6,14,0,0,0,0,0,0,0,0,0,0,0,0,2,1,0,0
35776,1,13,6,4,4,0,0,2,6,0,0,0,0,0,0,0,0,0,0,0,0,2,1,0,0
35777,1,13,6,4,4,0,0,2,6,1,2,1,2,3,3,2,4,0,2,0,0,2,1,0,0
35778,1,13,6,4,4,0,0,2,6,0,0,0,0,0,0,0,0,0,0,0,0,2,1,0,0
35779,1,13,7,5,5,0,0,2,7,0,0,0,0,0,0,0,0,0,0,0,0,2,1,0,0
35780,1,13,6,4,4,0,0,2,6,0,0,0,0,0,0,0,0,0,0,0,0,2,1,0,0
35781,1,13,10,6,6,0,0,4,10,0,0,0,0,0,0,0,0,0,0,0,0,2,1,0,0
35782,1,13,1,1,1,0,0,0,1,0,0,0,0,0,0,0,0,0,0,0,0,2,1,0,0
35783,1,13,1,1,1,0,0,0,1,0,0,0,0,0,0,0,0,0,0,0,0,2,1,0,0
35784,1,13,14,10,10,0,0,4,14,1,1,1,1,2,2,0,2,0,1,0,0,2,1,0,0
35785,1,13,46,26,30,3,0,12,49,3,6,3,6,9,9,20,28,1,42,2,0,2,1,0,0
35786,2,26,10,6,6,0,0,4,10,2,4,2,4,6,6,10,15,1,15,0,0,2,1,0,0
35787,3,47,15,10,10,0,0,5,15,2,4,2,4,6,6,10,15,1,15,0,0,2,1,0,0
35788,3,39,15,9,9,0,0,6,15,0,0,0,0,0,0,0,0,0,0,0,0,2,1,0,0
35789,2,36,10,7,7,0,0,3,10,1,2,1,2,3,3,2,4,0,2,0,0,2,1,0,0
35790,3,46,15,9,9,0,0,6,15,1,4,2,4,5,6,8,13,0,6,0,0,2,1,0,0
35791,2,21,10,6,6,0,0,4,10,0,0,0,0,0,0,0,0,0,0,0,0,2,1,0,0
35792,4,61,20,12,12,0,0,8,20,1,2,1,2,3,3,2,4,0,2,0,0,2,1,0,0
35793,2,51,127,75,83,2,11,30,129,4,14,7,14,18,21,61,87,2,175,9,0,2,1,0,0
35794,2,51,652,304,544,16,6,88,668,6,89,51,101,95,152,591,998,3,3399,188,0,2,1,0,0
35795,2,51,2,2,2,0,0,0,2,0,0,0,0,0,0,0,0,0,0,0,0,2,1,0,0
35796,2,51,8,5,5,0,0,3,8,0,0,0,0,0,0,0,0,0,0,0,0,2,1,0,0
35797,2,51,2,2,2,0,0,0,2,0,0,0,0,0,0,0,0,0,0,0,0,2,1,0,0
35798,2,51,14,8,8,0,0,6,14,0,0,0,0,0,0,0,0,0,0,0,0,2,1,0,0
35799,2,51,6,4,4,0,0,2,6,0,0,0,0,0,0,0,0,0,0,0,0,2,1,0,0
35800,2,51,6,4,4,0,0,2,6,1,2,1,2,3,3,2,4,0,2,0,0,2,1,0,0
35801,2,51,6,4,4,0,0,2,6,0,0,0,0,0,0,0,0,0,0,0,0,2,1,0,0
35802,2,51,7,5,5,0,0,2,7,0,0,0,0,0,0,0,0,0,0,0,0,2,1,0,0
35803,2,51,6,4,4,0,0,2,6,0,0,0,0,0,0,0,0,0,0,0,0,2,1,0,0
35804,2,51,10,6,6,0,0,4,10,0,0,0,0,0,0,0,0,0,0,0,0,2,1,0,0
35805,2,51,1,1,1,0,0,0,1,0,0,0,0,0,0,0,0,0,0,0,0,2,1,0,0
35806,2,51,1,1,1,0,0,0,1,0,0,0,0,0,0,0,0,0,0,0,0,2,1,0,0
35807,2,51,14,10,10,0,0,4,14,1,1,1,1,2,2,0,2,0,1,0,0,2,1,0,0
35808,2,51,46,26,30,3,0,12,49,3,6,3,6,9,9,20,28,1,42,2,0,2,1,0,0
35809,1,6,2,2,2,0,0,0,2,0,0,0,0,0,0,0,0,0,0,0,0,2,1,0,0
35810,8,263,51,25,36,0,0,15,51,3,11,6,12,14,18,42,68,1,112,6,0,2,1,0,0
35811,1,14,6,4,4,0,0,2,6,0,0,0,0,0,0,0,0,0,0,0,0,2,1,0,0
35812,4,163,27,21,21,0,0,6,27,3,6,3,6,9,9,20,28,1,42,2,0,2,1,0,0
35813,1,6,2,2,2,0,0,0,2,0,0,0,0,0,0,0,0,0,0,0,0,2,1,0,0
35814,1,41,7,5,5,0,0,2,7,1,2,1,2,3,3,2,4,0,2,0,0,2,1,0,0
35815,2,51,14,9,9,0,0,5,14,0,0,0,0,0,0,0,0,0,0,0,0,2,1,0,0
35816,2,40,13,9,8,0,0,4,13,0,0,0,0,0,0,0,0,0,0,0,0,2,1,0,0
35817,2,42,14,10,9,0,0,4,14,0,0,0,0,0,0,0,0,0,0,0,0,2,1,0,0
35818,2,33,12,8,7,0,0,4,12,0,0,0,0,0,0,0,0,0,0,0,0,2,1,0,0
35819,3,49,16,9,9,0,0,7,16,0,0,0,0,0,0,0,0,0,0,0,0,2,1,0,0
35820,1,18,3,3,3,0,0,0,3,0,0,0,0,0,0,0,0,0,0,0,0,2,1,0,0
35821,2,26,6,4,4,0,0,2,6,1,4,2,4,5,6,8,13,0,6,0,0,2,1,0,0
35822,1,134,149,67,118,4,0,27,153,1,17,14,28,18,42,69,175,0,144,8,0,2,1,0,0
35823,66,4392,520,294,400,33,13,81,553,10,261,204,367,271,571,2128,4614,7,32445,1802,1,2,1,1,0
35824,90,3974,1338,495,1086,10,64,173,1348,11,122,82,157,133,239,883,1686,7,11934,663,0,2,1,1,0
35825,33,999,465,148,393,5,8,60,470,4,31,20,31,35,51,161,261,2,523,29,0,2,1,0,0
35826,33,999,16,12,9,0,0,6,16,1,2,1,2,3,3,2,4,0,2,0,0,2,1,0,0
35827,144,5944,1782,648,1425,9,47,279,1791,8,171,97,189,179,286,1292,2140,4,9462,525,0,2,96,0,0
35828,33,1041,256,139,192,9,7,47,265,4,23,12,24,27,36,112,171,2,357,19,0,2,1,0,0
35829,23,613,102,59,69,5,3,24,107,6,22,15,28,28,43,113,206,3,789,43,0,2,1,0,0
35830,48,3659,996,429,845,24,10,117,1020,7,76,50,88,83,138,494,879,4,3565,198,0,2,1,0,0
35831,126,5406,1513,682,1277,25,13,200,1538,11,199,116,219,210,335,1557,2584,6,15641,868,0,2,1,1,0
35832,85,4936,1296,573,1062,40,33,157,1336,8,201,118,231,209,349,1561,2689,4,12365,686,0,2,1,0,0
35833,21,500,207,111,150,11,0,50,218,5,26,19,36,31,55,133,272,3,943,52,0,2,1,0,0
35834,98,5250,1457,730,1242,11,6,188,1468,10,292,166,329,302,495,2424,4078,5,22973,1276,1,2,12,0,0
35835,43,2690,652,304,544,16,6,88,668,6,89,51,101,95,152,591,998,3,3399,188,0,2,1,0,0
35836,72,3310,1455,414,1257,16,76,112,1471,5,41,23,46,46,69,231,381,2,1069,59,0,2,3,3,0
35837,2,56,7,6,5,0,0,2,7,1,1,1,2,2,3,0,3,1,3,0,0,2,1,0,0
35838,8,275,74,35,59,1,0,14,75,3,14,7,14,17,21,58,85,1,128,7,0,2,1,0,0
35839,70,3187,1020,354,843,12,15,144,1032,8,134,77,144,142,221,970,1580,4,6792,377,0,2,1,0,0
35840,47,2189,447,308,343,6,5,95,453,7,96,59,111,103,170,651,1136,4,4600,255,0,2,1,0,0
35841,3,229,53,23,39,0,0,13,53,2,8,4,8,10,12,26,39,1,39,2,0,2,1,0,0
35842,21,655,424,94,331,4,0,89,428,1,5,5,5,6,10,11,25,0,12,0,0,2,2,2,0
35843,38,2327,334,251,279,10,4,40,344,5,127,74,143,132,217,899,1528,2,4303,239,0,2,1,0,0
35844,12,497,184,100,137,2,15,30,186,6,38,20,39,44,59,214,322,3,991,55,0,2,2,2,0
35845,8,377,91,45,69,0,3,18,91,3,9,6,10,12,16,33,57,1,95,5,0,2,1,0,0
35846,78,3962,1293,570,1093,25,15,163,1318,10,195,123,241,205,364,1516,2795,6,17273,959,0,2,20,8,0
35847,29,1903,384,251,317,7,8,52,391,11,70,44,84,81,128,467,811,6,5355,297,0,2,2,2,0
35848,45,1953,386,256,301,16,9,68,402,4,59,35,69,63,104,355,621,2,1453,80,0,2,1,0,0
35849,28,1596,466,257,367,18,25,50,484,7,126,86,171,133,257,898,1813,4,8612,478,0,2,1,0,0
35850,15,1066,215,129,180,6,0,29,221,8,65,43,72,73,115,415,711,4,3153,175,0,2,1,0,0
35851,86,3411,1043,504,840,53,9,147,1096,9,180,112,198,189,310,1377,2344,4,11604,644,0,2,1,1,0
35852,12,478,295,56,236,0,4,54,295,2,9,5,10,11,15,30,51,1,57,3,0,2,1,0,0
35853,30,1440,373,158,315,8,0,51,381,5,76,44,79,81,123,486,779,2,2026,112,0,2,1,0,0
35854,81,3172,1178,367,1042,6,15,115,1184,9,94,51,95,103,146,644,976,4,4439,246,0,2,1,1,0
35855,9,449,219,78,157,11,5,46,230,3,24,20,34,27,54,114,256,2,545,30,0,2,1,0,0
35856,111,6122,1943,715,1694,26,18,214,1969,12,185,120,237,197,357,1436,2721,7,20915,1161,0,2,1,1,0
35857,37,1519,442,244,305,14,16,103,456,11,68,45,75,79,120,452,756,6,4588,254,0,2,1,0,0
35858,52,1986,1098,241,925,5,10,155,1103,7,46,25,49,53,74,273,423,3,1580,87,0,2,1,0,0
35859,53,1862,601,196,481,2,23,85,603,8,63,36,72,71,108,400,664,4,3036,168,0,2,4,4,0
35860,1,96,42,7,35,4,0,5,46,1,2,1,2,3,3,2,4,0,2,0,0,2,1,1,0
35861,1,96,11,6,10,0,0,1,11,2,4,2,4,6,6,10,15,1,15,0,0,2,1,1,0
35862,73,1512,207,111,150,11,0,50,218,5,26,19,36,31,55,133,272,3,943,52,0,2,0,1,0
35863,73,1512,410,198,237,31,55,97,441,11,63,38,72,74,110,414,683,6,4293,238,0,2,0,1,0
35864,315,6908,72,33,56,0,4,12,72,1,1,1,1,2,2,0,2,0,1,0,0,2,1,2,0
35865,315,6908,1454,835,1044,76,110,219,1530,17,275,158,296,292,454,2297,3718,9,34017,1889,1,2,1,2,0
35866,19,721,442,244,305,14,16,103,456,11,68,45,75,79,120,452,756,6,4588,254,0,2,21,21,0
35867,19,721,182,102,99,11,40,35,193,3,11,6,11,14,17,42,64,1,97,5,0,2,21,21,0
35868,1,96,42,7,35,4,0,5,46,1,2,1,2,3,3,2,4,0,2,0,0,2,1,1,0
35869,1,96,11,6,10,0,0,1,11,2,4,2,4,6,6,10,15,1,15,0,0,2,1,1,0
35870,6,151,127,75,83,2,11,30,129,4,14,7,14,18,21,61,87,2,175,9,0,2,9,4,1
35871,6,151,652,304,544,16,6,88,668,6,89,51,101,95,152,591,998,3,3399,188,0,2,9,4,1
35872,6,151,2,2,2,0,0,0,2,0,0,0,0,0,0,0,0,0,0,0,0,2,9,4,1
35873,6,151,8,5,5,0,0,3,8,0,0,0,0,0,0,0,0,0,0,0,0,2,9,4,1
35874,6,151,2,2,2,0,0,0,2,0,0,0,0,0,0,0,0,0,0,0,0,2,9,4,1
35875,6,151,14,8,8,0,0,6,14,0,0,0,0,0,0,0,0,0,0,0,0,2,9,4,1
35876,6,151,6,4,4,0,0,2,6,0,0,0,0,0,0,0,0,0,0,0,0,2,9,4,1
35877,6,151,6,4,4,0,0,2,6,1,2,1,2,3,3,2,4,0,2,0,0,2,9,4,1
35878,6,151,6,4,4,0,0,2,6,0,0,0,0,0,0,0,0,0,0,0,0,2,9,4,1
35879,6,151,7,5,5,0,0,2,7,0,0,0,0,0,0,0,0,0,0,0,0,2,9,4,1
35880,6,151,6,4,4,0,0,2,6,0,0,0,0,0,0,0,0,0,0,0,0,2,9,4,1
35881,6,151,10,6,6,0,0,4,10,0,0,0,0,0,0,0,0,0,0,0,0,2,9,4,1
35882,6,151,1,1,1,0,0,0,1,0,0,0,0,0,0,0,0,0,0,0,0,2,9,4,1
35883,6,151,1,1,1,0,0,0,1,0,0,0,0,0,0,0,0,0,0,0,0,2,9,4,1
35884,6,151,14,10,10,0,0,4,14,1,1,1,1,2,2,0,2,0,1,0,0,2,9,4,1
35885,6,151,46,26,30,3,0,12,49,3,6,3,6,9,9,20,28,1,42,2,0,2,9,4,1
35886,103,2661,773,422,505,30,103,129,803,14,77,46,83,91,129,535,839,7,6334,351,0,2,26,19,0
35887,38,2498,1157,318,931,29,22,177,1186,6,104,63,125,110,188,712,1274,3,4596,255,0,2,45,0,0
35888,73,1512,207,111,150,11,0,50,218,5,26,19,36,31,55,133,272,3,943,52,0,2,0,1,0
35889,73,1512,410,198,237,31,55,97,441,11,63,38,72,74,110,414,683,6,4293,238,0,2,0,1,0
35890,315,6908,72,33,56,0,4,12,72,1,1,1,1,2,2,0,2,0,1,0,0,2,1,2,0
35891,315,6908,1454,835,1044,76,110,219,1530,17,275,158,296,292,454,2297,3718,9,34017,1889,1,2,1,2,0
35892,19,721,442,244,305,14,16,103,456,11,68,45,75,79,120,452,756,6,4588,254,0,2,21,21,0
35893,19,721,182,102,99,11,40,35,193,3,11,6,11,14,17,42,64,1,97,5,0,2,21,21,0
35894,6,151,127,75,83,2,11,30,129,4,14,7,14,18,21,61,87,2,175,9,0,2,9,4,0
35895,6,151,652,304,544,16,6,88,668,6,89,51,101,95,152,591,998,3,3399,188,0,2,9,4,0
35896,6,151,2,2,2,0,0,0,2,0,0,0,0,0,0,0,0,0,0,0,0,2,9,4,0
35897,6,151,8,5,5,0,0,3,8,0,0,0,0,0,0,0,0,0,0,0,0,2,9,4,0
35898,6,151,2,2,2,0,0,0,2,0,0,0,0,0,0,0,0,0,0,0,0,2,9,4,0
35899,6,151,14,8,8,0,0,6,14,0,0,0,0,0,0,0,0,0,0,0,0,2,9,4,0
35900,6,151,6,4,4,0,0,2,6,0,0,0,0,0,0,0,0,0,0,0,0,2,9,4,0
35901,6,151,6,4,4,0,0,2,6,1,2,1,2,3,3,2,4,0,2,0,0,2,9,4,0
35902,6,151,6,4,4,0,0,2,6,0,0,0,0,0,0,0,0,0,0,0,0,2,9,4,0
35903,6,151,7,5,5,0,0,2,7,0,0,0,0,0,0,0,0,0,0,0,0,2,9,4,0
35904,6,151,6,4,4,0,0,2,6,0,0,0,0,0,0,0,0,0,0,0,0,2,9,4,0
35905,6,151,10,6,6,0,0,4,10,0,0,0,0,0,0,0,0,0,0,0,0,2,9,4,0
35906,6,151,1,1,1,0,0,0,1,0,0,0,0,0,0,0,0,0,0,0,0,2,9,4,0
35907,6,151,1,1,1,0,0,0,1,0,0,0,0,0,0,0,0,0,0,0,0,2,9,4,0
35908,6,151,14,10,10,0,0,4,14,1,1,1,1,2,2,0,2,0,1,0,0,2,9,4,0
35909,6,151,46,26,30,3,0,12,49,3,6,3,6,9,9,20,28,1,42,2,0,2,9,4,0
35910,6,153,127,75,83,2,11,30,129,4,14,7,14,18,21,61,87,2,175,9,0,2,3,3,0
35911,6,153,652,304,544,16,6,88,668,6,89,51,101,95,152,591,998,3,3399,188,0,2,3,3,0
35912,6,153,2,2,2,0,0,0,2,0,0,0,0,0,0,0,0,0,0,0,0,2,3,3,0
35913,6,153,8,5,5,0,0,3,8,0,0,0,0,0,0,0,0,0,0,0,0,2,3,3,0
35914,6,153,2,2,2,0,0,0,2,0,0,0,0,0,0,0,0,0,0,0,0,2,3,3,0
35915,6,153,14,8,8,0,0,6,14,0,0,0,0,0,0,0,0,0,0,0,0,2,3,3,0
35916,6,153,6,4,4,0,0,2,6,0,0,0,0,0,0,0,0,0,0,0,0,2,3,3,0
35917,6,153,6,4,4,0,0,2,6,1,2,1,2,3,3,2,4,0,2,0,0,2,3,3,0
35918,6,153,6,4,4,0,0,2,6,0,0,0,0,0,0,0,0,0,0,0,0,2,3,3,0
35919,6,153,7,5,5,0,0,2,7,0,0,0,0,0,0,0,0,0,0,0,0,2,3,3,0
35920,6,153,6,4,4,0,0,2,6,0,0,0,0,0,0,0,0,0,0,0,0,2,3,3,0
35921,6,153,10,6,6,0,0,4,10,0,0,0,0,0,0,0,0,0,0,0,0,2,3,3,0
35922,6,153,1,1,1,0,0,0,1,0,0,0,0,0,0,0,0,0,0,0,0,2,3,3,0
35923,6,153,1,1,1,0,0,0,1,0,0,0,0,0,0,0,0,0,0,0,0,2,3,3,0
35924,6,153,14,10,10,0,0,4,14,1,1,1,1,2,2,0,2,0,1,0,0,2,3,3,0
35925,6,153,46,26,30,3,0,12,49,3,6,3,6,9,9,20,28,1,42,2,0,2,3,3,0
35926,6,153,127,75,83,2,11,30,129,4,14,7,14,18,21,61,87,2,175,9,0,2,3,3,0
35927,6,153,652,304,544,16,6,88,668,6,89,51,101,95,152,591,998,3,3399,188,0,2,3,3,0
35928,6,153,2,2,2,0,0,0,2,0,0,0,0,0,0,0,0,0,0,0,0,2,3,3,0
35929,6,153,8,5,5,0,0,3,8,0,0,0,0,0,0,0,0,0,0,0,0,2,3,3,0
35930,6,153,2,2,2,0,0,0,2,0,0,0,0,0,0,0,0,0,0,0,0,2,3,3,0
35931,6,153,14,8,8,0,0,6,14,0,0,0,0,0,0,0,0,0,0,0,0,2,3,3,0
35932,6,153,6,4,4,0,0,2,6,0,0,0,0,0,0,0,0,0,0,0,0,2,3,3,0
35933,6,153,6,4,4,0,0,2,6,1,2,1,2,3,3,2,4,0,2,0,0,2,3,3,0
35934,6,153,6,4,4,0,0,2,6,0,0,0,0,0,0,0,0,0,0,0,0,2,3,3,0
35935,6,153,7,5,5,0,0,2,7,0,0,0,0,0,0,0,0,0,0,0,0,2,3,3,0
35936,6,153,6,4,4,0,0,2,6,0,0,0,0,0,0,0,0,0,0,0,0,2,3,3,0
35937,6,153,10,6,6,0,0,4,10,0,0,0,0,0,0,0,0,0,0,0,0,2,3,3,0
35938,6,153,1,1,1,0,0,0,1,0,0,0,0,0,0,0,0,0,0,0,0,2,3,3,0
35939,6,153,1,1,1,0,0,0,1,0,0,0,0,0,0,0,0,0,0,0,0,2,3,3,0
35940,6,153,14,10,10,0,0,4,14,1,1,1,1,2,2,0,2,0,1,0,0,2,3,3,0
35941,6,153,46,26,30,3,0,12,49,3,6,3,6,9,9,20,28,1,42,2,0,2,3,3,0
35942,6,153,127,75,83,2,11,30,129,4,14,7,14,18,21,61,87,2,175,9,0,2,10,5,0
35943,6,153,652,304,544,16,6,88,668,6,89,51,101,95,152,591,998,3,3399,188,0,2,10,5,0
35944,6,153,2,2,2,0,0,0,2,0,0,0,0,0,0,0,0,0,0,0,0,2,10,5,0
35945,6,153,8,5,5,0,0,3,8,0,0,0,0,0,0,0,0,0,0,0,0,2,10,5,0
35946,6,153,2,2,2,0,0,0,2,0,0,0,0,0,0,0,0,0,0,0,0,2,10,5,0
35947,6,153,14,8,8,0,0,6,14,0,0,0,0,0,0,0,0,0,0,0,0,2,10,5,0
35948,6,153,6,4,4,0,0,2,6,0,0,0,0,0,0,0,0,0,0,0,0,2,10,5,0
35949,6,153,6,4,4,0,0,2,6,1,2,1,2,3,3,2,4,0,2,0,0,2,10,5,0
35950,6,153,6,4,4,0,0,2,6,0,0,0,0,0,0,0,0,0,0,0,0,2,10,5,0
35951,6,153,7,5,5,0,0,2,7,0,0,0,0,0,0,0,0,0,0,0,0,2,10,5,0
35952,6,153,6,4,4,0,0,2,6,0,0,0,0,0,0,0,0,0,0,0,0,2,10,5,0
35953,6,153,10,6,6,0,0,4,10,0,0,0,0,0,0,0,0,0,0,0,0,2,10,5,0
35954,6,153,1,1,1,0,0,0,1,0,0,0,0,0,0,0,0,0,0,0,0,2,10,5,0
35955,6,153,1,1,1,0,0,0,1,0,0,0,0,0,0,0,0,0,0,0,0,2,10,5,0
35956,6,153,14,10,10,0,0,4,14,1,1,1,1,2,2,0,2,0,1,0,0,2,10,5,0
35957,6,153,46,26,30,3,0,12,49,3,6,3,6,9,9,20,28,1,42,2,0,2,10,5,0
35958,103,2661,773,422,505,30,103,129,803,14,77,46,83,91,129,535,839,7,6334,351,0,2,26,19,0
35959,38,2498,1157,318,931,29,22,177,1186,6,104,63,125,110,188,712,1274,3,4596,255,0,2,45,0,0
35960,90,2054,996,429,845,24,10,117,1020,7,76,50,88,83,138,494,879,4,3565,198,0,2,1,0,1
35961,90,2054,456,277,329,12,42,72,468,13,85,50,97,98,147,592,972,7,7212,400,0,2,1,0,1
35962,49,3737,996,429,845,24,10,117,1020,7,76,50,88,83,138,494,879,4,3565,198,0,2,20,0,1
35963,107,2805,773,422,505,30,103,129,803,14,77,46,83,91,129,535,839,7,6334,351,0,2,33,0,0
35964,2,235,149,67,118,4,0,27,153,1,17,14,28,18,42,69,175,0,144,8,0,2,30,0,0
35965,91,2069,996,429,845,24,10,117,1020,7,76,50,88,83,138,494,879,4,3565,198,0,2,8,11,0
35966,91,2069,456,277,329,12,42,72,468,13,85,50,97,98,147,592,972,7,7212,400,0,2,8,11,0
35967,49,3805,996,429,845,24,10,117,1020,7,76,50,88,83,138,494,879,4,3565,198,0,2,23,1,0
35968,91,2063,996,429,845,24,10,117,1020,7,76,50,88,83,138,494,879,4,3565,198,0,2,4,3,0
35969,91,2063,456,277,329,12,42,72,468,13,85,50,97,98,147,592,972,7,7212,400,0,2,4,3,0
35970,91,2055,996,429,845,24,10,117,1020,7,76,50,88,83,138,494,879,4,3565,198,0,2,8,12,0
35971,91,2055,456,277,329,12,42,72,468,13,85,50,97,98,147,592,972,7,7212,400,0,2,8,12,0
35972,49,3805,996,429,845,24,10,117,1020,7,76,50,88,83,138,494,879,4,3565,198,0,2,1,1,0
35973,91,2055,996,429,845,24,10,117,1020,7,76,50,88,83,138,494,879,4,3565,198,0,2,20,25,0
35974,91,2055,456,277,329,12,42,72,468,13,85,50,97,98,147,592,972,7,7212,400,0,2,20,25,0
35975,49,3805,996,429,845,24,10,117,1020,7,76,50,88,83,138,494,879,4,3565,198,0,2,42,0,0
35976,6,153,127,75,83,2,11,30,129,4,14,7,14,18,21,61,87,2,175,9,0,2,10,5,0
35977,6,153,652,304,544,16,6,88,668,6,89,51,101,95,152,591,998,3,3399,188,0,2,10,5,0
35978,6,153,2,2,2,0,0,0,2,0,0,0,0,0,0,0,0,0,0,0,0,2,10,5,0
35979,6,153,8,5,5,0,0,3,8,0,0,0,0,0,0,0,0,0,0,0,0,2,10,5,0
35980,6,153,2,2,2,0,0,0,2,0,0,0,0,0,0,0,0,0,0,0,0,2,10,5,0
35981,6,153,14,8,8,0,0,6,14,0,0,0,0,0,0,0,0,0,0,0,0,2,10,5,0
35982,6,153,6,4,4,0,0,2,6,0,0,0,0,0,0,0,0,0,0,0,0,2,10,5,0
35983,6,153,6,4,4,0,0,2,6,1,2,1,2,3,3,2,4,0,2,0,0,2,10,5,0
35984,6,153,6,4,4,0,0,2,6,0,0,0,0,0,0,0,0,0,0,0,0,2,10,5,0
35985,6,153,7,5,5,0,0,2,7,0,0,0,0,0,0,0,0,0,0,0,0,2,10,5,0
35986,6,153,6,4,4,0,0,2,6,0,0,0,0,0,0,0,0,0,0,0,0,2,10,5,0
35987,6,153,10,6,6,0,0,4,10,0,0,0,0,0,0,0,0,0,0,0,0,2,10,5,0
35988,6,153,1,1,1,0,0,0,1,0,0,0,0,0,0,0,0,0,0,0,0,2,10,5,0
35989,6,153,1,1,1,0,0,0,1,0,0,0,0,0,0,0,0,0,0,0,0,2,10,5,0
35990,6,153,14,10,10,0,0,4,14,1,1,1,1,2,2,0,2,0,1,0,0,2,10,5,0
35991,6,153,46,26,30,3,0,12,49,3,6,3,6,9,9,20,28,1,42,2,0,2,10,5,0
35992,117,3174,1523,757,1297,19,12,193,1542,12,193,117,230,205,347,1508,2664,7,19053,1058,0,2,12,0,0
35993,117,3174,701,378,504,33,58,109,734,13,110,68,126,123,194,794,1346,7,10027,557,0,2,12,0,0
35994,108,5173,1523,757,1297,19,12,193,1542,12,193,117,230,205,347,1508,2664,7,19053,1058,0,2,27,0,0
35995,57,1522,339,213,244,17,9,65,356,10,42,26,48,52,74,259,421,5,2410,133,0,2,132,120,0
35996,79,4018,1293,570,1093,25,15,163,1318,10,195,123,241,205,364,1516,2795,6,17273,959,0,2,39,10,0
35997,76,3947,1293,570,1093,25,15,163,1318,10,195,123,241,205,364,1516,2795,6,17273,959,0,2,3,3,0
35998,76,3942,1293,570,1093,25,15,163,1318,10,195,123,241,205,364,1516,2795,6,17273,959,0,2,0,1,0
35999,76,3942,1293,570,1093,25,15,163,1318,10,195,123,241,205,364,1516,2795,6,17273,959,0,2,3,4,0
36000,91,2055,996,429,845,24,10,117,1020,7,76,50,88,83,138,494,879,4,3565,198,0,2,20,25,0
36001,91,2055,456,277,329,12,42,72,468,13,85,50,97,98,147,592,972,7,7212,400,0,2,20,25,0
36002,49,3805,996,429,845,24,10,117,1020,7,76,50,88,83,138,494,879,4,3565,198,0,2,42,0,0
36003,77,3957,1293,570,1093,25,15,163,1318,10,195,123,241,205,364,1516,2795,6,17273,959,0,2,3,4,0
36004,57,1522,339,213,244,17,9,65,356,10,42,26,48,52,74,259,421,5,2410,133,0,2,132,120,0
36005,79,4018,1293,570,1093,25,15,163,1318,10,195,123,241,205,364,1516,2795,6,17273,959,0,2,39,10,0
36006,6,163,127,75,83,2,11,30,129,4,14,7,14,18,21,61,87,2,175,9,0,2,1,0,0
36007,6,163,652,304,544,16,6,88,668,6,89,51,101,95,152,591,998,3,3399,188,0,2,1,0,0
36008,6,163,2,2,2,0,0,0,2,0,0,0,0,0,0,0,0,0,0,0,0,2,1,0,0
36009,6,163,8,5,5,0,0,3,8,0,0,0,0,0,0,0,0,0,0,0,0,2,1,0,0
36010,6,163,2,2,2,0,0,0,2,0,0,0,0,0,0,0,0,0,0,0,0,2,1,0,0
36011,6,163,14,8,8,0,0,6,14,0,0,0,0,0,0,0,0,0,0,0,0,2,1,0,0
36012,6,163,6,4,4,0,0,2,6,0,0,0,0,0,0,0,0,0,0,0,0,2,1,0,0
36013,6,163,6,4,4,0,0,2,6,1,2,1,2,3,3,2,4,0,2,0,0,2,1,0,0
36014,6,163,6,4,4,0,0,2,6,0,0,0,0,0,0,0,0,0,0,0,0,2,1,0,0
36015,6,163,7,5,5,0,0,2,7,0,0,0,0,0,0,0,0,0,0,0,0,2,1,0,0
36016,6,163,6,4,4,0,0,2,6,0,0,0,0,0,0,0,0,0,0,0,0,2,1,0,0
36017,6,163,10,6,6,0,0,4,10,0,0,0,0,0,0,0,0,0,0,0,0,2,1,0,0
36018,6,163,1,1,1,0,0,0,1,0,0,0,0,0,0,0,0,0,0,0,0,2,1,0,0
36019,6,163,1,1,1,0,0,0,1,0,0,0,0,0,0,0,0,0,0,0,0,2,1,0,0
36020,6,163,14,10,10,0,0,4,14,1,1,1,1,2,2,0,2,0,1,0,0,2,1,0,0
36021,6,163,46,26,30,3,0,12,49,3,6,3,6,9,9,20,28,1,42,2,0,2,1,0,0
36022,231,5945,722,423,573,19,0,135,741,12,172,101,199,184,300,1320,2257,6,15668,870,0,2,0,9,0
36023,231,5945,1508,847,911,44,250,301,1552,14,148,88,169,162,257,1120,1886,7,15077,837,0,2,0,9,0
36024,314,6928,72,33,56,0,4,12,72,1,1,1,1,2,2,0,2,0,1,0,0,2,4,2,0
36025,314,6928,1454,835,1044,76,110,219,1530,17,275,158,296,292,454,2297,3718,9,34017,1889,1,2,4,2,0
36026,91,4008,1338,495,1086,10,64,173,1348,11,122,82,157,133,239,883,1686,7,11934,663,0,2,18,1,0
36027,231,5945,722,423,573,19,0,135,741,12,172,101,199,184,300,1320,2257,6,15668,870,0,2,0,9,0
36028,231,5945,1508,847,911,44,250,301,1552,14,148,88,169,162,257,1120,1886,7,15077,837,0,2,0,9,0
36029,6,163,127,75,83,2,11,30,129,4,14,7,14,18,21,61,87,2,175,9,0,2,1,0,0
36030,6,163,652,304,544,16,6,88,668,6,89,51,101,95,152,591,998,3,3399,188,0,2,1,0,0
36031,6,163,2,2,2,0,0,0,2,0,0,0,0,0,0,0,0,0,0,0,0,2,1,0,0
36032,6,163,8,5,5,0,0,3,8,0,0,0,0,0,0,0,0,0,0,0,0,2,1,0,0
36033,6,163,2,2,2,0,0,0,2,0,0,0,0,0,0,0,0,0,0,0,0,2,1,0,0
36034,6,163,14,8,8,0,0,6,14,0,0,0,0,0,0,0,0,0,0,0,0,2,1,0,0
36035,6,163,6,4,4,0,0,2,6,0,0,0,0,0,0,0,0,0,0,0,0,2,1,0,0
36036,6,163,6,4,4,0,0,2,6,1,2,1,2,3,3,2,4,0,2,0,0,2,1,0,0
36037,6,163,6,4,4,0,0,2,6,0,0,0,0,0,0,0,0,0,0,0,0,2,1,0,0
36038,6,163,7,5,5,0,0,2,7,0,0,0,0,0,0,0,0,0,0,0,0,2,1,0,0
36039,6,163,6,4,4,0,0,2,6,0,0,0,0,0,0,0,0,0,0,0,0,2,1,0,0
36040,6,163,10,6,6,0,0,4,10,0,0,0,0,0,0,0,0,0,0,0,0,2,1,0,0
36041,6,163,1,1,1,0,0,0,1,0,0,0,0,0,0,0,0,0,0,0,0,2,1,0,0
36042,6,163,1,1,1,0,0,0,1,0,0,0,0,0,0,0,0,0,0,0,0,2,1,0,0
36043,6,163,14,10,10,0,0,4,14,1,1,1,1,2,2,0,2,0,1,0,0,2,1,0,0
36044,6,163,46,26,30,3,0,12,49,3,6,3,6,9,9,20,28,1,42,2,0,2,1,0,0
36045,91,2055,996,429,845,24,10,117,1020,7,76,50,88,83,138,494,879,4,3565,198,0,2,20,25,0
36046,91,2055,456,277,329,12,42,72,468,13,85,50,97,98,147,592,972,7,7212,400,0,2,20,25,0
36047,49,3805,996,429,845,24,10,117,1020,7,76,50,88,83,138,494,879,4,3565,198,0,2,42,0,0
36048,78,4013,1293,570,1093,25,15,163,1318,10,195,123,241,205,364,1516,2795,6,17273,959,0,2,3,4,0
36049,231,5978,722,423,573,19,0,135,741,12,172,101,199,184,300,1320,2257,6,15668,870,0,2,7,1,1
36050,231,5978,1508,847,911,44,250,301,1552,14,148,88,169,162,257,1120,1886,7,15077,837,0,2,7,1,1
36051,56,2875,722,423,573,19,0,135,741,12,172,101,199,184,300,1320,2257,6,15668,870,0,2,23,0,1
36052,232,5970,722,423,573,19,0,135,741,12,172,101,199,184,300,1320,2257,6,15668,870,0,2,8,7,0
36053,232,5970,1508,847,911,44,250,301,1552,14,148,88,169,162,257,1120,1886,7,15077,837,0,2,8,7,0
36054,56,2883,722,423,573,19,0,135,741,12,172,101,199,184,300,1320,2257,6,15668,870,0,2,3,0,0
36055,314,6928,72,33,56,0,4,12,72,1,1,1,1,2,2,0,2,0,1,0,0,2,4,2,0
36056,314,6928,1454,835,1044,76,110,219,1530,17,275,158,296,292,454,2297,3718,9,34017,1889,1,2,4,2,0
36057,91,4008,1338,495,1086,10,64,173,1348,11,122,82,157,133,239,883,1686,7,11934,663,0,2,18,1,0
36058,232,5970,722,423,573,19,0,135,741,12,172,101,199,184,300,1320,2257,6,15668,870,0,2,13,6,0
36059,232,5970,1508,847,911,44,250,301,1552,14,148,88,169,162,257,1120,1886,7,15077,837,0,2,13,6,0
36060,56,2883,722,423,573,19,0,135,741,12,172,101,199,184,300,1320,2257,6,15668,870,0,2,26,0,0
36061,253,5855,4293,999,3693,19,54,507,4312,9,155,88,170,164,258,1156,1898,4,9368,520,0,2,26,2,1
36062,253,5855,1482,859,1002,125,135,219,1607,16,219,134,251,235,385,1766,3032,9,27804,1544,1,2,26,2,1
36063,70,1557,402,202,227,24,74,80,426,12,52,33,61,64,94,339,564,7,3969,220,0,2,10,2,1
36064,172,7635,4293,999,3693,19,54,507,4312,9,155,88,170,164,258,1156,1898,4,9368,520,0,2,43,0,1
36065,172,7635,1482,859,1002,125,135,219,1607,16,219,134,251,235,385,1766,3032,9,27804,1544,1,2,43,0,1
36066,253,5855,4293,999,3693,19,54,507,4312,9,155,88,170,164,258,1156,1898,4,9368,520,0,2,26,2,0
36067,253,5855,1482,859,1002,125,135,219,1607,16,219,134,251,235,385,1766,3032,9,27804,1544,1,2,26,2,0
36068,70,1557,402,202,227,24,74,80,426,12,52,33,61,64,94,339,564,7,3969,220,0,2,10,2,0
36069,172,7635,4293,999,3693,19,54,507,4312,9,155,88,170,164,258,1156,1898,4,9368,520,0,2,43,0,0
36070,172,7635,1482,859,1002,125,135,219,1607,16,219,134,251,235,385,1766,3032,9,27804,1544,1,2,43,0,0
36071,107,2805,773,422,505,30,103,129,803,14,77,46,83,91,129,535,839,7,6334,351,0,2,33,0,0
36072,2,235,149,67,118,4,0,27,153,1,17,14,28,18,42,69,175,0,144,8,0,2,30,0,0
36073,253,5853,4293,999,3693,19,54,507,4312,9,155,88,170,164,258,1156,1898,4,9368,520,0,2,26,2,0
36074,253,5853,1482,859,1002,125,135,219,1607,16,219,134,251,235,385,1766,3032,9,27804,1544,1,2,26,2,0
36075,70,1557,402,202,227,24,74,80,426,12,52,33,61,64,94,339,564,7,3969,220,0,2,10,2,0
36076,315,6924,72,33,56,0,4,12,72,1,1,1,1,2,2,0,2,0,1,0,0,2,4,2,0
36077,315,6924,1454,835,1044,76,110,219,1530,17,275,158,296,292,454,2297,3718,9,34017,1889,1,2,4,2,0
36078,91,4008,1338,495,1086,10,64,173,1348,11,122,82,157,133,239,883,1686,7,11934,663,0,2,18,1,0
36079,172,7635,4293,999,3693,19,54,507,4312,9,155,88,170,164,258,1156,1898,4,9368,520,0,2,43,0,0
36080,172,7635,1482,859,1002,125,135,219,1607,16,219,134,251,235,385,1766,3032,9,27804,1544,1,2,43,0,0
36081,253,5853,4293,999,3693,19,54,507,4312,9,155,88,170,164,258,1156,1898,4,9368,520,0,2,26,2,0
36082,253,5853,1482,859,1002,125,135,219,1607,16,219,134,251,235,385,1766,3032,9,27804,1544,1,2,26,2,0
36083,70,1557,402,202,227,24,74,80,426,12,52,33,61,64,94,339,564,7,3969,220,0,2,10,2,0
36084,315,6924,72,33,56,0,4,12,72,1,1,1,1,2,2,0,2,0,1,0,0,2,4,2,0
36085,315,6924,1454,835,1044,76,110,219,1530,17,275,158,296,292,454,2297,3718,9,34017,1889,1,2,4,2,0
36086,91,4008,1338,495,1086,10,64,173,1348,11,122,82,157,133,239,883,1686,7,11934,663,0,2,18,1,0
36087,172,7635,4293,999,3693,19,54,507,4312,9,155,88,170,164,258,1156,1898,4,9368,520,0,2,43,0,0
36088,172,7635,1482,859,1002,125,135,219,1607,16,219,134,251,235,385,1766,3032,9,27804,1544,1,2,43,0,0
36089,1,98,42,7,35,4,0,5,46,1,2,1,2,3,3,2,4,0,2,0,0,2,3,2,0
36090,1,98,11,6,10,0,0,1,11,2,4,2,4,6,6,10,15,1,15,0,0,2,3,2,0
36091,188,5732,1660,832,1314,41,38,274,1701,20,312,209,395,332,604,2671,5058,12,64042,3557,1,2,25,19,0
36092,188,5732,1057,646,719,113,100,145,1170,18,215,134,248,233,382,1740,3004,10,31186,1732,1,2,25,19,0
36093,73,1512,207,111,150,11,0,50,218,5,26,19,36,31,55,133,272,3,943,52,0,2,0,1,0
36094,73,1512,410,198,237,31,55,97,441,11,63,38,72,74,110,414,683,6,4293,238,0,2,0,1,0
36095,237,4939,2,2,2,0,0,0,2,0,0,0,0,0,0,0,0,0,0,0,0,2,7,14,0
36096,237,4939,99,48,90,1,3,5,100,0,0,0,0,0,0,0,0,0,0,0,0,2,7,14,0
36097,237,4939,8,5,5,2,0,1,10,0,0,0,0,0,0,0,0,0,0,0,0,2,7,14,0
36098,237,4939,1217,716,841,84,126,174,1301,14,185,118,215,199,333,1446,2542,8,20687,1149,0,2,7,14,0
36099,237,4939,160,89,115,0,13,31,160,7,15,11,17,22,28,78,124,3,495,27,0,2,7,14,0
36100,237,4939,10,10,9,9,0,0,19,0,0,0,0,0,0,0,0,0,0,0,0,2,7,14,0
36101,237,4939,173,84,99,8,29,36,181,5,12,7,13,17,20,54,81,2,221,12,0,2,7,14,0
36102,237,4939,3,1,1,3,0,0,6,0,0,0,0,0,0,0,0,0,0,0,0,2,7,14,0
36103,57,1522,339,213,244,17,9,65,356,10,42,26,48,52,74,259,421,5,2410,133,0,2,132,120,0
36104,253,5853,4293,999,3693,19,54,507,4312,9,155,88,170,164,258,1156,1898,4,9368,520,0,2,2,4,0
36105,253,5853,1482,859,1002,125,135,219,1607,16,219,134,251,235,385,1766,3032,9,27804,1544,1,2,2,4,0
36106,31,1087,74,35,59,1,0,14,75,3,14,7,14,17,21,58,85,1,128,7,0,2,28,4,0
36107,31,1087,245,125,200,5,7,34,250,7,30,17,34,37,51,166,265,3,1053,58,0,2,28,4,0
36108,117,3174,1523,757,1297,19,12,193,1542,12,193,117,230,205,347,1508,2664,7,19053,1058,0,2,12,0,0
36109,117,3174,701,378,504,33,58,109,734,13,110,68,126,123,194,794,1346,7,10027,557,0,2,12,0,0
36110,107,2805,773,422,505,30,103,129,803,14,77,46,83,91,129,535,839,7,6334,351,0,2,59,19,0
36111,19,513,205,80,86,16,53,53,221,7,18,10,19,25,29,94,134,3,497,27,0,2,8,14,0
36112,232,5970,722,423,573,19,0,135,741,12,172,101,199,184,300,1320,2257,6,15668,870,0,2,13,15,0
36113,232,5970,1508,847,911,44,250,301,1552,14,148,88,169,162,257,1120,1886,7,15077,837,0,2,13,15,0
36114,315,6924,72,33,56,0,4,12,72,1,1,1,1,2,2,0,2,0,1,0,0,2,1,2,0
36115,315,6924,1454,835,1044,76,110,219,1530,17,275,158,296,292,454,2297,3718,9,34017,1889,1,2,1,2,0
36116,282,5915,1943,715,1694,26,18,214,1969,12,185,120,237,197,357,1436,2721,7,20915,1161,0,2,1,1,0
36117,282,5915,1168,838,957,57,25,144,1225,19,348,224,416,367,640,3018,5452,11,61921,3440,1,2,1,1,0
36118,19,721,442,244,305,14,16,103,456,11,68,45,75,79,120,452,756,6,4588,254,0,2,21,21,0
36119,19,721,182,102,99,11,40,35,193,3,11,6,11,14,17,42,64,1,97,5,0,2,21,21,0
36120,106,4498,1289,550,1043,56,32,155,1345,10,167,93,185,177,278,1266,2075,5,11498,638,0,2,10,21,0
36121,6,163,127,75,83,2,11,30,129,4,14,7,14,18,21,61,87,2,175,9,0,2,1,0,0
36122,6,163,652,304,544,16,6,88,668,6,89,51,101,95,152,591,998,3,3399,188,0,2,1,0,0
36123,6,163,2,2,2,0,0,0,2,0,0,0,0,0,0,0,0,0,0,0,0,2,1,0,0
36124,6,163,8,5,5,0,0,3,8,0,0,0,0,0,0,0,0,0,0,0,0,2,1,0,0
36125,6,163,2,2,2,0,0,0,2,0,0,0,0,0,0,0,0,0,0,0,0,2,1,0,0
36126,6,163,14,8,8,0,0,6,14,0,0,0,0,0,0,0,0,0,0,0,0,2,1,0,0
36127,6,163,6,4,4,0,0,2,6,0,0,0,0,0,0,0,0,0,0,0,0,2,1,0,0
36128,6,163,6,4,4,0,0,2,6,1,2,1,2,3,3,2,4,0,2,0,0,2,1,0,0
36129,6,163,6,4,4,0,0,2,6,0,0,0,0,0,0,0,0,0,0,0,0,2,1,0,0
36130,6,163,7,5,5,0,0,2,7,0,0,0,0,0,0,0,0,0,0,0,0,2,1,0,0
36131,6,163,6,4,4,0,0,2,6,0,0,0,0,0,0,0,0,0,0,0,0,2,1,0,0
36132,6,163,10,6,6,0,0,4,10,0,0,0,0,0,0,0,0,0,0,0,0,2,1,0,0
36133,6,163,1,1,1,0,0,0,1,0,0,0,0,0,0,0,0,0,0,0,0,2,1,0,0
36134,6,163,1,1,1,0,0,0,1,0,0,0,0,0,0,0,0,0,0,0,0,2,1,0,0
36135,6,163,14,10,10,0,0,4,14,1,1,1,1,2,2,0,2,0,1,0,0,2,1,0,0
36136,6,163,46,26,30,3,0,12,49,3,6,3,6,9,9,20,28,1,42,2,0,2,1,0,0
36137,2,235,149,67,118,4,0,27,153,1,17,14,28,18,42,69,175,0,144,8,0,2,30,0,0
36138,38,2498,1157,318,931,29,22,177,1186,6,104,63,125,110,188,712,1274,3,4596,255,0,2,45,0,0
36139,129,5167,1450,624,1228,12,26,181,1462,14,306,186,354,320,540,2580,4493,8,36391,2021,1,2,24,37,0
36140,182,5438,1660,832,1314,41,38,274,1701,20,312,209,395,332,604,2671,5058,12,64042,3557,1,2,53,0,0
36141,98,5250,1457,730,1242,11,6,188,1468,10,292,166,329,302,495,2424,4078,5,22973,1276,1,2,47,74,0
36142,2,56,7,6,5,0,0,2,7,1,1,1,2,2,3,0,3,1,3,0,0,2,4,10,0
36143,108,5173,1523,757,1297,19,12,193,1542,12,193,117,230,205,347,1508,2664,7,19053,1058,0,2,27,0,0
36144,78,4013,1293,570,1093,25,15,163,1318,10,195,123,241,205,364,1516,2795,6,17273,959,0,2,59,26,0
36145,56,2883,722,423,573,19,0,135,741,12,172,101,199,184,300,1320,2257,6,15668,870,0,2,26,0,0
36146,30,1440,373,158,315,8,0,51,381,5,76,44,79,81,123,486,779,2,2026,112,0,2,1,1,0
36147,81,3172,1178,367,1042,6,15,115,1184,9,94,51,95,103,146,644,976,4,4439,246,0,2,8,0,0
36148,111,6122,1943,715,1694,26,18,214,1969,12,185,120,237,197,357,1436,2721,7,20915,1161,0,2,1,1,0
36149,71,1576,402,202,227,24,74,80,426,12,52,33,61,64,94,339,564,7,3969,220,0,2,7,3,0
36150,71,3226,1020,354,843,12,15,144,1032,8,134,77,144,142,221,970,1580,4,6792,377,0,2,22,0,0
36151,71,1576,402,202,227,24,74,80,426,12,52,33,61,64,94,339,564,7,3969,220,0,2,7,3,0
36152,71,3226,1020,354,843,12,15,144,1032,8,134,77,144,142,221,970,1580,4,6792,377,0,2,22,0,0
36153,189,5744,1660,832,1314,41,38,274,1701,20,312,209,395,332,604,2671,5058,12,64042,3557,1,2,12,4,0
36154,189,5744,1057,646,719,113,100,145,1170,18,215,134,248,233,382,1740,3004,10,31186,1732,1,2,12,4,0
36155,184,5506,1660,832,1314,41,38,274,1701,20,312,209,395,332,604,2671,5058,12,64042,3557,1,2,27,2,0
36156,189,5744,1660,832,1314,41,38,274,1701,20,312,209,395,332,604,2671,5058,12,64042,3557,1,2,12,4,0
36157,189,5744,1057,646,719,113,100,145,1170,18,215,134,248,233,382,1740,3004,10,31186,1732,1,2,12,4,0
36158,184,5506,1660,832,1314,41,38,274,1701,20,312,209,395,332,604,2671,5058,12,64042,3557,1,2,27,2,0
36159,1,94,42,7,35,4,0,5,46,1,2,1,2,3,3,2,4,0,2,0,0,2,2,4,1
36160,1,94,11,6,10,0,0,1,11,2,4,2,4,6,6,10,15,1,15,0,0,2,2,4,1
36161,221,4758,182,127,129,0,0,53,182,5,39,21,42,44,63,217,343,2,926,51,0,2,47,95,1
36162,221,4758,1165,710,800,67,119,181,1232,18,243,153,282,261,435,2000,3492,10,36473,2026,1,2,47,95,1
36163,25,514,2,2,2,0,0,0,2,0,0,0,0,0,0,0,0,0,0,0,0,2,0,4,1
36164,25,514,99,48,90,1,3,5,100,0,0,0,0,0,0,0,0,0,0,0,0,2,0,4,1
36165,25,514,8,5,5,2,0,1,10,0,0,0,0,0,0,0,0,0,0,0,0,2,0,4,1
36166,25,514,1217,716,841,84,126,174,1301,14,185,118,215,199,333,1446,2542,8,20687,1149,0,2,0,4,1
36167,25,514,160,89,115,0,13,31,160,7,15,11,17,22,28,78,124,3,495,27,0,2,0,4,1
36168,25,514,10,10,9,9,0,0,19,0,0,0,0,0,0,0,0,0,0,0,0,2,0,4,1
36169,25,514,173,84,99,8,29,36,181,5,12,7,13,17,20,54,81,2,221,12,0,2,0,4,1
36170,25,514,3,1,1,3,0,0,6,0,0,0,0,0,0,0,0,0,0,0,0,2,0,4,1
36171,174,5298,1660,832,1314,41,38,274,1701,20,312,209,395,332,604,2671,5058,12,64042,3557,1,2,9,93,1
36172,174,5298,1057,646,719,113,100,145,1170,18,215,134,248,233,382,1740,3004,10,31186,1732,1,2,9,93,1
36173,116,2173,477,336,357,30,23,73,507,16,194,134,250,210,384,1538,2962,10,30538,1696,0,2,1,1,1
36174,90,2044,996,429,845,24,10,117,1020,7,76,50,88,83,138,494,879,4,3565,198,0,2,1,2,1
36175,90,2044,456,277,329,12,42,72,468,13,85,50,97,98,147,592,972,7,7212,400,0,2,1,2,1
36176,160,3459,1513,682,1277,25,13,200,1538,11,199,116,219,210,335,1557,2584,6,15641,868,0,2,4,23,1
36177,160,3459,819,519,539,24,98,155,843,15,96,57,106,111,163,690,1107,8,9171,509,0,2,4,23,1
36178,59,1120,207,111,150,11,0,50,218,5,26,19,36,31,55,133,272,3,943,52,0,2,34,157,1
36179,59,1120,410,198,237,31,55,97,441,11,63,38,72,74,110,414,683,6,4293,238,0,2,34,157,1
36180,235,4913,2,2,2,0,0,0,2,0,0,0,0,0,0,0,0,0,0,0,0,2,3,10,1
36181,235,4913,99,48,90,1,3,5,100,0,0,0,0,0,0,0,0,0,0,0,0,2,3,10,1
36182,235,4913,8,5,5,2,0,1,10,0,0,0,0,0,0,0,0,0,0,0,0,2,3,10,1
36183,235,4913,1217,716,841,84,126,174,1301,14,185,118,215,199,333,1446,2542,8,20687,1149,0,2,3,10,1
36184,235,4913,160,89,115,0,13,31,160,7,15,11,17,22,28,78,124,3,495,27,0,2,3,10,1
36185,235,4913,10,10,9,9,0,0,19,0,0,0,0,0,0,0,0,0,0,0,0,2,3,10,1
36186,235,4913,173,84,99,8,29,36,181,5,12,7,13,17,20,54,81,2,221,12,0,2,3,10,1
36187,235,4913,3,1,1,3,0,0,6,0,0,0,0,0,0,0,0,0,0,0,0,2,3,10,1
36188,90,2308,1455,414,1257,16,76,112,1471,5,41,23,46,46,69,231,381,2,1069,59,0,2,0,27,1
36189,90,2308,669,365,481,22,61,110,691,15,103,63,122,118,185,747,1273,8,11311,628,0,2,0,27,1
36190,251,5838,4293,999,3693,19,54,507,4312,9,155,88,170,164,258,1156,1898,4,9368,520,0,2,1,5,1
36191,251,5838,1482,859,1002,125,135,219,1607,16,219,134,251,235,385,1766,3032,9,27804,1544,1,2,1,5,1
36192,117,3160,1523,757,1297,19,12,193,1542,12,193,117,230,205,347,1508,2664,7,19053,1058,0,2,0,4,1
36193,117,3160,701,378,504,33,58,109,734,13,110,68,126,123,194,794,1346,7,10027,557,0,2,0,4,1
36194,105,2779,773,422,505,30,103,129,803,14,77,46,83,91,129,535,839,7,6334,351,0,2,2,8,1
36195,149,3603,77,34,69,0,0,8,77,3,24,16,29,27,45,114,213,1,387,21,0,2,5,56,1
36196,149,3603,712,438,573,51,9,84,763,14,102,71,128,116,199,733,1364,8,11988,666,0,2,5,56,1
36197,71,1576,402,202,227,24,74,80,426,12,52,33,61,64,94,339,564,7,3969,220,0,2,2,2,1
36198,51,1113,447,308,343,6,5,95,453,7,96,59,111,103,170,651,1136,4,4600,255,0,2,2,14,1
36199,51,1113,322,174,179,16,74,51,338,10,41,26,46,51,72,252,408,5,2291,127,0,2,2,14,1
36200,15,490,184,100,137,2,15,30,186,6,38,20,39,44,59,214,322,3,991,55,0,2,3,12,1
36201,15,490,103,65,74,8,5,16,111,7,17,9,17,24,26,89,119,3,417,23,0,2,3,12,1
36202,58,1203,91,45,69,0,3,18,91,3,9,6,10,12,16,33,57,1,95,5,0,2,3,16,1
36203,58,1203,367,234,237,17,34,68,384,16,55,34,61,71,95,381,584,8,5183,287,0,2,3,16,1
36204,228,5903,722,423,573,19,0,135,741,12,172,101,199,184,300,1320,2257,6,15668,870,0,2,3,18,1
36205,228,5903,1508,847,911,44,250,301,1552,14,148,88,169,162,257,1120,1886,7,15077,837,0,2,3,18,1
36206,315,6914,72,33,56,0,4,12,72,1,1,1,1,2,2,0,2,0,1,0,0,2,2,3,1
36207,315,6914,1454,835,1044,76,110,219,1530,17,275,158,296,292,454,2297,3718,9,34017,1889,1,2,2,3,1
36208,89,1819,757,253,292,73,244,162,830,13,61,38,67,74,105,409,651,7,4654,258,0,2,4,15,1
36209,38,814,386,256,301,16,9,68,402,4,59,35,69,63,104,355,621,2,1453,80,0,2,1,34,1
36210,38,814,264,131,164,11,41,46,275,6,38,22,40,44,62,214,338,3,1068,59,0,2,1,34,1
36211,40,796,1178,367,1042,6,15,115,1184,9,94,51,95,103,146,644,976,4,4439,246,0,2,2,6,1
36212,40,796,177,108,140,8,0,27,185,6,30,16,32,36,48,162,248,3,794,44,0,2,2,6,1
36213,280,5888,1943,715,1694,26,18,214,1969,12,185,120,237,197,357,1436,2721,7,20915,1161,0,2,0,15,1
36214,280,5888,1168,838,957,57,25,144,1225,19,348,224,416,367,640,3018,5452,11,61921,3440,1,2,0,15,1
36215,19,717,442,244,305,14,16,103,456,11,68,45,75,79,120,452,756,6,4588,254,0,2,1,4,1
36216,19,717,182,102,99,11,40,35,193,3,11,6,11,14,17,42,64,1,97,5,0,2,1,4,1
36217,65,1263,1098,241,925,5,10,155,1103,7,46,25,49,53,74,273,423,3,1580,87,0,2,1,20,1
36218,65,1263,282,202,222,14,2,44,296,8,42,24,43,50,67,250,378,4,1548,86,0,2,1,20,1
36219,23,642,601,196,481,2,23,85,603,8,63,36,72,71,108,400,664,4,3036,168,0,2,1,22,1
36220,23,642,156,79,106,5,16,28,161,5,14,8,15,19,23,64,97,2,261,14,0,2,1,22,1
36221,104,4436,1289,550,1043,56,32,155,1345,10,167,93,185,177,278,1266,2075,5,11498,638,0,2,2,12,1
36222,31,994,182,127,129,0,0,53,182,5,39,21,42,44,63,217,343,2,926,51,0,2,6,27,1
36223,151,7251,1392,870,1177,35,17,170,1427,14,494,280,531,508,811,4473,7289,7,54850,3047,2,2,12,25,1
36224,95,2896,773,419,590,28,0,166,801,10,204,113,217,214,330,1598,2554,5,13587,754,0,2,1,3,1
36225,2,58,16,12,9,0,0,6,16,1,2,1,2,3,3,2,4,0,2,0,0,2,1,5,1
36226,65,4378,520,294,400,33,13,81,553,10,261,204,367,271,571,2128,4614,7,32445,1802,1,2,1,2,1
36227,90,3988,1338,495,1086,10,64,173,1348,11,122,82,157,133,239,883,1686,7,11934,663,0,2,0,2,1
36228,144,5933,1782,648,1425,9,47,279,1791,8,171,97,189,179,286,1292,2140,4,9462,525,0,2,0,2,1
36229,32,982,256,139,192,9,7,47,265,4,23,12,24,27,36,112,171,2,357,19,0,2,4,15,1
36230,19,517,102,59,69,5,3,24,107,6,22,15,28,28,43,113,206,3,789,43,0,2,1,13,1
36231,119,4920,1450,624,1228,12,26,181,1462,14,306,186,354,320,540,2580,4493,8,36391,2021,1,2,4,64,1
36232,176,5162,1660,832,1314,41,38,274,1701,20,312,209,395,332,604,2671,5058,12,64042,3557,1,2,7,91,1
36233,120,5123,1513,682,1277,25,13,200,1538,11,199,116,219,210,335,1557,2584,6,15641,868,0,2,7,66,1
36234,84,4916,1296,573,1062,40,33,157,1336,8,201,118,231,209,349,1561,2689,4,12365,686,0,2,0,2,1
36235,20,467,207,111,150,11,0,50,218,5,26,19,36,31,55,133,272,3,943,52,0,2,0,7,1
36236,98,5241,1457,730,1242,11,6,188,1468,10,292,166,329,302,495,2424,4078,5,22973,1276,1,2,0,3,1
36237,72,3266,1455,414,1257,16,76,112,1471,5,41,23,46,46,69,231,381,2,1069,59,0,2,3,7,1
36238,107,5160,1523,757,1297,19,12,193,1542,12,193,117,230,205,347,1508,2664,7,19053,1058,0,2,1,3,1
36239,70,3204,1020,354,843,12,15,144,1032,8,134,77,144,142,221,970,1580,4,6792,377,0,2,2,11,1
36240,44,2058,447,308,343,6,5,95,453,7,96,59,111,103,170,651,1136,4,4600,255,0,2,2,22,1
36241,9,444,184,100,137,2,15,30,186,6,38,20,39,44,59,214,322,3,991,55,0,2,4,14,1
36242,75,3960,1293,570,1093,25,15,163,1318,10,195,123,241,205,364,1516,2795,6,17273,959,0,2,5,19,1
36243,85,3387,1043,504,840,53,9,147,1096,9,180,112,198,189,310,1377,2344,4,11604,644,0,2,1,4,1
36244,79,3101,1178,367,1042,6,15,115,1184,9,94,51,95,103,146,644,976,4,4439,246,0,2,1,20,1
36245,35,1497,442,244,305,14,16,103,456,11,68,45,75,79,120,452,756,6,4588,254,0,2,0,3,1
36246,48,1943,1098,241,925,5,10,155,1103,7,46,25,49,53,74,273,423,3,1580,87,0,2,4,14,1
36247,48,1649,601,196,481,2,23,85,603,8,63,36,72,71,108,400,664,4,3036,168,0,2,0,95,1
36248,1,94,42,7,35,4,0,5,46,1,2,1,2,3,3,2,4,0,2,0,0,2,2,4,0
36249,1,94,11,6,10,0,0,1,11,2,4,2,4,6,6,10,15,1,15,0,0,2,2,4,0
36250,221,4758,182,127,129,0,0,53,182,5,39,21,42,44,63,217,343,2,926,51,0,2,47,95,0
36251,221,4758,1165,710,800,67,119,181,1232,18,243,153,282,261,435,2000,3492,10,36473,2026,1,2,47,95,0
36252,25,514,2,2,2,0,0,0,2,0,0,0,0,0,0,0,0,0,0,0,0,2,0,4,0
36253,25,514,99,48,90,1,3,5,100,0,0,0,0,0,0,0,0,0,0,0,0,2,0,4,0
36254,25,514,8,5,5,2,0,1,10,0,0,0,0,0,0,0,0,0,0,0,0,2,0,4,0
36255,25,514,1217,716,841,84,126,174,1301,14,185,118,215,199,333,1446,2542,8,20687,1149,0,2,0,4,0
36256,25,514,160,89,115,0,13,31,160,7,15,11,17,22,28,78,124,3,495,27,0,2,0,4,0
36257,25,514,10,10,9,9,0,0,19,0,0,0,0,0,0,0,0,0,0,0,0,2,0,4,0
36258,25,514,173,84,99,8,29,36,181,5,12,7,13,17,20,54,81,2,221,12,0,2,0,4,0
36259,25,514,3,1,1,3,0,0,6,0,0,0,0,0,0,0,0,0,0,0,0,2,0,4,0
36260,174,5298,1660,832,1314,41,38,274,1701,20,312,209,395,332,604,2671,5058,12,64042,3557,1,2,9,93,0
36261,174,5298,1057,646,719,113,100,145,1170,18,215,134,248,233,382,1740,3004,10,31186,1732,1,2,9,93,0
36262,116,2173,477,336,357,30,23,73,507,16,194,134,250,210,384,1538,2962,10,30538,1696,0,2,1,1,0
36263,90,2044,996,429,845,24,10,117,1020,7,76,50,88,83,138,494,879,4,3565,198,0,2,1,2,0
36264,90,2044,456,277,329,12,42,72,468,13,85,50,97,98,147,592,972,7,7212,400,0,2,1,2,0
36265,160,3459,1513,682,1277,25,13,200,1538,11,199,116,219,210,335,1557,2584,6,15641,868,0,2,4,23,0
36266,160,3459,819,519,539,24,98,155,843,15,96,57,106,111,163,690,1107,8,9171,509,0,2,4,23,0
36267,59,1120,207,111,150,11,0,50,218,5,26,19,36,31,55,133,272,3,943,52,0,2,34,157,0
36268,59,1120,410,198,237,31,55,97,441,11,63,38,72,74,110,414,683,6,4293,238,0,2,34,157,0
36269,235,4913,2,2,2,0,0,0,2,0,0,0,0,0,0,0,0,0,0,0,0,2,3,10,0
36270,235,4913,99,48,90,1,3,5,100,0,0,0,0,0,0,0,0,0,0,0,0,2,3,10,0
36271,235,4913,8,5,5,2,0,1,10,0,0,0,0,0,0,0,0,0,0,0,0,2,3,10,0
36272,235,4913,1217,716,841,84,126,174,1301,14,185,118,215,199,333,1446,2542,8,20687,1149,0,2,3,10,0
36273,235,4913,160,89,115,0,13,31,160,7,15,11,17,22,28,78,124,3,495,27,0,2,3,10,0
36274,235,4913,10,10,9,9,0,0,19,0,0,0,0,0,0,0,0,0,0,0,0,2,3,10,0
36275,235,4913,173,84,99,8,29,36,181,5,12,7,13,17,20,54,81,2,221,12,0,2,3,10,0
36276,235,4913,3,1,1,3,0,0,6,0,0,0,0,0,0,0,0,0,0,0,0,2,3,10,0
36277,90,2308,1455,414,1257,16,76,112,1471,5,41,23,46,46,69,231,381,2,1069,59,0,2,0,27,0
36278,90,2308,669,365,481,22,61,110,691,15,103,63,122,118,185,747,1273,8,11311,628,0,2,0,27,0
36279,251,5838,4293,999,3693,19,54,507,4312,9,155,88,170,164,258,1156,1898,4,9368,520,0,2,1,5,0
36280,251,5838,1482,859,1002,125,135,219,1607,16,219,134,251,235,385,1766,3032,9,27804,1544,1,2,1,5,0
36281,117,3160,1523,757,1297,19,12,193,1542,12,193,117,230,205,347,1508,2664,7,19053,1058,0,2,0,4,0
36282,117,3160,701,378,504,33,58,109,734,13,110,68,126,123,194,794,1346,7,10027,557,0,2,0,4,0
36283,105,2779,773,422,505,30,103,129,803,14,77,46,83,91,129,535,839,7,6334,351,0,2,2,8,0
36284,149,3603,77,34,69,0,0,8,77,3,24,16,29,27,45,114,213,1,387,21,0,2,5,56,0
36285,149,3603,712,438,573,51,9,84,763,14,102,71,128,116,199,733,1364,8,11988,666,0,2,5,56,0
36286,71,1576,402,202,227,24,74,80,426,12,52,33,61,64,94,339,564,7,3969,220,0,2,2,2,0
36287,51,1113,447,308,343,6,5,95,453,7,96,59,111,103,170,651,1136,4,4600,255,0,2,2,14,0
36288,51,1113,322,174,179,16,74,51,338,10,41,26,46,51,72,252,408,5,2291,127,0,2,2,14,0
36289,15,490,184,100,137,2,15,30,186,6,38,20,39,44,59,214,322,3,991,55,0,2,3,12,0
36290,15,490,103,65,74,8,5,16,111,7,17,9,17,24,26,89,119,3,417,23,0,2,3,12,0
36291,58,1203,91,45,69,0,3,18,91,3,9,6,10,12,16,33,57,1,95,5,0,2,3,16,0
36292,58,1203,367,234,237,17,34,68,384,16,55,34,61,71,95,381,584,8,5183,287,0,2,3,16,0
36293,228,5903,722,423,573,19,0,135,741,12,172,101,199,184,300,1320,2257,6,15668,870,0,2,3,18,0
36294,228,5903,1508,847,911,44,250,301,1552,14,148,88,169,162,257,1120,1886,7,15077,837,0,2,3,18,0
36295,315,6914,72,33,56,0,4,12,72,1,1,1,1,2,2,0,2,0,1,0,0,2,2,3,0
36296,315,6914,1454,835,1044,76,110,219,1530,17,275,158,296,292,454,2297,3718,9,34017,1889,1,2,2,3,0
36297,89,1819,757,253,292,73,244,162,830,13,61,38,67,74,105,409,651,7,4654,258,0,2,4,15,0
36298,38,814,386,256,301,16,9,68,402,4,59,35,69,63,104,355,621,2,1453,80,0,2,1,34,0
36299,38,814,264,131,164,11,41,46,275,6,38,22,40,44,62,214,338,3,1068,59,0,2,1,34,0
36300,40,796,1178,367,1042,6,15,115,1184,9,94,51,95,103,146,644,976,4,4439,246,0,2,2,6,0
36301,40,796,177,108,140,8,0,27,185,6,30,16,32,36,48,162,248,3,794,44,0,2,2,6,0
36302,280,5888,1943,715,1694,26,18,214,1969,12,185,120,237,197,357,1436,2721,7,20915,1161,0,2,0,15,0
36303,280,5888,1168,838,957,57,25,144,1225,19,348,224,416,367,640,3018,5452,11,61921,3440,1,2,0,15,0
36304,19,717,442,244,305,14,16,103,456,11,68,45,75,79,120,452,756,6,4588,254,0,2,1,4,0
36305,19,717,182,102,99,11,40,35,193,3,11,6,11,14,17,42,64,1,97,5,0,2,1,4,0
36306,65,1263,1098,241,925,5,10,155,1103,7,46,25,49,53,74,273,423,3,1580,87,0,2,1,20,0
36307,65,1263,282,202,222,14,2,44,296,8,42,24,43,50,67,250,378,4,1548,86,0,2,1,20,0
36308,23,642,601,196,481,2,23,85,603,8,63,36,72,71,108,400,664,4,3036,168,0,2,1,22,0
36309,23,642,156,79,106,5,16,28,161,5,14,8,15,19,23,64,97,2,261,14,0,2,1,22,0
36310,104,4436,1289,550,1043,56,32,155,1345,10,167,93,185,177,278,1266,2075,5,11498,638,0,2,2,12,0
36311,31,994,182,127,129,0,0,53,182,5,39,21,42,44,63,217,343,2,926,51,0,2,6,27,0
36312,151,7251,1392,870,1177,35,17,170,1427,14,494,280,531,508,811,4473,7289,7,54850,3047,2,2,12,25,0
36313,95,2896,773,419,590,28,0,166,801,10,204,113,217,214,330,1598,2554,5,13587,754,0,2,1,3,0
36314,2,58,16,12,9,0,0,6,16,1,2,1,2,3,3,2,4,0,2,0,0,2,1,5,0
36315,65,4378,520,294,400,33,13,81,553,10,261,204,367,271,571,2128,4614,7,32445,1802,1,2,1,2,0
36316,90,3988,1338,495,1086,10,64,173,1348,11,122,82,157,133,239,883,1686,7,11934,663,0,2,0,2,0
36317,144,5933,1782,648,1425,9,47,279,1791,8,171,97,189,179,286,1292,2140,4,9462,525,0,2,0,2,0
36318,32,982,256,139,192,9,7,47,265,4,23,12,24,27,36,112,171,2,357,19,0,2,4,15,0
36319,19,517,102,59,69,5,3,24,107,6,22,15,28,28,43,113,206,3,789,43,0,2,1,13,0
36320,119,4920,1450,624,1228,12,26,181,1462,14,306,186,354,320,540,2580,4493,8,36391,2021,1,2,4,64,0
36321,176,5162,1660,832,1314,41,38,274,1701,20,312,209,395,332,604,2671,5058,12,64042,3557,1,2,7,91,0
36322,120,5123,1513,682,1277,25,13,200,1538,11,199,116,219,210,335,1557,2584,6,15641,868,0,2,7,66,0
36323,84,4916,1296,573,1062,40,33,157,1336,8,201,118,231,209,349,1561,2689,4,12365,686,0,2,0,2,0
36324,20,467,207,111,150,11,0,50,218,5,26,19,36,31,55,133,272,3,943,52,0,2,0,7,0
36325,98,5241,1457,730,1242,11,6,188,1468,10,292,166,329,302,495,2424,4078,5,22973,1276,1,2,0,3,0
36326,72,3266,1455,414,1257,16,76,112,1471,5,41,23,46,46,69,231,381,2,1069,59,0,2,3,7,0
36327,107,5160,1523,757,1297,19,12,193,1542,12,193,117,230,205,347,1508,2664,7,19053,1058,0,2,1,3,0
36328,70,3204,1020,354,843,12,15,144,1032,8,134,77,144,142,221,970,1580,4,6792,377,0,2,2,11,0
36329,44,2058,447,308,343,6,5,95,453,7,96,59,111,103,170,651,1136,4,4600,255,0,2,2,22,0
36330,9,444,184,100,137,2,15,30,186,6,38,20,39,44,59,214,322,3,991,55,0,2,4,14,0
36331,75,3960,1293,570,1093,25,15,163,1318,10,195,123,241,205,364,1516,2795,6,17273,959,0,2,5,19,0
36332,85,3387,1043,504,840,53,9,147,1096,9,180,112,198,189,310,1377,2344,4,11604,644,0,2,1,4,0
36333,79,3101,1178,367,1042,6,15,115,1184,9,94,51,95,103,146,644,976,4,4439,246,0,2,1,20,0
36334,35,1497,442,244,305,14,16,103,456,11,68,45,75,79,120,452,756,6,4588,254,0,2,0,3,0
36335,48,1943,1098,241,925,5,10,155,1103,7,46,25,49,53,74,273,423,3,1580,87,0,2,4,14,0
36336,48,1649,601,196,481,2,23,85,603,8,63,36,72,71,108,400,664,4,3036,168,0,2,0,95,0
36337,7,296,72,33,56,0,4,12,72,1,1,1,1,2,2,0,2,0,1,0,0,2,1,1,0
36338,7,296,72,33,56,0,4,12,72,1,1,1,1,2,2,0,2,0,1,0,0,2,1,1,0
36339,105,2779,773,422,505,30,103,129,803,14,77,46,83,91,129,535,839,7,6334,351,0,2,1,1,0
36340,3,330,149,67,118,4,0,27,153,1,17,14,28,18,42,69,175,0,144,8,0,2,25,0,0
36341,105,2779,773,422,505,30,103,129,803,14,77,46,83,91,129,535,839,7,6334,351,0,2,1,1,0
36342,3,330,149,67,118,4,0,27,153,1,17,14,28,18,42,69,175,0,144,8,0,2,25,0,0
36343,3,42,14,8,8,0,0,6,14,0,0,0,0,0,0,0,0,0,0,0,0,2,0,1,0
36344,2,40,9,6,6,0,0,3,9,0,0,0,0,0,0,0,0,0,0,0,0,2,0,1,0
36345,2,40,13,9,8,0,0,4,13,0,0,0,0,0,0,0,0,0,0,0,0,2,0,1,0
36346,1,323,382,65,130,157,2,92,539,4,10,5,10,14,15,41,57,2,114,6,0,2,0,1,0
36347,60,1163,282,196,195,3,0,86,285,8,130,71,141,138,212,936,1507,4,6538,363,0,2,0,1,0
36348,4,77,127,75,83,2,11,30,129,4,14,7,14,18,21,61,87,2,175,9,0,2,0,1,0
36349,4,77,652,304,544,16,6,88,668,6,89,51,101,95,152,591,998,3,3399,188,0,2,0,1,0
36350,4,77,2,2,2,0,0,0,2,0,0,0,0,0,0,0,0,0,0,0,0,2,0,1,0
36351,4,77,8,5,5,0,0,3,8,0,0,0,0,0,0,0,0,0,0,0,0,2,0,1,0
36352,4,77,2,2,2,0,0,0,2,0,0,0,0,0,0,0,0,0,0,0,0,2,0,1,0
36353,4,77,14,8,8,0,0,6,14,0,0,0,0,0,0,0,0,0,0,0,0,2,0,1,0
36354,4,77,6,4,4,0,0,2,6,0,0,0,0,0,0,0,0,0,0,0,0,2,0,1,0
36355,4,77,6,4,4,0,0,2,6,1,2,1,2,3,3,2,4,0,2,0,0,2,0,1,0
36356,4,77,6,4,4,0,0,2,6,0,0,0,0,0,0,0,0,0,0,0,0,2,0,1,0
36357,4,77,7,5,5,0,0,2,7,0,0,0,0,0,0,0,0,0,0,0,0,2,0,1,0
36358,4,77,6,4,4,0,0,2,6,0,0,0,0,0,0,0,0,0,0,0,0,2,0,1,0
36359,4,77,10,6,6,0,0,4,10,0,0,0,0,0,0,0,0,0,0,0,0,2,0,1,0
36360,4,77,1,1,1,0,0,0,1,0,0,0,0,0,0,0,0,0,0,0,0,2,0,1,0
36361,4,77,1,1,1,0,0,0,1,0,0,0,0,0,0,0,0,0,0,0,0,2,0,1,0
36362,4,77,14,10,10,0,0,4,14,1,1,1,1,2,2,0,2,0,1,0,0,2,0,1,0
36363,4,77,46,26,30,3,0,12,49,3,6,3,6,9,9,20,28,1,42,2,0,2,0,1,0
36364,1,9,5,3,3,0,0,2,5,0,0,0,0,0,0,0,0,0,0,0,0,2,0,1,0
36365,1,90,13,10,10,0,0,3,13,1,2,1,2,3,3,2,4,0,2,0,0,2,0,1,0
36366,7,114,44,19,17,0,16,11,44,3,14,7,14,17,21,58,85,1,128,7,0,2,0,1,0
36367,3,66,127,75,83,2,11,30,129,4,14,7,14,18,21,61,87,2,175,9,0,2,0,1,0
36368,3,66,652,304,544,16,6,88,668,6,89,51,101,95,152,591,998,3,3399,188,0,2,0,1,0
36369,3,66,2,2,2,0,0,0,2,0,0,0,0,0,0,0,0,0,0,0,0,2,0,1,0
36370,3,66,8,5,5,0,0,3,8,0,0,0,0,0,0,0,0,0,0,0,0,2,0,1,0
36371,3,66,2,2,2,0,0,0,2,0,0,0,0,0,0,0,0,0,0,0,0,2,0,1,0
36372,3,66,14,8,8,0,0,6,14,0,0,0,0,0,0,0,0,0,0,0,0,2,0,1,0
36373,3,66,6,4,4,0,0,2,6,0,0,0,0,0,0,0,0,0,0,0,0,2,0,1,0
36374,3,66,6,4,4,0,0,2,6,1,2,1,2,3,3,2,4,0,2,0,0,2,0,1,0
36375,3,66,6,4,4,0,0,2,6,0,0,0,0,0,0,0,0,0,0,0,0,2,0,1,0
36376,3,66,7,5,5,0,0,2,7,0,0,0,0,0,0,0,0,0,0,0,0,2,0,1,0
36377,3,66,6,4,4,0,0,2,6,0,0,0,0,0,0,0,0,0,0,0,0,2,0,1,0
36378,3,66,10,6,6,0,0,4,10,0,0,0,0,0,0,0,0,0,0,0,0,2,0,1,0
36379,3,66,1,1,1,0,0,0,1,0,0,0,0,0,0,0,0,0,0,0,0,2,0,1,0
36380,3,66,1,1,1,0,0,0,1,0,0,0,0,0,0,0,0,0,0,0,0,2,0,1,0
36381,3,66,14,10,10,0,0,4,14,1,1,1,1,2,2,0,2,0,1,0,0,2,0,1,0
36382,3,66,46,26,30,3,0,12,49,3,6,3,6,9,9,20,28,1,42,2,0,2,0,1,0
36383,7,296,72,33,56,0,4,12,72,1,1,1,1,2,2,0,2,0,1,0,0,2,0,1,0
36384,12,229,127,75,83,2,11,30,129,4,14,7,14,18,21,61,87,2,175,9,0,2,0,1,0
36385,12,229,652,304,544,16,6,88,668,6,89,51,101,95,152,591,998,3,3399,188,0,2,0,1,0
36386,12,229,2,2,2,0,0,0,2,0,0,0,0,0,0,0,0,0,0,0,0,2,0,1,0
36387,12,229,8,5,5,0,0,3,8,0,0,0,0,0,0,0,0,0,0,0,0,2,0,1,0
36388,12,229,2,2,2,0,0,0,2,0,0,0,0,0,0,0,0,0,0,0,0,2,0,1,0
36389,12,229,14,8,8,0,0,6,14,0,0,0,0,0,0,0,0,0,0,0,0,2,0,1,0
36390,12,229,6,4,4,0,0,2,6,0,0,0,0,0,0,0,0,0,0,0,0,2,0,1,0
36391,12,229,6,4,4,0,0,2,6,1,2,1,2,3,3,2,4,0,2,0,0,2,0,1,0
36392,12,229,6,4,4,0,0,2,6,0,0,0,0,0,0,0,0,0,0,0,0,2,0,1,0
36393,12,229,7,5,5,0,0,2,7,0,0,0,0,0,0,0,0,0,0,0,0,2,0,1,0
36394,12,229,6,4,4,0,0,2,6,0,0,0,0,0,0,0,0,0,0,0,0,2,0,1,0
36395,12,229,10,6,6,0,0,4,10,0,0,0,0,0,0,0,0,0,0,0,0,2,0,1,0
36396,12,229,1,1,1,0,0,0,1,0,0,0,0,0,0,0,0,0,0,0,0,2,0,1,0
36397,12,229,1,1,1,0,0,0,1,0,0,0,0,0,0,0,0,0,0,0,0,2,0,1,0
36398,12,229,14,10,10,0,0,4,14,1,1,1,1,2,2,0,2,0,1,0,0,2,0,1,0
36399,12,229,46,26,30,3,0,12,49,3,6,3,6,9,9,20,28,1,42,2,0,2,0,1,0
36400,6,71,127,75,83,2,11,30,129,4,14,7,14,18,21,61,87,2,175,9,0,2,0,1,0
36401,6,71,652,304,544,16,6,88,668,6,89,51,101,95,152,591,998,3,3399,188,0,2,0,1,0
36402,6,71,2,2,2,0,0,0,2,0,0,0,0,0,0,0,0,0,0,0,0,2,0,1,0
36403,6,71,8,5,5,0,0,3,8,0,0,0,0,0,0,0,0,0,0,0,0,2,0,1,0
36404,6,71,2,2,2,0,0,0,2,0,0,0,0,0,0,0,0,0,0,0,0,2,0,1,0
36405,6,71,14,8,8,0,0,6,14,0,0,0,0,0,0,0,0,0,0,0,0,2,0,1,0
36406,6,71,6,4,4,0,0,2,6,0,0,0,0,0,0,0,0,0,0,0,0,2,0,1,0
36407,6,71,6,4,4,0,0,2,6,1,2,1,2,3,3,2,4,0,2,0,0,2,0,1,0
36408,6,71,6,4,4,0,0,2,6,0,0,0,0,0,0,0,0,0,0,0,0,2,0,1,0
36409,6,71,7,5,5,0,0,2,7,0,0,0,0,0,0,0,0,0,0,0,0,2,0,1,0
36410,6,71,6,4,4,0,0,2,6,0,0,0,0,0,0,0,0,0,0,0,0,2,0,1,0
36411,6,71,10,6,6,0,0,4,10,0,0,0,0,0,0,0,0,0,0,0,0,2,0,1,0
36412,6,71,1,1,1,0,0,0,1,0,0,0,0,0,0,0,0,0,0,0,0,2,0,1,0
36413,6,71,1,1,1,0,0,0,1,0,0,0,0,0,0,0,0,0,0,0,0,2,0,1,0
36414,6,71,14,10,10,0,0,4,14,1,1,1,1,2,2,0,2,0,1,0,0,2,0,1,0
36415,6,71,46,26,30,3,0,12,49,3,6,3,6,9,9,20,28,1,42,2,0,2,0,1,0
36416,3,26,14,7,7,2,0,5,16,0,0,0,0,0,0,0,0,0,0,0,0,2,0,1,0
36417,7,103,38,23,23,0,0,15,38,0,0,0,0,0,0,0,0,0,0,0,0,2,0,1,0
36418,17,378,85,59,61,8,0,16,93,5,18,10,18,23,28,86,126,2,316,17,0,2,0,1,0
36419,12,515,124,78,88,2,3,26,126,4,13,7,13,17,20,56,81,2,163,9,0,2,0,1,0
36420,1,94,42,7,35,4,0,5,46,1,2,1,2,3,3,2,4,0,2,0,0,2,0,1,0
36421,1,94,11,6,10,0,0,1,11,2,4,2,4,6,6,10,15,1,15,0,0,2,0,1,0
36422,11,242,19,8,11,5,0,4,24,2,5,3,6,7,9,13,25,1,30,1,0,2,0,1,0
36423,11,242,102,59,69,5,3,24,107,6,22,15,28,28,43,113,206,3,789,43,0,2,0,1,0
36424,11,242,106,40,36,3,49,17,109,8,17,13,23,25,36,93,167,5,904,50,0,2,0,1,0
36425,221,4758,182,127,129,0,0,53,182,5,39,21,42,44,63,217,343,2,926,51,0,2,0,1,0
36426,221,4758,1165,710,800,67,119,181,1232,18,243,153,282,261,435,2000,3492,10,36473,2026,1,2,0,1,0
36427,67,1570,773,419,590,28,0,166,801,10,204,113,217,214,330,1598,2554,5,13587,754,0,2,0,1,0
36428,67,1570,421,273,302,44,34,57,465,17,81,59,107,98,166,583,1098,11,12329,684,0,2,0,1,0
36429,14,411,149,95,105,2,0,41,151,8,54,28,55,62,83,334,494,4,2013,111,0,2,0,1,0
36430,14,411,82,56,54,0,13,15,82,4,13,8,16,17,24,56,98,2,241,13,0,2,0,1,0
36431,25,514,2,2,2,0,0,0,2,0,0,0,0,0,0,0,0,0,0,0,0,2,0,1,0
36432,25,514,99,48,90,1,3,5,100,0,0,0,0,0,0,0,0,0,0,0,0,2,0,1,0
36433,25,514,8,5,5,2,0,1,10,0,0,0,0,0,0,0,0,0,0,0,0,2,0,1,0
36434,25,514,1217,716,841,84,126,174,1301,14,185,118,215,199,333,1446,2542,8,20687,1149,0,2,0,1,0
36435,25,514,160,89,115,0,13,31,160,7,15,11,17,22,28,78,124,3,495,27,0,2,0,1,0
36436,25,514,10,10,9,9,0,0,19,0,0,0,0,0,0,0,0,0,0,0,0,2,0,1,0
36437,25,514,173,84,99,8,29,36,181,5,12,7,13,17,20,54,81,2,221,12,0,2,0,1,0
36438,25,514,3,1,1,3,0,0,6,0,0,0,0,0,0,0,0,0,0,0,0,2,0,1,0
36439,174,5298,1660,832,1314,41,38,274,1701,20,312,209,395,332,604,2671,5058,12,64042,3557,1,2,0,1,0
36440,174,5298,1057,646,719,113,100,145,1170,18,215,134,248,233,382,1740,3004,10,31186,1732,1,2,0,1,0
36441,17,348,95,58,50,9,16,20,104,12,33,24,45,45,69,209,378,8,3100,172,0,2,0,1,0
36442,116,2173,477,336,357,30,23,73,507,16,194,134,250,210,384,1538,2962,10,30538,1696,0,2,0,1,0
36443,90,2044,996,429,845,24,10,117,1020,7,76,50,88,83,138,494,879,4,3565,198,0,2,0,1,0
36444,90,2044,456,277,329,12,42,72,468,13,85,50,97,98,147,592,972,7,7212,400,0,2,0,1,0
36445,160,3459,1513,682,1277,25,13,200,1538,11,199,116,219,210,335,1557,2584,6,15641,868,0,2,0,1,0
36446,160,3459,819,519,539,24,98,155,843,15,96,57,106,111,163,690,1107,8,9171,509,0,2,0,1,0
36447,59,1120,207,111,150,11,0,50,218,5,26,19,36,31,55,133,272,3,943,52,0,2,0,1,0
36448,59,1120,410,198,237,31,55,97,441,11,63,38,72,74,110,414,683,6,4293,238,0,2,0,1,0
36449,235,4913,2,2,2,0,0,0,2,0,0,0,0,0,0,0,0,0,0,0,0,2,0,1,0
36450,235,4913,99,48,90,1,3,5,100,0,0,0,0,0,0,0,0,0,0,0,0,2,0,1,0
36451,235,4913,8,5,5,2,0,1,10,0,0,0,0,0,0,0,0,0,0,0,0,2,0,1,0
36452,235,4913,1217,716,841,84,126,174,1301,14,185,118,215,199,333,1446,2542,8,20687,1149,0,2,0,1,0
36453,235,4913,160,89,115,0,13,31,160,7,15,11,17,22,28,78,124,3,495,27,0,2,0,1,0
36454,235,4913,10,10,9,9,0,0,19,0,0,0,0,0,0,0,0,0,0,0,0,2,0,1,0
36455,235,4913,173,84,99,8,29,36,181,5,12,7,13,17,20,54,81,2,221,12,0,2,0,1,0
36456,235,4913,3,1,1,3,0,0,6,0,0,0,0,0,0,0,0,0,0,0,0,2,0,1,0
36457,98,2019,463,295,324,28,62,57,491,12,134,82,154,146,236,989,1696,6,11700,650,0,2,0,1,0
36458,55,770,167,116,138,4,5,22,171,8,48,30,56,56,86,292,499,4,2330,129,0,2,0,1,0
36459,57,1522,339,213,244,17,9,65,356,10,42,26,48,52,74,259,421,5,2410,133,0,2,0,1,0
36460,90,2308,1455,414,1257,16,76,112,1471,5,41,23,46,46,69,231,381,2,1069,59,0,2,0,1,0
36461,90,2308,669,365,481,22,61,110,691,15,103,63,122,118,185,747,1273,8,11311,628,0,2,0,1,0
36462,251,5838,4293,999,3693,19,54,507,4312,9,155,88,170,164,258,1156,1898,4,9368,520,0,2,0,1,0
36463,251,5838,1482,859,1002,125,135,219,1607,16,219,134,251,235,385,1766,3032,9,27804,1544,1,2,0,1,0
36464,6,140,44,22,19,0,19,6,44,2,10,6,12,12,18,35,64,1,77,4,0,2,0,1,0
36465,31,1087,74,35,59,1,0,14,75,3,14,7,14,17,21,58,85,1,128,7,0,2,0,1,0
36466,31,1087,245,125,200,5,7,34,250,7,30,17,34,37,51,166,265,3,1053,58,0,2,0,1,0
36467,54,657,647,139,84,35,284,233,682,0,0,0,0,0,0,0,0,0,0,0,0,2,0,1,0
36468,117,3160,1523,757,1297,19,12,193,1542,12,193,117,230,205,347,1508,2664,7,19053,1058,0,2,0,1,0
36469,117,3160,701,378,504,33,58,109,734,13,110,68,126,123,194,794,1346,7,10027,557,0,2,0,1,0
36470,105,2779,773,422,505,30,103,129,803,14,77,46,83,91,129,535,839,7,6334,351,0,2,0,1,0
36471,149,3603,77,34,69,0,0,8,77,3,24,16,29,27,45,114,213,1,387,21,0,2,0,1,0
36472,149,3603,712,438,573,51,9,84,763,14,102,71,128,116,199,733,1364,8,11988,666,0,2,0,1,0
36473,24,612,2,2,2,0,0,0,2,0,0,0,0,0,0,0,0,0,0,0,0,2,0,1,0
36474,24,612,99,48,90,1,3,5,100,0,0,0,0,0,0,0,0,0,0,0,0,2,0,1,0
36475,24,612,8,5,5,2,0,1,10,0,0,0,0,0,0,0,0,0,0,0,0,2,0,1,0
36476,24,612,1217,716,841,84,126,174,1301,14,185,118,215,199,333,1446,2542,8,20687,1149,0,2,0,1,0
36477,24,612,160,89,115,0,13,31,160,7,15,11,17,22,28,78,124,3,495,27,0,2,0,1,0
36478,24,612,10,10,9,9,0,0,19,0,0,0,0,0,0,0,0,0,0,0,0,2,0,1,0
36479,24,612,173,84,99,8,29,36,181,5,12,7,13,17,20,54,81,2,221,12,0,2,0,1,0
36480,24,612,3,1,1,3,0,0,6,0,0,0,0,0,0,0,0,0,0,0,0,2,0,1,0
36481,30,664,125,97,103,3,0,19,128,9,25,17,27,34,44,144,223,4,1087,60,0,2,0,1,0
36482,22,373,102,57,55,5,16,25,107,5,17,10,18,22,28,81,124,2,330,18,0,2,0,1,0
36483,71,1576,402,202,227,24,74,80,426,12,52,33,61,64,94,339,564,7,3969,220,0,2,0,1,0
36484,51,1113,447,308,343,6,5,95,453,7,96,59,111,103,170,651,1136,4,4600,255,0,2,0,1,0
36485,51,1113,322,174,179,16,74,51,338,10,41,26,46,51,72,252,408,5,2291,127,0,2,0,1,0
36486,75,1629,53,23,39,0,0,13,53,2,8,4,8,10,12,26,39,1,39,2,0,2,0,1,0
36487,75,1629,515,298,307,33,80,99,548,12,63,44,77,75,121,419,753,7,5527,307,0,2,0,1,0
36488,18,312,424,94,331,4,0,89,428,1,5,5,5,6,10,11,25,0,12,0,0,2,0,1,0
36489,18,312,38,23,23,6,0,8,44,3,11,7,11,14,18,42,68,1,102,5,0,2,0,1,0
36490,19,513,205,80,86,16,53,53,221,7,18,10,19,25,29,94,134,3,497,27,0,2,0,1,0
36491,15,490,184,100,137,2,15,30,186,6,38,20,39,44,59,214,322,3,991,55,0,2,0,1,0
36492,15,490,103,65,74,8,5,16,111,7,17,9,17,24,26,89,119,3,417,23,0,2,0,1,0
36493,58,1203,91,45,69,0,3,18,91,3,9,6,10,12,16,33,57,1,95,5,0,2,0,1,0
36494,58,1203,367,234,237,17,34,68,384,16,55,34,61,71,95,381,584,8,5183,287,0,2,0,1,0
36495,228,5903,722,423,573,19,0,135,741,12,172,101,199,184,300,1320,2257,6,15668,870,0,2,0,1,0
36496,228,5903,1508,847,911,44,250,301,1552,14,148,88,169,162,257,1120,1886,7,15077,837,0,2,0,1,0
36497,315,6914,72,33,56,0,4,12,72,1,1,1,1,2,2,0,2,0,1,0,0,2,0,1,0
36498,315,6914,1454,835,1044,76,110,219,1530,17,275,158,296,292,454,2297,3718,9,34017,1889,1,2,0,1,0
36499,89,1819,757,253,292,73,244,162,830,13,61,38,67,74,105,409,651,7,4654,258,0,2,0,1,0
36500,38,814,386,256,301,16,9,68,402,4,59,35,69,63,104,355,621,2,1453,80,0,2,0,1,0
36501,38,814,264,131,164,11,41,46,275,6,38,22,40,44,62,214,338,3,1068,59,0,2,0,1,0
36502,67,1753,466,257,367,18,25,50,484,7,126,86,171,133,257,898,1813,4,8612,478,0,2,0,1,0
36503,67,1753,507,281,342,29,59,88,536,10,53,29,57,63,86,336,514,5,2764,153,0,2,0,1,0
36504,25,552,215,129,180,6,0,29,221,8,65,43,72,73,115,415,711,4,3153,175,0,2,0,1,0
36505,25,552,97,69,77,3,3,16,100,6,22,13,23,28,36,113,173,3,542,30,0,2,0,1,0
36506,89,1894,1043,504,840,53,9,147,1096,9,180,112,198,189,310,1377,2344,4,11604,644,0,2,0,1,0
36507,89,1894,383,288,292,26,6,62,409,11,65,38,67,76,105,429,656,5,3719,206,0,2,0,1,0
36508,20,420,294,64,250,0,0,43,294,1,20,10,20,21,30,86,131,0,65,3,0,2,0,1,0
36509,20,420,78,46,62,3,0,14,81,3,8,4,8,11,12,28,41,1,62,3,0,2,0,1,0
36510,5,123,110,30,77,3,13,16,113,4,21,15,30,25,45,100,208,2,597,33,0,2,0,1,0
36511,5,123,28,15,21,1,0,6,29,0,0,0,0,0,0,0,0,0,0,0,0,2,0,1,0
36512,40,796,1178,367,1042,6,15,115,1184,9,94,51,95,103,146,644,976,4,4439,246,0,2,0,1,0
36513,40,796,177,108,140,8,0,27,185,6,30,16,32,36,48,162,248,3,794,44,0,2,0,1,0
36514,28,452,219,78,157,11,5,46,230,3,24,20,34,27,54,114,256,2,545,30,0,2,0,1,0
36515,28,452,108,64,79,9,0,20,117,5,15,11,19,20,30,70,129,3,410,22,0,2,0,1,0
36516,280,5888,1943,715,1694,26,18,214,1969,12,185,120,237,197,357,1436,2721,7,20915,1161,0,2,0,1,0
36517,280,5888,1168,838,957,57,25,144,1225,19,348,224,416,367,640,3018,5452,11,61921,3440,1,2,0,1,0
36518,19,717,442,244,305,14,16,103,456,11,68,45,75,79,120,452,756,6,4588,254,0,2,0,1,0
36519,19,717,182,102,99,11,40,35,193,3,11,6,11,14,17,42,64,1,97,5,0,2,0,1,0
36520,65,1263,1098,241,925,5,10,155,1103,7,46,25,49,53,74,273,423,3,1580,87,0,2,0,1,0
36521,65,1263,282,202,222,14,2,44,296,8,42,24,43,50,67,250,378,4,1548,86,0,2,0,1,0
36522,2,156,37,13,25,0,6,6,37,1,2,1,2,3,3,2,4,0,2,0,0,2,0,1,0
36523,2,156,133,47,40,1,43,49,134,0,0,0,0,0,0,0,0,0,0,0,0,2,0,1,0
36524,23,642,601,196,481,2,23,85,603,8,63,36,72,71,108,400,664,4,3036,168,0,2,0,1,0
36525,23,642,156,79,106,5,16,28,161,5,14,8,15,19,23,64,97,2,261,14,0,2,0,1,0
36526,104,4436,1289,550,1043,56,32,155,1345,10,167,93,185,177,278,1266,2075,5,11498,638,0,2,0,1,0
36527,31,994,182,127,129,0,0,53,182,5,39,21,42,44,63,217,343,2,926,51,0,2,0,1,0
36528,151,7251,1392,870,1177,35,17,170,1427,14,494,280,531,508,811,4473,7289,7,54850,3047,2,2,0,1,0
36529,95,2896,773,419,590,28,0,166,801,10,204,113,217,214,330,1598,2554,5,13587,754,0,2,0,1,0
36530,6,163,127,75,83,2,11,30,129,4,14,7,14,18,21,61,87,2,175,9,0,2,0,1,0
36531,6,163,652,304,544,16,6,88,668,6,89,51,101,95,152,591,998,3,3399,188,0,2,0,1,0
36532,6,163,2,2,2,0,0,0,2,0,0,0,0,0,0,0,0,0,0,0,0,2,0,1,0
36533,6,163,8,5,5,0,0,3,8,0,0,0,0,0,0,0,0,0,0,0,0,2,0,1,0
36534,6,163,2,2,2,0,0,0,2,0,0,0,0,0,0,0,0,0,0,0,0,2,0,1,0
36535,6,163,14,8,8,0,0,6,14,0,0,0,0,0,0,0,0,0,0,0,0,2,0,1,0
36536,6,163,6,4,4,0,0,2,6,0,0,0,0,0,0,0,0,0,0,0,0,2,0,1,0
36537,6,163,6,4,4,0,0,2,6,1,2,1,2,3,3,2,4,0,2,0,0,2,0,1,0
36538,6,163,6,4,4,0,0,2,6,0,0,0,0,0,0,0,0,0,0,0,0,2,0,1,0
36539,6,163,7,5,5,0,0,2,7,0,0,0,0,0,0,0,0,0,0,0,0,2,0,1,0
36540,6,163,6,4,4,0,0,2,6,0,0,0,0,0,0,0,0,0,0,0,0,2,0,1,0
36541,6,163,10,6,6,0,0,4,10,0,0,0,0,0,0,0,0,0,0,0,0,2,0,1,0
36542,6,163,1,1,1,0,0,0,1,0,0,0,0,0,0,0,0,0,0,0,0,2,0,1,0
36543,6,163,1,1,1,0,0,0,1,0,0,0,0,0,0,0,0,0,0,0,0,2,0,1,0
36544,6,163,14,10,10,0,0,4,14,1,1,1,1,2,2,0,2,0,1,0,0,2,0,1,0
36545,6,163,46,26,30,3,0,12,49,3,6,3,6,9,9,20,28,1,42,2,0,2,0,1,0
36546,14,845,75,38,59,1,3,12,76,2,4,2,4,6,6,10,15,1,15,0,0,2,0,1,0
36547,2,58,16,12,9,0,0,6,16,1,2,1,2,3,3,2,4,0,2,0,0,2,0,1,0
36548,1,6,2,2,2,0,0,0,2,0,0,0,0,0,0,0,0,0,0,0,0,2,0,1,0
36549,1,6,99,48,90,1,3,5,100,0,0,0,0,0,0,0,0,0,0,0,0,2,0,1,0
36550,1,6,8,5,5,2,0,1,10,0,0,0,0,0,0,0,0,0,0,0,0,2,0,1,0
36551,1,6,1217,716,841,84,126,174,1301,14,185,118,215,199,333,1446,2542,8,20687,1149,0,2,0,1,0
36552,1,6,160,89,115,0,13,31,160,7,15,11,17,22,28,78,124,3,495,27,0,2,0,1,0
36553,1,6,10,10,9,9,0,0,19,0,0,0,0,0,0,0,0,0,0,0,0,2,0,1,0
36554,1,6,173,84,99,8,29,36,181,5,12,7,13,17,20,54,81,2,221,12,0,2,0,1,0
36555,1,6,3,1,1,3,0,0,6,0,0,0,0,0,0,0,0,0,0,0,0,2,0,1,0
36556,1,6,2,2,2,0,0,0,2,0,0,0,0,0,0,0,0,0,0,0,0,2,0,1,0
36557,1,6,2,2,2,0,0,0,2,0,0,0,0,0,0,0,0,0,0,0,0,2,0,1,0
36558,1,6,2,2,2,0,0,0,2,0,0,0,0,0,0,0,0,0,0,0,0,2,0,1,0
36559,1,6,2,2,2,0,0,0,2,0,0,0,0,0,0,0,0,0,0,0,0,2,0,1,0
36560,1,8,127,75,83,2,11,30,129,4,14,7,14,18,21,61,87,2,175,9,0,2,0,1,0
36561,1,8,652,304,544,16,6,88,668,6,89,51,101,95,152,591,998,3,3399,188,0,2,0,1,0
36562,1,8,2,2,2,0,0,0,2,0,0,0,0,0,0,0,0,0,0,0,0,2,0,1,0
36563,1,8,8,5,5,0,0,3,8,0,0,0,0,0,0,0,0,0,0,0,0,2,0,1,0
36564,1,8,2,2,2,0,0,0,2,0,0,0,0,0,0,0,0,0,0,0,0,2,0,1,0
36565,1,8,14,8,8,0,0,6,14,0,0,0,0,0,0,0,0,0,0,0,0,2,0,1,0
36566,1,8,6,4,4,0,0,2,6,0,0,0,0,0,0,0,0,0,0,0,0,2,0,1,0
36567,1,8,6,4,4,0,0,2,6,1,2,1,2,3,3,2,4,0,2,0,0,2,0,1,0
36568,1,8,6,4,4,0,0,2,6,0,0,0,0,0,0,0,0,0,0,0,0,2,0,1,0
36569,1,8,7,5,5,0,0,2,7,0,0,0,0,0,0,0,0,0,0,0,0,2,0,1,0
36570,1,8,6,4,4,0,0,2,6,0,0,0,0,0,0,0,0,0,0,0,0,2,0,1,0
36571,1,8,10,6,6,0,0,4,10,0,0,0,0,0,0,0,0,0,0,0,0,2,0,1,0
36572,1,8,1,1,1,0,0,0,1,0,0,0,0,0,0,0,0,0,0,0,0,2,0,1,0
36573,1,8,1,1,1,0,0,0,1,0,0,0,0,0,0,0,0,0,0,0,0,2,0,1,0
36574,1,8,14,10,10,0,0,4,14,1,1,1,1,2,2,0,2,0,1,0,0,2,0,1,0
36575,1,8,46,26,30,3,0,12,49,3,6,3,6,9,9,20,28,1,42,2,0,2,0,1,0
36576,1,6,2,2,2,0,0,0,2,0,0,0,0,0,0,0,0,0,0,0,0,2,0,1,0
36577,1,6,2,2,2,0,0,0,2,0,0,0,0,0,0,0,0,0,0,0,0,2,0,1,0
36578,1,6,2,2,2,0,0,0,2,0,0,0,0,0,0,0,0,0,0,0,0,2,0,1,0
36579,1,6,2,2,2,0,0,0,2,0,0,0,0,0,0,0,0,0,0,0,0,2,0,1,0
36580,1,6,2,2,2,0,0,0,2,0,0,0,0,0,0,0,0,0,0,0,0,2,0,1,0
36581,1,6,2,2,2,0,0,0,2,0,0,0,0,0,0,0,0,0,0,0,0,2,0,1,0
36582,1,6,2,2,2,0,0,0,2,0,0,0,0,0,0,0,0,0,0,0,0,2,0,1,0
36583,1,6,2,2,2,0,0,0,2,0,0,0,0,0,0,0,0,0,0,0,0,2,0,1,0
36584,1,6,2,2,2,0,0,0,2,0,0,0,0,0,0,0,0,0,0,0,0,2,0,1,0
36585,2,25,127,75,83,2,11,30,129,4,14,7,14,18,21,61,87,2,175,9,0,2,0,1,0
36586,2,25,652,304,544,16,6,88,668,6,89,51,101,95,152,591,998,3,3399,188,0,2,0,1,0
36587,2,25,2,2,2,0,0,0,2,0,0,0,0,0,0,0,0,0,0,0,0,2,0,1,0
36588,2,25,8,5,5,0,0,3,8,0,0,0,0,0,0,0,0,0,0,0,0,2,0,1,0
36589,2,25,2,2,2,0,0,0,2,0,0,0,0,0,0,0,0,0,0,0,0,2,0,1,0
36590,2,25,14,8,8,0,0,6,14,0,0,0,0,0,0,0,0,0,0,0,0,2,0,1,0
36591,2,25,6,4,4,0,0,2,6,0,0,0,0,0,0,0,0,0,0,0,0,2,0,1,0
36592,2,25,6,4,4,0,0,2,6,1,2,1,2,3,3,2,4,0,2,0,0,2,0,1,0
36593,2,25,6,4,4,0,0,2,6,0,0,0,0,0,0,0,0,0,0,0,0,2,0,1,0
36594,2,25,7,5,5,0,0,2,7,0,0,0,0,0,0,0,0,0,0,0,0,2,0,1,0
36595,2,25,6,4,4,0,0,2,6,0,0,0,0,0,0,0,0,0,0,0,0,2,0,1,0
36596,2,25,10,6,6,0,0,4,10,0,0,0,0,0,0,0,0,0,0,0,0,2,0,1,0
36597,2,25,1,1,1,0,0,0,1,0,0,0,0,0,0,0,0,0,0,0,0,2,0,1,0
36598,2,25,1,1,1,0,0,0,1,0,0,0,0,0,0,0,0,0,0,0,0,2,0,1,0
36599,2,25,14,10,10,0,0,4,14,1,1,1,1,2,2,0,2,0,1,0,0,2,0,1,0
36600,2,25,46,26,30,3,0,12,49,3,6,3,6,9,9,20,28,1,42,2,0,2,0,1,0
36601,1,55,14,12,10,0,0,4,14,1,2,1,2,3,3,2,4,0,2,0,0,2,0,1,0
36602,1,58,14,12,10,0,0,4,14,1,2,1,2,3,3,2,4,0,2,0,0,2,0,1,0
36603,1,55,14,12,10,0,0,4,14,1,2,1,2,3,3,2,4,0,2,0,0,2,0,1,0
36604,1,77,19,18,14,0,0,5,19,1,2,1,2,3,3,2,4,0,2,0,0,2,0,1,0
36605,2,18,10,6,6,0,0,4,10,0,0,0,0,0,0,0,0,0,0,0,0,2,0,1,0
36606,2,36,127,75,83,2,11,30,129,4,14,7,14,18,21,61,87,2,175,9,0,2,0,1,0
36607,2,36,652,304,544,16,6,88,668,6,89,51,101,95,152,591,998,3,3399,188,0,2,0,1,0
36608,2,36,2,2,2,0,0,0,2,0,0,0,0,0,0,0,0,0,0,0,0,2,0,1,0
36609,2,36,8,5,5,0,0,3,8,0,0,0,0,0,0,0,0,0,0,0,0,2,0,1,0
36610,2,36,2,2,2,0,0,0,2,0,0,0,0,0,0,0,0,0,0,0,0,2,0,1,0
36611,2,36,14,8,8,0,0,6,14,0,0,0,0,0,0,0,0,0,0,0,0,2,0,1,0
36612,2,36,6,4,4,0,0,2,6,0,0,0,0,0,0,0,0,0,0,0,0,2,0,1,0
36613,2,36,6,4,4,0,0,2,6,1,2,1,2,3,3,2,4,0,2,0,0,2,0,1,0
36614,2,36,6,4,4,0,0,2,6,0,0,0,0,0,0,0,0,0,0,0,0,2,0,1,0
36615,2,36,7,5,5,0,0,2,7,0,0,0,0,0,0,0,0,0,0,0,0,2,0,1,0
36616,2,36,6,4,4,0,0,2,6,0,0,0,0,0,0,0,0,0,0,0,0,2,0,1,0
36617,2,36,10,6,6,0,0,4,10,0,0,0,0,0,0,0,0,0,0,0,0,2,0,1,0
36618,2,36,1,1,1,0,0,0,1,0,0,0,0,0,0,0,0,0,0,0,0,2,0,1,0
36619,2,36,1,1,1,0,0,0,1,0,0,0,0,0,0,0,0,0,0,0,0,2,0,1,0
36620,2,36,14,10,10,0,0,4,14,1,1,1,1,2,2,0,2,0,1,0,0,2,0,1,0
36621,2,36,46,26,30,3,0,12,49,3,6,3,6,9,9,20,28,1,42,2,0,2,0,1,0
36622,1,6,2,2,2,0,0,0,2,0,0,0,0,0,0,0,0,0,0,0,0,2,0,1,0
36623,1,6,2,2,2,0,0,0,2,0,0,0,0,0,0,0,0,0,0,0,0,2,0,1,0
36624,1,6,2,2,2,0,0,0,2,0,0,0,0,0,0,0,0,0,0,0,0,2,0,1,0
36625,1,6,2,2,2,0,0,0,2,0,0,0,0,0,0,0,0,0,0,0,0,2,0,1,0
36626,1,26,127,75,83,2,11,30,129,4,14,7,14,18,21,61,87,2,175,9,0,2,0,1,0
36627,1,26,652,304,544,16,6,88,668,6,89,51,101,95,152,591,998,3,3399,188,0,2,0,1,0
36628,1,26,2,2,2,0,0,0,2,0,0,0,0,0,0,0,0,0,0,0,0,2,0,1,0
36629,1,26,8,5,5,0,0,3,8,0,0,0,0,0,0,0,0,0,0,0,0,2,0,1,0
36630,1,26,2,2,2,0,0,0,2,0,0,0,0,0,0,0,0,0,0,0,0,2,0,1,0
36631,1,26,14,8,8,0,0,6,14,0,0,0,0,0,0,0,0,0,0,0,0,2,0,1,0
36632,1,26,6,4,4,0,0,2,6,0,0,0,0,0,0,0,0,0,0,0,0,2,0,1,0
36633,1,26,6,4,4,0,0,2,6,1,2,1,2,3,3,2,4,0,2,0,0,2,0,1,0
36634,1,26,6,4,4,0,0,2,6,0,0,0,0,0,0,0,0,0,0,0,0,2,0,1,0
36635,1,26,7,5,5,0,0,2,7,0,0,0,0,0,0,0,0,0,0,0,0,2,0,1,0
36636,1,26,6,4,4,0,0,2,6,0,0,0,0,0,0,0,0,0,0,0,0,2,0,1,0
36637,1,26,10,6,6,0,0,4,10,0,0,0,0,0,0,0,0,0,0,0,0,2,0,1,0
36638,1,26,1,1,1,0,0,0,1,0,0,0,0,0,0,0,0,0,0,0,0,2,0,1,0
36639,1,26,1,1,1,0,0,0,1,0,0,0,0,0,0,0,0,0,0,0,0,2,0,1,0
36640,1,26,14,10,10,0,0,4,14,1,1,1,1,2,2,0,2,0,1,0,0,2,0,1,0
36641,1,26,46,26,30,3,0,12,49,3,6,3,6,9,9,20,28,1,42,2,0,2,0,1,0
36642,1,7,2,2,2,0,0,0,2,0,0,0,0,0,0,0,0,0,0,0,0,2,0,1,0
36643,1,24,127,75,83,2,11,30,129,4,14,7,14,18,21,61,87,2,175,9,0,2,0,1,0
36644,1,24,652,304,544,16,6,88,668,6,89,51,101,95,152,591,998,3,3399,188,0,2,0,1,0
36645,1,24,2,2,2,0,0,0,2,0,0,0,0,0,0,0,0,0,0,0,0,2,0,1,0
36646,1,24,8,5,5,0,0,3,8,0,0,0,0,0,0,0,0,0,0,0,0,2,0,1,0
36647,1,24,2,2,2,0,0,0,2,0,0,0,0,0,0,0,0,0,0,0,0,2,0,1,0
36648,1,24,14,8,8,0,0,6,14,0,0,0,0,0,0,0,0,0,0,0,0,2,0,1,0
36649,1,24,6,4,4,0,0,2,6,0,0,0,0,0,0,0,0,0,0,0,0,2,0,1,0
36650,1,24,6,4,4,0,0,2,6,1,2,1,2,3,3,2,4,0,2,0,0,2,0,1,0
36651,1,24,6,4,4,0,0,2,6,0,0,0,0,0,0,0,0,0,0,0,0,2,0,1,0
36652,1,24,7,5,5,0,0,2,7,0,0,0,0,0,0,0,0,0,0,0,0,2,0,1,0
36653,1,24,6,4,4,0,0,2,6,0,0,0,0,0,0,0,0,0,0,0,0,2,0,1,0
36654,1,24,10,6,6,0,0,4,10,0,0,0,0,0,0,0,0,0,0,0,0,2,0,1,0
36655,1,24,1,1,1,0,0,0,1,0,0,0,0,0,0,0,0,0,0,0,0,2,0,1,0
36656,1,24,1,1,1,0,0,0,1,0,0,0,0,0,0,0,0,0,0,0,0,2,0,1,0
36657,1,24,14,10,10,0,0,4,14,1,1,1,1,2,2,0,2,0,1,0,0,2,0,1,0
36658,1,24,46,26,30,3,0,12,49,3,6,3,6,9,9,20,28,1,42,2,0,2,0,1,0
36659,1,7,2,2,2,0,0,0,2,0,0,0,0,0,0,0,0,0,0,0,0,2,0,1,0
36660,3,33,15,9,9,0,0,6,15,0,0,0,0,0,0,0,0,0,0,0,0,2,0,1,0
36661,1,13,127,75,83,2,11,30,129,4,14,7,14,18,21,61,87,2,175,9,0,2,0,1,0
36662,1,13,652,304,544,16,6,88,668,6,89,51,101,95,152,591,998,3,3399,188,0,2,0,1,0
36663,1,13,2,2,2,0,0,0,2,0,0,0,0,0,0,0,0,0,0,0,0,2,0,1,0
36664,1,13,8,5,5,0,0,3,8,0,0,0,0,0,0,0,0,0,0,0,0,2,0,1,0
36665,1,13,2,2,2,0,0,0,2,0,0,0,0,0,0,0,0,0,0,0,0,2,0,1,0
36666,1,13,14,8,8,0,0,6,14,0,0,0,0,0,0,0,0,0,0,0,0,2,0,1,0
36667,1,13,6,4,4,0,0,2,6,0,0,0,0,0,0,0,0,0,0,0,0,2,0,1,0
36668,1,13,6,4,4,0,0,2,6,1,2,1,2,3,3,2,4,0,2,0,0,2,0,1,0
36669,1,13,6,4,4,0,0,2,6,0,0,0,0,0,0,0,0,0,0,0,0,2,0,1,0
36670,1,13,7,5,5,0,0,2,7,0,0,0,0,0,0,0,0,0,0,0,0,2,0,1,0
36671,1,13,6,4,4,0,0,2,6,0,0,0,0,0,0,0,0,0,0,0,0,2,0,1,0
36672,1,13,10,6,6,0,0,4,10,0,0,0,0,0,0,0,0,0,0,0,0,2,0,1,0
36673,1,13,1,1,1,0,0,0,1,0,0,0,0,0,0,0,0,0,0,0,0,2,0,1,0
36674,1,13,1,1,1,0,0,0,1,0,0,0,0,0,0,0,0,0,0,0,0,2,0,1,0
36675,1,13,14,10,10,0,0,4,14,1,1,1,1,2,2,0,2,0,1,0,0,2,0,1,0
36676,1,13,46,26,30,3,0,12,49,3,6,3,6,9,9,20,28,1,42,2,0,2,0,1,0
36677,1,16,127,75,83,2,11,30,129,4,14,7,14,18,21,61,87,2,175,9,0,2,0,1,0
36678,1,16,652,304,544,16,6,88,668,6,89,51,101,95,152,591,998,3,3399,188,0,2,0,1,0
36679,1,16,2,2,2,0,0,0,2,0,0,0,0,0,0,0,0,0,0,0,0,2,0,1,0
36680,1,16,8,5,5,0,0,3,8,0,0,0,0,0,0,0,0,0,0,0,0,2,0,1,0
36681,1,16,2,2,2,0,0,0,2,0,0,0,0,0,0,0,0,0,0,0,0,2,0,1,0
36682,1,16,14,8,8,0,0,6,14,0,0,0,0,0,0,0,0,0,0,0,0,2,0,1,0
36683,1,16,6,4,4,0,0,2,6,0,0,0,0,0,0,0,0,0,0,0,0,2,0,1,0
36684,1,16,6,4,4,0,0,2,6,1,2,1,2,3,3,2,4,0,2,0,0,2,0,1,0
36685,1,16,6,4,4,0,0,2,6,0,0,0,0,0,0,0,0,0,0,0,0,2,0,1,0
36686,1,16,7,5,5,0,0,2,7,0,0,0,0,0,0,0,0,0,0,0,0,2,0,1,0
36687,1,16,6,4,4,0,0,2,6,0,0,0,0,0,0,0,0,0,0,0,0,2,0,1,0
36688,1,16,10,6,6,0,0,4,10,0,0,0,0,0,0,0,0,0,0,0,0,2,0,1,0
36689,1,16,1,1,1,0,0,0,1,0,0,0,0,0,0,0,0,0,0,0,0,2,0,1,0
36690,1,16,1,1,1,0,0,0,1,0,0,0,0,0,0,0,0,0,0,0,0,2,0,1,0
36691,1,16,14,10,10,0,0,4,14,1,1,1,1,2,2,0,2,0,1,0,0,2,0,1,0
36692,1,16,46,26,30,3,0,12,49,3,6,3,6,9,9,20,28,1,42,2,0,2,0,1,0
36693,1,10,2,2,2,0,0,0,2,1,2,1,2,3,3,2,4,0,2,0,0,2,0,1,0
36694,1,13,127,75,83,2,11,30,129,4,14,7,14,18,21,61,87,2,175,9,0,2,0,1,0
36695,1,13,652,304,544,16,6,88,668,6,89,51,101,95,152,591,998,3,3399,188,0,2,0,1,0
36696,1,13,2,2,2,0,0,0,2,0,0,0,0,0,0,0,0,0,0,0,0,2,0,1,0
36697,1,13,8,5,5,0,0,3,8,0,0,0,0,0,0,0,0,0,0,0,0,2,0,1,0
36698,1,13,2,2,2,0,0,0,2,0,0,0,0,0,0,0,0,0,0,0,0,2,0,1,0
36699,1,13,14,8,8,0,0,6,14,0,0,0,0,0,0,0,0,0,0,0,0,2,0,1,0
36700,1,13,6,4,4,0,0,2,6,0,0,0,0,0,0,0,0,0,0,0,0,2,0,1,0
36701,1,13,6,4,4,0,0,2,6,1,2,1,2,3,3,2,4,0,2,0,0,2,0,1,0
36702,1,13,6,4,4,0,0,2,6,0,0,0,0,0,0,0,0,0,0,0,0,2,0,1,0
36703,1,13,7,5,5,0,0,2,7,0,0,0,0,0,0,0,0,0,0,0,0,2,0,1,0
36704,1,13,6,4,4,0,0,2,6,0,0,0,0,0,0,0,0,0,0,0,0,2,0,1,0
36705,1,13,10,6,6,0,0,4,10,0,0,0,0,0,0,0,0,0,0,0,0,2,0,1,0
36706,1,13,1,1,1,0,0,0,1,0,0,0,0,0,0,0,0,0,0,0,0,2,0,1,0
36707,1,13,1,1,1,0,0,0,1,0,0,0,0,0,0,0,0,0,0,0,0,2,0,1,0
36708,1,13,14,10,10,0,0,4,14,1,1,1,1,2,2,0,2,0,1,0,0,2,0,1,0
36709,1,13,46,26,30,3,0,12,49,3,6,3,6,9,9,20,28,1,42,2,0,2,0,1,0
36710,2,26,10,6,6,0,0,4,10,2,4,2,4,6,6,10,15,1,15,0,0,2,0,1,0
36711,3,47,15,10,10,0,0,5,15,2,4,2,4,6,6,10,15,1,15,0,0,2,0,1,0
36712,3,39,15,9,9,0,0,6,15,0,0,0,0,0,0,0,0,0,0,0,0,2,0,1,0
36713,2,36,10,7,7,0,0,3,10,1,2,1,2,3,3,2,4,0,2,0,0,2,0,1,0
36714,3,46,15,9,9,0,0,6,15,1,4,2,4,5,6,8,13,0,6,0,0,2,0,1,0
36715,2,21,10,6,6,0,0,4,10,0,0,0,0,0,0,0,0,0,0,0,0,2,0,1,0
36716,4,61,20,12,12,0,0,8,20,1,2,1,2,3,3,2,4,0,2,0,0,2,0,1,0
36717,2,51,127,75,83,2,11,30,129,4,14,7,14,18,21,61,87,2,175,9,0,2,0,1,0
36718,2,51,652,304,544,16,6,88,668,6,89,51,101,95,152,591,998,3,3399,188,0,2,0,1,0
36719,2,51,2,2,2,0,0,0,2,0,0,0,0,0,0,0,0,0,0,0,0,2,0,1,0
36720,2,51,8,5,5,0,0,3,8,0,0,0,0,0,0,0,0,0,0,0,0,2,0,1,0
36721,2,51,2,2,2,0,0,0,2,0,0,0,0,0,0,0,0,0,0,0,0,2,0,1,0
36722,2,51,14,8,8,0,0,6,14,0,0,0,0,0,0,0,0,0,0,0,0,2,0,1,0
36723,2,51,6,4,4,0,0,2,6,0,0,0,0,0,0,0,0,0,0,0,0,2,0,1,0
36724,2,51,6,4,4,0,0,2,6,1,2,1,2,3,3,2,4,0,2,0,0,2,0,1,0
36725,2,51,6,4,4,0,0,2,6,0,0,0,0,0,0,0,0,0,0,0,0,2,0,1,0
36726,2,51,7,5,5,0,0,2,7,0,0,0,0,0,0,0,0,0,0,0,0,2,0,1,0
36727,2,51,6,4,4,0,0,2,6,0,0,0,0,0,0,0,0,0,0,0,0,2,0,1,0
36728,2,51,10,6,6,0,0,4,10,0,0,0,0,0,0,0,0,0,0,0,0,2,0,1,0
36729,2,51,1,1,1,0,0,0,1,0,0,0,0,0,0,0,0,0,0,0,0,2,0,1,0
36730,2,51,1,1,1,0,0,0,1,0,0,0,0,0,0,0,0,0,0,0,0,2,0,1,0
36731,2,51,14,10,10,0,0,4,14,1,1,1,1,2,2,0,2,0,1,0,0,2,0,1,0
36732,2,51,46,26,30,3,0,12,49,3,6,3,6,9,9,20,28,1,42,2,0,2,0,1,0
36733,1,6,2,2,2,0,0,0,2,0,0,0,0,0,0,0,0,0,0,0,0,2,0,1,0
36734,8,263,51,25,36,0,0,15,51,3,11,6,12,14,18,42,68,1,112,6,0,2,0,1,0
36735,1,14,6,4,4,0,0,2,6,0,0,0,0,0,0,0,0,0,0,0,0,2,0,1,0
36736,4,163,27,21,21,0,0,6,27,3,6,3,6,9,9,20,28,1,42,2,0,2,0,1,0
36737,1,6,2,2,2,0,0,0,2,0,0,0,0,0,0,0,0,0,0,0,0,2,0,1,0
36738,1,41,7,5,5,0,0,2,7,1,2,1,2,3,3,2,4,0,2,0,0,2,0,1,0
36739,2,51,14,9,9,0,0,5,14,0,0,0,0,0,0,0,0,0,0,0,0,2,0,1,0
36740,2,40,13,9,8,0,0,4,13,0,0,0,0,0,0,0,0,0,0,0,0,2,0,1,0
36741,2,42,14,10,9,0,0,4,14,0,0,0,0,0,0,0,0,0,0,0,0,2,0,1,0
36742,2,33,12,8,7,0,0,4,12,0,0,0,0,0,0,0,0,0,0,0,0,2,0,1,0
36743,3,49,16,9,9,0,0,7,16,0,0,0,0,0,0,0,0,0,0,0,0,2,0,1,0
36744,1,18,3,3,3,0,0,0,3,0,0,0,0,0,0,0,0,0,0,0,0,2,0,1,0
36745,2,26,6,4,4,0,0,2,6,1,4,2,4,5,6,8,13,0,6,0,0,2,0,1,0
36746,12,318,149,95,105,2,0,41,151,8,54,28,55,62,83,334,494,4,2013,111,0,2,0,1,0
36747,15,703,139,89,101,2,0,35,141,7,54,34,62,61,96,330,569,4,2287,127,0,2,0,1,0
36748,3,330,149,67,118,4,0,27,153,1,17,14,28,18,42,69,175,0,144,8,0,2,0,1,0
36749,38,2498,1157,318,931,29,22,177,1186,6,104,63,125,110,188,712,1274,3,4596,255,0,2,0,1,0
36750,65,4378,520,294,400,33,13,81,553,10,261,204,367,271,571,2128,4614,7,32445,1802,1,2,0,1,0
36751,90,3988,1338,495,1086,10,64,173,1348,11,122,82,157,133,239,883,1686,7,11934,663,0,2,0,1,0
36752,172,7635,4293,999,3693,19,54,507,4312,9,155,88,170,164,258,1156,1898,4,9368,520,0,2,0,1,0
36753,172,7635,1482,859,1002,125,135,219,1607,16,219,134,251,235,385,1766,3032,9,27804,1544,1,2,0,1,0
36754,33,999,465,148,393,5,8,60,470,4,31,20,31,35,51,161,261,2,523,29,0,2,0,1,0
36755,33,999,16,12,9,0,0,6,16,1,2,1,2,3,3,2,4,0,2,0,0,2,0,1,0
36756,144,5933,1782,648,1425,9,47,279,1791,8,171,97,189,179,286,1292,2140,4,9462,525,0,2,0,1,0
36757,32,982,256,139,192,9,7,47,265,4,23,12,24,27,36,112,171,2,357,19,0,2,0,1,0
36758,6,328,180,34,164,0,0,16,180,1,12,6,12,13,18,43,66,0,33,1,0,2,0,1,0
36759,19,517,102,59,69,5,3,24,107,6,22,15,28,28,43,113,206,3,789,43,0,2,0,1,0
36760,119,4920,1450,624,1228,12,26,181,1462,14,306,186,354,320,540,2580,4493,8,36391,2021,1,2,0,1,0
36761,176,5162,1660,832,1314,41,38,274,1701,20,312,209,395,332,604,2671,5058,12,64042,3557,1,2,0,1,0
36762,49,3805,996,429,845,24,10,117,1020,7,76,50,88,83,138,494,879,4,3565,198,0,2,0,1,0
36763,120,5123,1513,682,1277,25,13,200,1538,11,199,116,219,210,335,1557,2584,6,15641,868,0,2,0,1,0
36764,84,4916,1296,573,1062,40,33,157,1336,8,201,118,231,209,349,1561,2689,4,12365,686,0,2,0,1,0
36765,20,467,207,111,150,11,0,50,218,5,26,19,36,31,55,133,272,3,943,52,0,2,0,1,0
36766,98,5241,1457,730,1242,11,6,188,1468,10,292,166,329,302,495,2424,4078,5,22973,1276,1,2,0,1,0
36767,43,2690,652,304,544,16,6,88,668,6,89,51,101,95,152,591,998,3,3399,188,0,2,0,1,0
36768,72,3266,1455,414,1257,16,76,112,1471,5,41,23,46,46,69,231,381,2,1069,59,0,2,0,1,0
36769,2,56,7,6,5,0,0,2,7,1,1,1,2,2,3,0,3,1,3,0,0,2,0,1,0
36770,8,275,74,35,59,1,0,14,75,3,14,7,14,17,21,58,85,1,128,7,0,2,0,1,0
36771,107,5160,1523,757,1297,19,12,193,1542,12,193,117,230,205,347,1508,2664,7,19053,1058,0,2,0,1,0
36772,70,3204,1020,354,843,12,15,144,1032,8,134,77,144,142,221,970,1580,4,6792,377,0,2,0,1,0
36773,44,2058,447,308,343,6,5,95,453,7,96,59,111,103,170,651,1136,4,4600,255,0,2,0,1,0
36774,3,229,53,23,39,0,0,13,53,2,8,4,8,10,12,26,39,1,39,2,0,2,0,1,0
36775,21,655,424,94,331,4,0,89,428,1,5,5,5,6,10,11,25,0,12,0,0,2,0,1,0
36776,38,2327,334,251,279,10,4,40,344,5,127,74,143,132,217,899,1528,2,4303,239,0,2,0,1,0
36777,9,444,184,100,137,2,15,30,186,6,38,20,39,44,59,214,322,3,991,55,0,2,0,1,0
36778,8,377,91,45,69,0,3,18,91,3,9,6,10,12,16,33,57,1,95,5,0,2,0,1,0
36779,75,3960,1293,570,1093,25,15,163,1318,10,195,123,241,205,364,1516,2795,6,17273,959,0,2,0,1,0
36780,29,1903,384,251,317,7,8,52,391,11,70,44,84,81,128,467,811,6,5355,297,0,2,0,1,0
36781,56,2883,722,423,573,19,0,135,741,12,172,101,199,184,300,1320,2257,6,15668,870,0,2,0,1,0
36782,45,1953,386,256,301,16,9,68,402,4,59,35,69,63,104,355,621,2,1453,80,0,2,0,1,0
36783,28,1596,466,257,367,18,25,50,484,7,126,86,171,133,257,898,1813,4,8612,478,0,2,0,1,0
36784,15,1066,215,129,180,6,0,29,221,8,65,43,72,73,115,415,711,4,3153,175,0,2,0,1,0
36785,85,3387,1043,504,840,53,9,147,1096,9,180,112,198,189,310,1377,2344,4,11604,644,0,2,0,1,0
36786,12,478,295,56,236,0,4,54,295,2,9,5,10,11,15,30,51,1,57,3,0,2,0,1,0
36787,30,1440,373,158,315,8,0,51,381,5,76,44,79,81,123,486,779,2,2026,112,0,2,0,1,0
36788,79,3101,1178,367,1042,6,15,115,1184,9,94,51,95,103,146,644,976,4,4439,246,0,2,0,1,0
36789,9,449,219,78,157,11,5,46,230,3,24,20,34,27,54,114,256,2,545,30,0,2,0,1,0
36790,111,6122,1943,715,1694,26,18,214,1969,12,185,120,237,197,357,1436,2721,7,20915,1161,0,2,0,1,0
36791,35,1497,442,244,305,14,16,103,456,11,68,45,75,79,120,452,756,6,4588,254,0,2,0,1,0
36792,48,1943,1098,241,925,5,10,155,1103,7,46,25,49,53,74,273,423,3,1580,87,0,2,0,1,0
36793,48,1649,601,196,481,2,23,85,603,8,63,36,72,71,108,400,664,4,3036,168,0,2,0,1,0
36794,2,34,9,6,6,0,0,3,9,0,0,0,0,0,0,0,0,0,0,0,0,2,0,2,0
36795,2,34,13,9,8,0,0,4,13,0,0,0,0,0,0,0,0,0,0,0,0,2,0,2,0
36796,11,230,19,8,11,5,0,4,24,2,5,3,6,7,9,13,25,1,30,1,0,2,0,4,0
36797,11,230,102,59,69,5,3,24,107,6,22,15,28,28,43,113,206,3,789,43,0,2,0,4,0
36798,11,230,106,40,36,3,49,17,109,8,17,13,23,25,36,93,167,5,904,50,0,2,0,4,0
36799,221,4746,182,127,129,0,0,53,182,5,39,21,42,44,63,217,343,2,926,51,0,2,0,4,0
36800,221,4746,1165,710,800,67,119,181,1232,18,243,153,282,261,435,2000,3492,10,36473,2026,1,2,0,4,0
36801,67,1558,773,419,590,28,0,166,801,10,204,113,217,214,330,1598,2554,5,13587,754,0,2,0,4,0
36802,67,1558,421,273,302,44,34,57,465,17,81,59,107,98,166,583,1098,11,12329,684,0,2,0,4,0
36803,14,407,149,95,105,2,0,41,151,8,54,28,55,62,83,334,494,4,2013,111,0,2,1,2,0
36804,14,407,82,56,54,0,13,15,82,4,13,8,16,17,24,56,98,2,241,13,0,2,1,2,0
36805,25,502,2,2,2,0,0,0,2,0,0,0,0,0,0,0,0,0,0,0,0,2,0,4,0
36806,25,502,99,48,90,1,3,5,100,0,0,0,0,0,0,0,0,0,0,0,0,2,0,4,0
36807,25,502,8,5,5,2,0,1,10,0,0,0,0,0,0,0,0,0,0,0,0,2,0,4,0
36808,25,502,1217,716,841,84,126,174,1301,14,185,118,215,199,333,1446,2542,8,20687,1149,0,2,0,4,0
36809,25,502,160,89,115,0,13,31,160,7,15,11,17,22,28,78,124,3,495,27,0,2,0,4,0
36810,25,502,10,10,9,9,0,0,19,0,0,0,0,0,0,0,0,0,0,0,0,2,0,4,0
36811,25,502,173,84,99,8,29,36,181,5,12,7,13,17,20,54,81,2,221,12,0,2,0,4,0
36812,25,502,3,1,1,3,0,0,6,0,0,0,0,0,0,0,0,0,0,0,0,2,0,4,0
36813,174,5286,1660,832,1314,41,38,274,1701,20,312,209,395,332,604,2671,5058,12,64042,3557,1,2,0,4,0
36814,174,5286,1057,646,719,113,100,145,1170,18,215,134,248,233,382,1740,3004,10,31186,1732,1,2,0,4,0
36815,17,336,95,58,50,9,16,20,104,12,33,24,45,45,69,209,378,8,3100,172,0,2,0,4,0
36816,116,2161,477,336,357,30,23,73,507,16,194,134,250,210,384,1538,2962,10,30538,1696,0,2,0,4,0
36817,90,2032,996,429,845,24,10,117,1020,7,76,50,88,83,138,494,879,4,3565,198,0,2,0,4,0
36818,90,2032,456,277,329,12,42,72,468,13,85,50,97,98,147,592,972,7,7212,400,0,2,0,4,0
36819,160,3447,1513,682,1277,25,13,200,1538,11,199,116,219,210,335,1557,2584,6,15641,868,0,2,0,4,0
36820,160,3447,819,519,539,24,98,155,843,15,96,57,106,111,163,690,1107,8,9171,509,0,2,0,4,0
36821,59,1108,207,111,150,11,0,50,218,5,26,19,36,31,55,133,272,3,943,52,0,2,0,4,0
36822,59,1108,410,198,237,31,55,97,441,11,63,38,72,74,110,414,683,6,4293,238,0,2,0,4,0
36823,235,4901,2,2,2,0,0,0,2,0,0,0,0,0,0,0,0,0,0,0,0,2,0,4,0
36824,235,4901,99,48,90,1,3,5,100,0,0,0,0,0,0,0,0,0,0,0,0,2,0,4,0
36825,235,4901,8,5,5,2,0,1,10,0,0,0,0,0,0,0,0,0,0,0,0,2,0,4,0
36826,235,4901,1217,716,841,84,126,174,1301,14,185,118,215,199,333,1446,2542,8,20687,1149,0,2,0,4,0
36827,235,4901,160,89,115,0,13,31,160,7,15,11,17,22,28,78,124,3,495,27,0,2,0,4,0
36828,235,4901,10,10,9,9,0,0,19,0,0,0,0,0,0,0,0,0,0,0,0,2,0,4,0
36829,235,4901,173,84,99,8,29,36,181,5,12,7,13,17,20,54,81,2,221,12,0,2,0,4,0
36830,235,4901,3,1,1,3,0,0,6,0,0,0,0,0,0,0,0,0,0,0,0,2,0,4,0
36831,57,1510,339,213,244,17,9,65,356,10,42,26,48,52,74,259,421,5,2410,133,0,2,0,4,0
36832,90,2296,1455,414,1257,16,76,112,1471,5,41,23,46,46,69,231,381,2,1069,59,0,2,0,4,0
36833,90,2296,669,365,481,22,61,110,691,15,103,63,122,118,185,747,1273,8,11311,628,0,2,0,4,0
36834,251,5826,4293,999,3693,19,54,507,4312,9,155,88,170,164,258,1156,1898,4,9368,520,0,2,0,4,0
36835,251,5826,1482,859,1002,125,135,219,1607,16,219,134,251,235,385,1766,3032,9,27804,1544,1,2,0,4,0
36836,6,128,44,22,19,0,19,6,44,2,10,6,12,12,18,35,64,1,77,4,0,2,0,3,0
36837,31,1075,74,35,59,1,0,14,75,3,14,7,14,17,21,58,85,1,128,7,0,2,0,4,0
36838,31,1075,245,125,200,5,7,34,250,7,30,17,34,37,51,166,265,3,1053,58,0,2,0,4,0
36839,117,3148,1523,757,1297,19,12,193,1542,12,193,117,230,205,347,1508,2664,7,19053,1058,0,2,0,4,0
36840,117,3148,701,378,504,33,58,109,734,13,110,68,126,123,194,794,1346,7,10027,557,0,2,0,4,0
36841,105,2767,773,422,505,30,103,129,803,14,77,46,83,91,129,535,839,7,6334,351,0,2,0,4,0
36842,149,3591,77,34,69,0,0,8,77,3,24,16,29,27,45,114,213,1,387,21,0,2,0,4,0
36843,149,3591,712,438,573,51,9,84,763,14,102,71,128,116,199,733,1364,8,11988,666,0,2,0,4,0
36844,24,600,2,2,2,0,0,0,2,0,0,0,0,0,0,0,0,0,0,0,0,2,0,4,0
36845,24,600,99,48,90,1,3,5,100,0,0,0,0,0,0,0,0,0,0,0,0,2,0,4,0
36846,24,600,8,5,5,2,0,1,10,0,0,0,0,0,0,0,0,0,0,0,0,2,0,4,0
36847,24,600,1217,716,841,84,126,174,1301,14,185,118,215,199,333,1446,2542,8,20687,1149,0,2,0,4,0
36848,24,600,160,89,115,0,13,31,160,7,15,11,17,22,28,78,124,3,495,27,0,2,0,4,0
36849,24,600,10,10,9,9,0,0,19,0,0,0,0,0,0,0,0,0,0,0,0,2,0,4,0
36850,24,600,173,84,99,8,29,36,181,5,12,7,13,17,20,54,81,2,221,12,0,2,0,4,0
36851,24,600,3,1,1,3,0,0,6,0,0,0,0,0,0,0,0,0,0,0,0,2,0,4,0
36852,51,1101,447,308,343,6,5,95,453,7,96,59,111,103,170,651,1136,4,4600,255,0,2,0,4,0
36853,51,1101,322,174,179,16,74,51,338,10,41,26,46,51,72,252,408,5,2291,127,0,2,0,4,0
36854,75,1617,53,23,39,0,0,13,53,2,8,4,8,10,12,26,39,1,39,2,0,2,0,4,0
36855,75,1617,515,298,307,33,80,99,548,12,63,44,77,75,121,419,753,7,5527,307,0,2,0,4,0
36856,18,300,424,94,331,4,0,89,428,1,5,5,5,6,10,11,25,0,12,0,0,2,0,4,0
36857,18,300,38,23,23,6,0,8,44,3,11,7,11,14,18,42,68,1,102,5,0,2,0,4,0
36858,19,501,205,80,86,16,53,53,221,7,18,10,19,25,29,94,134,3,497,27,0,2,0,4,0
36859,15,478,184,100,137,2,15,30,186,6,38,20,39,44,59,214,322,3,991,55,0,2,0,4,0
36860,15,478,103,65,74,8,5,16,111,7,17,9,17,24,26,89,119,3,417,23,0,2,0,4,0
36861,58,1197,91,45,69,0,3,18,91,3,9,6,10,12,16,33,57,1,95,5,0,2,0,1,0
36862,58,1197,367,234,237,17,34,68,384,16,55,34,61,71,95,381,584,8,5183,287,0,2,0,1,0
36863,228,5891,722,423,573,19,0,135,741,12,172,101,199,184,300,1320,2257,6,15668,870,0,2,0,4,0
36864,228,5891,1508,847,911,44,250,301,1552,14,148,88,169,162,257,1120,1886,7,15077,837,0,2,0,4,0
36865,315,6902,72,33,56,0,4,12,72,1,1,1,1,2,2,0,2,0,1,0,0,2,0,4,0
36866,315,6902,1454,835,1044,76,110,219,1530,17,275,158,296,292,454,2297,3718,9,34017,1889,1,2,0,4,0
36867,89,1807,757,253,292,73,244,162,830,13,61,38,67,74,105,409,651,7,4654,258,0,2,1,4,0
36868,38,802,386,256,301,16,9,68,402,4,59,35,69,63,104,355,621,2,1453,80,0,2,0,4,0
36869,38,802,264,131,164,11,41,46,275,6,38,22,40,44,62,214,338,3,1068,59,0,2,0,4,0
36870,25,540,215,129,180,6,0,29,221,8,65,43,72,73,115,415,711,4,3153,175,0,2,0,4,0
36871,25,540,97,69,77,3,3,16,100,6,22,13,23,28,36,113,173,3,542,30,0,2,0,4,0
36872,89,1882,1043,504,840,53,9,147,1096,9,180,112,198,189,310,1377,2344,4,11604,644,0,2,0,4,0
36873,89,1882,383,288,292,26,6,62,409,11,65,38,67,76,105,429,656,5,3719,206,0,2,0,4,0
36874,20,408,294,64,250,0,0,43,294,1,20,10,20,21,30,86,131,0,65,3,0,2,0,4,0
36875,20,408,78,46,62,3,0,14,81,3,8,4,8,11,12,28,41,1,62,3,0,2,0,4,0
36876,5,111,110,30,77,3,13,16,113,4,21,15,30,25,45,100,208,2,597,33,0,2,0,4,0
36877,5,111,28,15,21,1,0,6,29,0,0,0,0,0,0,0,0,0,0,0,0,2,0,4,0
36878,40,784,1178,367,1042,6,15,115,1184,9,94,51,95,103,146,644,976,4,4439,246,0,2,0,4,0
36879,40,784,177,108,140,8,0,27,185,6,30,16,32,36,48,162,248,3,794,44,0,2,0,4,0
36880,280,5876,1943,715,1694,26,18,214,1969,12,185,120,237,197,357,1436,2721,7,20915,1161,0,2,0,4,0
36881,280,5876,1168,838,957,57,25,144,1225,19,348,224,416,367,640,3018,5452,11,61921,3440,1,2,0,4,0
36882,19,705,442,244,305,14,16,103,456,11,68,45,75,79,120,452,756,6,4588,254,0,2,0,4,0
36883,19,705,182,102,99,11,40,35,193,3,11,6,11,14,17,42,64,1,97,5,0,2,0,4,0
36884,65,1251,1098,241,925,5,10,155,1103,7,46,25,49,53,74,273,423,3,1580,87,0,2,0,4,0
36885,65,1251,282,202,222,14,2,44,296,8,42,24,43,50,67,250,378,4,1548,86,0,2,0,4,0
36886,23,630,601,196,481,2,23,85,603,8,63,36,72,71,108,400,664,4,3036,168,0,2,0,4,0
36887,23,630,156,79,106,5,16,28,161,5,14,8,15,19,23,64,97,2,261,14,0,2,0,4,0
36888,104,4424,1289,550,1043,56,32,155,1345,10,167,93,185,177,278,1266,2075,5,11498,638,0,2,0,4,0
36889,31,982,182,127,129,0,0,53,182,5,39,21,42,44,63,217,343,2,926,51,0,2,0,4,0
36890,151,7235,1392,870,1177,35,17,170,1427,14,494,280,531,508,811,4473,7289,7,54850,3047,2,2,1,5,0
36891,95,2884,773,419,590,28,0,166,801,10,204,113,217,214,330,1598,2554,5,13587,754,0,2,0,4,0
36892,14,833,75,38,59,1,3,12,76,2,4,2,4,6,6,10,15,1,15,0,0,2,0,4,0
36893,19,505,102,59,69,5,3,24,107,6,22,15,28,28,43,113,206,3,789,43,0,2,0,4,0
36894,119,4908,1450,624,1228,12,26,181,1462,14,306,186,354,320,540,2580,4493,8,36391,2021,1,2,0,4,0
36895,176,5150,1660,832,1314,41,38,274,1701,20,312,209,395,332,604,2671,5058,12,64042,3557,1,2,0,4,0
36896,49,3793,996,429,845,24,10,117,1020,7,76,50,88,83,138,494,879,4,3565,198,0,2,0,4,0
36897,120,5111,1513,682,1277,25,13,200,1538,11,199,116,219,210,335,1557,2584,6,15641,868,0,2,0,4,0
36898,84,4904,1296,573,1062,40,33,157,1336,8,201,118,231,209,349,1561,2689,4,12365,686,0,2,0,4,0
36899,20,455,207,111,150,11,0,50,218,5,26,19,36,31,55,133,272,3,943,52,0,2,0,4,0
36900,98,5229,1457,730,1242,11,6,188,1468,10,292,166,329,302,495,2424,4078,5,22973,1276,1,2,0,4,0
36901,43,2678,652,304,544,16,6,88,668,6,89,51,101,95,152,591,998,3,3399,188,0,2,0,4,0
36902,72,3254,1455,414,1257,16,76,112,1471,5,41,23,46,46,69,231,381,2,1069,59,0,2,0,4,0
36903,2,44,7,6,5,0,0,2,7,1,1,1,2,2,3,0,3,1,3,0,0,2,0,4,0
36904,8,263,74,35,59,1,0,14,75,3,14,7,14,17,21,58,85,1,128,7,0,2,0,4,0
36905,107,5148,1523,757,1297,19,12,193,1542,12,193,117,230,205,347,1508,2664,7,19053,1058,0,2,0,4,0
36906,70,3192,1020,354,843,12,15,144,1032,8,134,77,144,142,221,970,1580,4,6792,377,0,2,0,4,0
36907,44,2046,447,308,343,6,5,95,453,7,96,59,111,103,170,651,1136,4,4600,255,0,2,0,4,0
36908,21,643,424,94,331,4,0,89,428,1,5,5,5,6,10,11,25,0,12,0,0,2,0,4,0
36909,38,2315,334,251,279,10,4,40,344,5,127,74,143,132,217,899,1528,2,4303,239,0,2,0,4,0
36910,9,432,184,100,137,2,15,30,186,6,38,20,39,44,59,214,322,3,991,55,0,2,0,4,0
36911,75,3948,1293,570,1093,25,15,163,1318,10,195,123,241,205,364,1516,2795,6,17273,959,0,2,0,4,0
36912,29,1891,384,251,317,7,8,52,391,11,70,44,84,81,128,467,811,6,5355,297,0,2,0,4,0
36913,56,2871,722,423,573,19,0,135,741,12,172,101,199,184,300,1320,2257,6,15668,870,0,2,0,4,0
36914,45,1941,386,256,301,16,9,68,402,4,59,35,69,63,104,355,621,2,1453,80,0,2,0,4,0
36915,15,1054,215,129,180,6,0,29,221,8,65,43,72,73,115,415,711,4,3153,175,0,2,0,4,0
36916,85,3375,1043,504,840,53,9,147,1096,9,180,112,198,189,310,1377,2344,4,11604,644,0,2,0,4,0
36917,12,466,295,56,236,0,4,54,295,2,9,5,10,11,15,30,51,1,57,3,0,2,0,4,0
36918,30,1428,373,158,315,8,0,51,381,5,76,44,79,81,123,486,779,2,2026,112,0,2,0,4,0
36919,79,3089,1178,367,1042,6,15,115,1184,9,94,51,95,103,146,644,976,4,4439,246,0,2,0,4,0
36920,111,6110,1943,715,1694,26,18,214,1969,12,185,120,237,197,357,1436,2721,7,20915,1161,0,2,0,4,0
36921,35,1485,442,244,305,14,16,103,456,11,68,45,75,79,120,452,756,6,4588,254,0,2,0,4,0
36922,48,1931,1098,241,925,5,10,155,1103,7,46,25,49,53,74,273,423,3,1580,87,0,2,0,4,0
36923,48,1645,601,196,481,2,23,85,603,8,63,36,72,71,108,400,664,4,3036,168,0,2,0,2,0
36924,1,313,382,65,130,157,2,92,539,4,10,5,10,14,15,41,57,2,114,6,0,2,9,9,1
36925,60,1118,282,196,195,3,0,86,285,8,130,71,141,138,212,936,1507,4,6538,363,0,2,15,15,1
36926,7,111,44,19,17,0,16,11,44,3,14,7,14,17,21,58,85,1,128,7,0,2,1,1,1
36927,3,63,127,75,83,2,11,30,129,4,14,7,14,18,21,61,87,2,175,9,0,2,1,1,1
36928,3,63,652,304,544,16,6,88,668,6,89,51,101,95,152,591,998,3,3399,188,0,2,1,1,1
36929,3,63,2,2,2,0,0,0,2,0,0,0,0,0,0,0,0,0,0,0,0,2,1,1,1
36930,3,63,8,5,5,0,0,3,8,0,0,0,0,0,0,0,0,0,0,0,0,2,1,1,1
36931,3,63,2,2,2,0,0,0,2,0,0,0,0,0,0,0,0,0,0,0,0,2,1,1,1
36932,3,63,14,8,8,0,0,6,14,0,0,0,0,0,0,0,0,0,0,0,0,2,1,1,1
36933,3,63,6,4,4,0,0,2,6,0,0,0,0,0,0,0,0,0,0,0,0,2,1,1,1
36934,3,63,6,4,4,0,0,2,6,1,2,1,2,3,3,2,4,0,2,0,0,2,1,1,1
36935,3,63,6,4,4,0,0,2,6,0,0,0,0,0,0,0,0,0,0,0,0,2,1,1,1
36936,3,63,7,5,5,0,0,2,7,0,0,0,0,0,0,0,0,0,0,0,0,2,1,1,1
36937,3,63,6,4,4,0,0,2,6,0,0,0,0,0,0,0,0,0,0,0,0,2,1,1,1
36938,3,63,10,6,6,0,0,4,10,0,0,0,0,0,0,0,0,0,0,0,0,2,1,1,1
36939,3,63,1,1,1,0,0,0,1,0,0,0,0,0,0,0,0,0,0,0,0,2,1,1,1
36940,3,63,1,1,1,0,0,0,1,0,0,0,0,0,0,0,0,0,0,0,0,2,1,1,1
36941,3,63,14,10,10,0,0,4,14,1,1,1,1,2,2,0,2,0,1,0,0,2,1,1,1
36942,3,63,46,26,30,3,0,12,49,3,6,3,6,9,9,20,28,1,42,2,0,2,1,1,1
36943,7,293,72,33,56,0,4,12,72,1,1,1,1,2,2,0,2,0,1,0,0,2,1,1,1
36944,12,226,127,75,83,2,11,30,129,4,14,7,14,18,21,61,87,2,175,9,0,2,1,1,1
36945,12,226,652,304,544,16,6,88,668,6,89,51,101,95,152,591,998,3,3399,188,0,2,1,1,1
36946,12,226,2,2,2,0,0,0,2,0,0,0,0,0,0,0,0,0,0,0,0,2,1,1,1
36947,12,226,8,5,5,0,0,3,8,0,0,0,0,0,0,0,0,0,0,0,0,2,1,1,1
36948,12,226,2,2,2,0,0,0,2,0,0,0,0,0,0,0,0,0,0,0,0,2,1,1,1
36949,12,226,14,8,8,0,0,6,14,0,0,0,0,0,0,0,0,0,0,0,0,2,1,1,1
36950,12,226,6,4,4,0,0,2,6,0,0,0,0,0,0,0,0,0,0,0,0,2,1,1,1
36951,12,226,6,4,4,0,0,2,6,1,2,1,2,3,3,2,4,0,2,0,0,2,1,1,1
36952,12,226,6,4,4,0,0,2,6,0,0,0,0,0,0,0,0,0,0,0,0,2,1,1,1
36953,12,226,7,5,5,0,0,2,7,0,0,0,0,0,0,0,0,0,0,0,0,2,1,1,1
36954,12,226,6,4,4,0,0,2,6,0,0,0,0,0,0,0,0,0,0,0,0,2,1,1,1
36955,12,226,10,6,6,0,0,4,10,0,0,0,0,0,0,0,0,0,0,0,0,2,1,1,1
36956,12,226,1,1,1,0,0,0,1,0,0,0,0,0,0,0,0,0,0,0,0,2,1,1,1
36957,12,226,1,1,1,0,0,0,1,0,0,0,0,0,0,0,0,0,0,0,0,2,1,1,1
36958,12,226,14,10,10,0,0,4,14,1,1,1,1,2,2,0,2,0,1,0,0,2,1,1,1
36959,12,226,46,26,30,3,0,12,49,3,6,3,6,9,9,20,28,1,42,2,0,2,1,1,1
36960,3,23,14,7,7,2,0,5,16,0,0,0,0,0,0,0,0,0,0,0,0,2,1,1,1
36961,11,227,19,8,11,5,0,4,24,2,5,3,6,7,9,13,25,1,30,1,0,2,1,1,1
36962,11,227,102,59,69,5,3,24,107,6,22,15,28,28,43,113,206,3,789,43,0,2,1,1,1
36963,11,227,106,40,36,3,49,17,109,8,17,13,23,25,36,93,167,5,904,50,0,2,1,1,1
36964,221,4718,182,127,129,0,0,53,182,5,39,21,42,44,63,217,343,2,926,51,0,2,19,17,1
36965,221,4718,1165,710,800,67,119,181,1232,18,243,153,282,261,435,2000,3492,10,36473,2026,1,2,19,17,1
36966,67,1551,773,419,590,28,0,166,801,10,204,113,217,214,330,1598,2554,5,13587,754,0,2,2,3,1
36967,67,1551,421,273,302,44,34,57,465,17,81,59,107,98,166,583,1098,11,12329,684,0,2,2,3,1
36968,14,404,149,95,105,2,0,41,151,8,54,28,55,62,83,334,494,4,2013,111,0,2,5,8,1
36969,14,404,82,56,54,0,13,15,82,4,13,8,16,17,24,56,98,2,241,13,0,2,5,8,1
36970,25,489,2,2,2,0,0,0,2,0,0,0,0,0,0,0,0,0,0,0,0,2,3,5,1
36971,25,489,99,48,90,1,3,5,100,0,0,0,0,0,0,0,0,0,0,0,0,2,3,5,1
36972,25,489,8,5,5,2,0,1,10,0,0,0,0,0,0,0,0,0,0,0,0,2,3,5,1
36973,25,489,1217,716,841,84,126,174,1301,14,185,118,215,199,333,1446,2542,8,20687,1149,0,2,3,5,1
36974,25,489,160,89,115,0,13,31,160,7,15,11,17,22,28,78,124,3,495,27,0,2,3,5,1
36975,25,489,10,10,9,9,0,0,19,0,0,0,0,0,0,0,0,0,0,0,0,2,3,5,1
36976,25,489,173,84,99,8,29,36,181,5,12,7,13,17,20,54,81,2,221,12,0,2,3,5,1
36977,25,489,3,1,1,3,0,0,6,0,0,0,0,0,0,0,0,0,0,0,0,2,3,5,1
36978,174,5271,1660,832,1314,41,38,274,1701,20,312,209,395,332,604,2671,5058,12,64042,3557,1,2,33,29,1
36979,174,5271,1057,646,719,113,100,145,1170,18,215,134,248,233,382,1740,3004,10,31186,1732,1,2,33,29,1
36980,17,327,95,58,50,9,16,20,104,12,33,24,45,45,69,209,378,8,3100,172,0,2,1,3,1
36981,116,2120,477,336,357,30,23,73,507,16,194,134,250,210,384,1538,2962,10,30538,1696,0,2,43,41,1
36982,90,2017,996,429,845,24,10,117,1020,7,76,50,88,83,138,494,879,4,3565,198,0,2,7,8,1
36983,90,2017,456,277,329,12,42,72,468,13,85,50,97,98,147,592,972,7,7212,400,0,2,7,8,1
36984,160,3411,1513,682,1277,25,13,200,1538,11,199,116,219,210,335,1557,2584,6,15641,868,0,2,19,28,1
36985,160,3411,819,519,539,24,98,155,843,15,96,57,106,111,163,690,1107,8,9171,509,0,2,19,28,1
36986,59,1095,207,111,150,11,0,50,218,5,26,19,36,31,55,133,272,3,943,52,0,2,5,7,1
36987,59,1095,410,198,237,31,55,97,441,11,63,38,72,74,110,414,683,6,4293,238,0,2,5,7,1
36988,235,4869,2,2,2,0,0,0,2,0,0,0,0,0,0,0,0,0,0,0,0,2,20,24,1
36989,235,4869,99,48,90,1,3,5,100,0,0,0,0,0,0,0,0,0,0,0,0,2,20,24,1
36990,235,4869,8,5,5,2,0,1,10,0,0,0,0,0,0,0,0,0,0,0,0,2,20,24,1
36991,235,4869,1217,716,841,84,126,174,1301,14,185,118,215,199,333,1446,2542,8,20687,1149,0,2,20,24,1
36992,235,4869,160,89,115,0,13,31,160,7,15,11,17,22,28,78,124,3,495,27,0,2,20,24,1
36993,235,4869,10,10,9,9,0,0,19,0,0,0,0,0,0,0,0,0,0,0,0,2,20,24,1
36994,235,4869,173,84,99,8,29,36,181,5,12,7,13,17,20,54,81,2,221,12,0,2,20,24,1
36995,235,4869,3,1,1,3,0,0,6,0,0,0,0,0,0,0,0,0,0,0,0,2,20,24,1
36996,98,2010,463,295,324,28,62,57,491,12,134,82,154,146,236,989,1696,6,11700,650,0,2,8,9,1
36997,57,1484,339,213,244,17,9,65,356,10,42,26,48,52,74,259,421,5,2410,133,0,2,11,11,1
36998,90,2288,1455,414,1257,16,76,112,1471,5,41,23,46,46,69,231,381,2,1069,59,0,2,4,4,1
36999,90,2288,669,365,481,22,61,110,691,15,103,63,122,118,185,747,1273,8,11311,628,0,2,4,4,1
37000,251,5813,4293,999,3693,19,54,507,4312,9,155,88,170,164,258,1156,1898,4,9368,520,0,2,13,15,1
37001,251,5813,1482,859,1002,125,135,219,1607,16,219,134,251,235,385,1766,3032,9,27804,1544,1,2,13,15,1
37002,31,1078,74,35,59,1,0,14,75,3,14,7,14,17,21,58,85,1,128,7,0,2,9,7,1
37003,31,1078,245,125,200,5,7,34,250,7,30,17,34,37,51,166,265,3,1053,58,0,2,9,7,1
37004,117,3127,1523,757,1297,19,12,193,1542,12,193,117,230,205,347,1508,2664,7,19053,1058,0,2,10,11,1
37005,117,3127,701,378,504,33,58,109,734,13,110,68,126,123,194,794,1346,7,10027,557,0,2,10,11,1
37006,105,2753,773,422,505,30,103,129,803,14,77,46,83,91,129,535,839,7,6334,351,0,2,5,5,1
37007,146,3571,77,34,69,0,0,8,77,3,24,16,29,27,45,114,213,1,387,21,0,2,13,21,1
37008,146,3571,712,438,573,51,9,84,763,14,102,71,128,116,199,733,1364,8,11988,666,0,2,13,21,1
37009,30,657,125,97,103,3,0,19,128,9,25,17,27,34,44,144,223,4,1087,60,0,2,2,4,1
37010,22,367,102,57,55,5,16,25,107,5,17,10,18,22,28,81,124,2,330,18,0,2,2,2,1
37011,71,1560,402,202,227,24,74,80,426,12,52,33,61,64,94,339,564,7,3969,220,0,2,7,8,1
37012,51,1090,447,308,343,6,5,95,453,7,96,59,111,103,170,651,1136,4,4600,255,0,2,13,11,1
37013,51,1090,322,174,179,16,74,51,338,10,41,26,46,51,72,252,408,5,2291,127,0,2,13,11,1
37014,75,1603,53,23,39,0,0,13,53,2,8,4,8,10,12,26,39,1,39,2,0,2,6,9,1
37015,75,1603,515,298,307,33,80,99,548,12,63,44,77,75,121,419,753,7,5527,307,0,2,6,9,1
37016,18,296,424,94,331,4,0,89,428,1,5,5,5,6,10,11,25,0,12,0,0,2,1,3,1
37017,18,296,38,23,23,6,0,8,44,3,11,7,11,14,18,42,68,1,102,5,0,2,1,3,1
37018,19,499,205,80,86,16,53,53,221,7,18,10,19,25,29,94,134,3,497,27,0,2,3,3,1
37019,15,476,184,100,137,2,15,30,186,6,38,20,39,44,59,214,322,3,991,55,0,2,3,5,1
37020,15,476,103,65,74,8,5,16,111,7,17,9,17,24,26,89,119,3,417,23,0,2,3,5,1
37021,58,1189,91,45,69,0,3,18,91,3,9,6,10,12,16,33,57,1,95,5,0,2,5,6,1
37022,58,1189,367,234,237,17,34,68,384,16,55,34,61,71,95,381,584,8,5183,287,0,2,5,6,1
37023,228,5843,722,423,573,19,0,135,741,12,172,101,199,184,300,1320,2257,6,15668,870,0,2,34,33,1
37024,228,5843,1508,847,911,44,250,301,1552,14,148,88,169,162,257,1120,1886,7,15077,837,0,2,34,33,1
37025,314,6872,72,33,56,0,4,12,72,1,1,1,1,2,2,0,2,0,1,0,0,2,20,23,1
37026,314,6872,1454,835,1044,76,110,219,1530,17,275,158,296,292,454,2297,3718,9,34017,1889,1,2,20,23,1
37027,89,1801,757,253,292,73,244,162,830,13,61,38,67,74,105,409,651,7,4654,258,0,2,2,2,1
37028,38,787,386,256,301,16,9,68,402,4,59,35,69,63,104,355,621,2,1453,80,0,2,5,5,1
37029,38,787,264,131,164,11,41,46,275,6,38,22,40,44,62,214,338,3,1068,59,0,2,5,5,1
37030,67,1747,466,257,367,18,25,50,484,7,126,86,171,133,257,898,1813,4,8612,478,0,2,9,18,1
37031,67,1747,507,281,342,29,59,88,536,10,53,29,57,63,86,336,514,5,2764,153,0,2,9,18,1
37032,25,538,215,129,180,6,0,29,221,8,65,43,72,73,115,415,711,4,3153,175,0,2,2,2,1
37033,25,538,97,69,77,3,3,16,100,6,22,13,23,28,36,113,173,3,542,30,0,2,2,2,1
37034,89,1877,1043,504,840,53,9,147,1096,9,180,112,198,189,310,1377,2344,4,11604,644,0,2,3,3,1
37035,89,1877,383,288,292,26,6,62,409,11,65,38,67,76,105,429,656,5,3719,206,0,2,3,3,1
37036,280,5869,1943,715,1694,26,18,214,1969,12,185,120,237,197,357,1436,2721,7,20915,1161,0,2,19,22,1
37037,280,5869,1168,838,957,57,25,144,1225,19,348,224,416,367,640,3018,5452,11,61921,3440,1,2,19,22,1
37038,19,699,442,244,305,14,16,103,456,11,68,45,75,79,120,452,756,6,4588,254,0,2,2,2,1
37039,19,699,182,102,99,11,40,35,193,3,11,6,11,14,17,42,64,1,97,5,0,2,2,2,1
37040,2,153,37,13,25,0,6,6,37,1,2,1,2,3,3,2,4,0,2,0,0,2,1,1,1
37041,2,153,133,47,40,1,43,49,134,0,0,0,0,0,0,0,0,0,0,0,0,2,1,1,1
37042,23,630,601,196,481,2,23,85,603,8,63,36,72,71,108,400,664,4,3036,168,0,2,2,2,1
37043,23,630,156,79,106,5,16,28,161,5,14,8,15,19,23,64,97,2,261,14,0,2,2,2,1
37044,104,4398,1289,550,1043,56,32,155,1345,10,167,93,185,177,278,1266,2075,5,11498,638,0,2,9,10,1
37045,31,963,182,127,129,0,0,53,182,5,39,21,42,44,63,217,343,2,926,51,0,2,7,8,1
37046,151,7198,1392,870,1177,35,17,170,1427,14,494,280,531,508,811,4473,7289,7,54850,3047,2,2,14,15,1
37047,95,2841,773,419,590,28,0,166,801,10,204,113,217,214,330,1598,2554,5,13587,754,0,2,16,16,1
37048,1,52,14,12,10,0,0,4,14,1,2,1,2,3,3,2,4,0,2,0,0,2,1,1,1
37049,1,55,14,12,10,0,0,4,14,1,2,1,2,3,3,2,4,0,2,0,0,2,1,1,1
37050,1,52,14,12,10,0,0,4,14,1,2,1,2,3,3,2,4,0,2,0,0,2,1,1,1
37051,1,71,19,18,14,0,0,5,19,1,2,1,2,3,3,2,4,0,2,0,0,2,2,2,1
37052,3,44,15,10,10,0,0,5,15,2,4,2,4,6,6,10,15,1,15,0,0,2,1,1,1
37053,2,33,10,7,7,0,0,3,10,1,2,1,2,3,3,2,4,0,2,0,0,2,1,1,1
37054,3,43,15,9,9,0,0,6,15,1,4,2,4,5,6,8,13,0,6,0,0,2,1,1,1
37055,12,313,149,95,105,2,0,41,151,8,54,28,55,62,83,334,494,4,2013,111,0,2,3,3,1
37056,15,699,139,89,101,2,0,35,141,7,54,34,62,61,96,330,569,4,2287,127,0,2,4,4,1
37057,3,324,149,67,118,4,0,27,153,1,17,14,28,18,42,69,175,0,144,8,0,2,2,2,1
37058,38,2497,1157,318,931,29,22,177,1186,6,104,63,125,110,188,712,1274,3,4596,255,0,2,1,1,1
37059,65,4371,520,294,400,33,13,81,553,10,261,204,367,271,571,2128,4614,7,32445,1802,1,2,3,3,1
37060,90,3959,1338,495,1086,10,64,173,1348,11,122,82,157,133,239,883,1686,7,11934,663,0,2,11,11,1
37061,172,7590,4293,999,3693,19,54,507,4312,9,155,88,170,164,258,1156,1898,4,9368,520,0,2,15,15,1
37062,172,7590,1482,859,1002,125,135,219,1607,16,219,134,251,235,385,1766,3032,9,27804,1544,1,2,15,15,1
37063,33,984,465,148,393,5,8,60,470,4,31,20,31,35,51,161,261,2,523,29,0,2,5,5,1
37064,33,984,16,12,9,0,0,6,16,1,2,1,2,3,3,2,4,0,2,0,0,2,5,5,1
37065,144,5870,1782,648,1425,9,47,279,1791,8,171,97,189,179,286,1292,2140,4,9462,525,0,2,30,31,1
37066,32,968,256,139,192,9,7,47,265,4,23,12,24,27,36,112,171,2,357,19,0,2,4,7,1
37067,6,328,180,34,164,0,0,16,180,1,12,6,12,13,18,43,66,0,33,1,0,2,0,2,1
37068,19,499,102,59,69,5,3,24,107,6,22,15,28,28,43,113,206,3,789,43,0,2,2,2,1
37069,119,4854,1450,624,1228,12,26,181,1462,14,306,186,354,320,540,2580,4493,8,36391,2021,1,2,23,24,1
37070,176,5109,1660,832,1314,41,38,274,1701,20,312,209,395,332,604,2671,5058,12,64042,3557,1,2,14,15,1
37071,49,3780,996,429,845,24,10,117,1020,7,76,50,88,83,138,494,879,4,3565,198,0,2,5,5,1
37072,120,5083,1513,682,1277,25,13,200,1538,11,199,116,219,210,335,1557,2584,6,15641,868,0,2,10,10,1
37073,84,4871,1296,573,1062,40,33,157,1336,8,201,118,231,209,349,1561,2689,4,12365,686,0,2,11,11,1
37074,20,449,207,111,150,11,0,50,218,5,26,19,36,31,55,133,272,3,943,52,0,2,2,2,1
37075,98,5169,1457,730,1242,11,6,188,1468,10,292,166,329,302,495,2424,4078,5,22973,1276,1,2,20,20,1
37076,43,2669,652,304,544,16,6,88,668,6,89,51,101,95,152,591,998,3,3399,188,0,2,3,3,1
37077,72,3231,1455,414,1257,16,76,112,1471,5,41,23,46,46,69,231,381,2,1069,59,0,2,9,9,1
37078,107,5128,1523,757,1297,19,12,193,1542,12,193,117,230,205,347,1508,2664,7,19053,1058,0,2,12,12,1
37079,70,3177,1020,354,843,12,15,144,1032,8,134,77,144,142,221,970,1580,4,6792,377,0,2,5,5,1
37080,44,2024,447,308,343,6,5,95,453,7,96,59,111,103,170,651,1136,4,4600,255,0,2,8,8,1
37081,21,637,424,94,331,4,0,89,428,1,5,5,5,6,10,11,25,0,12,0,0,2,2,2,1
37082,38,2309,334,251,279,10,4,40,344,5,127,74,143,132,217,899,1528,2,4303,239,0,2,2,2,1
37083,9,423,184,100,137,2,15,30,186,6,38,20,39,44,59,214,322,3,991,55,0,2,3,3,1
37084,75,3937,1293,570,1093,25,15,163,1318,10,195,123,241,205,364,1516,2795,6,17273,959,0,2,5,5,1
37085,29,1873,384,251,317,7,8,52,391,11,70,44,84,81,128,467,811,6,5355,297,0,2,6,6,1
37086,56,2846,722,423,573,19,0,135,741,12,172,101,199,184,300,1320,2257,6,15668,870,0,2,10,10,1
37087,45,1932,386,256,301,16,9,68,402,4,59,35,69,63,104,355,621,2,1453,80,0,2,3,3,1
37088,28,1590,466,257,367,18,25,50,484,7,126,86,171,133,257,898,1813,4,8612,478,0,2,2,2,1
37089,15,1051,215,129,180,6,0,29,221,8,65,43,72,73,115,415,711,4,3153,175,0,2,1,1,1
37090,85,3359,1043,504,840,53,9,147,1096,9,180,112,198,189,310,1377,2344,4,11604,644,0,2,6,6,1
37091,30,1422,373,158,315,8,0,51,381,5,76,44,79,81,123,486,779,2,2026,112,0,2,2,2,1
37092,79,3071,1178,367,1042,6,15,115,1184,9,94,51,95,103,146,644,976,4,4439,246,0,2,6,6,1
37093,111,6048,1943,715,1694,26,18,214,1969,12,185,120,237,197,357,1436,2721,7,20915,1161,0,2,26,26,1
37094,35,1473,442,244,305,14,16,103,456,11,68,45,75,79,120,452,756,6,4588,254,0,2,4,4,1
37095,48,1928,1098,241,925,5,10,155,1103,7,46,25,49,53,74,273,423,3,1580,87,0,2,1,1,1
37096,48,1639,601,196,481,2,23,85,603,8,63,36,72,71,108,400,664,4,3036,168,0,2,1,1,1
37097,104,4398,1289,550,1043,56,32,155,1345,10,167,93,185,177,278,1266,2075,5,11498,638,0,2,2,3,1
37098,38,2497,1157,318,931,29,22,177,1186,6,104,63,125,110,188,712,1274,3,4596,255,0,2,2,4,1
37099,90,3959,1338,495,1086,10,64,173,1348,11,122,82,157,133,239,883,1686,7,11934,663,0,2,2,13,1
37100,172,7590,4293,999,3693,19,54,507,4312,9,155,88,170,164,258,1156,1898,4,9368,520,0,2,0,5,1
37101,172,7590,1482,859,1002,125,135,219,1607,16,219,134,251,235,385,1766,3032,9,27804,1544,1,2,0,5,1
37102,119,4854,1450,624,1228,12,26,181,1462,14,306,186,354,320,540,2580,4493,8,36391,2021,1,2,2,3,1
37103,120,5083,1513,682,1277,25,13,200,1538,11,199,116,219,210,335,1557,2584,6,15641,868,0,2,2,5,1
37104,72,3231,1455,414,1257,16,76,112,1471,5,41,23,46,46,69,231,381,2,1069,59,0,2,2,6,1
37105,107,5128,1523,757,1297,19,12,193,1542,12,193,117,230,205,347,1508,2664,7,19053,1058,0,2,2,2,1
37106,70,3177,1020,354,843,12,15,144,1032,8,134,77,144,142,221,970,1580,4,6792,377,0,2,0,1,1
37107,21,637,424,94,331,4,0,89,428,1,5,5,5,6,10,11,25,0,12,0,0,2,2,3,1
37108,9,423,184,100,137,2,15,30,186,6,38,20,39,44,59,214,322,3,991,55,0,2,2,3,1
37109,29,1873,384,251,317,7,8,52,391,11,70,44,84,81,128,467,811,6,5355,297,0,2,3,4,1
37110,85,3359,1043,504,840,53,9,147,1096,9,180,112,198,189,310,1377,2344,4,11604,644,0,2,4,6,1
37111,48,1639,601,196,481,2,23,85,603,8,63,36,72,71,108,400,664,4,3036,168,0,2,2,3,1
37112,228,5833,722,423,573,19,0,135,741,12,172,101,199,184,300,1320,2257,6,15668,870,0,2,4,5,0
37113,228,5833,1508,847,911,44,250,301,1552,14,148,88,169,162,257,1120,1886,7,15077,837,0,2,4,5,0
37114,38,2493,1157,318,931,29,22,177,1186,6,104,63,125,110,188,712,1274,3,4596,255,0,2,0,1,0
37115,1,92,42,7,35,4,0,5,46,1,2,1,2,3,3,2,4,0,2,0,0,2,0,1,0
37116,1,92,11,6,10,0,0,1,11,2,4,2,4,6,6,10,15,1,15,0,0,2,0,1,0
37117,174,5263,1660,832,1314,41,38,274,1701,20,312,209,395,332,604,2671,5058,12,64042,3557,1,2,1,2,0
37118,174,5263,1057,646,719,113,100,145,1170,18,215,134,248,233,382,1740,3004,10,31186,1732,1,2,1,2,0
37119,251,5822,4293,999,3693,19,54,507,4312,9,155,88,170,164,258,1156,1898,4,9368,520,0,2,5,5,0
37120,251,5822,1482,859,1002,125,135,219,1607,16,219,134,251,235,385,1766,3032,9,27804,1544,1,2,5,5,0
37121,104,2739,773,422,505,30,103,129,803,14,77,46,83,91,129,535,839,7,6334,351,0,2,23,28,0
37122,89,1896,1043,504,840,53,9,147,1096,9,180,112,198,189,310,1377,2344,4,11604,644,0,2,6,4,0
37123,89,1896,383,288,292,26,6,62,409,11,65,38,67,76,105,429,656,5,3719,206,0,2,6,4,0
37124,95,2839,773,419,590,28,0,166,801,10,204,113,217,214,330,1598,2554,5,13587,754,0,2,0,2,0
37125,3,305,149,67,118,4,0,27,153,1,17,14,28,18,42,69,175,0,144,8,0,2,0,5,0
37126,38,2493,1157,318,931,29,22,177,1186,6,104,63,125,110,188,712,1274,3,4596,255,0,2,2,3,0
37127,172,7590,4293,999,3693,19,54,507,4312,9,155,88,170,164,258,1156,1898,4,9368,520,0,2,2,3,0
37128,172,7590,1482,859,1002,125,135,219,1607,16,219,134,251,235,385,1766,3032,9,27804,1544,1,2,2,3,0
37129,144,5870,1782,648,1425,9,47,279,1791,8,171,97,189,179,286,1292,2140,4,9462,525,0,2,2,2,0
37130,48,1928,1098,241,925,5,10,155,1103,7,46,25,49,53,74,273,423,3,1580,87,0,2,1,1,0
37131,48,1639,601,196,481,2,23,85,603,8,63,36,72,71,108,400,664,4,3036,168,0,2,1,1,0
37132,95,2843,773,419,590,28,0,166,801,10,204,113,217,214,330,1598,2554,5,13587,754,0,2,1,1,0
37133,3,299,149,67,118,4,0,27,153,1,17,14,28,18,42,69,175,0,144,8,0,2,2,2,0
37134,3,42,14,8,8,0,0,6,14,0,0,0,0,0,0,0,0,0,0,0,0,2,0,1,0
37135,2,34,9,6,6,0,0,3,9,0,0,0,0,0,0,0,0,0,0,0,0,2,0,3,0
37136,2,34,13,9,8,0,0,4,13,0,0,0,0,0,0,0,0,0,0,0,0,2,0,3,0
37137,1,313,382,65,130,157,2,92,539,4,10,5,10,14,15,41,57,2,114,6,0,2,9,10,0
37138,60,1118,282,196,195,3,0,86,285,8,130,71,141,138,212,936,1507,4,6538,363,0,2,15,16,0
37139,4,77,127,75,83,2,11,30,129,4,14,7,14,18,21,61,87,2,175,9,0,2,0,1,0
37140,4,77,652,304,544,16,6,88,668,6,89,51,101,95,152,591,998,3,3399,188,0,2,0,1,0
37141,4,77,2,2,2,0,0,0,2,0,0,0,0,0,0,0,0,0,0,0,0,2,0,1,0
37142,4,77,8,5,5,0,0,3,8,0,0,0,0,0,0,0,0,0,0,0,0,2,0,1,0
37143,4,77,2,2,2,0,0,0,2,0,0,0,0,0,0,0,0,0,0,0,0,2,0,1,0
37144,4,77,14,8,8,0,0,6,14,0,0,0,0,0,0,0,0,0,0,0,0,2,0,1,0
37145,4,77,6,4,4,0,0,2,6,0,0,0,0,0,0,0,0,0,0,0,0,2,0,1,0
37146,4,77,6,4,4,0,0,2,6,1,2,1,2,3,3,2,4,0,2,0,0,2,0,1,0
37147,4,77,6,4,4,0,0,2,6,0,0,0,0,0,0,0,0,0,0,0,0,2,0,1,0
37148,4,77,7,5,5,0,0,2,7,0,0,0,0,0,0,0,0,0,0,0,0,2,0,1,0
37149,4,77,6,4,4,0,0,2,6,0,0,0,0,0,0,0,0,0,0,0,0,2,0,1,0
37150,4,77,10,6,6,0,0,4,10,0,0,0,0,0,0,0,0,0,0,0,0,2,0,1,0
37151,4,77,1,1,1,0,0,0,1,0,0,0,0,0,0,0,0,0,0,0,0,2,0,1,0
37152,4,77,1,1,1,0,0,0,1,0,0,0,0,0,0,0,0,0,0,0,0,2,0,1,0
37153,4,77,14,10,10,0,0,4,14,1,1,1,1,2,2,0,2,0,1,0,0,2,0,1,0
37154,4,77,46,26,30,3,0,12,49,3,6,3,6,9,9,20,28,1,42,2,0,2,0,1,0
37155,1,9,5,3,3,0,0,2,5,0,0,0,0,0,0,0,0,0,0,0,0,2,0,1,0
37156,1,90,13,10,10,0,0,3,13,1,2,1,2,3,3,2,4,0,2,0,0,2,0,1,0
37157,7,111,44,19,17,0,16,11,44,3,14,7,14,17,21,58,85,1,128,7,0,2,1,2,0
37158,3,63,127,75,83,2,11,30,129,4,14,7,14,18,21,61,87,2,175,9,0,2,1,2,0
37159,3,63,652,304,544,16,6,88,668,6,89,51,101,95,152,591,998,3,3399,188,0,2,1,2,0
37160,3,63,2,2,2,0,0,0,2,0,0,0,0,0,0,0,0,0,0,0,0,2,1,2,0
37161,3,63,8,5,5,0,0,3,8,0,0,0,0,0,0,0,0,0,0,0,0,2,1,2,0
37162,3,63,2,2,2,0,0,0,2,0,0,0,0,0,0,0,0,0,0,0,0,2,1,2,0
37163,3,63,14,8,8,0,0,6,14,0,0,0,0,0,0,0,0,0,0,0,0,2,1,2,0
37164,3,63,6,4,4,0,0,2,6,0,0,0,0,0,0,0,0,0,0,0,0,2,1,2,0
37165,3,63,6,4,4,0,0,2,6,1,2,1,2,3,3,2,4,0,2,0,0,2,1,2,0
37166,3,63,6,4,4,0,0,2,6,0,0,0,0,0,0,0,0,0,0,0,0,2,1,2,0
37167,3,63,7,5,5,0,0,2,7,0,0,0,0,0,0,0,0,0,0,0,0,2,1,2,0
37168,3,63,6,4,4,0,0,2,6,0,0,0,0,0,0,0,0,0,0,0,0,2,1,2,0
37169,3,63,10,6,6,0,0,4,10,0,0,0,0,0,0,0,0,0,0,0,0,2,1,2,0
37170,3,63,1,1,1,0,0,0,1,0,0,0,0,0,0,0,0,0,0,0,0,2,1,2,0
37171,3,63,1,1,1,0,0,0,1,0,0,0,0,0,0,0,0,0,0,0,0,2,1,2,0
37172,3,63,14,10,10,0,0,4,14,1,1,1,1,2,2,0,2,0,1,0,0,2,1,2,0
37173,3,63,46,26,30,3,0,12,49,3,6,3,6,9,9,20,28,1,42,2,0,2,1,2,0
37174,7,293,72,33,56,0,4,12,72,1,1,1,1,2,2,0,2,0,1,0,0,2,1,2,0
37175,12,226,127,75,83,2,11,30,129,4,14,7,14,18,21,61,87,2,175,9,0,2,1,2,0
37176,12,226,652,304,544,16,6,88,668,6,89,51,101,95,152,591,998,3,3399,188,0,2,1,2,0
37177,12,226,2,2,2,0,0,0,2,0,0,0,0,0,0,0,0,0,0,0,0,2,1,2,0
37178,12,226,8,5,5,0,0,3,8,0,0,0,0,0,0,0,0,0,0,0,0,2,1,2,0
37179,12,226,2,2,2,0,0,0,2,0,0,0,0,0,0,0,0,0,0,0,0,2,1,2,0
37180,12,226,14,8,8,0,0,6,14,0,0,0,0,0,0,0,0,0,0,0,0,2,1,2,0
37181,12,226,6,4,4,0,0,2,6,0,0,0,0,0,0,0,0,0,0,0,0,2,1,2,0
37182,12,226,6,4,4,0,0,2,6,1,2,1,2,3,3,2,4,0,2,0,0,2,1,2,0
37183,12,226,6,4,4,0,0,2,6,0,0,0,0,0,0,0,0,0,0,0,0,2,1,2,0
37184,12,226,7,5,5,0,0,2,7,0,0,0,0,0,0,0,0,0,0,0,0,2,1,2,0
37185,12,226,6,4,4,0,0,2,6,0,0,0,0,0,0,0,0,0,0,0,0,2,1,2,0
37186,12,226,10,6,6,0,0,4,10,0,0,0,0,0,0,0,0,0,0,0,0,2,1,2,0
37187,12,226,1,1,1,0,0,0,1,0,0,0,0,0,0,0,0,0,0,0,0,2,1,2,0
37188,12,226,1,1,1,0,0,0,1,0,0,0,0,0,0,0,0,0,0,0,0,2,1,2,0
37189,12,226,14,10,10,0,0,4,14,1,1,1,1,2,2,0,2,0,1,0,0,2,1,2,0
37190,12,226,46,26,30,3,0,12,49,3,6,3,6,9,9,20,28,1,42,2,0,2,1,2,0
37191,6,71,127,75,83,2,11,30,129,4,14,7,14,18,21,61,87,2,175,9,0,2,0,1,0
37192,6,71,652,304,544,16,6,88,668,6,89,51,101,95,152,591,998,3,3399,188,0,2,0,1,0
37193,6,71,2,2,2,0,0,0,2,0,0,0,0,0,0,0,0,0,0,0,0,2,0,1,0
37194,6,71,8,5,5,0,0,3,8,0,0,0,0,0,0,0,0,0,0,0,0,2,0,1,0
37195,6,71,2,2,2,0,0,0,2,0,0,0,0,0,0,0,0,0,0,0,0,2,0,1,0
37196,6,71,14,8,8,0,0,6,14,0,0,0,0,0,0,0,0,0,0,0,0,2,0,1,0
37197,6,71,6,4,4,0,0,2,6,0,0,0,0,0,0,0,0,0,0,0,0,2,0,1,0
37198,6,71,6,4,4,0,0,2,6,1,2,1,2,3,3,2,4,0,2,0,0,2,0,1,0
37199,6,71,6,4,4,0,0,2,6,0,0,0,0,0,0,0,0,0,0,0,0,2,0,1,0
37200,6,71,7,5,5,0,0,2,7,0,0,0,0,0,0,0,0,0,0,0,0,2,0,1,0
37201,6,71,6,4,4,0,0,2,6,0,0,0,0,0,0,0,0,0,0,0,0,2,0,1,0
37202,6,71,10,6,6,0,0,4,10,0,0,0,0,0,0,0,0,0,0,0,0,2,0,1,0
37203,6,71,1,1,1,0,0,0,1,0,0,0,0,0,0,0,0,0,0,0,0,2,0,1,0
37204,6,71,1,1,1,0,0,0,1,0,0,0,0,0,0,0,0,0,0,0,0,2,0,1,0
37205,6,71,14,10,10,0,0,4,14,1,1,1,1,2,2,0,2,0,1,0,0,2,0,1,0
37206,6,71,46,26,30,3,0,12,49,3,6,3,6,9,9,20,28,1,42,2,0,2,0,1,0
37207,3,23,14,7,7,2,0,5,16,0,0,0,0,0,0,0,0,0,0,0,0,2,1,2,0
37208,7,103,38,23,23,0,0,15,38,0,0,0,0,0,0,0,0,0,0,0,0,2,0,1,0
37209,17,378,85,59,61,8,0,16,93,5,18,10,18,23,28,86,126,2,316,17,0,2,0,1,0
37210,12,515,124,78,88,2,3,26,126,4,13,7,13,17,20,56,81,2,163,9,0,2,0,1,0
37211,1,92,42,7,35,4,0,5,46,1,2,1,2,3,3,2,4,0,2,0,0,2,0,2,0
37212,1,92,11,6,10,0,0,1,11,2,4,2,4,6,6,10,15,1,15,0,0,2,0,2,0
37213,11,227,19,8,11,5,0,4,24,2,5,3,6,7,9,13,25,1,30,1,0,2,1,6,0
37214,11,227,102,59,69,5,3,24,107,6,22,15,28,28,43,113,206,3,789,43,0,2,1,6,0
37215,11,227,106,40,36,3,49,17,109,8,17,13,23,25,36,93,167,5,904,50,0,2,1,6,0
37216,221,4718,182,127,129,0,0,53,182,5,39,21,42,44,63,217,343,2,926,51,0,2,19,22,0
37217,221,4718,1165,710,800,67,119,181,1232,18,243,153,282,261,435,2000,3492,10,36473,2026,1,2,19,22,0
37218,67,1551,773,419,590,28,0,166,801,10,204,113,217,214,330,1598,2554,5,13587,754,0,2,2,8,0
37219,67,1551,421,273,302,44,34,57,465,17,81,59,107,98,166,583,1098,11,12329,684,0,2,2,8,0
37220,14,404,149,95,105,2,0,41,151,8,54,28,55,62,83,334,494,4,2013,111,0,2,6,11,0
37221,14,404,82,56,54,0,13,15,82,4,13,8,16,17,24,56,98,2,241,13,0,2,6,11,0
37222,25,489,2,2,2,0,0,0,2,0,0,0,0,0,0,0,0,0,0,0,0,2,3,10,0
37223,25,489,99,48,90,1,3,5,100,0,0,0,0,0,0,0,0,0,0,0,0,2,3,10,0
37224,25,489,8,5,5,2,0,1,10,0,0,0,0,0,0,0,0,0,0,0,0,2,3,10,0
37225,25,489,1217,716,841,84,126,174,1301,14,185,118,215,199,333,1446,2542,8,20687,1149,0,2,3,10,0
37226,25,489,160,89,115,0,13,31,160,7,15,11,17,22,28,78,124,3,495,27,0,2,3,10,0
37227,25,489,10,10,9,9,0,0,19,0,0,0,0,0,0,0,0,0,0,0,0,2,3,10,0
37228,25,489,173,84,99,8,29,36,181,5,12,7,13,17,20,54,81,2,221,12,0,2,3,10,0
37229,25,489,3,1,1,3,0,0,6,0,0,0,0,0,0,0,0,0,0,0,0,2,3,10,0
37230,174,5263,1660,832,1314,41,38,274,1701,20,312,209,395,332,604,2671,5058,12,64042,3557,1,2,34,36,0
37231,174,5263,1057,646,719,113,100,145,1170,18,215,134,248,233,382,1740,3004,10,31186,1732,1,2,34,36,0
37232,17,327,95,58,50,9,16,20,104,12,33,24,45,45,69,209,378,8,3100,172,0,2,1,8,0
37233,116,2120,477,336,357,30,23,73,507,16,194,134,250,210,384,1538,2962,10,30538,1696,0,2,43,46,0
37234,90,2017,996,429,845,24,10,117,1020,7,76,50,88,83,138,494,879,4,3565,198,0,2,7,13,0
37235,90,2017,456,277,329,12,42,72,468,13,85,50,97,98,147,592,972,7,7212,400,0,2,7,13,0
37236,160,3411,1513,682,1277,25,13,200,1538,11,199,116,219,210,335,1557,2584,6,15641,868,0,2,19,33,0
37237,160,3411,819,519,539,24,98,155,843,15,96,57,106,111,163,690,1107,8,9171,509,0,2,19,33,0
37238,59,1095,207,111,150,11,0,50,218,5,26,19,36,31,55,133,272,3,943,52,0,2,5,12,0
37239,59,1095,410,198,237,31,55,97,441,11,63,38,72,74,110,414,683,6,4293,238,0,2,5,12,0
37240,235,4869,2,2,2,0,0,0,2,0,0,0,0,0,0,0,0,0,0,0,0,2,20,29,0
37241,235,4869,99,48,90,1,3,5,100,0,0,0,0,0,0,0,0,0,0,0,0,2,20,29,0
37242,235,4869,8,5,5,2,0,1,10,0,0,0,0,0,0,0,0,0,0,0,0,2,20,29,0
37243,235,4869,1217,716,841,84,126,174,1301,14,185,118,215,199,333,1446,2542,8,20687,1149,0,2,20,29,0
37244,235,4869,160,89,115,0,13,31,160,7,15,11,17,22,28,78,124,3,495,27,0,2,20,29,0
37245,235,4869,10,10,9,9,0,0,19,0,0,0,0,0,0,0,0,0,0,0,0,2,20,29,0
37246,235,4869,173,84,99,8,29,36,181,5,12,7,13,17,20,54,81,2,221,12,0,2,20,29,0
37247,235,4869,3,1,1,3,0,0,6,0,0,0,0,0,0,0,0,0,0,0,0,2,20,29,0
37248,98,2010,463,295,324,28,62,57,491,12,134,82,154,146,236,989,1696,6,11700,650,0,2,8,10,0
37249,55,770,167,116,138,4,5,22,171,8,48,30,56,56,86,292,499,4,2330,129,0,2,0,1,0
37250,57,1484,339,213,244,17,9,65,356,10,42,26,48,52,74,259,421,5,2410,133,0,2,11,16,0
37251,90,2288,1455,414,1257,16,76,112,1471,5,41,23,46,46,69,231,381,2,1069,59,0,2,4,9,0
37252,90,2288,669,365,481,22,61,110,691,15,103,63,122,118,185,747,1273,8,11311,628,0,2,4,9,0
37253,251,5822,4293,999,3693,19,54,507,4312,9,155,88,170,164,258,1156,1898,4,9368,520,0,2,18,25,0
37254,251,5822,1482,859,1002,125,135,219,1607,16,219,134,251,235,385,1766,3032,9,27804,1544,1,2,18,25,0
37255,6,128,44,22,19,0,19,6,44,2,10,6,12,12,18,35,64,1,77,4,0,2,0,4,0
37256,31,1078,74,35,59,1,0,14,75,3,14,7,14,17,21,58,85,1,128,7,0,2,9,12,0
37257,31,1078,245,125,200,5,7,34,250,7,30,17,34,37,51,166,265,3,1053,58,0,2,9,12,0
37258,54,657,647,139,84,35,284,233,682,0,0,0,0,0,0,0,0,0,0,0,0,2,0,1,0
37259,117,3127,1523,757,1297,19,12,193,1542,12,193,117,230,205,347,1508,2664,7,19053,1058,0,2,10,16,0
37260,117,3127,701,378,504,33,58,109,734,13,110,68,126,123,194,794,1346,7,10027,557,0,2,10,16,0
37261,104,2739,773,422,505,30,103,129,803,14,77,46,83,91,129,535,839,7,6334,351,0,2,28,38,0
37262,146,3571,77,34,69,0,0,8,77,3,24,16,29,27,45,114,213,1,387,21,0,2,13,26,0
37263,146,3571,712,438,573,51,9,84,763,14,102,71,128,116,199,733,1364,8,11988,666,0,2,13,26,0
37264,24,600,2,2,2,0,0,0,2,0,0,0,0,0,0,0,0,0,0,0,0,2,0,5,0
37265,24,600,99,48,90,1,3,5,100,0,0,0,0,0,0,0,0,0,0,0,0,2,0,5,0
37266,24,600,8,5,5,2,0,1,10,0,0,0,0,0,0,0,0,0,0,0,0,2,0,5,0
37267,24,600,1217,716,841,84,126,174,1301,14,185,118,215,199,333,1446,2542,8,20687,1149,0,2,0,5,0
37268,24,600,160,89,115,0,13,31,160,7,15,11,17,22,28,78,124,3,495,27,0,2,0,5,0
37269,24,600,10,10,9,9,0,0,19,0,0,0,0,0,0,0,0,0,0,0,0,2,0,5,0
37270,24,600,173,84,99,8,29,36,181,5,12,7,13,17,20,54,81,2,221,12,0,2,0,5,0
37271,24,600,3,1,1,3,0,0,6,0,0,0,0,0,0,0,0,0,0,0,0,2,0,5,0
37272,30,657,125,97,103,3,0,19,128,9,25,17,27,34,44,144,223,4,1087,60,0,2,2,5,0
37273,22,367,102,57,55,5,16,25,107,5,17,10,18,22,28,81,124,2,330,18,0,2,2,3,0
37274,71,1560,402,202,227,24,74,80,426,12,52,33,61,64,94,339,564,7,3969,220,0,2,7,9,0
37275,51,1090,447,308,343,6,5,95,453,7,96,59,111,103,170,651,1136,4,4600,255,0,2,13,16,0
37276,51,1090,322,174,179,16,74,51,338,10,41,26,46,51,72,252,408,5,2291,127,0,2,13,16,0
37277,75,1603,53,23,39,0,0,13,53,2,8,4,8,10,12,26,39,1,39,2,0,2,6,14,0
37278,75,1603,515,298,307,33,80,99,548,12,63,44,77,75,121,419,753,7,5527,307,0,2,6,14,0
37279,18,296,424,94,331,4,0,89,428,1,5,5,5,6,10,11,25,0,12,0,0,2,1,8,0
37280,18,296,38,23,23,6,0,8,44,3,11,7,11,14,18,42,68,1,102,5,0,2,1,8,0
37281,19,499,205,80,86,16,53,53,221,7,18,10,19,25,29,94,134,3,497,27,0,2,3,8,0
37282,15,476,184,100,137,2,15,30,186,6,38,20,39,44,59,214,322,3,991,55,0,2,3,10,0
37283,15,476,103,65,74,8,5,16,111,7,17,9,17,24,26,89,119,3,417,23,0,2,3,10,0
37284,58,1189,91,45,69,0,3,18,91,3,9,6,10,12,16,33,57,1,95,5,0,2,5,8,0
37285,58,1189,367,234,237,17,34,68,384,16,55,34,61,71,95,381,584,8,5183,287,0,2,5,8,0
37286,228,5833,722,423,573,19,0,135,741,12,172,101,199,184,300,1320,2257,6,15668,870,0,2,38,43,0
37287,228,5833,1508,847,911,44,250,301,1552,14,148,88,169,162,257,1120,1886,7,15077,837,0,2,38,43,0
37288,314,6872,72,33,56,0,4,12,72,1,1,1,1,2,2,0,2,0,1,0,0,2,20,28,0
37289,314,6872,1454,835,1044,76,110,219,1530,17,275,158,296,292,454,2297,3718,9,34017,1889,1,2,20,28,0
37290,89,1801,757,253,292,73,244,162,830,13,61,38,67,74,105,409,651,7,4654,258,0,2,3,7,0
37291,38,787,386,256,301,16,9,68,402,4,59,35,69,63,104,355,621,2,1453,80,0,2,5,10,0
37292,38,787,264,131,164,11,41,46,275,6,38,22,40,44,62,214,338,3,1068,59,0,2,5,10,0
37293,67,1747,466,257,367,18,25,50,484,7,126,86,171,133,257,898,1813,4,8612,478,0,2,9,19,0
37294,67,1747,507,281,342,29,59,88,536,10,53,29,57,63,86,336,514,5,2764,153,0,2,9,19,0
37295,25,538,215,129,180,6,0,29,221,8,65,43,72,73,115,415,711,4,3153,175,0,2,2,7,0
37296,25,538,97,69,77,3,3,16,100,6,22,13,23,28,36,113,173,3,542,30,0,2,2,7,0
37297,89,1896,1043,504,840,53,9,147,1096,9,180,112,198,189,310,1377,2344,4,11604,644,0,2,9,12,0
37298,89,1896,383,288,292,26,6,62,409,11,65,38,67,76,105,429,656,5,3719,206,0,2,9,12,0
37299,20,408,294,64,250,0,0,43,294,1,20,10,20,21,30,86,131,0,65,3,0,2,0,5,0
37300,20,408,78,46,62,3,0,14,81,3,8,4,8,11,12,28,41,1,62,3,0,2,0,5,0
37301,5,111,110,30,77,3,13,16,113,4,21,15,30,25,45,100,208,2,597,33,0,2,0,5,0
37302,5,111,28,15,21,1,0,6,29,0,0,0,0,0,0,0,0,0,0,0,0,2,0,5,0
37303,40,784,1178,367,1042,6,15,115,1184,9,94,51,95,103,146,644,976,4,4439,246,0,2,0,5,0
37304,40,784,177,108,140,8,0,27,185,6,30,16,32,36,48,162,248,3,794,44,0,2,0,5,0
37305,28,452,219,78,157,11,5,46,230,3,24,20,34,27,54,114,256,2,545,30,0,2,0,1,0
37306,28,452,108,64,79,9,0,20,117,5,15,11,19,20,30,70,129,3,410,22,0,2,0,1,0
37307,280,5869,1943,715,1694,26,18,214,1969,12,185,120,237,197,357,1436,2721,7,20915,1161,0,2,19,27,0
37308,280,5869,1168,838,957,57,25,144,1225,19,348,224,416,367,640,3018,5452,11,61921,3440,1,2,19,27,0
37309,19,699,442,244,305,14,16,103,456,11,68,45,75,79,120,452,756,6,4588,254,0,2,2,7,0
37310,19,699,182,102,99,11,40,35,193,3,11,6,11,14,17,42,64,1,97,5,0,2,2,7,0
37311,65,1251,1098,241,925,5,10,155,1103,7,46,25,49,53,74,273,423,3,1580,87,0,2,0,5,0
37312,65,1251,282,202,222,14,2,44,296,8,42,24,43,50,67,250,378,4,1548,86,0,2,0,5,0
37313,2,153,37,13,25,0,6,6,37,1,2,1,2,3,3,2,4,0,2,0,0,2,1,2,0
37314,2,153,133,47,40,1,43,49,134,0,0,0,0,0,0,0,0,0,0,0,0,2,1,2,0
37315,23,630,601,196,481,2,23,85,603,8,63,36,72,71,108,400,664,4,3036,168,0,2,2,7,0
37316,23,630,156,79,106,5,16,28,161,5,14,8,15,19,23,64,97,2,261,14,0,2,2,7,0
37317,104,4398,1289,550,1043,56,32,155,1345,10,167,93,185,177,278,1266,2075,5,11498,638,0,2,10,17,0
37318,31,963,182,127,129,0,0,53,182,5,39,21,42,44,63,217,343,2,926,51,0,2,7,13,0
37319,151,7198,1392,870,1177,35,17,170,1427,14,494,280,531,508,811,4473,7289,7,54850,3047,2,2,15,21,0
37320,95,2843,773,419,590,28,0,166,801,10,204,113,217,214,330,1598,2554,5,13587,754,0,2,17,24,0
37321,6,163,127,75,83,2,11,30,129,4,14,7,14,18,21,61,87,2,175,9,0,2,0,1,0
37322,6,163,652,304,544,16,6,88,668,6,89,51,101,95,152,591,998,3,3399,188,0,2,0,1,0
37323,6,163,2,2,2,0,0,0,2,0,0,0,0,0,0,0,0,0,0,0,0,2,0,1,0
37324,6,163,8,5,5,0,0,3,8,0,0,0,0,0,0,0,0,0,0,0,0,2,0,1,0
37325,6,163,2,2,2,0,0,0,2,0,0,0,0,0,0,0,0,0,0,0,0,2,0,1,0
37326,6,163,14,8,8,0,0,6,14,0,0,0,0,0,0,0,0,0,0,0,0,2,0,1,0
37327,6,163,6,4,4,0,0,2,6,0,0,0,0,0,0,0,0,0,0,0,0,2,0,1,0
37328,6,163,6,4,4,0,0,2,6,1,2,1,2,3,3,2,4,0,2,0,0,2,0,1,0
37329,6,163,6,4,4,0,0,2,6,0,0,0,0,0,0,0,0,0,0,0,0,2,0,1,0
37330,6,163,7,5,5,0,0,2,7,0,0,0,0,0,0,0,0,0,0,0,0,2,0,1,0
37331,6,163,6,4,4,0,0,2,6,0,0,0,0,0,0,0,0,0,0,0,0,2,0,1,0
37332,6,163,10,6,6,0,0,4,10,0,0,0,0,0,0,0,0,0,0,0,0,2,0,1,0
37333,6,163,1,1,1,0,0,0,1,0,0,0,0,0,0,0,0,0,0,0,0,2,0,1,0
37334,6,163,1,1,1,0,0,0,1,0,0,0,0,0,0,0,0,0,0,0,0,2,0,1,0
37335,6,163,14,10,10,0,0,4,14,1,1,1,1,2,2,0,2,0,1,0,0,2,0,1,0
37336,6,163,46,26,30,3,0,12,49,3,6,3,6,9,9,20,28,1,42,2,0,2,0,1,0
37337,14,833,75,38,59,1,3,12,76,2,4,2,4,6,6,10,15,1,15,0,0,2,0,5,0
37338,2,58,16,12,9,0,0,6,16,1,2,1,2,3,3,2,4,0,2,0,0,2,0,1,0
37339,1,6,2,2,2,0,0,0,2,0,0,0,0,0,0,0,0,0,0,0,0,2,0,1,0
37340,1,6,99,48,90,1,3,5,100,0,0,0,0,0,0,0,0,0,0,0,0,2,0,1,0
37341,1,6,8,5,5,2,0,1,10,0,0,0,0,0,0,0,0,0,0,0,0,2,0,1,0
37342,1,6,1217,716,841,84,126,174,1301,14,185,118,215,199,333,1446,2542,8,20687,1149,0,2,0,1,0
37343,1,6,160,89,115,0,13,31,160,7,15,11,17,22,28,78,124,3,495,27,0,2,0,1,0
37344,1,6,10,10,9,9,0,0,19,0,0,0,0,0,0,0,0,0,0,0,0,2,0,1,0
37345,1,6,173,84,99,8,29,36,181,5,12,7,13,17,20,54,81,2,221,12,0,2,0,1,0
37346,1,6,3,1,1,3,0,0,6,0,0,0,0,0,0,0,0,0,0,0,0,2,0,1,0
37347,1,6,2,2,2,0,0,0,2,0,0,0,0,0,0,0,0,0,0,0,0,2,0,1,0
37348,1,6,2,2,2,0,0,0,2,0,0,0,0,0,0,0,0,0,0,0,0,2,0,1,0
37349,1,6,2,2,2,0,0,0,2,0,0,0,0,0,0,0,0,0,0,0,0,2,0,1,0
37350,1,6,2,2,2,0,0,0,2,0,0,0,0,0,0,0,0,0,0,0,0,2,0,1,0
37351,1,8,127,75,83,2,11,30,129,4,14,7,14,18,21,61,87,2,175,9,0,2,0,1,0
37352,1,8,652,304,544,16,6,88,668,6,89,51,101,95,152,591,998,3,3399,188,0,2,0,1,0
37353,1,8,2,2,2,0,0,0,2,0,0,0,0,0,0,0,0,0,0,0,0,2,0,1,0
37354,1,8,8,5,5,0,0,3,8,0,0,0,0,0,0,0,0,0,0,0,0,2,0,1,0
37355,1,8,2,2,2,0,0,0,2,0,0,0,0,0,0,0,0,0,0,0,0,2,0,1,0
37356,1,8,14,8,8,0,0,6,14,0,0,0,0,0,0,0,0,0,0,0,0,2,0,1,0
37357,1,8,6,4,4,0,0,2,6,0,0,0,0,0,0,0,0,0,0,0,0,2,0,1,0
37358,1,8,6,4,4,0,0,2,6,1,2,1,2,3,3,2,4,0,2,0,0,2,0,1,0
37359,1,8,6,4,4,0,0,2,6,0,0,0,0,0,0,0,0,0,0,0,0,2,0,1,0
37360,1,8,7,5,5,0,0,2,7,0,0,0,0,0,0,0,0,0,0,0,0,2,0,1,0
37361,1,8,6,4,4,0,0,2,6,0,0,0,0,0,0,0,0,0,0,0,0,2,0,1,0
37362,1,8,10,6,6,0,0,4,10,0,0,0,0,0,0,0,0,0,0,0,0,2,0,1,0
37363,1,8,1,1,1,0,0,0,1,0,0,0,0,0,0,0,0,0,0,0,0,2,0,1,0
37364,1,8,1,1,1,0,0,0,1,0,0,0,0,0,0,0,0,0,0,0,0,2,0,1,0
37365,1,8,14,10,10,0,0,4,14,1,1,1,1,2,2,0,2,0,1,0,0,2,0,1,0
37366,1,8,46,26,30,3,0,12,49,3,6,3,6,9,9,20,28,1,42,2,0,2,0,1,0
37367,1,6,2,2,2,0,0,0,2,0,0,0,0,0,0,0,0,0,0,0,0,2,0,1,0
37368,1,6,2,2,2,0,0,0,2,0,0,0,0,0,0,0,0,0,0,0,0,2,0,1,0
37369,1,6,2,2,2,0,0,0,2,0,0,0,0,0,0,0,0,0,0,0,0,2,0,1,0
37370,1,6,2,2,2,0,0,0,2,0,0,0,0,0,0,0,0,0,0,0,0,2,0,1,0
37371,1,6,2,2,2,0,0,0,2,0,0,0,0,0,0,0,0,0,0,0,0,2,0,1,0
37372,1,6,2,2,2,0,0,0,2,0,0,0,0,0,0,0,0,0,0,0,0,2,0,1,0
37373,1,6,2,2,2,0,0,0,2,0,0,0,0,0,0,0,0,0,0,0,0,2,0,1,0
37374,1,6,2,2,2,0,0,0,2,0,0,0,0,0,0,0,0,0,0,0,0,2,0,1,0
37375,1,6,2,2,2,0,0,0,2,0,0,0,0,0,0,0,0,0,0,0,0,2,0,1,0
37376,2,25,127,75,83,2,11,30,129,4,14,7,14,18,21,61,87,2,175,9,0,2,0,1,0
37377,2,25,652,304,544,16,6,88,668,6,89,51,101,95,152,591,998,3,3399,188,0,2,0,1,0
37378,2,25,2,2,2,0,0,0,2,0,0,0,0,0,0,0,0,0,0,0,0,2,0,1,0
37379,2,25,8,5,5,0,0,3,8,0,0,0,0,0,0,0,0,0,0,0,0,2,0,1,0
37380,2,25,2,2,2,0,0,0,2,0,0,0,0,0,0,0,0,0,0,0,0,2,0,1,0
37381,2,25,14,8,8,0,0,6,14,0,0,0,0,0,0,0,0,0,0,0,0,2,0,1,0
37382,2,25,6,4,4,0,0,2,6,0,0,0,0,0,0,0,0,0,0,0,0,2,0,1,0
37383,2,25,6,4,4,0,0,2,6,1,2,1,2,3,3,2,4,0,2,0,0,2,0,1,0
37384,2,25,6,4,4,0,0,2,6,0,0,0,0,0,0,0,0,0,0,0,0,2,0,1,0
37385,2,25,7,5,5,0,0,2,7,0,0,0,0,0,0,0,0,0,0,0,0,2,0,1,0
37386,2,25,6,4,4,0,0,2,6,0,0,0,0,0,0,0,0,0,0,0,0,2,0,1,0
37387,2,25,10,6,6,0,0,4,10,0,0,0,0,0,0,0,0,0,0,0,0,2,0,1,0
37388,2,25,1,1,1,0,0,0,1,0,0,0,0,0,0,0,0,0,0,0,0,2,0,1,0
37389,2,25,1,1,1,0,0,0,1,0,0,0,0,0,0,0,0,0,0,0,0,2,0,1,0
37390,2,25,14,10,10,0,0,4,14,1,1,1,1,2,2,0,2,0,1,0,0,2,0,1,0
37391,2,25,46,26,30,3,0,12,49,3,6,3,6,9,9,20,28,1,42,2,0,2,0,1,0
37392,1,52,14,12,10,0,0,4,14,1,2,1,2,3,3,2,4,0,2,0,0,2,1,2,0
37393,1,55,14,12,10,0,0,4,14,1,2,1,2,3,3,2,4,0,2,0,0,2,1,2,0
37394,1,52,14,12,10,0,0,4,14,1,2,1,2,3,3,2,4,0,2,0,0,2,1,2,0
37395,1,71,19,18,14,0,0,5,19,1,2,1,2,3,3,2,4,0,2,0,0,2,2,3,0
37396,2,18,10,6,6,0,0,4,10,0,0,0,0,0,0,0,0,0,0,0,0,2,0,1,0
37397,2,36,127,75,83,2,11,30,129,4,14,7,14,18,21,61,87,2,175,9,0,2,0,1,0
37398,2,36,652,304,544,16,6,88,668,6,89,51,101,95,152,591,998,3,3399,188,0,2,0,1,0
37399,2,36,2,2,2,0,0,0,2,0,0,0,0,0,0,0,0,0,0,0,0,2,0,1,0
37400,2,36,8,5,5,0,0,3,8,0,0,0,0,0,0,0,0,0,0,0,0,2,0,1,0
37401,2,36,2,2,2,0,0,0,2,0,0,0,0,0,0,0,0,0,0,0,0,2,0,1,0
37402,2,36,14,8,8,0,0,6,14,0,0,0,0,0,0,0,0,0,0,0,0,2,0,1,0
37403,2,36,6,4,4,0,0,2,6,0,0,0,0,0,0,0,0,0,0,0,0,2,0,1,0
37404,2,36,6,4,4,0,0,2,6,1,2,1,2,3,3,2,4,0,2,0,0,2,0,1,0
37405,2,36,6,4,4,0,0,2,6,0,0,0,0,0,0,0,0,0,0,0,0,2,0,1,0
37406,2,36,7,5,5,0,0,2,7,0,0,0,0,0,0,0,0,0,0,0,0,2,0,1,0
37407,2,36,6,4,4,0,0,2,6,0,0,0,0,0,0,0,0,0,0,0,0,2,0,1,0
37408,2,36,10,6,6,0,0,4,10,0,0,0,0,0,0,0,0,0,0,0,0,2,0,1,0
37409,2,36,1,1,1,0,0,0,1,0,0,0,0,0,0,0,0,0,0,0,0,2,0,1,0
37410,2,36,1,1,1,0,0,0,1,0,0,0,0,0,0,0,0,0,0,0,0,2,0,1,0
37411,2,36,14,10,10,0,0,4,14,1,1,1,1,2,2,0,2,0,1,0,0,2,0,1,0
37412,2,36,46,26,30,3,0,12,49,3,6,3,6,9,9,20,28,1,42,2,0,2,0,1,0
37413,1,6,2,2,2,0,0,0,2,0,0,0,0,0,0,0,0,0,0,0,0,2,0,1,0
37414,1,6,2,2,2,0,0,0,2,0,0,0,0,0,0,0,0,0,0,0,0,2,0,1,0
37415,1,6,2,2,2,0,0,0,2,0,0,0,0,0,0,0,0,0,0,0,0,2,0,1,0
37416,1,6,2,2,2,0,0,0,2,0,0,0,0,0,0,0,0,0,0,0,0,2,0,1,0
37417,1,26,127,75,83,2,11,30,129,4,14,7,14,18,21,61,87,2,175,9,0,2,0,1,0
37418,1,26,652,304,544,16,6,88,668,6,89,51,101,95,152,591,998,3,3399,188,0,2,0,1,0
37419,1,26,2,2,2,0,0,0,2,0,0,0,0,0,0,0,0,0,0,0,0,2,0,1,0
37420,1,26,8,5,5,0,0,3,8,0,0,0,0,0,0,0,0,0,0,0,0,2,0,1,0
37421,1,26,2,2,2,0,0,0,2,0,0,0,0,0,0,0,0,0,0,0,0,2,0,1,0
37422,1,26,14,8,8,0,0,6,14,0,0,0,0,0,0,0,0,0,0,0,0,2,0,1,0
37423,1,26,6,4,4,0,0,2,6,0,0,0,0,0,0,0,0,0,0,0,0,2,0,1,0
37424,1,26,6,4,4,0,0,2,6,1,2,1,2,3,3,2,4,0,2,0,0,2,0,1,0
37425,1,26,6,4,4,0,0,2,6,0,0,0,0,0,0,0,0,0,0,0,0,2,0,1,0
37426,1,26,7,5,5,0,0,2,7,0,0,0,0,0,0,0,0,0,0,0,0,2,0,1,0
37427,1,26,6,4,4,0,0,2,6,0,0,0,0,0,0,0,0,0,0,0,0,2,0,1,0
37428,1,26,10,6,6,0,0,4,10,0,0,0,0,0,0,0,0,0,0,0,0,2,0,1,0
37429,1,26,1,1,1,0,0,0,1,0,0,0,0,0,0,0,0,0,0,0,0,2,0,1,0
37430,1,26,1,1,1,0,0,0,1,0,0,0,0,0,0,0,0,0,0,0,0,2,0,1,0
37431,1,26,14,10,10,0,0,4,14,1,1,1,1,2,2,0,2,0,1,0,0,2,0,1,0
37432,1,26,46,26,30,3,0,12,49,3,6,3,6,9,9,20,28,1,42,2,0,2,0,1,0
37433,1,7,2,2,2,0,0,0,2,0,0,0,0,0,0,0,0,0,0,0,0,2,0,1,0
37434,1,24,127,75,83,2,11,30,129,4,14,7,14,18,21,61,87,2,175,9,0,2,0,1,0
37435,1,24,652,304,544,16,6,88,668,6,89,51,101,95,152,591,998,3,3399,188,0,2,0,1,0
37436,1,24,2,2,2,0,0,0,2,0,0,0,0,0,0,0,0,0,0,0,0,2,0,1,0
37437,1,24,8,5,5,0,0,3,8,0,0,0,0,0,0,0,0,0,0,0,0,2,0,1,0
37438,1,24,2,2,2,0,0,0,2,0,0,0,0,0,0,0,0,0,0,0,0,2,0,1,0
37439,1,24,14,8,8,0,0,6,14,0,0,0,0,0,0,0,0,0,0,0,0,2,0,1,0
37440,1,24,6,4,4,0,0,2,6,0,0,0,0,0,0,0,0,0,0,0,0,2,0,1,0
37441,1,24,6,4,4,0,0,2,6,1,2,1,2,3,3,2,4,0,2,0,0,2,0,1,0
37442,1,24,6,4,4,0,0,2,6,0,0,0,0,0,0,0,0,0,0,0,0,2,0,1,0
37443,1,24,7,5,5,0,0,2,7,0,0,0,0,0,0,0,0,0,0,0,0,2,0,1,0
37444,1,24,6,4,4,0,0,2,6,0,0,0,0,0,0,0,0,0,0,0,0,2,0,1,0
37445,1,24,10,6,6,0,0,4,10,0,0,0,0,0,0,0,0,0,0,0,0,2,0,1,0
37446,1,24,1,1,1,0,0,0,1,0,0,0,0,0,0,0,0,0,0,0,0,2,0,1,0
37447,1,24,1,1,1,0,0,0,1,0,0,0,0,0,0,0,0,0,0,0,0,2,0,1,0
37448,1,24,14,10,10,0,0,4,14,1,1,1,1,2,2,0,2,0,1,0,0,2,0,1,0
37449,1,24,46,26,30,3,0,12,49,3,6,3,6,9,9,20,28,1,42,2,0,2,0,1,0
37450,1,7,2,2,2,0,0,0,2,0,0,0,0,0,0,0,0,0,0,0,0,2,0,1,0
37451,3,33,15,9,9,0,0,6,15,0,0,0,0,0,0,0,0,0,0,0,0,2,0,1,0
37452,1,13,127,75,83,2,11,30,129,4,14,7,14,18,21,61,87,2,175,9,0,2,0,1,0
37453,1,13,652,304,544,16,6,88,668,6,89,51,101,95,152,591,998,3,3399,188,0,2,0,1,0
37454,1,13,2,2,2,0,0,0,2,0,0,0,0,0,0,0,0,0,0,0,0,2,0,1,0
37455,1,13,8,5,5,0,0,3,8,0,0,0,0,0,0,0,0,0,0,0,0,2,0,1,0
37456,1,13,2,2,2,0,0,0,2,0,0,0,0,0,0,0,0,0,0,0,0,2,0,1,0
37457,1,13,14,8,8,0,0,6,14,0,0,0,0,0,0,0,0,0,0,0,0,2,0,1,0
37458,1,13,6,4,4,0,0,2,6,0,0,0,0,0,0,0,0,0,0,0,0,2,0,1,0
37459,1,13,6,4,4,0,0,2,6,1,2,1,2,3,3,2,4,0,2,0,0,2,0,1,0
37460,1,13,6,4,4,0,0,2,6,0,0,0,0,0,0,0,0,0,0,0,0,2,0,1,0
37461,1,13,7,5,5,0,0,2,7,0,0,0,0,0,0,0,0,0,0,0,0,2,0,1,0
37462,1,13,6,4,4,0,0,2,6,0,0,0,0,0,0,0,0,0,0,0,0,2,0,1,0
37463,1,13,10,6,6,0,0,4,10,0,0,0,0,0,0,0,0,0,0,0,0,2,0,1,0
37464,1,13,1,1,1,0,0,0,1,0,0,0,0,0,0,0,0,0,0,0,0,2,0,1,0
37465,1,13,1,1,1,0,0,0,1,0,0,0,0,0,0,0,0,0,0,0,0,2,0,1,0
37466,1,13,14,10,10,0,0,4,14,1,1,1,1,2,2,0,2,0,1,0,0,2,0,1,0
37467,1,13,46,26,30,3,0,12,49,3,6,3,6,9,9,20,28,1,42,2,0,2,0,1,0
37468,1,16,127,75,83,2,11,30,129,4,14,7,14,18,21,61,87,2,175,9,0,2,0,1,0
37469,1,16,652,304,544,16,6,88,668,6,89,51,101,95,152,591,998,3,3399,188,0,2,0,1,0
37470,1,16,2,2,2,0,0,0,2,0,0,0,0,0,0,0,0,0,0,0,0,2,0,1,0
37471,1,16,8,5,5,0,0,3,8,0,0,0,0,0,0,0,0,0,0,0,0,2,0,1,0
37472,1,16,2,2,2,0,0,0,2,0,0,0,0,0,0,0,0,0,0,0,0,2,0,1,0
37473,1,16,14,8,8,0,0,6,14,0,0,0,0,0,0,0,0,0,0,0,0,2,0,1,0
37474,1,16,6,4,4,0,0,2,6,0,0,0,0,0,0,0,0,0,0,0,0,2,0,1,0
37475,1,16,6,4,4,0,0,2,6,1,2,1,2,3,3,2,4,0,2,0,0,2,0,1,0
37476,1,16,6,4,4,0,0,2,6,0,0,0,0,0,0,0,0,0,0,0,0,2,0,1,0
37477,1,16,7,5,5,0,0,2,7,0,0,0,0,0,0,0,0,0,0,0,0,2,0,1,0
37478,1,16,6,4,4,0,0,2,6,0,0,0,0,0,0,0,0,0,0,0,0,2,0,1,0
37479,1,16,10,6,6,0,0,4,10,0,0,0,0,0,0,0,0,0,0,0,0,2,0,1,0
37480,1,16,1,1,1,0,0,0,1,0,0,0,0,0,0,0,0,0,0,0,0,2,0,1,0
37481,1,16,1,1,1,0,0,0,1,0,0,0,0,0,0,0,0,0,0,0,0,2,0,1,0
37482,1,16,14,10,10,0,0,4,14,1,1,1,1,2,2,0,2,0,1,0,0,2,0,1,0
37483,1,16,46,26,30,3,0,12,49,3,6,3,6,9,9,20,28,1,42,2,0,2,0,1,0
37484,1,10,2,2,2,0,0,0,2,1,2,1,2,3,3,2,4,0,2,0,0,2,0,1,0
37485,1,13,127,75,83,2,11,30,129,4,14,7,14,18,21,61,87,2,175,9,0,2,0,1,0
37486,1,13,652,304,544,16,6,88,668,6,89,51,101,95,152,591,998,3,3399,188,0,2,0,1,0
37487,1,13,2,2,2,0,0,0,2,0,0,0,0,0,0,0,0,0,0,0,0,2,0,1,0
37488,1,13,8,5,5,0,0,3,8,0,0,0,0,0,0,0,0,0,0,0,0,2,0,1,0
37489,1,13,2,2,2,0,0,0,2,0,0,0,0,0,0,0,0,0,0,0,0,2,0,1,0
37490,1,13,14,8,8,0,0,6,14,0,0,0,0,0,0,0,0,0,0,0,0,2,0,1,0
37491,1,13,6,4,4,0,0,2,6,0,0,0,0,0,0,0,0,0,0,0,0,2,0,1,0
37492,1,13,6,4,4,0,0,2,6,1,2,1,2,3,3,2,4,0,2,0,0,2,0,1,0
37493,1,13,6,4,4,0,0,2,6,0,0,0,0,0,0,0,0,0,0,0,0,2,0,1,0
37494,1,13,7,5,5,0,0,2,7,0,0,0,0,0,0,0,0,0,0,0,0,2,0,1,0
37495,1,13,6,4,4,0,0,2,6,0,0,0,0,0,0,0,0,0,0,0,0,2,0,1,0
37496,1,13,10,6,6,0,0,4,10,0,0,0,0,0,0,0,0,0,0,0,0,2,0,1,0
37497,1,13,1,1,1,0,0,0,1,0,0,0,0,0,0,0,0,0,0,0,0,2,0,1,0
37498,1,13,1,1,1,0,0,0,1,0,0,0,0,0,0,0,0,0,0,0,0,2,0,1,0
37499,1,13,14,10,10,0,0,4,14,1,1,1,1,2,2,0,2,0,1,0,0,2,0,1,0
37500,1,13,46,26,30,3,0,12,49,3,6,3,6,9,9,20,28,1,42,2,0,2,0,1,0
37501,2,26,10,6,6,0,0,4,10,2,4,2,4,6,6,10,15,1,15,0,0,2,0,1,0
37502,3,44,15,10,10,0,0,5,15,2,4,2,4,6,6,10,15,1,15,0,0,2,1,2,0
37503,3,39,15,9,9,0,0,6,15,0,0,0,0,0,0,0,0,0,0,0,0,2,0,1,0
37504,2,33,10,7,7,0,0,3,10,1,2,1,2,3,3,2,4,0,2,0,0,2,1,2,0
37505,3,43,15,9,9,0,0,6,15,1,4,2,4,5,6,8,13,0,6,0,0,2,1,2,0
37506,2,21,10,6,6,0,0,4,10,0,0,0,0,0,0,0,0,0,0,0,0,2,0,1,0
37507,4,61,20,12,12,0,0,8,20,1,2,1,2,3,3,2,4,0,2,0,0,2,0,1,0
37508,2,51,127,75,83,2,11,30,129,4,14,7,14,18,21,61,87,2,175,9,0,2,0,1,0
37509,2,51,652,304,544,16,6,88,668,6,89,51,101,95,152,591,998,3,3399,188,0,2,0,1,0
37510,2,51,2,2,2,0,0,0,2,0,0,0,0,0,0,0,0,0,0,0,0,2,0,1,0
37511,2,51,8,5,5,0,0,3,8,0,0,0,0,0,0,0,0,0,0,0,0,2,0,1,0
37512,2,51,2,2,2,0,0,0,2,0,0,0,0,0,0,0,0,0,0,0,0,2,0,1,0
37513,2,51,14,8,8,0,0,6,14,0,0,0,0,0,0,0,0,0,0,0,0,2,0,1,0
37514,2,51,6,4,4,0,0,2,6,0,0,0,0,0,0,0,0,0,0,0,0,2,0,1,0
37515,2,51,6,4,4,0,0,2,6,1,2,1,2,3,3,2,4,0,2,0,0,2,0,1,0
37516,2,51,6,4,4,0,0,2,6,0,0,0,0,0,0,0,0,0,0,0,0,2,0,1,0
37517,2,51,7,5,5,0,0,2,7,0,0,0,0,0,0,0,0,0,0,0,0,2,0,1,0
37518,2,51,6,4,4,0,0,2,6,0,0,0,0,0,0,0,0,0,0,0,0,2,0,1,0
37519,2,51,10,6,6,0,0,4,10,0,0,0,0,0,0,0,0,0,0,0,0,2,0,1,0
37520,2,51,1,1,1,0,0,0,1,0,0,0,0,0,0,0,0,0,0,0,0,2,0,1,0
37521,2,51,1,1,1,0,0,0,1,0,0,0,0,0,0,0,0,0,0,0,0,2,0,1,0
37522,2,51,14,10,10,0,0,4,14,1,1,1,1,2,2,0,2,0,1,0,0,2,0,1,0
37523,2,51,46,26,30,3,0,12,49,3,6,3,6,9,9,20,28,1,42,2,0,2,0,1,0
37524,1,6,2,2,2,0,0,0,2,0,0,0,0,0,0,0,0,0,0,0,0,2,0,1,0
37525,8,263,51,25,36,0,0,15,51,3,11,6,12,14,18,42,68,1,112,6,0,2,0,1,0
37526,1,14,6,4,4,0,0,2,6,0,0,0,0,0,0,0,0,0,0,0,0,2,0,1,0
37527,4,163,27,21,21,0,0,6,27,3,6,3,6,9,9,20,28,1,42,2,0,2,0,1,0
37528,1,6,2,2,2,0,0,0,2,0,0,0,0,0,0,0,0,0,0,0,0,2,0,1,0
37529,1,41,7,5,5,0,0,2,7,1,2,1,2,3,3,2,4,0,2,0,0,2,0,1,0
37530,2,51,14,9,9,0,0,5,14,0,0,0,0,0,0,0,0,0,0,0,0,2,0,1,0
37531,2,40,13,9,8,0,0,4,13,0,0,0,0,0,0,0,0,0,0,0,0,2,0,1,0
37532,2,42,14,10,9,0,0,4,14,0,0,0,0,0,0,0,0,0,0,0,0,2,0,1,0
37533,2,33,12,8,7,0,0,4,12,0,0,0,0,0,0,0,0,0,0,0,0,2,0,1,0
37534,3,49,16,9,9,0,0,7,16,0,0,0,0,0,0,0,0,0,0,0,0,2,0,1,0
37535,1,18,3,3,3,0,0,0,3,0,0,0,0,0,0,0,0,0,0,0,0,2,0,1,0
37536,2,26,6,4,4,0,0,2,6,1,4,2,4,5,6,8,13,0,6,0,0,2,0,1,0
37537,12,313,149,95,105,2,0,41,151,8,54,28,55,62,83,334,494,4,2013,111,0,2,3,4,0
37538,15,699,139,89,101,2,0,35,141,7,54,34,62,61,96,330,569,4,2287,127,0,2,4,5,0
37539,3,299,149,67,118,4,0,27,153,1,17,14,28,18,42,69,175,0,144,8,0,2,4,10,0
37540,38,2493,1157,318,931,29,22,177,1186,6,104,63,125,110,188,712,1274,3,4596,255,0,2,5,10,0
37541,65,4371,520,294,400,33,13,81,553,10,261,204,367,271,571,2128,4614,7,32445,1802,1,2,3,4,0
37542,90,3959,1338,495,1086,10,64,173,1348,11,122,82,157,133,239,883,1686,7,11934,663,0,2,11,23,0
37543,172,7590,4293,999,3693,19,54,507,4312,9,155,88,170,164,258,1156,1898,4,9368,520,0,2,17,24,0
37544,172,7590,1482,859,1002,125,135,219,1607,16,219,134,251,235,385,1766,3032,9,27804,1544,1,2,17,24,0
37545,33,984,465,148,393,5,8,60,470,4,31,20,31,35,51,161,261,2,523,29,0,2,5,6,0
37546,33,984,16,12,9,0,0,6,16,1,2,1,2,3,3,2,4,0,2,0,0,2,5,6,0
37547,144,5870,1782,648,1425,9,47,279,1791,8,171,97,189,179,286,1292,2140,4,9462,525,0,2,32,34,0
37548,32,968,256,139,192,9,7,47,265,4,23,12,24,27,36,112,171,2,357,19,0,2,4,8,0
37549,6,328,180,34,164,0,0,16,180,1,12,6,12,13,18,43,66,0,33,1,0,2,0,3,0
37550,19,499,102,59,69,5,3,24,107,6,22,15,28,28,43,113,206,3,789,43,0,2,2,7,0
37551,119,4854,1450,624,1228,12,26,181,1462,14,306,186,354,320,540,2580,4493,8,36391,2021,1,2,24,31,0
37552,176,5109,1660,832,1314,41,38,274,1701,20,312,209,395,332,604,2671,5058,12,64042,3557,1,2,14,20,0
37553,49,3780,996,429,845,24,10,117,1020,7,76,50,88,83,138,494,879,4,3565,198,0,2,5,10,0
37554,120,5083,1513,682,1277,25,13,200,1538,11,199,116,219,210,335,1557,2584,6,15641,868,0,2,12,20,0
37555,84,4871,1296,573,1062,40,33,157,1336,8,201,118,231,209,349,1561,2689,4,12365,686,0,2,11,16,0
37556,20,449,207,111,150,11,0,50,218,5,26,19,36,31,55,133,272,3,943,52,0,2,2,7,0
37557,98,5169,1457,730,1242,11,6,188,1468,10,292,166,329,302,495,2424,4078,5,22973,1276,1,2,20,25,0
37558,43,2669,652,304,544,16,6,88,668,6,89,51,101,95,152,591,998,3,3399,188,0,2,3,8,0
37559,72,3231,1455,414,1257,16,76,112,1471,5,41,23,46,46,69,231,381,2,1069,59,0,2,10,19,0
37560,2,44,7,6,5,0,0,2,7,1,1,1,2,2,3,0,3,1,3,0,0,2,0,5,0
37561,8,263,74,35,59,1,0,14,75,3,14,7,14,17,21,58,85,1,128,7,0,2,0,5,0
37562,107,5128,1523,757,1297,19,12,193,1542,12,193,117,230,205,347,1508,2664,7,19053,1058,0,2,14,19,0
37563,70,3177,1020,354,843,12,15,144,1032,8,134,77,144,142,221,970,1580,4,6792,377,0,2,5,11,0
37564,44,2024,447,308,343,6,5,95,453,7,96,59,111,103,170,651,1136,4,4600,255,0,2,8,13,0
37565,3,229,53,23,39,0,0,13,53,2,8,4,8,10,12,26,39,1,39,2,0,2,0,1,0
37566,21,637,424,94,331,4,0,89,428,1,5,5,5,6,10,11,25,0,12,0,0,2,4,10,0
37567,38,2309,334,251,279,10,4,40,344,5,127,74,143,132,217,899,1528,2,4303,239,0,2,2,7,0
37568,9,423,184,100,137,2,15,30,186,6,38,20,39,44,59,214,322,3,991,55,0,2,5,11,0
37569,8,377,91,45,69,0,3,18,91,3,9,6,10,12,16,33,57,1,95,5,0,2,0,1,0
37570,75,3937,1293,570,1093,25,15,163,1318,10,195,123,241,205,364,1516,2795,6,17273,959,0,2,5,10,0
37571,29,1873,384,251,317,7,8,52,391,11,70,44,84,81,128,467,811,6,5355,297,0,2,9,15,0
37572,56,2846,722,423,573,19,0,135,741,12,172,101,199,184,300,1320,2257,6,15668,870,0,2,10,15,0
37573,45,1932,386,256,301,16,9,68,402,4,59,35,69,63,104,355,621,2,1453,80,0,2,3,8,0
37574,28,1590,466,257,367,18,25,50,484,7,126,86,171,133,257,898,1813,4,8612,478,0,2,2,3,0
37575,15,1051,215,129,180,6,0,29,221,8,65,43,72,73,115,415,711,4,3153,175,0,2,1,6,0
37576,85,3359,1043,504,840,53,9,147,1096,9,180,112,198,189,310,1377,2344,4,11604,644,0,2,9,16,0
37577,12,466,295,56,236,0,4,54,295,2,9,5,10,11,15,30,51,1,57,3,0,2,0,5,0
37578,30,1422,373,158,315,8,0,51,381,5,76,44,79,81,123,486,779,2,2026,112,0,2,2,7,0
37579,79,3071,1178,367,1042,6,15,115,1184,9,94,51,95,103,146,644,976,4,4439,246,0,2,6,11,0
37580,9,449,219,78,157,11,5,46,230,3,24,20,34,27,54,114,256,2,545,30,0,2,0,1,0
37581,111,6048,1943,715,1694,26,18,214,1969,12,185,120,237,197,357,1436,2721,7,20915,1161,0,2,26,31,0
37582,35,1473,442,244,305,14,16,103,456,11,68,45,75,79,120,452,756,6,4588,254,0,2,4,9,0
37583,48,1928,1098,241,925,5,10,155,1103,7,46,25,49,53,74,273,423,3,1580,87,0,2,2,7,0
37584,48,1639,601,196,481,2,23,85,603,8,63,36,72,71,108,400,664,4,3036,168,0,2,4,8,0
37585,172,5239,1660,832,1314,41,38,274,1701,20,312,209,395,332,604,2671,5058,12,64042,3557,1,2,3,11,0
37586,172,5239,1057,646,719,113,100,145,1170,18,215,134,248,233,382,1740,3004,10,31186,1732,1,2,3,11,0
37587,174,5041,1660,832,1314,41,38,274,1701,20,312,209,395,332,604,2671,5058,12,64042,3557,1,2,2,27,0
37588,168,5062,1660,832,1314,41,38,274,1701,20,312,209,395,332,604,2671,5058,12,64042,3557,1,2,0,23,0
37589,168,5062,1057,646,719,113,100,145,1170,18,215,134,248,233,382,1740,3004,10,31186,1732,1,2,0,23,0
37590,168,4910,1660,832,1314,41,38,274,1701,20,312,209,395,332,604,2671,5058,12,64042,3557,1,2,0,53,0
37591,3,42,14,8,8,0,0,6,14,0,0,0,0,0,0,0,0,0,0,0,0,2,0,1,0
37592,2,34,9,6,6,0,0,3,9,0,0,0,0,0,0,0,0,0,0,0,0,2,0,3,0
37593,2,34,13,9,8,0,0,4,13,0,0,0,0,0,0,0,0,0,0,0,0,2,0,3,0
37594,1,313,382,65,130,157,2,92,539,4,10,5,10,14,15,41,57,2,114,6,0,2,9,10,0
37595,60,1118,282,196,195,3,0,86,285,8,130,71,141,138,212,936,1507,4,6538,363,0,2,15,16,0
37596,4,77,127,75,83,2,11,30,129,4,14,7,14,18,21,61,87,2,175,9,0,2,0,1,0
37597,4,77,652,304,544,16,6,88,668,6,89,51,101,95,152,591,998,3,3399,188,0,2,0,1,0
37598,4,77,2,2,2,0,0,0,2,0,0,0,0,0,0,0,0,0,0,0,0,2,0,1,0
37599,4,77,8,5,5,0,0,3,8,0,0,0,0,0,0,0,0,0,0,0,0,2,0,1,0
37600,4,77,2,2,2,0,0,0,2,0,0,0,0,0,0,0,0,0,0,0,0,2,0,1,0
37601,4,77,14,8,8,0,0,6,14,0,0,0,0,0,0,0,0,0,0,0,0,2,0,1,0
37602,4,77,6,4,4,0,0,2,6,0,0,0,0,0,0,0,0,0,0,0,0,2,0,1,0
37603,4,77,6,4,4,0,0,2,6,1,2,1,2,3,3,2,4,0,2,0,0,2,0,1,0
37604,4,77,6,4,4,0,0,2,6,0,0,0,0,0,0,0,0,0,0,0,0,2,0,1,0
37605,4,77,7,5,5,0,0,2,7,0,0,0,0,0,0,0,0,0,0,0,0,2,0,1,0
37606,4,77,6,4,4,0,0,2,6,0,0,0,0,0,0,0,0,0,0,0,0,2,0,1,0
37607,4,77,10,6,6,0,0,4,10,0,0,0,0,0,0,0,0,0,0,0,0,2,0,1,0
37608,4,77,1,1,1,0,0,0,1,0,0,0,0,0,0,0,0,0,0,0,0,2,0,1,0
37609,4,77,1,1,1,0,0,0,1,0,0,0,0,0,0,0,0,0,0,0,0,2,0,1,0
37610,4,77,14,10,10,0,0,4,14,1,1,1,1,2,2,0,2,0,1,0,0,2,0,1,0
37611,4,77,46,26,30,3,0,12,49,3,6,3,6,9,9,20,28,1,42,2,0,2,0,1,0
37612,1,9,5,3,3,0,0,2,5,0,0,0,0,0,0,0,0,0,0,0,0,2,0,1,0
37613,1,90,13,10,10,0,0,3,13,1,2,1,2,3,3,2,4,0,2,0,0,2,0,1,0
37614,7,111,44,19,17,0,16,11,44,3,14,7,14,17,21,58,85,1,128,7,0,2,1,2,0
37615,3,63,127,75,83,2,11,30,129,4,14,7,14,18,21,61,87,2,175,9,0,2,1,2,0
37616,3,63,652,304,544,16,6,88,668,6,89,51,101,95,152,591,998,3,3399,188,0,2,1,2,0
37617,3,63,2,2,2,0,0,0,2,0,0,0,0,0,0,0,0,0,0,0,0,2,1,2,0
37618,3,63,8,5,5,0,0,3,8,0,0,0,0,0,0,0,0,0,0,0,0,2,1,2,0
37619,3,63,2,2,2,0,0,0,2,0,0,0,0,0,0,0,0,0,0,0,0,2,1,2,0
37620,3,63,14,8,8,0,0,6,14,0,0,0,0,0,0,0,0,0,0,0,0,2,1,2,0
37621,3,63,6,4,4,0,0,2,6,0,0,0,0,0,0,0,0,0,0,0,0,2,1,2,0
37622,3,63,6,4,4,0,0,2,6,1,2,1,2,3,3,2,4,0,2,0,0,2,1,2,0
37623,3,63,6,4,4,0,0,2,6,0,0,0,0,0,0,0,0,0,0,0,0,2,1,2,0
37624,3,63,7,5,5,0,0,2,7,0,0,0,0,0,0,0,0,0,0,0,0,2,1,2,0
37625,3,63,6,4,4,0,0,2,6,0,0,0,0,0,0,0,0,0,0,0,0,2,1,2,0
37626,3,63,10,6,6,0,0,4,10,0,0,0,0,0,0,0,0,0,0,0,0,2,1,2,0
37627,3,63,1,1,1,0,0,0,1,0,0,0,0,0,0,0,0,0,0,0,0,2,1,2,0
37628,3,63,1,1,1,0,0,0,1,0,0,0,0,0,0,0,0,0,0,0,0,2,1,2,0
37629,3,63,14,10,10,0,0,4,14,1,1,1,1,2,2,0,2,0,1,0,0,2,1,2,0
37630,3,63,46,26,30,3,0,12,49,3,6,3,6,9,9,20,28,1,42,2,0,2,1,2,0
37631,7,293,72,33,56,0,4,12,72,1,1,1,1,2,2,0,2,0,1,0,0,2,2,3,0
37632,12,226,127,75,83,2,11,30,129,4,14,7,14,18,21,61,87,2,175,9,0,2,1,2,0
37633,12,226,652,304,544,16,6,88,668,6,89,51,101,95,152,591,998,3,3399,188,0,2,1,2,0
37634,12,226,2,2,2,0,0,0,2,0,0,0,0,0,0,0,0,0,0,0,0,2,1,2,0
37635,12,226,8,5,5,0,0,3,8,0,0,0,0,0,0,0,0,0,0,0,0,2,1,2,0
37636,12,226,2,2,2,0,0,0,2,0,0,0,0,0,0,0,0,0,0,0,0,2,1,2,0
37637,12,226,14,8,8,0,0,6,14,0,0,0,0,0,0,0,0,0,0,0,0,2,1,2,0
37638,12,226,6,4,4,0,0,2,6,0,0,0,0,0,0,0,0,0,0,0,0,2,1,2,0
37639,12,226,6,4,4,0,0,2,6,1,2,1,2,3,3,2,4,0,2,0,0,2,1,2,0
37640,12,226,6,4,4,0,0,2,6,0,0,0,0,0,0,0,0,0,0,0,0,2,1,2,0
37641,12,226,7,5,5,0,0,2,7,0,0,0,0,0,0,0,0,0,0,0,0,2,1,2,0
37642,12,226,6,4,4,0,0,2,6,0,0,0,0,0,0,0,0,0,0,0,0,2,1,2,0
37643,12,226,10,6,6,0,0,4,10,0,0,0,0,0,0,0,0,0,0,0,0,2,1,2,0
37644,12,226,1,1,1,0,0,0,1,0,0,0,0,0,0,0,0,0,0,0,0,2,1,2,0
37645,12,226,1,1,1,0,0,0,1,0,0,0,0,0,0,0,0,0,0,0,0,2,1,2,0
37646,12,226,14,10,10,0,0,4,14,1,1,1,1,2,2,0,2,0,1,0,0,2,1,2,0
37647,12,226,46,26,30,3,0,12,49,3,6,3,6,9,9,20,28,1,42,2,0,2,1,2,0
37648,6,71,127,75,83,2,11,30,129,4,14,7,14,18,21,61,87,2,175,9,0,2,0,1,0
37649,6,71,652,304,544,16,6,88,668,6,89,51,101,95,152,591,998,3,3399,188,0,2,0,1,0
37650,6,71,2,2,2,0,0,0,2,0,0,0,0,0,0,0,0,0,0,0,0,2,0,1,0
37651,6,71,8,5,5,0,0,3,8,0,0,0,0,0,0,0,0,0,0,0,0,2,0,1,0
37652,6,71,2,2,2,0,0,0,2,0,0,0,0,0,0,0,0,0,0,0,0,2,0,1,0
37653,6,71,14,8,8,0,0,6,14,0,0,0,0,0,0,0,0,0,0,0,0,2,0,1,0
37654,6,71,6,4,4,0,0,2,6,0,0,0,0,0,0,0,0,0,0,0,0,2,0,1,0
37655,6,71,6,4,4,0,0,2,6,1,2,1,2,3,3,2,4,0,2,0,0,2,0,1,0
37656,6,71,6,4,4,0,0,2,6,0,0,0,0,0,0,0,0,0,0,0,0,2,0,1,0
37657,6,71,7,5,5,0,0,2,7,0,0,0,0,0,0,0,0,0,0,0,0,2,0,1,0
37658,6,71,6,4,4,0,0,2,6,0,0,0,0,0,0,0,0,0,0,0,0,2,0,1,0
37659,6,71,10,6,6,0,0,4,10,0,0,0,0,0,0,0,0,0,0,0,0,2,0,1,0
37660,6,71,1,1,1,0,0,0,1,0,0,0,0,0,0,0,0,0,0,0,0,2,0,1,0
37661,6,71,1,1,1,0,0,0,1,0,0,0,0,0,0,0,0,0,0,0,0,2,0,1,0
37662,6,71,14,10,10,0,0,4,14,1,1,1,1,2,2,0,2,0,1,0,0,2,0,1,0
37663,6,71,46,26,30,3,0,12,49,3,6,3,6,9,9,20,28,1,42,2,0,2,0,1,0
37664,3,23,14,7,7,2,0,5,16,0,0,0,0,0,0,0,0,0,0,0,0,2,1,2,0
37665,7,103,38,23,23,0,0,15,38,0,0,0,0,0,0,0,0,0,0,0,0,2,0,1,0
37666,17,378,85,59,61,8,0,16,93,5,18,10,18,23,28,86,126,2,316,17,0,2,0,1,0
37667,12,515,124,78,88,2,3,26,126,4,13,7,13,17,20,56,81,2,163,9,0,2,0,1,0
37668,1,92,42,7,35,4,0,5,46,1,2,1,2,3,3,2,4,0,2,0,0,2,2,6,0
37669,1,92,11,6,10,0,0,1,11,2,4,2,4,6,6,10,15,1,15,0,0,2,2,6,0
37670,11,227,19,8,11,5,0,4,24,2,5,3,6,7,9,13,25,1,30,1,0,2,1,6,0
37671,11,227,102,59,69,5,3,24,107,6,22,15,28,28,43,113,206,3,789,43,0,2,1,6,0
37672,11,227,106,40,36,3,49,17,109,8,17,13,23,25,36,93,167,5,904,50,0,2,1,6,0
37673,221,4718,182,127,129,0,0,53,182,5,39,21,42,44,63,217,343,2,926,51,0,2,65,116,0
37674,221,4718,1165,710,800,67,119,181,1232,18,243,153,282,261,435,2000,3492,10,36473,2026,1,2,65,116,0
37675,67,1551,773,419,590,28,0,166,801,10,204,113,217,214,330,1598,2554,5,13587,754,0,2,2,8,0
37676,67,1551,421,273,302,44,34,57,465,17,81,59,107,98,166,583,1098,11,12329,684,0,2,2,8,0
37677,14,404,149,95,105,2,0,41,151,8,54,28,55,62,83,334,494,4,2013,111,0,2,6,11,0
37678,14,404,82,56,54,0,13,15,82,4,13,8,16,17,24,56,98,2,241,13,0,2,6,11,0
37679,25,489,2,2,2,0,0,0,2,0,0,0,0,0,0,0,0,0,0,0,0,2,3,14,0
37680,25,489,99,48,90,1,3,5,100,0,0,0,0,0,0,0,0,0,0,0,0,2,3,14,0
37681,25,489,8,5,5,2,0,1,10,0,0,0,0,0,0,0,0,0,0,0,0,2,3,14,0
37682,25,489,1217,716,841,84,126,174,1301,14,185,118,215,199,333,1446,2542,8,20687,1149,0,2,3,14,0
37683,25,489,160,89,115,0,13,31,160,7,15,11,17,22,28,78,124,3,495,27,0,2,3,14,0
37684,25,489,10,10,9,9,0,0,19,0,0,0,0,0,0,0,0,0,0,0,0,2,3,14,0
37685,25,489,173,84,99,8,29,36,181,5,12,7,13,17,20,54,81,2,221,12,0,2,3,14,0
37686,25,489,3,1,1,3,0,0,6,0,0,0,0,0,0,0,0,0,0,0,0,2,3,14,0
37687,174,5263,1660,832,1314,41,38,274,1701,20,312,209,395,332,604,2671,5058,12,64042,3557,1,2,54,132,0
37688,174,5263,1057,646,719,113,100,145,1170,18,215,134,248,233,382,1740,3004,10,31186,1732,1,2,54,132,0
37689,17,327,95,58,50,9,16,20,104,12,33,24,45,45,69,209,378,8,3100,172,0,2,1,8,0
37690,116,2120,477,336,357,30,23,73,507,16,194,134,250,210,384,1538,2962,10,30538,1696,0,2,44,47,0
37691,90,2017,996,429,845,24,10,117,1020,7,76,50,88,83,138,494,879,4,3565,198,0,2,8,15,0
37692,90,2017,456,277,329,12,42,72,468,13,85,50,97,98,147,592,972,7,7212,400,0,2,8,15,0
37693,160,3411,1513,682,1277,25,13,200,1538,11,199,116,219,210,335,1557,2584,6,15641,868,0,2,23,56,0
37694,160,3411,819,519,539,24,98,155,843,15,96,57,106,111,163,690,1107,8,9171,509,0,2,23,56,0
37695,59,1095,207,111,150,11,0,50,218,5,26,19,36,31,55,133,272,3,943,52,0,2,36,166,0
37696,59,1095,410,198,237,31,55,97,441,11,63,38,72,74,110,414,683,6,4293,238,0,2,36,166,0
37697,235,4869,2,2,2,0,0,0,2,0,0,0,0,0,0,0,0,0,0,0,0,2,22,38,0
37698,235,4869,99,48,90,1,3,5,100,0,0,0,0,0,0,0,0,0,0,0,0,2,22,38,0
37699,235,4869,8,5,5,2,0,1,10,0,0,0,0,0,0,0,0,0,0,0,0,2,22,38,0
37700,235,4869,1217,716,841,84,126,174,1301,14,185,118,215,199,333,1446,2542,8,20687,1149,0,2,22,38,0
37701,235,4869,160,89,115,0,13,31,160,7,15,11,17,22,28,78,124,3,495,27,0,2,22,38,0
37702,235,4869,10,10,9,9,0,0,19,0,0,0,0,0,0,0,0,0,0,0,0,2,22,38,0
37703,235,4869,173,84,99,8,29,36,181,5,12,7,13,17,20,54,81,2,221,12,0,2,22,38,0
37704,235,4869,3,1,1,3,0,0,6,0,0,0,0,0,0,0,0,0,0,0,0,2,22,38,0
37705,98,2010,463,295,324,28,62,57,491,12,134,82,154,146,236,989,1696,6,11700,650,0,2,8,10,0
37706,55,770,167,116,138,4,5,22,171,8,48,30,56,56,86,292,499,4,2330,129,0,2,0,1,0
37707,57,1484,339,213,244,17,9,65,356,10,42,26,48,52,74,259,421,5,2410,133,0,2,11,16,0
37708,90,2288,1455,414,1257,16,76,112,1471,5,41,23,46,46,69,231,381,2,1069,59,0,2,4,36,0
37709,90,2288,669,365,481,22,61,110,691,15,103,63,122,118,185,747,1273,8,11311,628,0,2,4,36,0
37710,251,5822,4293,999,3693,19,54,507,4312,9,155,88,170,164,258,1156,1898,4,9368,520,0,2,19,30,0
37711,251,5822,1482,859,1002,125,135,219,1607,16,219,134,251,235,385,1766,3032,9,27804,1544,1,2,19,30,0
37712,6,128,44,22,19,0,19,6,44,2,10,6,12,12,18,35,64,1,77,4,0,2,0,4,0
37713,31,1078,74,35,59,1,0,14,75,3,14,7,14,17,21,58,85,1,128,7,0,2,9,12,0
37714,31,1078,245,125,200,5,7,34,250,7,30,17,34,37,51,166,265,3,1053,58,0,2,9,12,0
37715,54,657,647,139,84,35,284,233,682,0,0,0,0,0,0,0,0,0,0,0,0,2,0,1,0
37716,117,3127,1523,757,1297,19,12,193,1542,12,193,117,230,205,347,1508,2664,7,19053,1058,0,2,10,20,0
37717,117,3127,701,378,504,33,58,109,734,13,110,68,126,123,194,794,1346,7,10027,557,0,2,10,20,0
37718,104,2739,773,422,505,30,103,129,803,14,77,46,83,91,129,535,839,7,6334,351,0,2,31,47,0
37719,146,3571,77,34,69,0,0,8,77,3,24,16,29,27,45,114,213,1,387,21,0,2,18,82,0
37720,146,3571,712,438,573,51,9,84,763,14,102,71,128,116,199,733,1364,8,11988,666,0,2,18,82,0
37721,24,600,2,2,2,0,0,0,2,0,0,0,0,0,0,0,0,0,0,0,0,2,0,5,0
37722,24,600,99,48,90,1,3,5,100,0,0,0,0,0,0,0,0,0,0,0,0,2,0,5,0
37723,24,600,8,5,5,2,0,1,10,0,0,0,0,0,0,0,0,0,0,0,0,2,0,5,0
37724,24,600,1217,716,841,84,126,174,1301,14,185,118,215,199,333,1446,2542,8,20687,1149,0,2,0,5,0
37725,24,600,160,89,115,0,13,31,160,7,15,11,17,22,28,78,124,3,495,27,0,2,0,5,0
37726,24,600,10,10,9,9,0,0,19,0,0,0,0,0,0,0,0,0,0,0,0,2,0,5,0
37727,24,600,173,84,99,8,29,36,181,5,12,7,13,17,20,54,81,2,221,12,0,2,0,5,0
37728,24,600,3,1,1,3,0,0,6,0,0,0,0,0,0,0,0,0,0,0,0,2,0,5,0
37729,30,657,125,97,103,3,0,19,128,9,25,17,27,34,44,144,223,4,1087,60,0,2,2,5,0
37730,22,367,102,57,55,5,16,25,107,5,17,10,18,22,28,81,124,2,330,18,0,2,2,3,0
37731,71,1560,402,202,227,24,74,80,426,12,52,33,61,64,94,339,564,7,3969,220,0,2,16,14,0
37732,51,1090,447,308,343,6,5,95,453,7,96,59,111,103,170,651,1136,4,4600,255,0,2,15,30,0
37733,51,1090,322,174,179,16,74,51,338,10,41,26,46,51,72,252,408,5,2291,127,0,2,15,30,0
37734,75,1603,53,23,39,0,0,13,53,2,8,4,8,10,12,26,39,1,39,2,0,2,6,14,0
37735,75,1603,515,298,307,33,80,99,548,12,63,44,77,75,121,419,753,7,5527,307,0,2,6,14,0
37736,18,296,424,94,331,4,0,89,428,1,5,5,5,6,10,11,25,0,12,0,0,2,1,8,0
37737,18,296,38,23,23,6,0,8,44,3,11,7,11,14,18,42,68,1,102,5,0,2,1,8,0
37738,19,499,205,80,86,16,53,53,221,7,18,10,19,25,29,94,134,3,497,27,0,2,3,8,0
37739,15,476,184,100,137,2,15,30,186,6,38,20,39,44,59,214,322,3,991,55,0,2,6,22,0
37740,15,476,103,65,74,8,5,16,111,7,17,9,17,24,26,89,119,3,417,23,0,2,6,22,0
37741,58,1189,91,45,69,0,3,18,91,3,9,6,10,12,16,33,57,1,95,5,0,2,8,24,0
37742,58,1189,367,234,237,17,34,68,384,16,55,34,61,71,95,381,584,8,5183,287,0,2,8,24,0
37743,228,5833,722,423,573,19,0,135,741,12,172,101,199,184,300,1320,2257,6,15668,870,0,2,41,61,0
37744,228,5833,1508,847,911,44,250,301,1552,14,148,88,169,162,257,1120,1886,7,15077,837,0,2,41,61,0
37745,314,6872,72,33,56,0,4,12,72,1,1,1,1,2,2,0,2,0,1,0,0,2,22,31,0
37746,314,6872,1454,835,1044,76,110,219,1530,17,275,158,296,292,454,2297,3718,9,34017,1889,1,2,22,31,0
37747,89,1801,757,253,292,73,244,162,830,13,61,38,67,74,105,409,651,7,4654,258,0,2,7,22,0
37748,38,787,386,256,301,16,9,68,402,4,59,35,69,63,104,355,621,2,1453,80,0,2,6,44,0
37749,38,787,264,131,164,11,41,46,275,6,38,22,40,44,62,214,338,3,1068,59,0,2,6,44,0
37750,67,1747,466,257,367,18,25,50,484,7,126,86,171,133,257,898,1813,4,8612,478,0,2,9,19,0
37751,67,1747,507,281,342,29,59,88,536,10,53,29,57,63,86,336,514,5,2764,153,0,2,9,19,0
37752,25,538,215,129,180,6,0,29,221,8,65,43,72,73,115,415,711,4,3153,175,0,2,2,7,0
37753,25,538,97,69,77,3,3,16,100,6,22,13,23,28,36,113,173,3,542,30,0,2,2,7,0
37754,89,1896,1043,504,840,53,9,147,1096,9,180,112,198,189,310,1377,2344,4,11604,644,0,2,9,12,0
37755,89,1896,383,288,292,26,6,62,409,11,65,38,67,76,105,429,656,5,3719,206,0,2,9,12,0
37756,20,408,294,64,250,0,0,43,294,1,20,10,20,21,30,86,131,0,65,3,0,2,0,5,0
37757,20,408,78,46,62,3,0,14,81,3,8,4,8,11,12,28,41,1,62,3,0,2,0,5,0
37758,5,111,110,30,77,3,13,16,113,4,21,15,30,25,45,100,208,2,597,33,0,2,0,5,0
37759,5,111,28,15,21,1,0,6,29,0,0,0,0,0,0,0,0,0,0,0,0,2,0,5,0
37760,40,784,1178,367,1042,6,15,115,1184,9,94,51,95,103,146,644,976,4,4439,246,0,2,2,11,0
37761,40,784,177,108,140,8,0,27,185,6,30,16,32,36,48,162,248,3,794,44,0,2,2,11,0
37762,28,452,219,78,157,11,5,46,230,3,24,20,34,27,54,114,256,2,545,30,0,2,0,1,0
37763,28,452,108,64,79,9,0,20,117,5,15,11,19,20,30,70,129,3,410,22,0,2,0,1,0
37764,280,5869,1943,715,1694,26,18,214,1969,12,185,120,237,197,357,1436,2721,7,20915,1161,0,2,19,42,0
37765,280,5869,1168,838,957,57,25,144,1225,19,348,224,416,367,640,3018,5452,11,61921,3440,1,2,19,42,0
37766,19,699,442,244,305,14,16,103,456,11,68,45,75,79,120,452,756,6,4588,254,0,2,3,11,0
37767,19,699,182,102,99,11,40,35,193,3,11,6,11,14,17,42,64,1,97,5,0,2,3,11,0
37768,65,1251,1098,241,925,5,10,155,1103,7,46,25,49,53,74,273,423,3,1580,87,0,2,1,25,0
37769,65,1251,282,202,222,14,2,44,296,8,42,24,43,50,67,250,378,4,1548,86,0,2,1,25,0
37770,2,153,37,13,25,0,6,6,37,1,2,1,2,3,3,2,4,0,2,0,0,2,1,2,0
37771,2,153,133,47,40,1,43,49,134,0,0,0,0,0,0,0,0,0,0,0,0,2,1,2,0
37772,23,630,601,196,481,2,23,85,603,8,63,36,72,71,108,400,664,4,3036,168,0,2,3,29,0
37773,23,630,156,79,106,5,16,28,161,5,14,8,15,19,23,64,97,2,261,14,0,2,3,29,0
37774,104,4398,1289,550,1043,56,32,155,1345,10,167,93,185,177,278,1266,2075,5,11498,638,0,2,12,29,0
37775,31,963,182,127,129,0,0,53,182,5,39,21,42,44,63,217,343,2,926,51,0,2,12,39,0
37776,151,7198,1392,870,1177,35,17,170,1427,14,494,280,531,508,811,4473,7289,7,54850,3047,2,2,27,46,0
37777,95,2843,773,419,590,28,0,166,801,10,204,113,217,214,330,1598,2554,5,13587,754,0,2,17,26,0
37778,6,163,127,75,83,2,11,30,129,4,14,7,14,18,21,61,87,2,175,9,0,2,0,1,0
37779,6,163,652,304,544,16,6,88,668,6,89,51,101,95,152,591,998,3,3399,188,0,2,0,1,0
37780,6,163,2,2,2,0,0,0,2,0,0,0,0,0,0,0,0,0,0,0,0,2,0,1,0
37781,6,163,8,5,5,0,0,3,8,0,0,0,0,0,0,0,0,0,0,0,0,2,0,1,0
37782,6,163,2,2,2,0,0,0,2,0,0,0,0,0,0,0,0,0,0,0,0,2,0,1,0
37783,6,163,14,8,8,0,0,6,14,0,0,0,0,0,0,0,0,0,0,0,0,2,0,1,0
37784,6,163,6,4,4,0,0,2,6,0,0,0,0,0,0,0,0,0,0,0,0,2,0,1,0
37785,6,163,6,4,4,0,0,2,6,1,2,1,2,3,3,2,4,0,2,0,0,2,0,1,0
37786,6,163,6,4,4,0,0,2,6,0,0,0,0,0,0,0,0,0,0,0,0,2,0,1,0
37787,6,163,7,5,5,0,0,2,7,0,0,0,0,0,0,0,0,0,0,0,0,2,0,1,0
37788,6,163,6,4,4,0,0,2,6,0,0,0,0,0,0,0,0,0,0,0,0,2,0,1,0
37789,6,163,10,6,6,0,0,4,10,0,0,0,0,0,0,0,0,0,0,0,0,2,0,1,0
37790,6,163,1,1,1,0,0,0,1,0,0,0,0,0,0,0,0,0,0,0,0,2,0,1,0
37791,6,163,1,1,1,0,0,0,1,0,0,0,0,0,0,0,0,0,0,0,0,2,0,1,0
37792,6,163,14,10,10,0,0,4,14,1,1,1,1,2,2,0,2,0,1,0,0,2,0,1,0
37793,6,163,46,26,30,3,0,12,49,3,6,3,6,9,9,20,28,1,42,2,0,2,0,1,0
37794,14,833,75,38,59,1,3,12,76,2,4,2,4,6,6,10,15,1,15,0,0,2,0,5,0
37795,2,58,16,12,9,0,0,6,16,1,2,1,2,3,3,2,4,0,2,0,0,2,1,6,0
37796,1,6,2,2,2,0,0,0,2,0,0,0,0,0,0,0,0,0,0,0,0,2,0,1,0
37797,1,6,99,48,90,1,3,5,100,0,0,0,0,0,0,0,0,0,0,0,0,2,0,1,0
37798,1,6,8,5,5,2,0,1,10,0,0,0,0,0,0,0,0,0,0,0,0,2,0,1,0
37799,1,6,1217,716,841,84,126,174,1301,14,185,118,215,199,333,1446,2542,8,20687,1149,0,2,0,1,0
37800,1,6,160,89,115,0,13,31,160,7,15,11,17,22,28,78,124,3,495,27,0,2,0,1,0
37801,1,6,10,10,9,9,0,0,19,0,0,0,0,0,0,0,0,0,0,0,0,2,0,1,0
37802,1,6,173,84,99,8,29,36,181,5,12,7,13,17,20,54,81,2,221,12,0,2,0,1,0
37803,1,6,3,1,1,3,0,0,6,0,0,0,0,0,0,0,0,0,0,0,0,2,0,1,0
37804,1,6,2,2,2,0,0,0,2,0,0,0,0,0,0,0,0,0,0,0,0,2,0,1,0
37805,1,6,2,2,2,0,0,0,2,0,0,0,0,0,0,0,0,0,0,0,0,2,0,1,0
37806,1,6,2,2,2,0,0,0,2,0,0,0,0,0,0,0,0,0,0,0,0,2,0,1,0
37807,1,6,2,2,2,0,0,0,2,0,0,0,0,0,0,0,0,0,0,0,0,2,0,1,0
37808,1,8,127,75,83,2,11,30,129,4,14,7,14,18,21,61,87,2,175,9,0,2,0,1,0
37809,1,8,652,304,544,16,6,88,668,6,89,51,101,95,152,591,998,3,3399,188,0,2,0,1,0
37810,1,8,2,2,2,0,0,0,2,0,0,0,0,0,0,0,0,0,0,0,0,2,0,1,0
37811,1,8,8,5,5,0,0,3,8,0,0,0,0,0,0,0,0,0,0,0,0,2,0,1,0
37812,1,8,2,2,2,0,0,0,2,0,0,0,0,0,0,0,0,0,0,0,0,2,0,1,0
37813,1,8,14,8,8,0,0,6,14,0,0,0,0,0,0,0,0,0,0,0,0,2,0,1,0
37814,1,8,6,4,4,0,0,2,6,0,0,0,0,0,0,0,0,0,0,0,0,2,0,1,0
37815,1,8,6,4,4,0,0,2,6,1,2,1,2,3,3,2,4,0,2,0,0,2,0,1,0
37816,1,8,6,4,4,0,0,2,6,0,0,0,0,0,0,0,0,0,0,0,0,2,0,1,0
37817,1,8,7,5,5,0,0,2,7,0,0,0,0,0,0,0,0,0,0,0,0,2,0,1,0
37818,1,8,6,4,4,0,0,2,6,0,0,0,0,0,0,0,0,0,0,0,0,2,0,1,0
37819,1,8,10,6,6,0,0,4,10,0,0,0,0,0,0,0,0,0,0,0,0,2,0,1,0
37820,1,8,1,1,1,0,0,0,1,0,0,0,0,0,0,0,0,0,0,0,0,2,0,1,0
37821,1,8,1,1,1,0,0,0,1,0,0,0,0,0,0,0,0,0,0,0,0,2,0,1,0
37822,1,8,14,10,10,0,0,4,14,1,1,1,1,2,2,0,2,0,1,0,0,2,0,1,0
37823,1,8,46,26,30,3,0,12,49,3,6,3,6,9,9,20,28,1,42,2,0,2,0,1,0
37824,1,6,2,2,2,0,0,0,2,0,0,0,0,0,0,0,0,0,0,0,0,2,0,1,0
37825,1,6,2,2,2,0,0,0,2,0,0,0,0,0,0,0,0,0,0,0,0,2,0,1,0
37826,1,6,2,2,2,0,0,0,2,0,0,0,0,0,0,0,0,0,0,0,0,2,0,1,0
37827,1,6,2,2,2,0,0,0,2,0,0,0,0,0,0,0,0,0,0,0,0,2,0,1,0
37828,1,6,2,2,2,0,0,0,2,0,0,0,0,0,0,0,0,0,0,0,0,2,0,1,0
37829,1,6,2,2,2,0,0,0,2,0,0,0,0,0,0,0,0,0,0,0,0,2,0,1,0
37830,1,6,2,2,2,0,0,0,2,0,0,0,0,0,0,0,0,0,0,0,0,2,0,1,0
37831,1,6,2,2,2,0,0,0,2,0,0,0,0,0,0,0,0,0,0,0,0,2,0,1,0
37832,1,6,2,2,2,0,0,0,2,0,0,0,0,0,0,0,0,0,0,0,0,2,0,1,0
37833,2,25,127,75,83,2,11,30,129,4,14,7,14,18,21,61,87,2,175,9,0,2,0,1,0
37834,2,25,652,304,544,16,6,88,668,6,89,51,101,95,152,591,998,3,3399,188,0,2,0,1,0
37835,2,25,2,2,2,0,0,0,2,0,0,0,0,0,0,0,0,0,0,0,0,2,0,1,0
37836,2,25,8,5,5,0,0,3,8,0,0,0,0,0,0,0,0,0,0,0,0,2,0,1,0
37837,2,25,2,2,2,0,0,0,2,0,0,0,0,0,0,0,0,0,0,0,0,2,0,1,0
37838,2,25,14,8,8,0,0,6,14,0,0,0,0,0,0,0,0,0,0,0,0,2,0,1,0
37839,2,25,6,4,4,0,0,2,6,0,0,0,0,0,0,0,0,0,0,0,0,2,0,1,0
37840,2,25,6,4,4,0,0,2,6,1,2,1,2,3,3,2,4,0,2,0,0,2,0,1,0
37841,2,25,6,4,4,0,0,2,6,0,0,0,0,0,0,0,0,0,0,0,0,2,0,1,0
37842,2,25,7,5,5,0,0,2,7,0,0,0,0,0,0,0,0,0,0,0,0,2,0,1,0
37843,2,25,6,4,4,0,0,2,6,0,0,0,0,0,0,0,0,0,0,0,0,2,0,1,0
37844,2,25,10,6,6,0,0,4,10,0,0,0,0,0,0,0,0,0,0,0,0,2,0,1,0
37845,2,25,1,1,1,0,0,0,1,0,0,0,0,0,0,0,0,0,0,0,0,2,0,1,0
37846,2,25,1,1,1,0,0,0,1,0,0,0,0,0,0,0,0,0,0,0,0,2,0,1,0
37847,2,25,14,10,10,0,0,4,14,1,1,1,1,2,2,0,2,0,1,0,0,2,0,1,0
37848,2,25,46,26,30,3,0,12,49,3,6,3,6,9,9,20,28,1,42,2,0,2,0,1,0
37849,1,52,14,12,10,0,0,4,14,1,2,1,2,3,3,2,4,0,2,0,0,2,1,2,0
37850,1,55,14,12,10,0,0,4,14,1,2,1,2,3,3,2,4,0,2,0,0,2,1,2,0
37851,1,52,14,12,10,0,0,4,14,1,2,1,2,3,3,2,4,0,2,0,0,2,1,2,0
37852,1,71,19,18,14,0,0,5,19,1,2,1,2,3,3,2,4,0,2,0,0,2,2,3,0
37853,2,18,10,6,6,0,0,4,10,0,0,0,0,0,0,0,0,0,0,0,0,2,0,1,0
37854,2,36,127,75,83,2,11,30,129,4,14,7,14,18,21,61,87,2,175,9,0,2,0,1,0
37855,2,36,652,304,544,16,6,88,668,6,89,51,101,95,152,591,998,3,3399,188,0,2,0,1,0
37856,2,36,2,2,2,0,0,0,2,0,0,0,0,0,0,0,0,0,0,0,0,2,0,1,0
37857,2,36,8,5,5,0,0,3,8,0,0,0,0,0,0,0,0,0,0,0,0,2,0,1,0
37858,2,36,2,2,2,0,0,0,2,0,0,0,0,0,0,0,0,0,0,0,0,2,0,1,0
37859,2,36,14,8,8,0,0,6,14,0,0,0,0,0,0,0,0,0,0,0,0,2,0,1,0
37860,2,36,6,4,4,0,0,2,6,0,0,0,0,0,0,0,0,0,0,0,0,2,0,1,0
37861,2,36,6,4,4,0,0,2,6,1,2,1,2,3,3,2,4,0,2,0,0,2,0,1,0
37862,2,36,6,4,4,0,0,2,6,0,0,0,0,0,0,0,0,0,0,0,0,2,0,1,0
37863,2,36,7,5,5,0,0,2,7,0,0,0,0,0,0,0,0,0,0,0,0,2,0,1,0
37864,2,36,6,4,4,0,0,2,6,0,0,0,0,0,0,0,0,0,0,0,0,2,0,1,0
37865,2,36,10,6,6,0,0,4,10,0,0,0,0,0,0,0,0,0,0,0,0,2,0,1,0
37866,2,36,1,1,1,0,0,0,1,0,0,0,0,0,0,0,0,0,0,0,0,2,0,1,0
37867,2,36,1,1,1,0,0,0,1,0,0,0,0,0,0,0,0,0,0,0,0,2,0,1,0
37868,2,36,14,10,10,0,0,4,14,1,1,1,1,2,2,0,2,0,1,0,0,2,0,1,0
37869,2,36,46,26,30,3,0,12,49,3,6,3,6,9,9,20,28,1,42,2,0,2,0,1,0
37870,1,6,2,2,2,0,0,0,2,0,0,0,0,0,0,0,0,0,0,0,0,2,0,1,0
37871,1,6,2,2,2,0,0,0,2,0,0,0,0,0,0,0,0,0,0,0,0,2,0,1,0
37872,1,6,2,2,2,0,0,0,2,0,0,0,0,0,0,0,0,0,0,0,0,2,0,1,0
37873,1,6,2,2,2,0,0,0,2,0,0,0,0,0,0,0,0,0,0,0,0,2,0,1,0
37874,1,26,127,75,83,2,11,30,129,4,14,7,14,18,21,61,87,2,175,9,0,2,0,1,0
37875,1,26,652,304,544,16,6,88,668,6,89,51,101,95,152,591,998,3,3399,188,0,2,0,1,0
37876,1,26,2,2,2,0,0,0,2,0,0,0,0,0,0,0,0,0,0,0,0,2,0,1,0
37877,1,26,8,5,5,0,0,3,8,0,0,0,0,0,0,0,0,0,0,0,0,2,0,1,0
37878,1,26,2,2,2,0,0,0,2,0,0,0,0,0,0,0,0,0,0,0,0,2,0,1,0
37879,1,26,14,8,8,0,0,6,14,0,0,0,0,0,0,0,0,0,0,0,0,2,0,1,0
37880,1,26,6,4,4,0,0,2,6,0,0,0,0,0,0,0,0,0,0,0,0,2,0,1,0
37881,1,26,6,4,4,0,0,2,6,1,2,1,2,3,3,2,4,0,2,0,0,2,0,1,0
37882,1,26,6,4,4,0,0,2,6,0,0,0,0,0,0,0,0,0,0,0,0,2,0,1,0
37883,1,26,7,5,5,0,0,2,7,0,0,0,0,0,0,0,0,0,0,0,0,2,0,1,0
37884,1,26,6,4,4,0,0,2,6,0,0,0,0,0,0,0,0,0,0,0,0,2,0,1,0
37885,1,26,10,6,6,0,0,4,10,0,0,0,0,0,0,0,0,0,0,0,0,2,0,1,0
37886,1,26,1,1,1,0,0,0,1,0,0,0,0,0,0,0,0,0,0,0,0,2,0,1,0
37887,1,26,1,1,1,0,0,0,1,0,0,0,0,0,0,0,0,0,0,0,0,2,0,1,0
37888,1,26,14,10,10,0,0,4,14,1,1,1,1,2,2,0,2,0,1,0,0,2,0,1,0
37889,1,26,46,26,30,3,0,12,49,3,6,3,6,9,9,20,28,1,42,2,0,2,0,1,0
37890,1,7,2,2,2,0,0,0,2,0,0,0,0,0,0,0,0,0,0,0,0,2,0,1,0
37891,1,24,127,75,83,2,11,30,129,4,14,7,14,18,21,61,87,2,175,9,0,2,0,1,0
37892,1,24,652,304,544,16,6,88,668,6,89,51,101,95,152,591,998,3,3399,188,0,2,0,1,0
37893,1,24,2,2,2,0,0,0,2,0,0,0,0,0,0,0,0,0,0,0,0,2,0,1,0
37894,1,24,8,5,5,0,0,3,8,0,0,0,0,0,0,0,0,0,0,0,0,2,0,1,0
37895,1,24,2,2,2,0,0,0,2,0,0,0,0,0,0,0,0,0,0,0,0,2,0,1,0
37896,1,24,14,8,8,0,0,6,14,0,0,0,0,0,0,0,0,0,0,0,0,2,0,1,0
37897,1,24,6,4,4,0,0,2,6,0,0,0,0,0,0,0,0,0,0,0,0,2,0,1,0
37898,1,24,6,4,4,0,0,2,6,1,2,1,2,3,3,2,4,0,2,0,0,2,0,1,0
37899,1,24,6,4,4,0,0,2,6,0,0,0,0,0,0,0,0,0,0,0,0,2,0,1,0
37900,1,24,7,5,5,0,0,2,7,0,0,0,0,0,0,0,0,0,0,0,0,2,0,1,0
37901,1,24,6,4,4,0,0,2,6,0,0,0,0,0,0,0,0,0,0,0,0,2,0,1,0
37902,1,24,10,6,6,0,0,4,10,0,0,0,0,0,0,0,0,0,0,0,0,2,0,1,0
37903,1,24,1,1,1,0,0,0,1,0,0,0,0,0,0,0,0,0,0,0,0,2,0,1,0
37904,1,24,1,1,1,0,0,0,1,0,0,0,0,0,0,0,0,0,0,0,0,2,0,1,0
37905,1,24,14,10,10,0,0,4,14,1,1,1,1,2,2,0,2,0,1,0,0,2,0,1,0
37906,1,24,46,26,30,3,0,12,49,3,6,3,6,9,9,20,28,1,42,2,0,2,0,1,0
37907,1,7,2,2,2,0,0,0,2,0,0,0,0,0,0,0,0,0,0,0,0,2,0,1,0
37908,3,33,15,9,9,0,0,6,15,0,0,0,0,0,0,0,0,0,0,0,0,2,0,1,0
37909,1,13,127,75,83,2,11,30,129,4,14,7,14,18,21,61,87,2,175,9,0,2,0,1,0
37910,1,13,652,304,544,16,6,88,668,6,89,51,101,95,152,591,998,3,3399,188,0,2,0,1,0
37911,1,13,2,2,2,0,0,0,2,0,0,0,0,0,0,0,0,0,0,0,0,2,0,1,0
37912,1,13,8,5,5,0,0,3,8,0,0,0,0,0,0,0,0,0,0,0,0,2,0,1,0
37913,1,13,2,2,2,0,0,0,2,0,0,0,0,0,0,0,0,0,0,0,0,2,0,1,0
37914,1,13,14,8,8,0,0,6,14,0,0,0,0,0,0,0,0,0,0,0,0,2,0,1,0
37915,1,13,6,4,4,0,0,2,6,0,0,0,0,0,0,0,0,0,0,0,0,2,0,1,0
37916,1,13,6,4,4,0,0,2,6,1,2,1,2,3,3,2,4,0,2,0,0,2,0,1,0
37917,1,13,6,4,4,0,0,2,6,0,0,0,0,0,0,0,0,0,0,0,0,2,0,1,0
37918,1,13,7,5,5,0,0,2,7,0,0,0,0,0,0,0,0,0,0,0,0,2,0,1,0
37919,1,13,6,4,4,0,0,2,6,0,0,0,0,0,0,0,0,0,0,0,0,2,0,1,0
37920,1,13,10,6,6,0,0,4,10,0,0,0,0,0,0,0,0,0,0,0,0,2,0,1,0
37921,1,13,1,1,1,0,0,0,1,0,0,0,0,0,0,0,0,0,0,0,0,2,0,1,0
37922,1,13,1,1,1,0,0,0,1,0,0,0,0,0,0,0,0,0,0,0,0,2,0,1,0
37923,1,13,14,10,10,0,0,4,14,1,1,1,1,2,2,0,2,0,1,0,0,2,0,1,0
37924,1,13,46,26,30,3,0,12,49,3,6,3,6,9,9,20,28,1,42,2,0,2,0,1,0
37925,1,16,127,75,83,2,11,30,129,4,14,7,14,18,21,61,87,2,175,9,0,2,0,1,0
37926,1,16,652,304,544,16,6,88,668,6,89,51,101,95,152,591,998,3,3399,188,0,2,0,1,0
37927,1,16,2,2,2,0,0,0,2,0,0,0,0,0,0,0,0,0,0,0,0,2,0,1,0
37928,1,16,8,5,5,0,0,3,8,0,0,0,0,0,0,0,0,0,0,0,0,2,0,1,0
37929,1,16,2,2,2,0,0,0,2,0,0,0,0,0,0,0,0,0,0,0,0,2,0,1,0
37930,1,16,14,8,8,0,0,6,14,0,0,0,0,0,0,0,0,0,0,0,0,2,0,1,0
37931,1,16,6,4,4,0,0,2,6,0,0,0,0,0,0,0,0,0,0,0,0,2,0,1,0
37932,1,16,6,4,4,0,0,2,6,1,2,1,2,3,3,2,4,0,2,0,0,2,0,1,0
37933,1,16,6,4,4,0,0,2,6,0,0,0,0,0,0,0,0,0,0,0,0,2,0,1,0
37934,1,16,7,5,5,0,0,2,7,0,0,0,0,0,0,0,0,0,0,0,0,2,0,1,0
37935,1,16,6,4,4,0,0,2,6,0,0,0,0,0,0,0,0,0,0,0,0,2,0,1,0
37936,1,16,10,6,6,0,0,4,10,0,0,0,0,0,0,0,0,0,0,0,0,2,0,1,0
37937,1,16,1,1,1,0,0,0,1,0,0,0,0,0,0,0,0,0,0,0,0,2,0,1,0
37938,1,16,1,1,1,0,0,0,1,0,0,0,0,0,0,0,0,0,0,0,0,2,0,1,0
37939,1,16,14,10,10,0,0,4,14,1,1,1,1,2,2,0,2,0,1,0,0,2,0,1,0
37940,1,16,46,26,30,3,0,12,49,3,6,3,6,9,9,20,28,1,42,2,0,2,0,1,0
37941,1,10,2,2,2,0,0,0,2,1,2,1,2,3,3,2,4,0,2,0,0,2,0,1,0
37942,1,13,127,75,83,2,11,30,129,4,14,7,14,18,21,61,87,2,175,9,0,2,0,1,0
37943,1,13,652,304,544,16,6,88,668,6,89,51,101,95,152,591,998,3,3399,188,0,2,0,1,0
37944,1,13,2,2,2,0,0,0,2,0,0,0,0,0,0,0,0,0,0,0,0,2,0,1,0
37945,1,13,8,5,5,0,0,3,8,0,0,0,0,0,0,0,0,0,0,0,0,2,0,1,0
37946,1,13,2,2,2,0,0,0,2,0,0,0,0,0,0,0,0,0,0,0,0,2,0,1,0
37947,1,13,14,8,8,0,0,6,14,0,0,0,0,0,0,0,0,0,0,0,0,2,0,1,0
37948,1,13,6,4,4,0,0,2,6,0,0,0,0,0,0,0,0,0,0,0,0,2,0,1,0
37949,1,13,6,4,4,0,0,2,6,1,2,1,2,3,3,2,4,0,2,0,0,2,0,1,0
37950,1,13,6,4,4,0,0,2,6,0,0,0,0,0,0,0,0,0,0,0,0,2,0,1,0
37951,1,13,7,5,5,0,0,2,7,0,0,0,0,0,0,0,0,0,0,0,0,2,0,1,0
37952,1,13,6,4,4,0,0,2,6,0,0,0,0,0,0,0,0,0,0,0,0,2,0,1,0
37953,1,13,10,6,6,0,0,4,10,0,0,0,0,0,0,0,0,0,0,0,0,2,0,1,0
37954,1,13,1,1,1,0,0,0,1,0,0,0,0,0,0,0,0,0,0,0,0,2,0,1,0
37955,1,13,1,1,1,0,0,0,1,0,0,0,0,0,0,0,0,0,0,0,0,2,0,1,0
37956,1,13,14,10,10,0,0,4,14,1,1,1,1,2,2,0,2,0,1,0,0,2,0,1,0
37957,1,13,46,26,30,3,0,12,49,3,6,3,6,9,9,20,28,1,42,2,0,2,0,1,0
37958,2,26,10,6,6,0,0,4,10,2,4,2,4,6,6,10,15,1,15,0,0,2,0,1,0
37959,3,44,15,10,10,0,0,5,15,2,4,2,4,6,6,10,15,1,15,0,0,2,1,2,0
37960,3,39,15,9,9,0,0,6,15,0,0,0,0,0,0,0,0,0,0,0,0,2,0,1,0
37961,2,33,10,7,7,0,0,3,10,1,2,1,2,3,3,2,4,0,2,0,0,2,1,2,0
37962,3,43,15,9,9,0,0,6,15,1,4,2,4,5,6,8,13,0,6,0,0,2,1,2,0
37963,2,21,10,6,6,0,0,4,10,0,0,0,0,0,0,0,0,0,0,0,0,2,0,1,0
37964,4,61,20,12,12,0,0,8,20,1,2,1,2,3,3,2,4,0,2,0,0,2,0,1,0
37965,2,51,127,75,83,2,11,30,129,4,14,7,14,18,21,61,87,2,175,9,0,2,0,1,0
37966,2,51,652,304,544,16,6,88,668,6,89,51,101,95,152,591,998,3,3399,188,0,2,0,1,0
37967,2,51,2,2,2,0,0,0,2,0,0,0,0,0,0,0,0,0,0,0,0,2,0,1,0
37968,2,51,8,5,5,0,0,3,8,0,0,0,0,0,0,0,0,0,0,0,0,2,0,1,0
37969,2,51,2,2,2,0,0,0,2,0,0,0,0,0,0,0,0,0,0,0,0,2,0,1,0
37970,2,51,14,8,8,0,0,6,14,0,0,0,0,0,0,0,0,0,0,0,0,2,0,1,0
37971,2,51,6,4,4,0,0,2,6,0,0,0,0,0,0,0,0,0,0,0,0,2,0,1,0
37972,2,51,6,4,4,0,0,2,6,1,2,1,2,3,3,2,4,0,2,0,0,2,0,1,0
37973,2,51,6,4,4,0,0,2,6,0,0,0,0,0,0,0,0,0,0,0,0,2,0,1,0
37974,2,51,7,5,5,0,0,2,7,0,0,0,0,0,0,0,0,0,0,0,0,2,0,1,0
37975,2,51,6,4,4,0,0,2,6,0,0,0,0,0,0,0,0,0,0,0,0,2,0,1,0
37976,2,51,10,6,6,0,0,4,10,0,0,0,0,0,0,0,0,0,0,0,0,2,0,1,0
37977,2,51,1,1,1,0,0,0,1,0,0,0,0,0,0,0,0,0,0,0,0,2,0,1,0
37978,2,51,1,1,1,0,0,0,1,0,0,0,0,0,0,0,0,0,0,0,0,2,0,1,0
37979,2,51,14,10,10,0,0,4,14,1,1,1,1,2,2,0,2,0,1,0,0,2,0,1,0
37980,2,51,46,26,30,3,0,12,49,3,6,3,6,9,9,20,28,1,42,2,0,2,0,1,0
37981,1,6,2,2,2,0,0,0,2,0,0,0,0,0,0,0,0,0,0,0,0,2,0,1,0
37982,8,263,51,25,36,0,0,15,51,3,11,6,12,14,18,42,68,1,112,6,0,2,0,1,0
37983,1,14,6,4,4,0,0,2,6,0,0,0,0,0,0,0,0,0,0,0,0,2,0,1,0
37984,4,163,27,21,21,0,0,6,27,3,6,3,6,9,9,20,28,1,42,2,0,2,0,1,0
37985,1,6,2,2,2,0,0,0,2,0,0,0,0,0,0,0,0,0,0,0,0,2,0,1,0
37986,1,41,7,5,5,0,0,2,7,1,2,1,2,3,3,2,4,0,2,0,0,2,0,1,0
37987,2,51,14,9,9,0,0,5,14,0,0,0,0,0,0,0,0,0,0,0,0,2,0,1,0
37988,2,40,13,9,8,0,0,4,13,0,0,0,0,0,0,0,0,0,0,0,0,2,0,1,0
37989,2,42,14,10,9,0,0,4,14,0,0,0,0,0,0,0,0,0,0,0,0,2,0,1,0
37990,2,33,12,8,7,0,0,4,12,0,0,0,0,0,0,0,0,0,0,0,0,2,0,1,0
37991,3,49,16,9,9,0,0,7,16,0,0,0,0,0,0,0,0,0,0,0,0,2,0,1,0
37992,1,18,3,3,3,0,0,0,3,0,0,0,0,0,0,0,0,0,0,0,0,2,0,1,0
37993,2,26,6,4,4,0,0,2,6,1,4,2,4,5,6,8,13,0,6,0,0,2,0,1,0
37994,12,313,149,95,105,2,0,41,151,8,54,28,55,62,83,334,494,4,2013,111,0,2,3,4,0
37995,15,699,139,89,101,2,0,35,141,7,54,34,62,61,96,330,569,4,2287,127,0,2,4,5,0
37996,3,299,149,67,118,4,0,27,153,1,17,14,28,18,42,69,175,0,144,8,0,2,27,8,0
37997,38,2493,1157,318,931,29,22,177,1186,6,104,63,125,110,188,712,1274,3,4596,255,0,2,5,10,0
37998,65,4371,520,294,400,33,13,81,553,10,261,204,367,271,571,2128,4614,7,32445,1802,1,2,3,5,0
37999,90,3959,1338,495,1086,10,64,173,1348,11,122,82,157,133,239,883,1686,7,11934,663,0,2,11,25,0
38000,172,7590,4293,999,3693,19,54,507,4312,9,155,88,170,164,258,1156,1898,4,9368,520,0,2,17,24,0
38001,172,7590,1482,859,1002,125,135,219,1607,16,219,134,251,235,385,1766,3032,9,27804,1544,1,2,17,24,0
38002,33,984,465,148,393,5,8,60,470,4,31,20,31,35,51,161,261,2,523,29,0,2,5,6,0
38003,33,984,16,12,9,0,0,6,16,1,2,1,2,3,3,2,4,0,2,0,0,2,5,6,0
38004,144,5870,1782,648,1425,9,47,279,1791,8,171,97,189,179,286,1292,2140,4,9462,525,0,2,32,36,0
38005,32,968,256,139,192,9,7,47,265,4,23,12,24,27,36,112,171,2,357,19,0,2,8,23,0
38006,6,328,180,34,164,0,0,16,180,1,12,6,12,13,18,43,66,0,33,1,0,2,0,3,0
38007,19,499,102,59,69,5,3,24,107,6,22,15,28,28,43,113,206,3,789,43,0,2,3,20,0
38008,119,4854,1450,624,1228,12,26,181,1462,14,306,186,354,320,540,2580,4493,8,36391,2021,1,2,28,95,0
38009,176,5109,1660,832,1314,41,38,274,1701,20,312,209,395,332,604,2671,5058,12,64042,3557,1,2,48,113,0
38010,49,3780,996,429,845,24,10,117,1020,7,76,50,88,83,138,494,879,4,3565,198,0,2,5,10,0
38011,120,5083,1513,682,1277,25,13,200,1538,11,199,116,219,210,335,1557,2584,6,15641,868,0,2,19,86,0
38012,84,4871,1296,573,1062,40,33,157,1336,8,201,118,231,209,349,1561,2689,4,12365,686,0,2,11,18,0
38013,20,449,207,111,150,11,0,50,218,5,26,19,36,31,55,133,272,3,943,52,0,2,2,14,0
38014,98,5169,1457,730,1242,11,6,188,1468,10,292,166,329,302,495,2424,4078,5,22973,1276,1,2,20,28,0
38015,43,2669,652,304,544,16,6,88,668,6,89,51,101,95,152,591,998,3,3399,188,0,2,3,8,0
38016,72,3231,1455,414,1257,16,76,112,1471,5,41,23,46,46,69,231,381,2,1069,59,0,2,13,26,0
38017,2,44,7,6,5,0,0,2,7,1,1,1,2,2,3,0,3,1,3,0,0,2,0,5,0
38018,8,263,74,35,59,1,0,14,75,3,14,7,14,17,21,58,85,1,128,7,0,2,0,5,0
38019,107,5128,1523,757,1297,19,12,193,1542,12,193,117,230,205,347,1508,2664,7,19053,1058,0,2,15,22,0
38020,70,3177,1020,354,843,12,15,144,1032,8,134,77,144,142,221,970,1580,4,6792,377,0,2,29,22,0
38021,44,2024,447,308,343,6,5,95,453,7,96,59,111,103,170,651,1136,4,4600,255,0,2,10,35,0
38022,3,229,53,23,39,0,0,13,53,2,8,4,8,10,12,26,39,1,39,2,0,2,0,1,0
38023,21,637,424,94,331,4,0,89,428,1,5,5,5,6,10,11,25,0,12,0,0,2,4,10,0
38024,38,2309,334,251,279,10,4,40,344,5,127,74,143,132,217,899,1528,2,4303,239,0,2,2,7,0
38025,9,423,184,100,137,2,15,30,186,6,38,20,39,44,59,214,322,3,991,55,0,2,9,25,0
38026,8,377,91,45,69,0,3,18,91,3,9,6,10,12,16,33,57,1,95,5,0,2,0,1,0
38027,75,3937,1293,570,1093,25,15,163,1318,10,195,123,241,205,364,1516,2795,6,17273,959,0,2,10,29,0
38028,29,1873,384,251,317,7,8,52,391,11,70,44,84,81,128,467,811,6,5355,297,0,2,9,15,0
38029,56,2846,722,423,573,19,0,135,741,12,172,101,199,184,300,1320,2257,6,15668,870,0,2,10,15,0
38030,45,1932,386,256,301,16,9,68,402,4,59,35,69,63,104,355,621,2,1453,80,0,2,3,8,0
38031,28,1590,466,257,367,18,25,50,484,7,126,86,171,133,257,898,1813,4,8612,478,0,2,2,3,0
38032,15,1051,215,129,180,6,0,29,221,8,65,43,72,73,115,415,711,4,3153,175,0,2,1,6,0
38033,85,3359,1043,504,840,53,9,147,1096,9,180,112,198,189,310,1377,2344,4,11604,644,0,2,10,20,0
38034,12,466,295,56,236,0,4,54,295,2,9,5,10,11,15,30,51,1,57,3,0,2,0,5,0
38035,30,1422,373,158,315,8,0,51,381,5,76,44,79,81,123,486,779,2,2026,112,0,2,2,7,0
38036,79,3071,1178,367,1042,6,15,115,1184,9,94,51,95,103,146,644,976,4,4439,246,0,2,7,31,0
38037,9,449,219,78,157,11,5,46,230,3,24,20,34,27,54,114,256,2,545,30,0,2,0,1,0
38038,111,6048,1943,715,1694,26,18,214,1969,12,185,120,237,197,357,1436,2721,7,20915,1161,0,2,26,31,0
38039,35,1473,442,244,305,14,16,103,456,11,68,45,75,79,120,452,756,6,4588,254,0,2,4,12,0
38040,48,1928,1098,241,925,5,10,155,1103,7,46,25,49,53,74,273,423,3,1580,87,0,2,6,21,0
38041,48,1639,601,196,481,2,23,85,603,8,63,36,72,71,108,400,664,4,3036,168,0,2,4,103,0
38042,168,5062,1660,832,1314,41,38,274,1701,20,312,209,395,332,604,2671,5058,12,64042,3557,1,2,0,31,0
38043,168,5062,1057,646,719,113,100,145,1170,18,215,134,248,233,382,1740,3004,10,31186,1732,1,2,0,31,0
38044,168,4910,1660,832,1314,41,38,274,1701,20,312,209,395,332,604,2671,5058,12,64042,3557,1,2,0,78,0
38045,236,4872,2,2,2,0,0,0,2,0,0,0,0,0,0,0,0,0,0,0,0,2,1,1,0
38046,236,4872,99,48,90,1,3,5,100,0,0,0,0,0,0,0,0,0,0,0,0,2,1,1,0
38047,236,4872,8,5,5,2,0,1,10,0,0,0,0,0,0,0,0,0,0,0,0,2,1,1,0
38048,236,4872,1217,716,841,84,126,174,1301,14,185,118,215,199,333,1446,2542,8,20687,1149,0,2,1,1,0
38049,236,4872,160,89,115,0,13,31,160,7,15,11,17,22,28,78,124,3,495,27,0,2,1,1,0
38050,236,4872,10,10,9,9,0,0,19,0,0,0,0,0,0,0,0,0,0,0,0,2,1,1,0
38051,236,4872,173,84,99,8,29,36,181,5,12,7,13,17,20,54,81,2,221,12,0,2,1,1,0
38052,236,4872,3,1,1,3,0,0,6,0,0,0,0,0,0,0,0,0,0,0,0,2,1,1,0
38053,101,5251,1457,730,1242,11,6,188,1468,10,292,166,329,302,495,2424,4078,5,22973,1276,1,2,23,0,0
38054,65,1270,1098,241,925,5,10,155,1103,7,46,25,49,53,74,273,423,3,1580,87,0,2,2,0,0
38055,65,1270,282,202,222,14,2,44,296,8,42,24,43,50,67,250,378,4,1548,86,0,2,2,0,0
38056,49,1964,1098,241,925,5,10,155,1103,7,46,25,49,53,74,273,423,3,1580,87,0,2,23,0,0
38057,236,4872,2,2,2,0,0,0,2,0,0,0,0,0,0,0,0,0,0,0,0,2,1,1,0
38058,236,4872,99,48,90,1,3,5,100,0,0,0,0,0,0,0,0,0,0,0,0,2,1,1,0
38059,236,4872,8,5,5,2,0,1,10,0,0,0,0,0,0,0,0,0,0,0,0,2,1,1,0
38060,236,4872,1217,716,841,84,126,174,1301,14,185,118,215,199,333,1446,2542,8,20687,1149,0,2,1,1,0
38061,236,4872,160,89,115,0,13,31,160,7,15,11,17,22,28,78,124,3,495,27,0,2,1,1,0
38062,236,4872,10,10,9,9,0,0,19,0,0,0,0,0,0,0,0,0,0,0,0,2,1,1,0
38063,236,4872,173,84,99,8,29,36,181,5,12,7,13,17,20,54,81,2,221,12,0,2,1,1,0
38064,236,4872,3,1,1,3,0,0,6,0,0,0,0,0,0,0,0,0,0,0,0,2,1,1,0
38065,101,5251,1457,730,1242,11,6,188,1468,10,292,166,329,302,495,2424,4078,5,22973,1276,1,2,23,0,0
38066,18,476,205,80,86,16,53,53,221,7,18,10,19,25,29,94,134,3,497,27,0,2,1,4,0
38067,226,5756,722,423,573,19,0,135,741,12,172,101,199,184,300,1320,2257,6,15668,870,0,2,10,26,0
38068,226,5756,1508,847,911,44,250,301,1552,14,148,88,169,162,257,1120,1886,7,15077,837,0,2,10,26,0
38069,65,1270,1098,241,925,5,10,155,1103,7,46,25,49,53,74,273,423,3,1580,87,0,2,2,0,0
38070,65,1270,282,202,222,14,2,44,296,8,42,24,43,50,67,250,378,4,1548,86,0,2,2,0,0
38071,49,1964,1098,241,925,5,10,155,1103,7,46,25,49,53,74,273,423,3,1580,87,0,2,23,0,0
38072,163,4979,1660,832,1314,41,38,274,1701,20,312,209,395,332,604,2671,5058,12,64042,3557,1,2,3,15,1
38073,163,4979,1057,646,719,113,100,145,1170,18,215,134,248,233,382,1740,3004,10,31186,1732,1,2,3,15,1
38074,114,2084,477,336,357,30,23,73,507,16,194,134,250,210,384,1538,2962,10,30538,1696,0,2,2,11,1
38075,59,1095,207,111,150,11,0,50,218,5,26,19,36,31,55,133,272,3,943,52,0,2,1,1,1
38076,59,1095,410,198,237,31,55,97,441,11,63,38,72,74,110,414,683,6,4293,238,0,2,1,1,1
38077,57,1176,91,45,69,0,3,18,91,3,9,6,10,12,16,33,57,1,95,5,0,2,1,3,1
38078,57,1176,367,234,237,17,34,68,384,16,55,34,61,71,95,381,584,8,5183,287,0,2,1,3,1
38079,104,4398,1289,550,1043,56,32,155,1345,10,167,93,185,177,278,1266,2075,5,11498,638,0,2,3,11,1
38080,95,2843,773,419,590,28,0,166,801,10,204,113,217,214,330,1598,2554,5,13587,754,0,2,1,1,1
38081,90,3959,1338,495,1086,10,64,173,1348,11,122,82,157,133,239,883,1686,7,11934,663,0,2,1,1,1
38082,119,4854,1450,624,1228,12,26,181,1462,14,306,186,354,320,540,2580,4493,8,36391,2021,1,2,1,1,1
38083,120,5083,1513,682,1277,25,13,200,1538,11,199,116,219,210,335,1557,2584,6,15641,868,0,2,7,7,1
38084,72,3231,1455,414,1257,16,76,112,1471,5,41,23,46,46,69,231,381,2,1069,59,0,2,2,2,1
38085,107,5128,1523,757,1297,19,12,193,1542,12,193,117,230,205,347,1508,2664,7,19053,1058,0,2,3,3,1
38086,21,637,424,94,331,4,0,89,428,1,5,5,5,6,10,11,25,0,12,0,0,2,1,1,1
38087,56,2845,722,423,573,19,0,135,741,12,172,101,199,184,300,1320,2257,6,15668,870,0,2,3,5,1
38088,85,3340,1043,504,840,53,9,147,1096,9,180,112,198,189,310,1377,2344,4,11604,644,0,2,3,5,1
38089,111,6048,1943,715,1694,26,18,214,1969,12,185,120,237,197,357,1436,2721,7,20915,1161,0,2,0,1,1
38090,48,1639,601,196,481,2,23,85,603,8,63,36,72,71,108,400,664,4,3036,168,0,2,4,4,1
38091,18,476,205,80,86,16,53,53,221,7,18,10,19,25,29,94,134,3,497,27,0,2,1,4,0
38092,226,5756,722,423,573,19,0,135,741,12,172,101,199,184,300,1320,2257,6,15668,870,0,2,10,26,0
38093,226,5756,1508,847,911,44,250,301,1552,14,148,88,169,162,257,1120,1886,7,15077,837,0,2,10,26,0
38094,163,4979,1660,832,1314,41,38,274,1701,20,312,209,395,332,604,2671,5058,12,64042,3557,1,2,3,15,0
38095,163,4979,1057,646,719,113,100,145,1170,18,215,134,248,233,382,1740,3004,10,31186,1732,1,2,3,15,0
38096,114,2084,477,336,357,30,23,73,507,16,194,134,250,210,384,1538,2962,10,30538,1696,0,2,2,11,0
38097,59,1095,207,111,150,11,0,50,218,5,26,19,36,31,55,133,272,3,943,52,0,2,1,1,0
38098,59,1095,410,198,237,31,55,97,441,11,63,38,72,74,110,414,683,6,4293,238,0,2,1,1,0
38099,57,1176,91,45,69,0,3,18,91,3,9,6,10,12,16,33,57,1,95,5,0,2,1,3,0
38100,57,1176,367,234,237,17,34,68,384,16,55,34,61,71,95,381,584,8,5183,287,0,2,1,3,0
38101,104,4398,1289,550,1043,56,32,155,1345,10,167,93,185,177,278,1266,2075,5,11498,638,0,2,3,11,0
38102,95,2843,773,419,590,28,0,166,801,10,204,113,217,214,330,1598,2554,5,13587,754,0,2,1,1,0
38103,90,3959,1338,495,1086,10,64,173,1348,11,122,82,157,133,239,883,1686,7,11934,663,0,2,1,1,0
38104,119,4854,1450,624,1228,12,26,181,1462,14,306,186,354,320,540,2580,4493,8,36391,2021,1,2,1,1,0
38105,120,5083,1513,682,1277,25,13,200,1538,11,199,116,219,210,335,1557,2584,6,15641,868,0,2,7,7,0
38106,72,3231,1455,414,1257,16,76,112,1471,5,41,23,46,46,69,231,381,2,1069,59,0,2,2,2,0
38107,107,5128,1523,757,1297,19,12,193,1542,12,193,117,230,205,347,1508,2664,7,19053,1058,0,2,3,3,0
38108,21,637,424,94,331,4,0,89,428,1,5,5,5,6,10,11,25,0,12,0,0,2,1,1,0
38109,56,2845,722,423,573,19,0,135,741,12,172,101,199,184,300,1320,2257,6,15668,870,0,2,3,5,0
38110,85,3340,1043,504,840,53,9,147,1096,9,180,112,198,189,310,1377,2344,4,11604,644,0,2,3,5,0
38111,111,6048,1943,715,1694,26,18,214,1969,12,185,120,237,197,357,1436,2721,7,20915,1161,0,2,0,1,0
38112,48,1639,601,196,481,2,23,85,603,8,63,36,72,71,108,400,664,4,3036,168,0,2,4,4,0
38113,8,210,127,75,83,2,11,30,129,4,14,7,14,18,21,61,87,2,175,9,0,2,15,0,0
38114,8,210,652,304,544,16,6,88,668,6,89,51,101,95,152,591,998,3,3399,188,0,2,15,0,0
38115,8,210,2,2,2,0,0,0,2,0,0,0,0,0,0,0,0,0,0,0,0,2,15,0,0
38116,8,210,8,5,5,0,0,3,8,0,0,0,0,0,0,0,0,0,0,0,0,2,15,0,0
38117,8,210,2,2,2,0,0,0,2,0,0,0,0,0,0,0,0,0,0,0,0,2,15,0,0
38118,8,210,14,8,8,0,0,6,14,0,0,0,0,0,0,0,0,0,0,0,0,2,15,0,0
38119,8,210,6,4,4,0,0,2,6,0,0,0,0,0,0,0,0,0,0,0,0,2,15,0,0
38120,8,210,6,4,4,0,0,2,6,1,2,1,2,3,3,2,4,0,2,0,0,2,15,0,0
38121,8,210,6,4,4,0,0,2,6,0,0,0,0,0,0,0,0,0,0,0,0,2,15,0,0
38122,8,210,7,5,5,0,0,2,7,0,0,0,0,0,0,0,0,0,0,0,0,2,15,0,0
38123,8,210,6,4,4,0,0,2,6,0,0,0,0,0,0,0,0,0,0,0,0,2,15,0,0
38124,8,210,10,6,6,0,0,4,10,0,0,0,0,0,0,0,0,0,0,0,0,2,15,0,0
38125,8,210,1,1,1,0,0,0,1,0,0,0,0,0,0,0,0,0,0,0,0,2,15,0,0
38126,8,210,1,1,1,0,0,0,1,0,0,0,0,0,0,0,0,0,0,0,0,2,15,0,0
38127,8,210,14,10,10,0,0,4,14,1,1,1,1,2,2,0,2,0,1,0,0,2,15,0,0
38128,8,210,46,26,30,3,0,12,49,3,6,3,6,9,9,20,28,1,42,2,0,2,15,0,0
38129,8,210,127,75,83,2,11,30,129,4,14,7,14,18,21,61,87,2,175,9,0,2,15,0,0
38130,8,210,652,304,544,16,6,88,668,6,89,51,101,95,152,591,998,3,3399,188,0,2,15,0,0
38131,8,210,2,2,2,0,0,0,2,0,0,0,0,0,0,0,0,0,0,0,0,2,15,0,0
38132,8,210,8,5,5,0,0,3,8,0,0,0,0,0,0,0,0,0,0,0,0,2,15,0,0
38133,8,210,2,2,2,0,0,0,2,0,0,0,0,0,0,0,0,0,0,0,0,2,15,0,0
38134,8,210,14,8,8,0,0,6,14,0,0,0,0,0,0,0,0,0,0,0,0,2,15,0,0
38135,8,210,6,4,4,0,0,2,6,0,0,0,0,0,0,0,0,0,0,0,0,2,15,0,0
38136,8,210,6,4,4,0,0,2,6,1,2,1,2,3,3,2,4,0,2,0,0,2,15,0,0
38137,8,210,6,4,4,0,0,2,6,0,0,0,0,0,0,0,0,0,0,0,0,2,15,0,0
38138,8,210,7,5,5,0,0,2,7,0,0,0,0,0,0,0,0,0,0,0,0,2,15,0,0
38139,8,210,6,4,4,0,0,2,6,0,0,0,0,0,0,0,0,0,0,0,0,2,15,0,0
38140,8,210,10,6,6,0,0,4,10,0,0,0,0,0,0,0,0,0,0,0,0,2,15,0,0
38141,8,210,1,1,1,0,0,0,1,0,0,0,0,0,0,0,0,0,0,0,0,2,15,0,0
38142,8,210,1,1,1,0,0,0,1,0,0,0,0,0,0,0,0,0,0,0,0,2,15,0,0
38143,8,210,14,10,10,0,0,4,14,1,1,1,1,2,2,0,2,0,1,0,0,2,15,0,0
38144,8,210,46,26,30,3,0,12,49,3,6,3,6,9,9,20,28,1,42,2,0,2,15,0,0
38145,23,642,601,196,481,2,23,85,603,8,63,36,72,71,108,400,664,4,3036,168,0,2,1,0,1
38146,23,642,156,79,106,5,16,28,161,5,14,8,15,19,23,64,97,2,261,14,0,2,1,0,1
38147,172,7582,4293,999,3693,19,54,507,4312,9,155,88,170,164,258,1156,1898,4,9368,520,0,2,1,2,1
38148,172,7582,1482,859,1002,125,135,219,1607,16,219,134,251,235,385,1766,3032,9,27804,1544,1,2,1,2,1
38149,52,1740,601,196,481,2,23,85,603,8,63,36,72,71,108,400,664,4,3036,168,0,2,31,0,1
38150,105,2754,773,422,505,30,103,129,803,14,77,46,83,91,129,535,839,7,6334,351,0,2,9,4,0
38151,42,2613,1157,318,931,29,22,177,1186,6,104,63,125,110,188,712,1274,3,4596,255,0,2,37,6,0
38152,105,2754,773,422,505,30,103,129,803,14,77,46,83,91,129,535,839,7,6334,351,0,2,9,4,0
38153,42,2613,1157,318,931,29,22,177,1186,6,104,63,125,110,188,712,1274,3,4596,255,0,2,37,6,0
38154,23,642,601,196,481,2,23,85,603,8,63,36,72,71,108,400,664,4,3036,168,0,2,1,0,0
38155,23,642,156,79,106,5,16,28,161,5,14,8,15,19,23,64,97,2,261,14,0,2,1,0,0
38156,172,7582,4293,999,3693,19,54,507,4312,9,155,88,170,164,258,1156,1898,4,9368,520,0,2,1,2,0
38157,172,7582,1482,859,1002,125,135,219,1607,16,219,134,251,235,385,1766,3032,9,27804,1544,1,2,1,2,0
38158,52,1740,601,196,481,2,23,85,603,8,63,36,72,71,108,400,664,4,3036,168,0,2,31,0,0
38159,219,4666,182,127,129,0,0,53,182,5,39,21,42,44,63,217,343,2,926,51,0,2,0,7,0
38160,219,4666,1165,710,800,67,119,181,1232,18,243,153,282,261,435,2000,3492,10,36473,2026,1,2,0,7,0
38161,150,7150,1392,870,1177,35,17,170,1427,14,494,280,531,508,811,4473,7289,7,54850,3047,2,2,3,11,0
38162,114,2073,477,336,357,30,23,73,507,16,194,134,250,210,384,1538,2962,10,30538,1696,0,2,2,9,0
38163,18,474,205,80,86,16,53,53,221,7,18,10,19,25,29,94,134,3,497,27,0,2,1,1,0
38164,12,314,149,95,105,2,0,41,151,8,54,28,55,62,83,334,494,4,2013,111,0,2,1,1,0
38165,172,7582,4293,999,3693,19,54,507,4312,9,155,88,170,164,258,1156,1898,4,9368,520,0,2,2,2,0
38166,172,7582,1482,859,1002,125,135,219,1607,16,219,134,251,235,385,1766,3032,9,27804,1544,1,2,2,2,0
38167,32,965,256,139,192,9,7,47,265,4,23,12,24,27,36,112,171,2,357,19,0,2,1,1,0
38168,55,2831,722,423,573,19,0,135,741,12,172,101,199,184,300,1320,2257,6,15668,870,0,2,1,6,0
38169,35,1463,442,244,305,14,16,103,456,11,68,45,75,79,120,452,756,6,4588,254,0,2,0,1,0
38170,114,2073,477,336,357,30,23,73,507,16,194,134,250,210,384,1538,2962,10,30538,1696,0,2,2,9,0
38171,18,474,205,80,86,16,53,53,221,7,18,10,19,25,29,94,134,3,497,27,0,2,1,1,0
38172,12,314,149,95,105,2,0,41,151,8,54,28,55,62,83,334,494,4,2013,111,0,2,1,1,0
38173,172,7582,4293,999,3693,19,54,507,4312,9,155,88,170,164,258,1156,1898,4,9368,520,0,2,2,2,0
38174,172,7582,1482,859,1002,125,135,219,1607,16,219,134,251,235,385,1766,3032,9,27804,1544,1,2,2,2,0
38175,32,965,256,139,192,9,7,47,265,4,23,12,24,27,36,112,171,2,357,19,0,2,1,1,0
38176,55,2831,722,423,573,19,0,135,741,12,172,101,199,184,300,1320,2257,6,15668,870,0,2,1,6,0
38177,35,1463,442,244,305,14,16,103,456,11,68,45,75,79,120,452,756,6,4588,254,0,2,0,1,0
38178,219,4666,182,127,129,0,0,53,182,5,39,21,42,44,63,217,343,2,926,51,0,2,0,7,0
38179,219,4666,1165,710,800,67,119,181,1232,18,243,153,282,261,435,2000,3492,10,36473,2026,1,2,0,7,0
38180,150,7150,1392,870,1177,35,17,170,1427,14,494,280,531,508,811,4473,7289,7,54850,3047,2,2,3,11,0
38181,219,4666,182,127,129,0,0,53,182,5,39,21,42,44,63,217,343,2,926,51,0,2,0,1,0
38182,219,4666,1165,710,800,67,119,181,1232,18,243,153,282,261,435,2000,3492,10,36473,2026,1,2,0,1,0
38183,92,2323,1455,414,1257,16,76,112,1471,5,41,23,46,46,69,231,381,2,1069,59,0,2,13,3,0
38184,92,2323,669,365,481,22,61,110,691,15,103,63,122,118,185,747,1273,8,11311,628,0,2,13,3,0
38185,74,3363,1455,414,1257,16,76,112,1471,5,41,23,46,46,69,231,381,2,1069,59,0,2,24,0,0
38186,14,833,75,38,59,1,3,12,76,2,4,2,4,6,6,10,15,1,15,0,0,2,1,1,0
38187,14,833,75,38,59,1,3,12,76,2,4,2,4,6,6,10,15,1,15,0,0,2,1,1,0
38188,219,4666,182,127,129,0,0,53,182,5,39,21,42,44,63,217,343,2,926,51,0,2,0,1,0
38189,219,4666,1165,710,800,67,119,181,1232,18,243,153,282,261,435,2000,3492,10,36473,2026,1,2,0,1,0
38190,9,449,219,78,157,11,5,46,230,3,24,20,34,27,54,114,256,2,545,30,0,2,1,1,0
38191,29,461,219,78,157,11,5,46,230,3,24,20,34,27,54,114,256,2,545,30,0,2,2,1,0
38192,29,461,108,64,79,9,0,20,117,5,15,11,19,20,30,70,129,3,410,22,0,2,2,1,0
38193,11,488,219,78,157,11,5,46,230,3,24,20,34,27,54,114,256,2,545,30,0,2,15,11,0
38194,26,435,219,78,157,11,5,46,230,3,24,20,34,27,54,114,256,2,545,30,0,2,0,6,0
38195,26,435,108,64,79,9,0,20,117,5,15,11,19,20,30,70,129,3,410,22,0,2,0,6,0
38196,10,475,219,78,157,11,5,46,230,3,24,20,34,27,54,114,256,2,545,30,0,2,1,7,0
38197,235,4840,2,2,2,0,0,0,2,0,0,0,0,0,0,0,0,0,0,0,0,2,0,11,0
38198,235,4840,99,48,90,1,3,5,100,0,0,0,0,0,0,0,0,0,0,0,0,2,0,11,0
38199,235,4840,8,5,5,2,0,1,10,0,0,0,0,0,0,0,0,0,0,0,0,2,0,11,0
38200,235,4840,1217,716,841,84,126,174,1301,14,185,118,215,199,333,1446,2542,8,20687,1149,0,2,0,11,0
38201,235,4840,160,89,115,0,13,31,160,7,15,11,17,22,28,78,124,3,495,27,0,2,0,11,0
38202,235,4840,10,10,9,9,0,0,19,0,0,0,0,0,0,0,0,0,0,0,0,2,0,11,0
38203,235,4840,173,84,99,8,29,36,181,5,12,7,13,17,20,54,81,2,221,12,0,2,0,11,0
38204,235,4840,3,1,1,3,0,0,6,0,0,0,0,0,0,0,0,0,0,0,0,2,0,11,0
38205,10,475,219,78,157,11,5,46,230,3,24,20,34,27,54,114,256,2,545,30,0,2,2,2,0
38206,235,4840,2,2,2,0,0,0,2,0,0,0,0,0,0,0,0,0,0,0,0,2,0,11,0
38207,235,4840,99,48,90,1,3,5,100,0,0,0,0,0,0,0,0,0,0,0,0,2,0,11,0
38208,235,4840,8,5,5,2,0,1,10,0,0,0,0,0,0,0,0,0,0,0,0,2,0,11,0
38209,235,4840,1217,716,841,84,126,174,1301,14,185,118,215,199,333,1446,2542,8,20687,1149,0,2,0,11,0
38210,235,4840,160,89,115,0,13,31,160,7,15,11,17,22,28,78,124,3,495,27,0,2,0,11,0
38211,235,4840,10,10,9,9,0,0,19,0,0,0,0,0,0,0,0,0,0,0,0,2,0,11,0
38212,235,4840,173,84,99,8,29,36,181,5,12,7,13,17,20,54,81,2,221,12,0,2,0,11,0
38213,235,4840,3,1,1,3,0,0,6,0,0,0,0,0,0,0,0,0,0,0,0,2,0,11,0
38214,235,4842,2,2,2,0,0,0,2,0,0,0,0,0,0,0,0,0,0,0,0,2,2,2,0
38215,235,4842,99,48,90,1,3,5,100,0,0,0,0,0,0,0,0,0,0,0,0,2,2,2,0
38216,235,4842,8,5,5,2,0,1,10,0,0,0,0,0,0,0,0,0,0,0,0,2,2,2,0
38217,235,4842,1217,716,841,84,126,174,1301,14,185,118,215,199,333,1446,2542,8,20687,1149,0,2,2,2,0
38218,235,4842,160,89,115,0,13,31,160,7,15,11,17,22,28,78,124,3,495,27,0,2,2,2,0
38219,235,4842,10,10,9,9,0,0,19,0,0,0,0,0,0,0,0,0,0,0,0,2,2,2,0
38220,235,4842,173,84,99,8,29,36,181,5,12,7,13,17,20,54,81,2,221,12,0,2,2,2,0
38221,235,4842,3,1,1,3,0,0,6,0,0,0,0,0,0,0,0,0,0,0,0,2,2,2,0
38222,146,3595,77,34,69,0,0,8,77,3,24,16,29,27,45,114,213,1,387,21,0,2,17,13,0
38223,146,3595,712,438,573,51,9,84,763,14,102,71,128,116,199,733,1364,8,11988,666,0,2,17,13,0
38224,226,5756,722,423,573,19,0,135,741,12,172,101,199,184,300,1320,2257,6,15668,870,0,2,5,6,0
38225,226,5756,1508,847,911,44,250,301,1552,14,148,88,169,162,257,1120,1886,7,15077,837,0,2,5,6,0
38226,280,5857,1943,715,1694,26,18,214,1969,12,185,120,237,197,357,1436,2721,7,20915,1161,0,2,7,11,0
38227,280,5857,1168,838,957,57,25,144,1225,19,348,224,416,367,640,3018,5452,11,61921,3440,1,2,7,11,0
38228,104,4414,1289,550,1043,56,32,155,1345,10,167,93,185,177,278,1266,2075,5,11498,638,0,2,14,15,0
38229,90,3963,1338,495,1086,10,64,173,1348,11,122,82,157,133,239,883,1686,7,11934,663,0,2,3,3,0
38230,168,4914,1660,832,1314,41,38,274,1701,20,312,209,395,332,604,2671,5058,12,64042,3557,1,2,3,3,0
38231,49,3782,996,429,845,24,10,117,1020,7,76,50,88,83,138,494,879,4,3565,198,0,2,2,2,0
38232,120,5085,1513,682,1277,25,13,200,1538,11,199,116,219,210,335,1557,2584,6,15641,868,0,2,2,2,0
38233,84,4875,1296,573,1062,40,33,157,1336,8,201,118,231,209,349,1561,2689,4,12365,686,0,2,6,7,0
38234,101,5249,1457,730,1242,11,6,188,1468,10,292,166,329,302,495,2424,4078,5,22973,1276,1,2,11,14,0
38235,43,2669,652,304,544,16,6,88,668,6,89,51,101,95,152,591,998,3,3399,188,0,2,7,9,0
38236,8,269,74,35,59,1,0,14,75,3,14,7,14,17,21,58,85,1,128,7,0,2,4,4,0
38237,70,3179,1020,354,843,12,15,144,1032,8,134,77,144,142,221,970,1580,4,6792,377,0,2,2,2,0
38238,29,1875,384,251,317,7,8,52,391,11,70,44,84,81,128,467,811,6,5355,297,0,2,2,2,0
38239,55,2829,722,423,573,19,0,135,741,12,172,101,199,184,300,1320,2257,6,15668,870,0,2,6,8,0
38240,85,3346,1043,504,840,53,9,147,1096,9,180,112,198,189,310,1377,2344,4,11604,644,0,2,3,3,0
38241,30,1424,373,158,315,8,0,51,381,5,76,44,79,81,123,486,779,2,2026,112,0,2,2,2,0
38242,111,6050,1943,715,1694,26,18,214,1969,12,185,120,237,197,357,1436,2721,7,20915,1161,0,2,2,2,0
38243,49,1968,1098,241,925,5,10,155,1103,7,46,25,49,53,74,273,423,3,1580,87,0,2,3,3,0
38244,58,1091,207,111,150,11,0,50,218,5,26,19,36,31,55,133,272,3,943,52,0,2,15,14,0
38245,58,1091,410,198,237,31,55,97,441,11,63,38,72,74,110,414,683,6,4293,238,0,2,15,14,0
38246,251,5809,4293,999,3693,19,54,507,4312,9,155,88,170,164,258,1156,1898,4,9368,520,0,2,1,7,0
38247,251,5809,1482,859,1002,125,135,219,1607,16,219,134,251,235,385,1766,3032,9,27804,1544,1,2,1,7,0
38248,105,2754,773,422,505,30,103,129,803,14,77,46,83,91,129,535,839,7,6334,351,0,2,3,3,0
38249,314,6868,72,33,56,0,4,12,72,1,1,1,1,2,2,0,2,0,1,0,0,2,2,4,0
38250,314,6868,1454,835,1044,76,110,219,1530,17,275,158,296,292,454,2297,3718,9,34017,1889,1,2,2,4,0
38251,89,1799,757,253,292,73,244,162,830,13,61,38,67,74,105,409,651,7,4654,258,0,2,4,2,0
38252,314,6853,72,33,56,0,4,12,72,1,1,1,1,2,2,0,2,0,1,0,0,2,0,2,0
38253,314,6853,1454,835,1044,76,110,219,1530,17,275,158,296,292,454,2297,3718,9,34017,1889,1,2,0,2,0
38254,88,1782,757,253,292,73,244,162,830,13,61,38,67,74,105,409,651,7,4654,258,0,2,0,14,0
38255,144,5870,1782,648,1425,9,47,279,1791,8,171,97,189,179,286,1292,2140,4,9462,525,0,2,1,1,0
38256,111,2037,477,336,357,30,23,73,507,16,194,134,250,210,384,1538,2962,10,30538,1696,0,2,3,11,0
38257,2,183,37,13,25,0,6,6,37,1,2,1,2,3,3,2,4,0,2,0,0,2,20,0,0
38258,2,183,133,47,40,1,43,49,134,0,0,0,0,0,0,0,0,0,0,0,0,2,20,0,0
38259,2,103,37,13,25,0,6,6,37,1,2,1,2,3,3,2,4,0,2,0,0,0,37,0,0
38260,146,3596,77,34,69,0,0,8,77,3,24,16,29,27,45,114,213,1,387,21,0,2,10,2,0
38261,146,3596,712,438,573,51,9,84,763,14,102,71,128,116,199,733,1364,8,11988,666,0,2,10,2,0
38262,146,3596,77,34,69,0,0,8,77,3,24,16,29,27,45,114,213,1,387,21,0,2,1,0,0
38263,146,3596,712,438,573,51,9,84,763,14,102,71,128,116,199,733,1364,8,11988,666,0,2,1,0,0
38264,92,2323,1455,414,1257,16,76,112,1471,5,41,23,46,46,69,231,381,2,1069,59,0,2,13,3,0
38265,92,2323,669,365,481,22,61,110,691,15,103,63,122,118,185,747,1273,8,11311,628,0,2,13,3,0
38266,74,3363,1455,414,1257,16,76,112,1471,5,41,23,46,46,69,231,381,2,1069,59,0,2,24,0,0
38267,146,3596,77,34,69,0,0,8,77,3,24,16,29,27,45,114,213,1,387,21,0,2,3,2,0
38268,146,3596,712,438,573,51,9,84,763,14,102,71,128,116,199,733,1364,8,11988,666,0,2,3,2,0
38269,235,4842,2,2,2,0,0,0,2,0,0,0,0,0,0,0,0,0,0,0,0,2,2,2,0
38270,235,4842,99,48,90,1,3,5,100,0,0,0,0,0,0,0,0,0,0,0,0,2,2,2,0
38271,235,4842,8,5,5,2,0,1,10,0,0,0,0,0,0,0,0,0,0,0,0,2,2,2,0
38272,235,4842,1217,716,841,84,126,174,1301,14,185,118,215,199,333,1446,2542,8,20687,1149,0,2,2,2,0
38273,235,4842,160,89,115,0,13,31,160,7,15,11,17,22,28,78,124,3,495,27,0,2,2,2,0
38274,235,4842,10,10,9,9,0,0,19,0,0,0,0,0,0,0,0,0,0,0,0,2,2,2,0
38275,235,4842,173,84,99,8,29,36,181,5,12,7,13,17,20,54,81,2,221,12,0,2,2,2,0
38276,235,4842,3,1,1,3,0,0,6,0,0,0,0,0,0,0,0,0,0,0,0,2,2,2,0
38277,146,3596,77,34,69,0,0,8,77,3,24,16,29,27,45,114,213,1,387,21,0,2,28,14,0
38278,146,3596,712,438,573,51,9,84,763,14,102,71,128,116,199,733,1364,8,11988,666,0,2,28,14,0
38279,226,5756,722,423,573,19,0,135,741,12,172,101,199,184,300,1320,2257,6,15668,870,0,2,5,6,0
38280,226,5756,1508,847,911,44,250,301,1552,14,148,88,169,162,257,1120,1886,7,15077,837,0,2,5,6,0
38281,280,5857,1943,715,1694,26,18,214,1969,12,185,120,237,197,357,1436,2721,7,20915,1161,0,2,7,11,0
38282,280,5857,1168,838,957,57,25,144,1225,19,348,224,416,367,640,3018,5452,11,61921,3440,1,2,7,11,0
38283,104,4414,1289,550,1043,56,32,155,1345,10,167,93,185,177,278,1266,2075,5,11498,638,0,2,14,15,0
38284,90,3963,1338,495,1086,10,64,173,1348,11,122,82,157,133,239,883,1686,7,11934,663,0,2,3,3,0
38285,168,4914,1660,832,1314,41,38,274,1701,20,312,209,395,332,604,2671,5058,12,64042,3557,1,2,3,3,0
38286,49,3782,996,429,845,24,10,117,1020,7,76,50,88,83,138,494,879,4,3565,198,0,2,2,2,0
38287,120,5085,1513,682,1277,25,13,200,1538,11,199,116,219,210,335,1557,2584,6,15641,868,0,2,2,2,0
38288,84,4875,1296,573,1062,40,33,157,1336,8,201,118,231,209,349,1561,2689,4,12365,686,0,2,6,7,0
38289,101,5249,1457,730,1242,11,6,188,1468,10,292,166,329,302,495,2424,4078,5,22973,1276,1,2,11,14,0
38290,43,2669,652,304,544,16,6,88,668,6,89,51,101,95,152,591,998,3,3399,188,0,2,7,9,0
38291,8,269,74,35,59,1,0,14,75,3,14,7,14,17,21,58,85,1,128,7,0,2,4,4,0
38292,70,3179,1020,354,843,12,15,144,1032,8,134,77,144,142,221,970,1580,4,6792,377,0,2,2,2,0
38293,29,1875,384,251,317,7,8,52,391,11,70,44,84,81,128,467,811,6,5355,297,0,2,2,2,0
38294,55,2829,722,423,573,19,0,135,741,12,172,101,199,184,300,1320,2257,6,15668,870,0,2,6,8,0
38295,85,3346,1043,504,840,53,9,147,1096,9,180,112,198,189,310,1377,2344,4,11604,644,0,2,3,3,0
38296,30,1424,373,158,315,8,0,51,381,5,76,44,79,81,123,486,779,2,2026,112,0,2,2,2,0
38297,111,6050,1943,715,1694,26,18,214,1969,12,185,120,237,197,357,1436,2721,7,20915,1161,0,2,2,2,0
38298,49,1968,1098,241,925,5,10,155,1103,7,46,25,49,53,74,273,423,3,1580,87,0,2,3,3,0
38299,2,183,37,13,25,0,6,6,37,1,2,1,2,3,3,2,4,0,2,0,0,2,20,0,0
38300,2,183,133,47,40,1,43,49,134,0,0,0,0,0,0,0,0,0,0,0,0,2,20,0,0
38301,2,103,37,13,25,0,6,6,37,1,2,1,2,3,3,2,4,0,2,0,0,0,37,0,0
38302,111,2037,477,336,357,30,23,73,507,16,194,134,250,210,384,1538,2962,10,30538,1696,0,2,3,11,0
38303,58,1091,207,111,150,11,0,50,218,5,26,19,36,31,55,133,272,3,943,52,0,2,15,14,0
38304,58,1091,410,198,237,31,55,97,441,11,63,38,72,74,110,414,683,6,4293,238,0,2,15,14,0
38305,251,5809,4293,999,3693,19,54,507,4312,9,155,88,170,164,258,1156,1898,4,9368,520,0,2,1,7,0
38306,251,5809,1482,859,1002,125,135,219,1607,16,219,134,251,235,385,1766,3032,9,27804,1544,1,2,1,7,0
38307,105,2754,773,422,505,30,103,129,803,14,77,46,83,91,129,535,839,7,6334,351,0,2,3,3,0
38308,314,6853,72,33,56,0,4,12,72,1,1,1,1,2,2,0,2,0,1,0,0,2,2,6,0
38309,314,6853,1454,835,1044,76,110,219,1530,17,275,158,296,292,454,2297,3718,9,34017,1889,1,2,2,6,0
38310,88,1782,757,253,292,73,244,162,830,13,61,38,67,74,105,409,651,7,4654,258,0,2,4,16,0
38311,144,5870,1782,648,1425,9,47,279,1791,8,171,97,189,179,286,1292,2140,4,9462,525,0,2,1,1,0
38312,26,435,219,78,157,11,5,46,230,3,24,20,34,27,54,114,256,2,545,30,0,2,2,7,0
38313,26,435,108,64,79,9,0,20,117,5,15,11,19,20,30,70,129,3,410,22,0,2,2,7,0
38314,10,475,219,78,157,11,5,46,230,3,24,20,34,27,54,114,256,2,545,30,0,2,9,11,0
38315,146,3596,77,34,69,0,0,8,77,3,24,16,29,27,45,114,213,1,387,21,0,2,2,2,0
38316,146,3596,712,438,573,51,9,84,763,14,102,71,128,116,199,733,1364,8,11988,666,0,2,2,2,0
38317,226,5756,722,423,573,19,0,135,741,12,172,101,199,184,300,1320,2257,6,15668,870,0,2,1,1,0
38318,226,5756,1508,847,911,44,250,301,1552,14,148,88,169,162,257,1120,1886,7,15077,837,0,2,1,1,0
38319,146,3596,77,34,69,0,0,8,77,3,24,16,29,27,45,114,213,1,387,21,0,2,2,2,0
38320,146,3596,712,438,573,51,9,84,763,14,102,71,128,116,199,733,1364,8,11988,666,0,2,2,2,0
38321,226,5756,722,423,573,19,0,135,741,12,172,101,199,184,300,1320,2257,6,15668,870,0,2,1,1,0
38322,226,5756,1508,847,911,44,250,301,1552,14,148,88,169,162,257,1120,1886,7,15077,837,0,2,1,1,0
38323,236,4874,2,2,2,0,0,0,2,0,0,0,0,0,0,0,0,0,0,0,0,2,2,1,1
38324,236,4874,99,48,90,1,3,5,100,0,0,0,0,0,0,0,0,0,0,0,0,2,2,1,1
38325,236,4874,8,5,5,2,0,1,10,0,0,0,0,0,0,0,0,0,0,0,0,2,2,1,1
38326,236,4874,1217,716,841,84,126,174,1301,14,185,118,215,199,333,1446,2542,8,20687,1149,0,2,2,1,1
38327,236,4874,160,89,115,0,13,31,160,7,15,11,17,22,28,78,124,3,495,27,0,2,2,1,1
38328,236,4874,10,10,9,9,0,0,19,0,0,0,0,0,0,0,0,0,0,0,0,2,2,1,1
38329,236,4874,173,84,99,8,29,36,181,5,12,7,13,17,20,54,81,2,221,12,0,2,2,1,1
38330,236,4874,3,1,1,3,0,0,6,0,0,0,0,0,0,0,0,0,0,0,0,2,2,1,1
38331,15,340,103,47,73,2,12,15,105,5,16,9,17,21,26,75,114,2,303,16,0,0,102,0,1
38332,15,340,86,50,52,8,5,21,94,3,5,3,6,8,9,16,27,1,48,2,0,0,102,0,1
38333,14,833,75,38,59,1,3,12,76,2,4,2,4,6,6,10,15,1,15,0,0,2,8,15,1
38334,8,304,103,47,73,2,12,15,105,5,16,9,17,21,26,75,114,2,303,16,0,0,99,0,1
38335,13,278,103,47,73,2,12,15,105,5,16,9,17,21,26,75,114,2,303,16,0,2,24,40,0
38336,13,278,86,50,52,8,5,21,94,3,5,3,6,8,9,16,27,1,48,2,0,2,24,40,0
38337,8,310,103,47,73,2,12,15,105,5,16,9,17,21,26,75,114,2,303,16,0,2,8,4,0
38338,280,5856,1943,715,1694,26,18,214,1969,12,185,120,237,197,357,1436,2721,7,20915,1161,0,2,1,2,0
38339,280,5856,1168,838,957,57,25,144,1225,19,348,224,416,367,640,3018,5452,11,61921,3440,1,2,1,2,0
38340,1,94,42,7,35,4,0,5,46,1,2,1,2,3,3,2,4,0,2,0,0,2,1,0,1
38341,1,94,11,6,10,0,0,1,11,2,4,2,4,6,6,10,15,1,15,0,0,2,1,0,1
38342,27,542,2,2,2,0,0,0,2,0,0,0,0,0,0,0,0,0,0,0,0,2,7,1,1
38343,27,542,99,48,90,1,3,5,100,0,0,0,0,0,0,0,0,0,0,0,0,2,7,1,1
38344,27,542,8,5,5,2,0,1,10,0,0,0,0,0,0,0,0,0,0,0,0,2,7,1,1
38345,27,542,1217,716,841,84,126,174,1301,14,185,118,215,199,333,1446,2542,8,20687,1149,0,2,7,1,1
38346,27,542,160,89,115,0,13,31,160,7,15,11,17,22,28,78,124,3,495,27,0,2,7,1,1
38347,27,542,10,10,9,9,0,0,19,0,0,0,0,0,0,0,0,0,0,0,0,2,7,1,1
38348,27,542,173,84,99,8,29,36,181,5,12,7,13,17,20,54,81,2,221,12,0,2,7,1,1
38349,27,542,3,1,1,3,0,0,6,0,0,0,0,0,0,0,0,0,0,0,0,2,7,1,1
38350,170,5244,1660,832,1314,41,38,274,1701,20,312,209,395,332,604,2671,5058,12,64042,3557,1,2,66,23,1
38351,170,5244,1057,646,719,113,100,145,1170,18,215,134,248,233,382,1740,3004,10,31186,1732,1,2,66,23,1
38352,111,2040,477,336,357,30,23,73,507,16,194,134,250,210,384,1538,2962,10,30538,1696,0,2,4,0,1
38353,55,670,647,139,84,35,284,233,682,0,0,0,0,0,0,0,0,0,0,0,0,2,15,0,1
38354,103,4384,1289,550,1043,56,32,155,1345,10,167,93,185,177,278,1266,2075,5,11498,638,0,2,0,45,1
38355,32,968,256,139,192,9,7,47,265,4,23,12,24,27,36,112,171,2,357,19,0,2,3,0,1
38356,171,5019,1660,832,1314,41,38,274,1701,20,312,209,395,332,604,2671,5058,12,64042,3557,1,2,51,0,1
38357,170,5218,1660,832,1314,41,38,274,1701,20,312,209,395,332,604,2671,5058,12,64042,3557,1,2,0,5,0
38358,170,5218,1057,646,719,113,100,145,1170,18,215,134,248,233,382,1740,3004,10,31186,1732,1,2,0,5,0
38359,148,4602,1660,832,1314,41,38,274,1701,20,312,209,395,332,604,2671,5058,12,64042,3557,1,2,78,159,1
38360,148,4602,1057,646,719,113,100,145,1170,18,215,134,248,233,382,1740,3004,10,31186,1732,1,2,78,159,1
38361,146,3588,77,34,69,0,0,8,77,3,24,16,29,27,45,114,213,1,387,21,0,2,8,14,1
38362,146,3588,712,438,573,51,9,84,763,14,102,71,128,116,199,733,1364,8,11988,666,0,2,8,14,1
38363,59,1205,91,45,69,0,3,18,91,3,9,6,10,12,16,33,57,1,95,5,0,2,2,0,1
38364,59,1205,367,234,237,17,34,68,384,16,55,34,61,71,95,381,584,8,5183,287,0,2,2,0,1
38365,225,5725,722,423,573,19,0,135,741,12,172,101,199,184,300,1320,2257,6,15668,870,0,2,6,13,1
38366,225,5725,1508,847,911,44,250,301,1552,14,148,88,169,162,257,1120,1886,7,15077,837,0,2,6,13,1
38367,105,4490,1289,550,1043,56,32,155,1345,10,167,93,185,177,278,1266,2075,5,11498,638,0,2,13,0,1
38368,119,4854,1450,624,1228,12,26,181,1462,14,306,186,354,320,540,2580,4493,8,36391,2021,1,2,2,2,1
38369,168,5033,1660,832,1314,41,38,274,1701,20,312,209,395,332,604,2671,5058,12,64042,3557,1,2,62,53,1
38370,9,413,91,45,69,0,3,18,91,3,9,6,10,12,16,33,57,1,95,5,0,2,5,0,1
38371,148,4602,1660,832,1314,41,38,274,1701,20,312,209,395,332,604,2671,5058,12,64042,3557,1,2,78,159,0
38372,148,4602,1057,646,719,113,100,145,1170,18,215,134,248,233,382,1740,3004,10,31186,1732,1,2,78,159,0
38373,146,3588,77,34,69,0,0,8,77,3,24,16,29,27,45,114,213,1,387,21,0,2,8,14,0
38374,146,3588,712,438,573,51,9,84,763,14,102,71,128,116,199,733,1364,8,11988,666,0,2,8,14,0
38375,59,1205,91,45,69,0,3,18,91,3,9,6,10,12,16,33,57,1,95,5,0,2,2,0,0
38376,59,1205,367,234,237,17,34,68,384,16,55,34,61,71,95,381,584,8,5183,287,0,2,2,0,0
38377,225,5725,722,423,573,19,0,135,741,12,172,101,199,184,300,1320,2257,6,15668,870,0,2,6,13,0
38378,225,5725,1508,847,911,44,250,301,1552,14,148,88,169,162,257,1120,1886,7,15077,837,0,2,6,13,0
38379,105,4490,1289,550,1043,56,32,155,1345,10,167,93,185,177,278,1266,2075,5,11498,638,0,2,13,0,0
38380,119,4854,1450,624,1228,12,26,181,1462,14,306,186,354,320,540,2580,4493,8,36391,2021,1,2,2,2,0
38381,168,5033,1660,832,1314,41,38,274,1701,20,312,209,395,332,604,2671,5058,12,64042,3557,1,2,62,53,0
38382,9,413,91,45,69,0,3,18,91,3,9,6,10,12,16,33,57,1,95,5,0,2,5,0,0
38383,17,467,205,80,86,16,53,53,221,7,18,10,19,25,29,94,134,3,497,27,0,2,3,7,0
38384,17,467,205,80,86,16,53,53,221,7,18,10,19,25,29,94,134,3,497,27,0,2,3,7,0
38385,280,5856,1943,715,1694,26,18,214,1969,12,185,120,237,197,357,1436,2721,7,20915,1161,0,2,1,2,0
38386,280,5856,1168,838,957,57,25,144,1225,19,348,224,416,367,640,3018,5452,11,61921,3440,1,2,1,2,0
38387,235,4844,2,2,2,0,0,0,2,0,0,0,0,0,0,0,0,0,0,0,0,2,2,1,0
38388,235,4844,99,48,90,1,3,5,100,0,0,0,0,0,0,0,0,0,0,0,0,2,2,1,0
38389,235,4844,8,5,5,2,0,1,10,0,0,0,0,0,0,0,0,0,0,0,0,2,2,1,0
38390,235,4844,1217,716,841,84,126,174,1301,14,185,118,215,199,333,1446,2542,8,20687,1149,0,2,2,1,0
38391,235,4844,160,89,115,0,13,31,160,7,15,11,17,22,28,78,124,3,495,27,0,2,2,1,0
38392,235,4844,10,10,9,9,0,0,19,0,0,0,0,0,0,0,0,0,0,0,0,2,2,1,0
38393,235,4844,173,84,99,8,29,36,181,5,12,7,13,17,20,54,81,2,221,12,0,2,2,1,0
38394,235,4844,3,1,1,3,0,0,6,0,0,0,0,0,0,0,0,0,0,0,0,2,2,1,0
38395,13,278,103,47,73,2,12,15,105,5,16,9,17,21,26,75,114,2,303,16,0,0,86,0,0
38396,13,278,86,50,52,8,5,21,94,3,5,3,6,8,9,16,27,1,48,2,0,0,86,0,0
38397,14,833,75,38,59,1,3,12,76,2,4,2,4,6,6,10,15,1,15,0,0,2,8,15,0
38398,8,310,103,47,73,2,12,15,105,5,16,9,17,21,26,75,114,2,303,16,0,0,103,0,0
38399,148,4610,1660,832,1314,41,38,274,1701,20,312,209,395,332,604,2671,5058,12,64042,3557,1,2,2,1,0
38400,148,4610,1057,646,719,113,100,145,1170,18,215,134,248,233,382,1740,3004,10,31186,1732,1,2,2,1,0
38401,169,5104,1660,832,1314,41,38,274,1701,20,312,209,395,332,604,2671,5058,12,64042,3557,1,2,18,0,0
38402,71,1562,402,202,227,24,74,80,426,12,52,33,61,64,94,339,564,7,3969,220,0,2,1,4,0
38403,145,5899,1782,648,1425,9,47,279,1791,8,171,97,189,179,286,1292,2140,4,9462,525,0,2,13,0,0
38404,71,1562,402,202,227,24,74,80,426,12,52,33,61,64,94,339,564,7,3969,220,0,2,1,4,0
38405,145,5899,1782,648,1425,9,47,279,1791,8,171,97,189,179,286,1292,2140,4,9462,525,0,2,13,0,0
38406,17,382,85,59,61,8,0,16,93,5,18,10,18,23,28,86,126,2,316,17,0,2,1,1,1
38407,12,518,124,78,88,2,3,26,126,4,13,7,13,17,20,56,81,2,163,9,0,2,1,1,1
38408,113,2243,463,295,324,28,62,57,491,12,134,82,154,146,236,989,1696,6,11700,650,0,2,39,0,1
38409,104,4398,1289,550,1043,56,32,155,1345,10,167,93,185,177,278,1266,2075,5,11498,638,0,2,1,1,1
38410,4,166,27,21,21,0,0,6,27,3,6,3,6,9,9,20,28,1,42,2,0,2,1,1,1
38411,120,5083,1513,682,1277,25,13,200,1538,11,199,116,219,210,335,1557,2584,6,15641,868,0,2,1,1,1
38412,38,2301,334,251,279,10,4,40,344,5,127,74,143,132,217,899,1528,2,4303,239,0,2,3,5,1
38413,9,423,184,100,137,2,15,30,186,6,38,20,39,44,59,214,322,3,991,55,0,2,1,1,1
38414,55,670,647,139,84,35,284,233,682,0,0,0,0,0,0,0,0,0,0,0,0,2,7,0,0
38415,169,5193,1660,832,1314,41,38,274,1701,20,312,209,395,332,604,2671,5058,12,64042,3557,1,2,2,7,0
38416,169,5193,1057,646,719,113,100,145,1170,18,215,134,248,233,382,1740,3004,10,31186,1732,1,2,2,7,0
38417,27,542,2,2,2,0,0,0,2,0,0,0,0,0,0,0,0,0,0,0,0,2,5,1,0
38418,27,542,99,48,90,1,3,5,100,0,0,0,0,0,0,0,0,0,0,0,0,2,5,1,0
38419,27,542,8,5,5,2,0,1,10,0,0,0,0,0,0,0,0,0,0,0,0,2,5,1,0
38420,27,542,1217,716,841,84,126,174,1301,14,185,118,215,199,333,1446,2542,8,20687,1149,0,2,5,1,0
38421,27,542,160,89,115,0,13,31,160,7,15,11,17,22,28,78,124,3,495,27,0,2,5,1,0
38422,27,542,10,10,9,9,0,0,19,0,0,0,0,0,0,0,0,0,0,0,0,2,5,1,0
38423,27,542,173,84,99,8,29,36,181,5,12,7,13,17,20,54,81,2,221,12,0,2,5,1,0
38424,27,542,3,1,1,3,0,0,6,0,0,0,0,0,0,0,0,0,0,0,0,2,5,1,0
38425,171,5019,1660,832,1314,41,38,274,1701,20,312,209,395,332,604,2671,5058,12,64042,3557,1,2,3,3,0
38426,17,382,85,59,61,8,0,16,93,5,18,10,18,23,28,86,126,2,316,17,0,2,1,1,0
38427,12,518,124,78,88,2,3,26,126,4,13,7,13,17,20,56,81,2,163,9,0,2,1,1,0
38428,113,2243,463,295,324,28,62,57,491,12,134,82,154,146,236,989,1696,6,11700,650,0,2,39,0,0
38429,104,4398,1289,550,1043,56,32,155,1345,10,167,93,185,177,278,1266,2075,5,11498,638,0,2,1,1,0
38430,4,166,27,21,21,0,0,6,27,3,6,3,6,9,9,20,28,1,42,2,0,2,1,1,0
38431,120,5083,1513,682,1277,25,13,200,1538,11,199,116,219,210,335,1557,2584,6,15641,868,0,2,1,1,0
38432,38,2301,334,251,279,10,4,40,344,5,127,74,143,132,217,899,1528,2,4303,239,0,2,3,5,0
38433,9,423,184,100,137,2,15,30,186,6,38,20,39,44,59,214,322,3,991,55,0,2,1,1,0
38434,149,4616,1660,832,1314,41,38,274,1701,20,312,209,395,332,604,2671,5058,12,64042,3557,1,2,2,0,0
38435,149,4616,1057,646,719,113,100,145,1170,18,215,134,248,233,382,1740,3004,10,31186,1732,1,2,2,0,0
38436,148,4610,1660,832,1314,41,38,274,1701,20,312,209,395,332,604,2671,5058,12,64042,3557,1,2,2,1,0
38437,148,4610,1057,646,719,113,100,145,1170,18,215,134,248,233,382,1740,3004,10,31186,1732,1,2,2,1,0
38438,169,5104,1660,832,1314,41,38,274,1701,20,312,209,395,332,604,2671,5058,12,64042,3557,1,2,18,0,0
38439,17,382,85,59,61,8,0,16,93,5,18,10,18,23,28,86,126,2,316,17,0,2,1,1,0
38440,12,518,124,78,88,2,3,26,126,4,13,7,13,17,20,56,81,2,163,9,0,2,1,1,0
38441,113,2243,463,295,324,28,62,57,491,12,134,82,154,146,236,989,1696,6,11700,650,0,2,39,0,0
38442,105,4490,1289,550,1043,56,32,155,1345,10,167,93,185,177,278,1266,2075,5,11498,638,0,2,1,1,0
38443,4,166,27,21,21,0,0,6,27,3,6,3,6,9,9,20,28,1,42,2,0,2,1,1,0
38444,120,5085,1513,682,1277,25,13,200,1538,11,199,116,219,210,335,1557,2584,6,15641,868,0,2,1,1,0
38445,38,2301,334,251,279,10,4,40,344,5,127,74,143,132,217,899,1528,2,4303,239,0,2,3,5,0
38446,9,423,184,100,137,2,15,30,186,6,38,20,39,44,59,214,322,3,991,55,0,2,1,1,0
38447,104,4414,1289,550,1043,56,32,155,1345,10,167,93,185,177,278,1266,2075,5,11498,638,0,2,45,0,0
38448,104,4414,1289,550,1043,56,32,155,1345,10,167,93,185,177,278,1266,2075,5,11498,638,0,2,4,1,0
38449,27,566,2,2,2,0,0,0,2,0,0,0,0,0,0,0,0,0,0,0,0,2,8,0,1
38450,27,566,99,48,90,1,3,5,100,0,0,0,0,0,0,0,0,0,0,0,0,2,8,0,1
38451,27,566,8,5,5,2,0,1,10,0,0,0,0,0,0,0,0,0,0,0,0,2,8,0,1
38452,27,566,1217,716,841,84,126,174,1301,14,185,118,215,199,333,1446,2542,8,20687,1149,0,2,8,0,1
38453,27,566,160,89,115,0,13,31,160,7,15,11,17,22,28,78,124,3,495,27,0,2,8,0,1
38454,27,566,10,10,9,9,0,0,19,0,0,0,0,0,0,0,0,0,0,0,0,2,8,0,1
38455,27,566,173,84,99,8,29,36,181,5,12,7,13,17,20,54,81,2,221,12,0,2,8,0,1
38456,27,566,3,1,1,3,0,0,6,0,0,0,0,0,0,0,0,0,0,0,0,2,8,0,1
38457,173,5396,1660,832,1314,41,38,274,1701,20,312,209,395,332,604,2671,5058,12,64042,3557,1,2,66,35,1
38458,173,5396,1057,646,719,113,100,145,1170,18,215,134,248,233,382,1740,3004,10,31186,1732,1,2,66,35,1
38459,235,4848,2,2,2,0,0,0,2,0,0,0,0,0,0,0,0,0,0,0,0,2,4,2,1
38460,235,4848,99,48,90,1,3,5,100,0,0,0,0,0,0,0,0,0,0,0,0,2,4,2,1
38461,235,4848,8,5,5,2,0,1,10,0,0,0,0,0,0,0,0,0,0,0,0,2,4,2,1
38462,235,4848,1217,716,841,84,126,174,1301,14,185,118,215,199,333,1446,2542,8,20687,1149,0,2,4,2,1
38463,235,4848,160,89,115,0,13,31,160,7,15,11,17,22,28,78,124,3,495,27,0,2,4,2,1
38464,235,4848,10,10,9,9,0,0,19,0,0,0,0,0,0,0,0,0,0,0,0,2,4,2,1
38465,235,4848,173,84,99,8,29,36,181,5,12,7,13,17,20,54,81,2,221,12,0,2,4,2,1
38466,235,4848,3,1,1,3,0,0,6,0,0,0,0,0,0,0,0,0,0,0,0,2,4,2,1
38467,55,670,647,139,84,35,284,233,682,0,0,0,0,0,0,0,0,0,0,0,0,2,2,0,1
38468,173,5082,1660,832,1314,41,38,274,1701,20,312,209,395,332,604,2671,5058,12,64042,3557,1,2,33,2,1
38469,55,670,647,139,84,35,284,233,682,0,0,0,0,0,0,0,0,0,0,0,0,2,1,0,0
38470,17,378,85,59,61,8,0,16,93,5,18,10,18,23,28,86,126,2,316,17,0,2,1,1,0
38471,12,515,124,78,88,2,3,26,126,4,13,7,13,17,20,56,81,2,163,9,0,2,1,1,0
38472,4,163,27,21,21,0,0,6,27,3,6,3,6,9,9,20,28,1,42,2,0,2,1,1,0
38473,58,1109,207,111,150,11,0,50,218,5,26,19,36,31,55,133,272,3,943,52,0,2,4,0,0
38474,58,1109,410,198,237,31,55,97,441,11,63,38,72,74,110,414,683,6,4293,238,0,2,4,0,0
38475,251,5809,4293,999,3693,19,54,507,4312,9,155,88,170,164,258,1156,1898,4,9368,520,0,2,1,1,0
38476,251,5809,1482,859,1002,125,135,219,1607,16,219,134,251,235,385,1766,3032,9,27804,1544,1,2,1,1,0
38477,172,7582,4293,999,3693,19,54,507,4312,9,155,88,170,164,258,1156,1898,4,9368,520,0,2,7,4,0
38478,172,7582,1482,859,1002,125,135,219,1607,16,219,134,251,235,385,1766,3032,9,27804,1544,1,2,7,4,0
38479,145,5899,1782,648,1425,9,47,279,1791,8,171,97,189,179,286,1292,2140,4,9462,525,0,2,1,1,0
38480,113,2243,463,295,324,28,62,57,491,12,134,82,154,146,236,989,1696,6,11700,650,0,2,39,0,0
38481,105,4490,1289,550,1043,56,32,155,1345,10,167,93,185,177,278,1266,2075,5,11498,638,0,2,1,1,0
38482,120,5085,1513,682,1277,25,13,200,1538,11,199,116,219,210,335,1557,2584,6,15641,868,0,2,1,1,0
38483,38,2301,334,251,279,10,4,40,344,5,127,74,143,132,217,899,1528,2,4303,239,0,2,3,5,0
38484,9,423,184,100,137,2,15,30,186,6,38,20,39,44,59,214,322,3,991,55,0,2,1,1,0
38485,112,2047,477,336,357,30,23,73,507,16,194,134,250,210,384,1538,2962,10,30538,1696,0,2,4,1,0
38486,121,4896,1450,624,1228,12,26,181,1462,14,306,186,354,320,540,2580,4493,8,36391,2021,1,2,12,0,0
38487,114,2088,477,336,357,30,23,73,507,16,194,134,250,210,384,1538,2962,10,30538,1696,0,2,20,2,0
38488,121,4918,1450,624,1228,12,26,181,1462,14,306,186,354,320,540,2580,4493,8,36391,2021,1,2,19,10,0
38489,149,4624,1660,832,1314,41,38,274,1701,20,312,209,395,332,604,2671,5058,12,64042,3557,1,2,2,0,0
38490,149,4624,1057,646,719,113,100,145,1170,18,215,134,248,233,382,1740,3004,10,31186,1732,1,2,2,0,0
38491,114,2088,477,336,357,30,23,73,507,16,194,134,250,210,384,1538,2962,10,30538,1696,0,2,23,2,0
38492,121,4918,1450,624,1228,12,26,181,1462,14,306,186,354,320,540,2580,4493,8,36391,2021,1,2,21,0,0
38493,173,5396,1660,832,1314,41,38,274,1701,20,312,209,395,332,604,2671,5058,12,64042,3557,1,2,1,1,0
38494,173,5396,1057,646,719,113,100,145,1170,18,215,134,248,233,382,1740,3004,10,31186,1732,1,2,1,1,0
38495,148,4610,1660,832,1314,41,38,274,1701,20,312,209,395,332,604,2671,5058,12,64042,3557,1,2,1,1,0
38496,148,4610,1057,646,719,113,100,145,1170,18,215,134,248,233,382,1740,3004,10,31186,1732,1,2,1,1,0
38497,149,4624,1660,832,1314,41,38,274,1701,20,312,209,395,332,604,2671,5058,12,64042,3557,1,2,1,1,0
38498,149,4624,1057,646,719,113,100,145,1170,18,215,134,248,233,382,1740,3004,10,31186,1732,1,2,1,1,0
38499,235,4842,2,2,2,0,0,0,2,0,0,0,0,0,0,0,0,0,0,0,0,2,2,2,0
38500,235,4842,99,48,90,1,3,5,100,0,0,0,0,0,0,0,0,0,0,0,0,2,2,2,0
38501,235,4842,8,5,5,2,0,1,10,0,0,0,0,0,0,0,0,0,0,0,0,2,2,2,0
38502,235,4842,1217,716,841,84,126,174,1301,14,185,118,215,199,333,1446,2542,8,20687,1149,0,2,2,2,0
38503,235,4842,160,89,115,0,13,31,160,7,15,11,17,22,28,78,124,3,495,27,0,2,2,2,0
38504,235,4842,10,10,9,9,0,0,19,0,0,0,0,0,0,0,0,0,0,0,0,2,2,2,0
38505,235,4842,173,84,99,8,29,36,181,5,12,7,13,17,20,54,81,2,221,12,0,2,2,2,0
38506,235,4842,3,1,1,3,0,0,6,0,0,0,0,0,0,0,0,0,0,0,0,2,2,2,0
38507,27,562,2,2,2,0,0,0,2,0,0,0,0,0,0,0,0,0,0,0,0,2,4,5,0
38508,27,562,99,48,90,1,3,5,100,0,0,0,0,0,0,0,0,0,0,0,0,2,4,5,0
38509,27,562,8,5,5,2,0,1,10,0,0,0,0,0,0,0,0,0,0,0,0,2,4,5,0
38510,27,562,1217,716,841,84,126,174,1301,14,185,118,215,199,333,1446,2542,8,20687,1149,0,2,4,5,0
38511,27,562,160,89,115,0,13,31,160,7,15,11,17,22,28,78,124,3,495,27,0,2,4,5,0
38512,27,562,10,10,9,9,0,0,19,0,0,0,0,0,0,0,0,0,0,0,0,2,4,5,0
38513,27,562,173,84,99,8,29,36,181,5,12,7,13,17,20,54,81,2,221,12,0,2,4,5,0
38514,27,562,3,1,1,3,0,0,6,0,0,0,0,0,0,0,0,0,0,0,0,2,4,5,0
38515,174,5392,1660,832,1314,41,38,274,1701,20,312,209,395,332,604,2671,5058,12,64042,3557,1,2,7,3,0
38516,174,5392,1057,646,719,113,100,145,1170,18,215,134,248,233,382,1740,3004,10,31186,1732,1,2,7,3,0
38517,55,670,647,139,84,35,284,233,682,0,0,0,0,0,0,0,0,0,0,0,0,2,1,1,0
38518,173,5098,1660,832,1314,41,38,274,1701,20,312,209,395,332,604,2671,5058,12,64042,3557,1,2,19,2,0
38519,174,5392,1660,832,1314,41,38,274,1701,20,312,209,395,332,604,2671,5058,12,64042,3557,1,2,3,1,0
38520,174,5392,1057,646,719,113,100,145,1170,18,215,134,248,233,382,1740,3004,10,31186,1732,1,2,3,1,0
38521,173,5098,1660,832,1314,41,38,274,1701,20,312,209,395,332,604,2671,5058,12,64042,3557,1,2,12,7,0
38522,235,4842,2,2,2,0,0,0,2,0,0,0,0,0,0,0,0,0,0,0,0,2,2,4,0
38523,235,4842,99,48,90,1,3,5,100,0,0,0,0,0,0,0,0,0,0,0,0,2,2,4,0
38524,235,4842,8,5,5,2,0,1,10,0,0,0,0,0,0,0,0,0,0,0,0,2,2,4,0
38525,235,4842,1217,716,841,84,126,174,1301,14,185,118,215,199,333,1446,2542,8,20687,1149,0,2,2,4,0
38526,235,4842,160,89,115,0,13,31,160,7,15,11,17,22,28,78,124,3,495,27,0,2,2,4,0
38527,235,4842,10,10,9,9,0,0,19,0,0,0,0,0,0,0,0,0,0,0,0,2,2,4,0
38528,235,4842,173,84,99,8,29,36,181,5,12,7,13,17,20,54,81,2,221,12,0,2,2,4,0
38529,235,4842,3,1,1,3,0,0,6,0,0,0,0,0,0,0,0,0,0,0,0,2,2,4,0
38530,174,5414,1660,832,1314,41,38,274,1701,20,312,209,395,332,604,2671,5058,12,64042,3557,1,2,18,9,0
38531,174,5414,1057,646,719,113,100,145,1170,18,215,134,248,233,382,1740,3004,10,31186,1732,1,2,18,9,0
38532,160,5064,1660,832,1314,41,38,274,1701,20,312,209,395,332,604,2671,5058,12,64042,3557,1,2,82,159,0
38533,160,5064,1057,646,719,113,100,145,1170,18,215,134,248,233,382,1740,3004,10,31186,1732,1,2,82,159,0
38534,114,2091,477,336,357,30,23,73,507,16,194,134,250,210,384,1538,2962,10,30538,1696,0,2,23,2,0
38535,235,4844,2,2,2,0,0,0,2,0,0,0,0,0,0,0,0,0,0,0,0,2,2,1,0
38536,235,4844,99,48,90,1,3,5,100,0,0,0,0,0,0,0,0,0,0,0,0,2,2,1,0
38537,235,4844,8,5,5,2,0,1,10,0,0,0,0,0,0,0,0,0,0,0,0,2,2,1,0
38538,235,4844,1217,716,841,84,126,174,1301,14,185,118,215,199,333,1446,2542,8,20687,1149,0,2,2,1,0
38539,235,4844,160,89,115,0,13,31,160,7,15,11,17,22,28,78,124,3,495,27,0,2,2,1,0
38540,235,4844,10,10,9,9,0,0,19,0,0,0,0,0,0,0,0,0,0,0,0,2,2,1,0
38541,235,4844,173,84,99,8,29,36,181,5,12,7,13,17,20,54,81,2,221,12,0,2,2,1,0
38542,235,4844,3,1,1,3,0,0,6,0,0,0,0,0,0,0,0,0,0,0,0,2,2,1,0
38543,113,2243,463,295,324,28,62,57,491,12,134,82,154,146,236,989,1696,6,11700,650,0,2,39,0,0
38544,13,278,103,47,73,2,12,15,105,5,16,9,17,21,26,75,114,2,303,16,0,0,86,0,0
38545,13,278,86,50,52,8,5,21,94,3,5,3,6,8,9,16,27,1,48,2,0,0,86,0,0
38546,146,3588,77,34,69,0,0,8,77,3,24,16,29,27,45,114,213,1,387,21,0,2,8,14,0
38547,146,3588,712,438,573,51,9,84,763,14,102,71,128,116,199,733,1364,8,11988,666,0,2,8,14,0
38548,71,1562,402,202,227,24,74,80,426,12,52,33,61,64,94,339,564,7,3969,220,0,2,1,4,0
38549,17,467,205,80,86,16,53,53,221,7,18,10,19,25,29,94,134,3,497,27,0,2,3,7,0
38550,59,1205,91,45,69,0,3,18,91,3,9,6,10,12,16,33,57,1,95,5,0,2,2,0,0
38551,59,1205,367,234,237,17,34,68,384,16,55,34,61,71,95,381,584,8,5183,287,0,2,2,0,0
38552,225,5725,722,423,573,19,0,135,741,12,172,101,199,184,300,1320,2257,6,15668,870,0,2,6,13,0
38553,225,5725,1508,847,911,44,250,301,1552,14,148,88,169,162,257,1120,1886,7,15077,837,0,2,6,13,0
38554,280,5856,1943,715,1694,26,18,214,1969,12,185,120,237,197,357,1436,2721,7,20915,1161,0,2,1,2,0
38555,280,5856,1168,838,957,57,25,144,1225,19,348,224,416,367,640,3018,5452,11,61921,3440,1,2,1,2,0
38556,105,4490,1289,550,1043,56,32,155,1345,10,167,93,185,177,278,1266,2075,5,11498,638,0,2,14,1,0
38557,14,833,75,38,59,1,3,12,76,2,4,2,4,6,6,10,15,1,15,0,0,2,8,15,0
38558,145,5899,1782,648,1425,9,47,279,1791,8,171,97,189,179,286,1292,2140,4,9462,525,0,2,13,0,0
38559,121,4918,1450,624,1228,12,26,181,1462,14,306,186,354,320,540,2580,4493,8,36391,2021,1,2,23,2,0
38560,174,5288,1660,832,1314,41,38,274,1701,20,312,209,395,332,604,2671,5058,12,64042,3557,1,2,80,53,0
38561,120,5085,1513,682,1277,25,13,200,1538,11,199,116,219,210,335,1557,2584,6,15641,868,0,2,1,1,0
38562,8,310,103,47,73,2,12,15,105,5,16,9,17,21,26,75,114,2,303,16,0,0,103,0,0
38563,38,2301,334,251,279,10,4,40,344,5,127,74,143,132,217,899,1528,2,4303,239,0,2,3,5,0
38564,9,423,184,100,137,2,15,30,186,6,38,20,39,44,59,214,322,3,991,55,0,2,1,1,0
38565,9,413,91,45,69,0,3,18,91,3,9,6,10,12,16,33,57,1,95,5,0,2,5,0,0
38566,160,5080,1660,832,1314,41,38,274,1701,20,312,209,395,332,604,2671,5058,12,64042,3557,1,2,7,7,0
38567,160,5080,1057,646,719,113,100,145,1170,18,215,134,248,233,382,1740,3004,10,31186,1732,1,2,7,7,0
38568,160,5080,1660,832,1314,41,38,274,1701,20,312,209,395,332,604,2671,5058,12,64042,3557,1,2,1,1,0
38569,160,5080,1057,646,719,113,100,145,1170,18,215,134,248,233,382,1740,3004,10,31186,1732,1,2,1,1,0
38570,27,562,2,2,2,0,0,0,2,0,0,0,0,0,0,0,0,0,0,0,0,2,1,1,0
38571,27,562,99,48,90,1,3,5,100,0,0,0,0,0,0,0,0,0,0,0,0,2,1,1,0
38572,27,562,8,5,5,2,0,1,10,0,0,0,0,0,0,0,0,0,0,0,0,2,1,1,0
38573,27,562,1217,716,841,84,126,174,1301,14,185,118,215,199,333,1446,2542,8,20687,1149,0,2,1,1,0
38574,27,562,160,89,115,0,13,31,160,7,15,11,17,22,28,78,124,3,495,27,0,2,1,1,0
38575,27,562,10,10,9,9,0,0,19,0,0,0,0,0,0,0,0,0,0,0,0,2,1,1,0
38576,27,562,173,84,99,8,29,36,181,5,12,7,13,17,20,54,81,2,221,12,0,2,1,1,0
38577,27,562,3,1,1,3,0,0,6,0,0,0,0,0,0,0,0,0,0,0,0,2,1,1,0
38578,175,5312,1660,832,1314,41,38,274,1701,20,312,209,395,332,604,2671,5058,12,64042,3557,1,2,4,0,0
38579,160,5086,1660,832,1314,41,38,274,1701,20,312,209,395,332,604,2671,5058,12,64042,3557,1,2,1,1,0
38580,160,5086,1057,646,719,113,100,145,1170,18,215,134,248,233,382,1740,3004,10,31186,1732,1,2,1,1,0
38581,55,670,647,139,84,35,284,233,682,0,0,0,0,0,0,0,0,0,0,0,0,2,18,7,0
38582,160,5078,1660,832,1314,41,38,274,1701,20,312,209,395,332,604,2671,5058,12,64042,3557,1,2,4,4,0
38583,160,5078,1057,646,719,113,100,145,1170,18,215,134,248,233,382,1740,3004,10,31186,1732,1,2,4,4,0
38584,175,5312,1660,832,1314,41,38,274,1701,20,312,209,395,332,604,2671,5058,12,64042,3557,1,2,4,0,0
38585,58,1109,207,111,150,11,0,50,218,5,26,19,36,31,55,133,272,3,943,52,0,2,4,0,0
38586,58,1109,410,198,237,31,55,97,441,11,63,38,72,74,110,414,683,6,4293,238,0,2,4,0,0
38587,251,5809,4293,999,3693,19,54,507,4312,9,155,88,170,164,258,1156,1898,4,9368,520,0,2,1,1,0
38588,251,5809,1482,859,1002,125,135,219,1607,16,219,134,251,235,385,1766,3032,9,27804,1544,1,2,1,1,0
38589,172,7582,4293,999,3693,19,54,507,4312,9,155,88,170,164,258,1156,1898,4,9368,520,0,2,7,4,0
38590,172,7582,1482,859,1002,125,135,219,1607,16,219,134,251,235,385,1766,3032,9,27804,1544,1,2,7,4,0
38591,145,5899,1782,648,1425,9,47,279,1791,8,171,97,189,179,286,1292,2140,4,9462,525,0,2,1,1,0
38592,1,94,42,7,35,4,0,5,46,1,2,1,2,3,3,2,4,0,2,0,0,2,1,0,0
38593,1,94,11,6,10,0,0,1,11,2,4,2,4,6,6,10,15,1,15,0,0,2,1,0,0
38594,27,562,2,2,2,0,0,0,2,0,0,0,0,0,0,0,0,0,0,0,0,2,18,1,0
38595,27,562,99,48,90,1,3,5,100,0,0,0,0,0,0,0,0,0,0,0,0,2,18,1,0
38596,27,562,8,5,5,2,0,1,10,0,0,0,0,0,0,0,0,0,0,0,0,2,18,1,0
38597,27,562,1217,716,841,84,126,174,1301,14,185,118,215,199,333,1446,2542,8,20687,1149,0,2,18,1,0
38598,27,562,160,89,115,0,13,31,160,7,15,11,17,22,28,78,124,3,495,27,0,2,18,1,0
38599,27,562,10,10,9,9,0,0,19,0,0,0,0,0,0,0,0,0,0,0,0,2,18,1,0
38600,27,562,173,84,99,8,29,36,181,5,12,7,13,17,20,54,81,2,221,12,0,2,18,1,0
38601,27,562,3,1,1,3,0,0,6,0,0,0,0,0,0,0,0,0,0,0,0,2,18,1,0
38602,160,5078,1660,832,1314,41,38,274,1701,20,312,209,395,332,604,2671,5058,12,64042,3557,1,2,116,36,0
38603,160,5078,1057,646,719,113,100,145,1170,18,215,134,248,233,382,1740,3004,10,31186,1732,1,2,116,36,0
38604,114,2091,477,336,357,30,23,73,507,16,194,134,250,210,384,1538,2962,10,30538,1696,0,2,4,0,0
38605,55,670,647,139,84,35,284,233,682,0,0,0,0,0,0,0,0,0,0,0,0,2,36,0,0
38606,105,4490,1289,550,1043,56,32,155,1345,10,167,93,185,177,278,1266,2075,5,11498,638,0,2,4,1,0
38607,32,968,256,139,192,9,7,47,265,4,23,12,24,27,36,112,171,2,357,19,0,2,3,0,0
38608,175,5312,1660,832,1314,41,38,274,1701,20,312,209,395,332,604,2671,5058,12,64042,3557,1,2,112,0,0
38609,159,5037,1660,832,1314,41,38,274,1701,20,312,209,395,332,604,2671,5058,12,64042,3557,1,2,8,20,0
38610,159,5037,1057,646,719,113,100,145,1170,18,215,134,248,233,382,1740,3004,10,31186,1732,1,2,8,20,0
38611,159,5037,1660,832,1314,41,38,274,1701,20,312,209,395,332,604,2671,5058,12,64042,3557,1,2,8,20,0
38612,159,5037,1057,646,719,113,100,145,1170,18,215,134,248,233,382,1740,3004,10,31186,1732,1,2,8,20,0
38613,146,3590,77,34,69,0,0,8,77,3,24,16,29,27,45,114,213,1,387,21,0,2,4,1,0
38614,146,3590,712,438,573,51,9,84,763,14,102,71,128,116,199,733,1364,8,11988,666,0,2,4,1,0
38615,106,4541,1289,550,1043,56,32,155,1345,10,167,93,185,177,278,1266,2075,5,11498,638,0,2,6,0,0
38616,146,3590,77,34,69,0,0,8,77,3,24,16,29,27,45,114,213,1,387,21,0,2,4,1,0
38617,146,3590,712,438,573,51,9,84,763,14,102,71,128,116,199,733,1364,8,11988,666,0,2,4,1,0
38618,106,4541,1289,550,1043,56,32,155,1345,10,167,93,185,177,278,1266,2075,5,11498,638,0,2,6,0,0
38619,75,1605,53,23,39,0,0,13,53,2,8,4,8,10,12,26,39,1,39,2,0,2,1,1,0
38620,75,1605,515,298,307,33,80,99,548,12,63,44,77,75,121,419,753,7,5527,307,0,2,1,1,0
38621,102,5281,1457,730,1242,11,6,188,1468,10,292,166,329,302,495,2424,4078,5,22973,1276,1,2,8,2,0
38622,75,1605,53,23,39,0,0,13,53,2,8,4,8,10,12,26,39,1,39,2,0,2,1,1,0
38623,75,1605,515,298,307,33,80,99,548,12,63,44,77,75,121,419,753,7,5527,307,0,2,1,1,0
38624,102,5281,1457,730,1242,11,6,188,1468,10,292,166,329,302,495,2424,4078,5,22973,1276,1,2,8,2,0
38625,91,2310,1455,414,1257,16,76,112,1471,5,41,23,46,46,69,231,381,2,1069,59,0,2,19,22,0
38626,91,2310,669,365,481,22,61,110,691,15,103,63,122,118,185,747,1273,8,11311,628,0,2,19,22,0
38627,1,92,42,7,35,4,0,5,46,1,2,1,2,3,3,2,4,0,2,0,0,2,0,1,1
38628,1,92,11,6,10,0,0,1,11,2,4,2,4,6,6,10,15,1,15,0,0,2,0,1,1
38629,180,5373,1660,832,1314,41,38,274,1701,20,312,209,395,332,604,2671,5058,12,64042,3557,1,2,66,6,1
38630,180,5373,1057,646,719,113,100,145,1170,18,215,134,248,233,382,1740,3004,10,31186,1732,1,2,66,6,1
38631,179,5679,1660,832,1314,41,38,274,1701,20,312,209,395,332,604,2671,5058,12,64042,3557,1,2,131,47,1
38632,1,92,42,7,35,4,0,5,46,1,2,1,2,3,3,2,4,0,2,0,0,2,0,1,0
38633,1,92,11,6,10,0,0,1,11,2,4,2,4,6,6,10,15,1,15,0,0,2,0,1,0
38634,180,5373,1660,832,1314,41,38,274,1701,20,312,209,395,332,604,2671,5058,12,64042,3557,1,2,66,6,0
38635,180,5373,1057,646,719,113,100,145,1170,18,215,134,248,233,382,1740,3004,10,31186,1732,1,2,66,6,0
38636,179,5679,1660,832,1314,41,38,274,1701,20,312,209,395,332,604,2671,5058,12,64042,3557,1,2,131,47,0
38637,60,1136,282,196,195,3,0,86,285,8,130,71,141,138,212,936,1507,4,6538,363,0,2,3,2,0
38638,7,289,72,33,56,0,4,12,72,1,1,1,1,2,2,0,2,0,1,0,0,2,2,2,0
38639,91,2310,1455,414,1257,16,76,112,1471,5,41,23,46,46,69,231,381,2,1069,59,0,2,19,22,0
38640,91,2310,669,365,481,22,61,110,691,15,103,63,122,118,185,747,1273,8,11311,628,0,2,19,22,0
38641,60,1136,282,196,195,3,0,86,285,8,130,71,141,138,212,936,1507,4,6538,363,0,2,3,2,0
38642,7,289,72,33,56,0,4,12,72,1,1,1,1,2,2,0,2,0,1,0,0,2,2,2,0
38643,60,1136,282,196,195,3,0,86,285,8,130,71,141,138,212,936,1507,4,6538,363,0,2,3,2,0
38644,7,289,72,33,56,0,4,12,72,1,1,1,1,2,2,0,2,0,1,0,0,2,2,2,0
38645,17,378,85,59,61,8,0,16,93,5,18,10,18,23,28,86,126,2,316,17,0,2,1,1,0
38646,12,515,124,78,88,2,3,26,126,4,13,7,13,17,20,56,81,2,163,9,0,2,1,1,0
38647,219,4666,182,127,129,0,0,53,182,5,39,21,42,44,63,217,343,2,926,51,0,2,0,8,0
38648,219,4666,1165,710,800,67,119,181,1232,18,243,153,282,261,435,2000,3492,10,36473,2026,1,2,0,8,0
38649,27,562,2,2,2,0,0,0,2,0,0,0,0,0,0,0,0,0,0,0,0,2,18,1,0
38650,27,562,99,48,90,1,3,5,100,0,0,0,0,0,0,0,0,0,0,0,0,2,18,1,0
38651,27,562,8,5,5,2,0,1,10,0,0,0,0,0,0,0,0,0,0,0,0,2,18,1,0
38652,27,562,1217,716,841,84,126,174,1301,14,185,118,215,199,333,1446,2542,8,20687,1149,0,2,18,1,0
38653,27,562,160,89,115,0,13,31,160,7,15,11,17,22,28,78,124,3,495,27,0,2,18,1,0
38654,27,562,10,10,9,9,0,0,19,0,0,0,0,0,0,0,0,0,0,0,0,2,18,1,0
38655,27,562,173,84,99,8,29,36,181,5,12,7,13,17,20,54,81,2,221,12,0,2,18,1,0
38656,27,562,3,1,1,3,0,0,6,0,0,0,0,0,0,0,0,0,0,0,0,2,18,1,0
38657,180,5373,1660,832,1314,41,38,274,1701,20,312,209,395,332,604,2671,5058,12,64042,3557,1,2,259,252,0
38658,180,5373,1057,646,719,113,100,145,1170,18,215,134,248,233,382,1740,3004,10,31186,1732,1,2,259,252,0
38659,114,2091,477,336,357,30,23,73,507,16,194,134,250,210,384,1538,2962,10,30538,1696,0,2,33,32,0
38660,58,1109,207,111,150,11,0,50,218,5,26,19,36,31,55,133,272,3,943,52,0,2,20,15,0
38661,58,1109,410,198,237,31,55,97,441,11,63,38,72,74,110,414,683,6,4293,238,0,2,20,15,0
38662,235,4844,2,2,2,0,0,0,2,0,0,0,0,0,0,0,0,0,0,0,0,2,5,15,0
38663,235,4844,99,48,90,1,3,5,100,0,0,0,0,0,0,0,0,0,0,0,0,2,5,15,0
38664,235,4844,8,5,5,2,0,1,10,0,0,0,0,0,0,0,0,0,0,0,0,2,5,15,0
38665,235,4844,1217,716,841,84,126,174,1301,14,185,118,215,199,333,1446,2542,8,20687,1149,0,2,5,15,0
38666,235,4844,160,89,115,0,13,31,160,7,15,11,17,22,28,78,124,3,495,27,0,2,5,15,0
38667,235,4844,10,10,9,9,0,0,19,0,0,0,0,0,0,0,0,0,0,0,0,2,5,15,0
38668,235,4844,173,84,99,8,29,36,181,5,12,7,13,17,20,54,81,2,221,12,0,2,5,15,0
38669,235,4844,3,1,1,3,0,0,6,0,0,0,0,0,0,0,0,0,0,0,0,2,5,15,0
38670,91,2310,1455,414,1257,16,76,112,1471,5,41,23,46,46,69,231,381,2,1069,59,0,2,20,13,0
38671,91,2310,669,365,481,22,61,110,691,15,103,63,122,118,185,747,1273,8,11311,628,0,2,20,13,0
38672,13,278,103,47,73,2,12,15,105,5,16,9,17,21,26,75,114,2,303,16,0,0,86,0,0
38673,13,278,86,50,52,8,5,21,94,3,5,3,6,8,9,16,27,1,48,2,0,0,86,0,0
38674,251,5809,4293,999,3693,19,54,507,4312,9,155,88,170,164,258,1156,1898,4,9368,520,0,2,2,8,0
38675,251,5809,1482,859,1002,125,135,219,1607,16,219,134,251,235,385,1766,3032,9,27804,1544,1,2,2,8,0
38676,55,670,647,139,84,35,284,233,682,0,0,0,0,0,0,0,0,0,0,0,0,2,36,0,0
38677,105,2754,773,422,505,30,103,129,803,14,77,46,83,91,129,535,839,7,6334,351,0,2,12,7,0
38678,146,3590,77,34,69,0,0,8,77,3,24,16,29,27,45,114,213,1,387,21,0,2,39,28,0
38679,146,3590,712,438,573,51,9,84,763,14,102,71,128,116,199,733,1364,8,11988,666,0,2,39,28,0
38680,71,1562,402,202,227,24,74,80,426,12,52,33,61,64,94,339,564,7,3969,220,0,2,1,4,0
38681,75,1605,53,23,39,0,0,13,53,2,8,4,8,10,12,26,39,1,39,2,0,2,1,1,0
38682,75,1605,515,298,307,33,80,99,548,12,63,44,77,75,121,419,753,7,5527,307,0,2,1,1,0
38683,17,467,205,80,86,16,53,53,221,7,18,10,19,25,29,94,134,3,497,27,0,2,5,12,0
38684,59,1205,91,45,69,0,3,18,91,3,9,6,10,12,16,33,57,1,95,5,0,2,3,3,0
38685,59,1205,367,234,237,17,34,68,384,16,55,34,61,71,95,381,584,8,5183,287,0,2,3,3,0
38686,225,5725,722,423,573,19,0,135,741,12,172,101,199,184,300,1320,2257,6,15668,870,0,2,19,43,0
38687,225,5725,1508,847,911,44,250,301,1552,14,148,88,169,162,257,1120,1886,7,15077,837,0,2,19,43,0
38688,314,6853,72,33,56,0,4,12,72,1,1,1,1,2,2,0,2,0,1,0,0,2,2,6,0
38689,314,6853,1454,835,1044,76,110,219,1530,17,275,158,296,292,454,2297,3718,9,34017,1889,1,2,2,6,0
38690,88,1782,757,253,292,73,244,162,830,13,61,38,67,74,105,409,651,7,4654,258,0,2,4,16,0
38691,26,435,219,78,157,11,5,46,230,3,24,20,34,27,54,114,256,2,545,30,0,2,2,7,0
38692,26,435,108,64,79,9,0,20,117,5,15,11,19,20,30,70,129,3,410,22,0,2,2,7,0
38693,280,5856,1943,715,1694,26,18,214,1969,12,185,120,237,197,357,1436,2721,7,20915,1161,0,2,8,13,0
38694,280,5856,1168,838,957,57,25,144,1225,19,348,224,416,367,640,3018,5452,11,61921,3440,1,2,8,13,0
38695,65,1270,1098,241,925,5,10,155,1103,7,46,25,49,53,74,273,423,3,1580,87,0,2,2,0,0
38696,65,1270,282,202,222,14,2,44,296,8,42,24,43,50,67,250,378,4,1548,86,0,2,2,0,0
38697,2,183,37,13,25,0,6,6,37,1,2,1,2,3,3,2,4,0,2,0,0,2,20,0,0
38698,2,183,133,47,40,1,43,49,134,0,0,0,0,0,0,0,0,0,0,0,0,2,20,0,0
38699,23,642,601,196,481,2,23,85,603,8,63,36,72,71,108,400,664,4,3036,168,0,2,1,0,0
38700,23,642,156,79,106,5,16,28,161,5,14,8,15,19,23,64,97,2,261,14,0,2,1,0,0
38701,106,4541,1289,550,1043,56,32,155,1345,10,167,93,185,177,278,1266,2075,5,11498,638,0,2,40,27,0
38702,150,7150,1392,870,1177,35,17,170,1427,14,494,280,531,508,811,4473,7289,7,54850,3047,2,2,3,11,0
38703,95,2843,773,419,590,28,0,166,801,10,204,113,217,214,330,1598,2554,5,13587,754,0,2,1,1,0
38704,8,210,127,75,83,2,11,30,129,4,14,7,14,18,21,61,87,2,175,9,0,2,15,0,0
38705,8,210,652,304,544,16,6,88,668,6,89,51,101,95,152,591,998,3,3399,188,0,2,15,0,0
38706,8,210,2,2,2,0,0,0,2,0,0,0,0,0,0,0,0,0,0,0,0,2,15,0,0
38707,8,210,8,5,5,0,0,3,8,0,0,0,0,0,0,0,0,0,0,0,0,2,15,0,0
38708,8,210,2,2,2,0,0,0,2,0,0,0,0,0,0,0,0,0,0,0,0,2,15,0,0
38709,8,210,14,8,8,0,0,6,14,0,0,0,0,0,0,0,0,0,0,0,0,2,15,0,0
38710,8,210,6,4,4,0,0,2,6,0,0,0,0,0,0,0,0,0,0,0,0,2,15,0,0
38711,8,210,6,4,4,0,0,2,6,1,2,1,2,3,3,2,4,0,2,0,0,2,15,0,0
38712,8,210,6,4,4,0,0,2,6,0,0,0,0,0,0,0,0,0,0,0,0,2,15,0,0
38713,8,210,7,5,5,0,0,2,7,0,0,0,0,0,0,0,0,0,0,0,0,2,15,0,0
38714,8,210,6,4,4,0,0,2,6,0,0,0,0,0,0,0,0,0,0,0,0,2,15,0,0
38715,8,210,10,6,6,0,0,4,10,0,0,0,0,0,0,0,0,0,0,0,0,2,15,0,0
38716,8,210,1,1,1,0,0,0,1,0,0,0,0,0,0,0,0,0,0,0,0,2,15,0,0
38717,8,210,1,1,1,0,0,0,1,0,0,0,0,0,0,0,0,0,0,0,0,2,15,0,0
38718,8,210,14,10,10,0,0,4,14,1,1,1,1,2,2,0,2,0,1,0,0,2,15,0,0
38719,8,210,46,26,30,3,0,12,49,3,6,3,6,9,9,20,28,1,42,2,0,2,15,0,0
38720,14,833,75,38,59,1,3,12,76,2,4,2,4,6,6,10,15,1,15,0,0,2,9,16,0
38721,4,163,27,21,21,0,0,6,27,3,6,3,6,9,9,20,28,1,42,2,0,2,1,1,0
38722,12,314,149,95,105,2,0,41,151,8,54,28,55,62,83,334,494,4,2013,111,0,2,1,1,0
38723,42,2613,1157,318,931,29,22,177,1186,6,104,63,125,110,188,712,1274,3,4596,255,0,2,37,6,0
38724,90,3963,1338,495,1086,10,64,173,1348,11,122,82,157,133,239,883,1686,7,11934,663,0,2,4,4,0
38725,172,7582,4293,999,3693,19,54,507,4312,9,155,88,170,164,258,1156,1898,4,9368,520,0,2,10,8,0
38726,172,7582,1482,859,1002,125,135,219,1607,16,219,134,251,235,385,1766,3032,9,27804,1544,1,2,10,8,0
38727,145,5899,1782,648,1425,9,47,279,1791,8,171,97,189,179,286,1292,2140,4,9462,525,0,2,15,2,0
38728,32,968,256,139,192,9,7,47,265,4,23,12,24,27,36,112,171,2,357,19,0,2,4,1,0
38729,121,4918,1450,624,1228,12,26,181,1462,14,306,186,354,320,540,2580,4493,8,36391,2021,1,2,24,3,0
38730,179,5679,1660,832,1314,41,38,274,1701,20,312,209,395,332,604,2671,5058,12,64042,3557,1,2,297,152,0
38731,49,3782,996,429,845,24,10,117,1020,7,76,50,88,83,138,494,879,4,3565,198,0,2,2,2,0
38732,120,5085,1513,682,1277,25,13,200,1538,11,199,116,219,210,335,1557,2584,6,15641,868,0,2,9,9,0
38733,84,4875,1296,573,1062,40,33,157,1336,8,201,118,231,209,349,1561,2689,4,12365,686,0,2,6,7,0
38734,102,5281,1457,730,1242,11,6,188,1468,10,292,166,329,302,495,2424,4078,5,22973,1276,1,2,42,16,0
38735,43,2669,652,304,544,16,6,88,668,6,89,51,101,95,152,591,998,3,3399,188,0,2,7,9,0
38736,74,3363,1455,414,1257,16,76,112,1471,5,41,23,46,46,69,231,381,2,1069,59,0,2,26,2,0
38737,8,310,103,47,73,2,12,15,105,5,16,9,17,21,26,75,114,2,303,16,0,0,103,0,0
38738,8,269,74,35,59,1,0,14,75,3,14,7,14,17,21,58,85,1,128,7,0,2,4,4,0
38739,107,5128,1523,757,1297,19,12,193,1542,12,193,117,230,205,347,1508,2664,7,19053,1058,0,2,3,3,0
38740,70,3179,1020,354,843,12,15,144,1032,8,134,77,144,142,221,970,1580,4,6792,377,0,2,2,2,0
38741,21,637,424,94,331,4,0,89,428,1,5,5,5,6,10,11,25,0,12,0,0,2,1,1,0
38742,9,413,91,45,69,0,3,18,91,3,9,6,10,12,16,33,57,1,95,5,0,2,5,0,0
38743,29,1875,384,251,317,7,8,52,391,11,70,44,84,81,128,467,811,6,5355,297,0,2,2,2,0
38744,55,2829,722,423,573,19,0,135,741,12,172,101,199,184,300,1320,2257,6,15668,870,0,2,10,19,0
38745,85,3346,1043,504,840,53,9,147,1096,9,180,112,198,189,310,1377,2344,4,11604,644,0,2,6,8,0
38746,30,1424,373,158,315,8,0,51,381,5,76,44,79,81,123,486,779,2,2026,112,0,2,2,2,0
38747,10,475,219,78,157,11,5,46,230,3,24,20,34,27,54,114,256,2,545,30,0,2,9,11,0
38748,111,6050,1943,715,1694,26,18,214,1969,12,185,120,237,197,357,1436,2721,7,20915,1161,0,2,2,3,0
38749,35,1463,442,244,305,14,16,103,456,11,68,45,75,79,120,452,756,6,4588,254,0,2,0,1,0
38750,49,1968,1098,241,925,5,10,155,1103,7,46,25,49,53,74,273,423,3,1580,87,0,2,26,3,0
38751,2,103,37,13,25,0,6,6,37,1,2,1,2,3,3,2,4,0,2,0,0,0,37,0,0
38752,52,1740,601,196,481,2,23,85,603,8,63,36,72,71,108,400,664,4,3036,168,0,2,35,4,0
38753,113,2243,463,295,324,28,62,57,491,12,134,82,154,146,236,989,1696,6,11700,650,0,2,1,1,0
38754,113,2243,463,295,324,28,62,57,491,12,134,82,154,146,236,989,1696,6,11700,650,0,2,1,1,0
38755,250,5777,4293,999,3693,19,54,507,4312,9,155,88,170,164,258,1156,1898,4,9368,520,0,2,0,7,0
38756,250,5777,1482,859,1002,125,135,219,1607,16,219,134,251,235,385,1766,3032,9,27804,1544,1,2,0,7,0
38757,13,817,75,38,59,1,3,12,76,2,4,2,4,6,6,10,15,1,15,0,0,2,0,4,0
38758,170,7532,4293,999,3693,19,54,507,4312,9,155,88,170,164,258,1156,1898,4,9368,520,0,2,16,30,0
38759,170,7532,1482,859,1002,125,135,219,1607,16,219,134,251,235,385,1766,3032,9,27804,1544,1,2,16,30,0
38760,87,1703,757,253,292,73,244,162,830,13,61,38,67,74,105,409,651,7,4654,258,0,2,4,16,1
38761,38,712,386,256,301,16,9,68,402,4,59,35,69,63,104,355,621,2,1453,80,0,2,4,14,1
38762,38,712,264,131,164,11,41,46,275,6,38,22,40,44,62,214,338,3,1068,59,0,2,4,14,1
38763,30,879,256,139,192,9,7,47,265,4,23,12,24,27,36,112,171,2,357,19,0,2,8,22,1
38764,70,3178,1020,354,843,12,15,144,1032,8,134,77,144,142,221,970,1580,4,6792,377,0,2,2,1,1
38765,45,1930,386,256,301,16,9,68,402,4,59,35,69,63,104,355,621,2,1453,80,0,2,10,16,1
38766,86,1672,757,253,292,73,244,162,830,13,61,38,67,74,105,409,651,7,4654,258,0,2,0,7,0
38767,12,788,75,38,59,1,3,12,76,2,4,2,4,6,6,10,15,1,15,0,0,2,0,6,0
38768,28,820,256,139,192,9,7,47,265,4,23,12,24,27,36,112,171,2,357,19,0,2,0,12,0
38769,70,1518,402,202,227,24,74,80,426,12,52,33,61,64,94,339,564,7,3969,220,0,2,6,14,0
38770,85,1663,757,253,292,73,244,162,830,13,61,38,67,74,105,409,651,7,4654,258,0,2,3,5,0
38771,38,702,386,256,301,16,9,68,402,4,59,35,69,63,104,355,621,2,1453,80,0,2,6,7,0
38772,38,702,264,131,164,11,41,46,275,6,38,22,40,44,62,214,338,3,1068,59,0,2,6,7,0
38773,11,753,75,38,59,1,3,12,76,2,4,2,4,6,6,10,15,1,15,0,0,2,0,9,0
38774,69,3112,1020,354,843,12,15,144,1032,8,134,77,144,142,221,970,1580,4,6792,377,0,2,0,13,0
38775,236,4859,2,2,2,0,0,0,2,0,0,0,0,0,0,0,0,0,0,0,0,2,14,10,0
38776,236,4859,99,48,90,1,3,5,100,0,0,0,0,0,0,0,0,0,0,0,0,2,14,10,0
38777,236,4859,8,5,5,2,0,1,10,0,0,0,0,0,0,0,0,0,0,0,0,2,14,10,0
38778,236,4859,1217,716,841,84,126,174,1301,14,185,118,215,199,333,1446,2542,8,20687,1149,0,2,14,10,0
38779,236,4859,160,89,115,0,13,31,160,7,15,11,17,22,28,78,124,3,495,27,0,2,14,10,0
38780,236,4859,10,10,9,9,0,0,19,0,0,0,0,0,0,0,0,0,0,0,0,2,14,10,0
38781,236,4859,173,84,99,8,29,36,181,5,12,7,13,17,20,54,81,2,221,12,0,2,14,10,0
38782,236,4859,3,1,1,3,0,0,6,0,0,0,0,0,0,0,0,0,0,0,0,2,14,10,0
38783,7,287,75,38,59,1,3,12,76,2,4,2,4,6,6,10,15,1,15,0,0,2,0,118,0
38784,106,5687,1457,730,1242,11,6,188,1468,10,292,166,329,302,495,2424,4078,5,22973,1276,1,2,114,0,0
38785,55,761,167,116,138,4,5,22,171,8,48,30,56,56,86,292,499,4,2330,129,0,2,3,4,0
38786,5,216,75,38,59,1,3,12,76,2,4,2,4,6,6,10,15,1,15,0,0,2,0,24,0
38787,108,5765,1457,730,1242,11,6,188,1468,10,292,166,329,302,495,2424,4078,5,22973,1276,1,2,24,0,0
38788,141,3466,77,34,69,0,0,8,77,3,24,16,29,27,45,114,213,1,387,21,0,2,0,22,0
38789,141,3466,712,438,573,51,9,84,763,14,102,71,128,116,199,733,1364,8,11988,666,0,2,0,22,0
38790,55,2824,722,423,573,19,0,135,741,12,172,101,199,184,300,1320,2257,6,15668,870,0,2,1,2,0
38791,18,638,442,244,305,14,16,103,456,11,68,45,75,79,120,452,756,6,4588,254,0,2,0,15,0
38792,18,638,182,102,99,11,40,35,193,3,11,6,11,14,17,42,64,1,97,5,0,2,0,15,0
38793,34,1434,442,244,305,14,16,103,456,11,68,45,75,79,120,452,756,6,4588,254,0,2,6,10,0
38794,314,6847,72,33,56,0,4,12,72,1,1,1,1,2,2,0,2,0,1,0,0,2,3,2,0
38795,314,6847,1454,835,1044,76,110,219,1530,17,275,158,296,292,454,2297,3718,9,34017,1889,1,2,3,2,0
38796,54,640,647,139,84,35,284,233,682,0,0,0,0,0,0,0,0,0,0,0,0,2,0,22,0
38797,2,173,37,13,25,0,6,6,37,1,2,1,2,3,3,2,4,0,2,0,0,2,0,10,0
38798,2,173,133,47,40,1,43,49,134,0,0,0,0,0,0,0,0,0,0,0,0,2,0,10,0
38799,23,615,601,196,481,2,23,85,603,8,63,36,72,71,108,400,664,4,3036,168,0,2,0,5,0
38800,23,615,156,79,106,5,16,28,161,5,14,8,15,19,23,64,97,2,261,14,0,2,0,5,0
38801,106,4531,1289,550,1043,56,32,155,1345,10,167,93,185,177,278,1266,2075,5,11498,638,0,2,2,5,0
38802,170,7525,4293,999,3693,19,54,507,4312,9,155,88,170,164,258,1156,1898,4,9368,520,0,2,1,2,0
38803,170,7525,1482,859,1002,125,135,219,1607,16,219,134,251,235,385,1766,3032,9,27804,1544,1,2,1,2,0
38804,145,5874,1782,648,1425,9,47,279,1791,8,171,97,189,179,286,1292,2140,4,9462,525,0,2,13,14,0
38805,69,3090,1020,354,843,12,15,144,1032,8,134,77,144,142,221,970,1580,4,6792,377,0,2,3,9,0
38806,34,1424,442,244,305,14,16,103,456,11,68,45,75,79,120,452,756,6,4588,254,0,2,1,4,0
38807,48,1651,601,196,481,2,23,85,603,8,63,36,72,71,108,400,664,4,3036,168,0,2,8,31,0
38808,250,5776,4293,999,3693,19,54,507,4312,9,155,88,170,164,258,1156,1898,4,9368,520,0,2,6,4,0
38809,250,5776,1482,859,1002,125,135,219,1607,16,219,134,251,235,385,1766,3032,9,27804,1544,1,2,6,4,0
38810,59,1116,207,111,150,11,0,50,218,5,26,19,36,31,55,133,272,3,943,52,0,2,2,2,1
38811,59,1116,410,198,237,31,55,97,441,11,63,38,72,74,110,414,683,6,4293,238,0,2,2,2,1
38812,236,4863,2,2,2,0,0,0,2,0,0,0,0,0,0,0,0,0,0,0,0,2,1,0,1
38813,236,4863,99,48,90,1,3,5,100,0,0,0,0,0,0,0,0,0,0,0,0,2,1,0,1
38814,236,4863,8,5,5,2,0,1,10,0,0,0,0,0,0,0,0,0,0,0,0,2,1,0,1
38815,236,4863,1217,716,841,84,126,174,1301,14,185,118,215,199,333,1446,2542,8,20687,1149,0,2,1,0,1
38816,236,4863,160,89,115,0,13,31,160,7,15,11,17,22,28,78,124,3,495,27,0,2,1,0,1
38817,236,4863,10,10,9,9,0,0,19,0,0,0,0,0,0,0,0,0,0,0,0,2,1,0,1
38818,236,4863,173,84,99,8,29,36,181,5,12,7,13,17,20,54,81,2,221,12,0,2,1,0,1
38819,236,4863,3,1,1,3,0,0,6,0,0,0,0,0,0,0,0,0,0,0,0,2,1,0,1
38820,250,5782,4293,999,3693,19,54,507,4312,9,155,88,170,164,258,1156,1898,4,9368,520,0,2,7,3,1
38821,250,5782,1482,859,1002,125,135,219,1607,16,219,134,251,235,385,1766,3032,9,27804,1544,1,2,7,3,1
38822,4,178,75,38,59,1,3,12,76,2,4,2,4,6,6,10,15,1,15,0,0,2,0,12,1
38823,170,7527,4293,999,3693,19,54,507,4312,9,155,88,170,164,258,1156,1898,4,9368,520,0,2,11,15,1
38824,170,7527,1482,859,1002,125,135,219,1607,16,219,134,251,235,385,1766,3032,9,27804,1544,1,2,11,15,1
38825,12,226,127,75,83,2,11,30,129,4,14,7,14,18,21,61,87,2,175,9,0,2,1,1,0
38826,12,226,652,304,544,16,6,88,668,6,89,51,101,95,152,591,998,3,3399,188,0,2,1,1,0
38827,12,226,2,2,2,0,0,0,2,0,0,0,0,0,0,0,0,0,0,0,0,2,1,1,0
38828,12,226,8,5,5,0,0,3,8,0,0,0,0,0,0,0,0,0,0,0,0,2,1,1,0
38829,12,226,2,2,2,0,0,0,2,0,0,0,0,0,0,0,0,0,0,0,0,2,1,1,0
38830,12,226,14,8,8,0,0,6,14,0,0,0,0,0,0,0,0,0,0,0,0,2,1,1,0
38831,12,226,6,4,4,0,0,2,6,0,0,0,0,0,0,0,0,0,0,0,0,2,1,1,0
38832,12,226,6,4,4,0,0,2,6,1,2,1,2,3,3,2,4,0,2,0,0,2,1,1,0
38833,12,226,6,4,4,0,0,2,6,0,0,0,0,0,0,0,0,0,0,0,0,2,1,1,0
38834,12,226,7,5,5,0,0,2,7,0,0,0,0,0,0,0,0,0,0,0,0,2,1,1,0
38835,12,226,6,4,4,0,0,2,6,0,0,0,0,0,0,0,0,0,0,0,0,2,1,1,0
38836,12,226,10,6,6,0,0,4,10,0,0,0,0,0,0,0,0,0,0,0,0,2,1,1,0
38837,12,226,1,1,1,0,0,0,1,0,0,0,0,0,0,0,0,0,0,0,0,2,1,1,0
38838,12,226,1,1,1,0,0,0,1,0,0,0,0,0,0,0,0,0,0,0,0,2,1,1,0
38839,12,226,14,10,10,0,0,4,14,1,1,1,1,2,2,0,2,0,1,0,0,2,1,1,0
38840,12,226,46,26,30,3,0,12,49,3,6,3,6,9,9,20,28,1,42,2,0,2,1,1,0
38841,84,1645,757,253,292,73,244,162,830,13,61,38,67,74,105,409,651,7,4654,258,0,2,3,6,0
38842,37,680,386,256,301,16,9,68,402,4,59,35,69,63,104,355,621,2,1453,80,0,2,1,6,0
38843,37,680,264,131,164,11,41,46,275,6,38,22,40,44,62,214,338,3,1068,59,0,2,1,6,0
38844,12,226,127,75,83,2,11,30,129,4,14,7,14,18,21,61,87,2,175,9,0,2,1,1,0
38845,12,226,652,304,544,16,6,88,668,6,89,51,101,95,152,591,998,3,3399,188,0,2,1,1,0
38846,12,226,2,2,2,0,0,0,2,0,0,0,0,0,0,0,0,0,0,0,0,2,1,1,0
38847,12,226,8,5,5,0,0,3,8,0,0,0,0,0,0,0,0,0,0,0,0,2,1,1,0
38848,12,226,2,2,2,0,0,0,2,0,0,0,0,0,0,0,0,0,0,0,0,2,1,1,0
38849,12,226,14,8,8,0,0,6,14,0,0,0,0,0,0,0,0,0,0,0,0,2,1,1,0
38850,12,226,6,4,4,0,0,2,6,0,0,0,0,0,0,0,0,0,0,0,0,2,1,1,0
38851,12,226,6,4,4,0,0,2,6,1,2,1,2,3,3,2,4,0,2,0,0,2,1,1,0
38852,12,226,6,4,4,0,0,2,6,0,0,0,0,0,0,0,0,0,0,0,0,2,1,1,0
38853,12,226,7,5,5,0,0,2,7,0,0,0,0,0,0,0,0,0,0,0,0,2,1,1,0
38854,12,226,6,4,4,0,0,2,6,0,0,0,0,0,0,0,0,0,0,0,0,2,1,1,0
38855,12,226,10,6,6,0,0,4,10,0,0,0,0,0,0,0,0,0,0,0,0,2,1,1,0
38856,12,226,1,1,1,0,0,0,1,0,0,0,0,0,0,0,0,0,0,0,0,2,1,1,0
38857,12,226,1,1,1,0,0,0,1,0,0,0,0,0,0,0,0,0,0,0,0,2,1,1,0
38858,12,226,14,10,10,0,0,4,14,1,1,1,1,2,2,0,2,0,1,0,0,2,1,1,0
38859,12,226,46,26,30,3,0,12,49,3,6,3,6,9,9,20,28,1,42,2,0,2,1,1,0
38860,219,4669,182,127,129,0,0,53,182,5,39,21,42,44,63,217,343,2,926,51,0,2,1,1,0
38861,219,4669,1165,710,800,67,119,181,1232,18,243,153,282,261,435,2000,3492,10,36473,2026,1,2,1,1,0
38862,33,1013,256,139,192,9,7,47,265,4,23,12,24,27,36,112,171,2,357,19,0,2,8,1,0
38863,113,2243,463,295,324,28,62,57,491,12,134,82,154,146,236,989,1696,6,11700,650,0,2,1,1,0
38864,1,92,42,7,35,4,0,5,46,1,2,1,2,3,3,2,4,0,2,0,0,2,1,1,0
38865,1,92,11,6,10,0,0,1,11,2,4,2,4,6,6,10,15,1,15,0,0,2,1,1,0
38866,58,1130,207,111,150,11,0,50,218,5,26,19,36,31,55,133,272,3,943,52,0,2,6,0,0
38867,58,1130,410,198,237,31,55,97,441,11,63,38,72,74,110,414,683,6,4293,238,0,2,6,0,0
38868,235,4848,2,2,2,0,0,0,2,0,0,0,0,0,0,0,0,0,0,0,0,2,1,1,0
38869,235,4848,99,48,90,1,3,5,100,0,0,0,0,0,0,0,0,0,0,0,0,2,1,1,0
38870,235,4848,8,5,5,2,0,1,10,0,0,0,0,0,0,0,0,0,0,0,0,2,1,1,0
38871,235,4848,1217,716,841,84,126,174,1301,14,185,118,215,199,333,1446,2542,8,20687,1149,0,2,1,1,0
38872,235,4848,160,89,115,0,13,31,160,7,15,11,17,22,28,78,124,3,495,27,0,2,1,1,0
38873,235,4848,10,10,9,9,0,0,19,0,0,0,0,0,0,0,0,0,0,0,0,2,1,1,0
38874,235,4848,173,84,99,8,29,36,181,5,12,7,13,17,20,54,81,2,221,12,0,2,1,1,0
38875,235,4848,3,1,1,3,0,0,6,0,0,0,0,0,0,0,0,0,0,0,0,2,1,1,0
38876,106,4545,1289,550,1043,56,32,155,1345,10,167,93,185,177,278,1266,2075,5,11498,638,0,2,1,1,0
38877,121,4918,1450,624,1228,12,26,181,1462,14,306,186,354,320,540,2580,4493,8,36391,2021,1,2,2,1,0
38878,102,5285,1457,730,1242,11,6,188,1468,10,292,166,329,302,495,2424,4078,5,22973,1276,1,2,1,2,0
38879,2,48,7,6,5,0,0,2,7,1,1,1,2,2,3,0,3,1,3,0,0,2,1,1,0
38880,219,4669,182,127,129,0,0,53,182,5,39,21,42,44,63,217,343,2,926,51,0,2,1,1,0
38881,219,4669,1165,710,800,67,119,181,1232,18,243,153,282,261,435,2000,3492,10,36473,2026,1,2,1,1,0
38882,33,1013,256,139,192,9,7,47,265,4,23,12,24,27,36,112,171,2,357,19,0,2,8,1,0
38883,25,429,219,78,157,11,5,46,230,3,24,20,34,27,54,114,256,2,545,30,0,2,1,1,1
38884,25,429,108,64,79,9,0,20,117,5,15,11,19,20,30,70,129,3,410,22,0,2,1,1,1
38885,11,631,219,78,157,11,5,46,230,3,24,20,34,27,54,114,256,2,545,30,0,2,53,0,1
38886,25,429,219,78,157,11,5,46,230,3,24,20,34,27,54,114,256,2,545,30,0,2,1,1,0
38887,25,429,108,64,79,9,0,20,117,5,15,11,19,20,30,70,129,3,410,22,0,2,1,1,0
38888,11,631,219,78,157,11,5,46,230,3,24,20,34,27,54,114,256,2,545,30,0,2,53,0,0
38889,1,92,42,7,35,4,0,5,46,1,2,1,2,3,3,2,4,0,2,0,0,2,1,1,0
38890,1,92,11,6,10,0,0,1,11,2,4,2,4,6,6,10,15,1,15,0,0,2,1,1,0
38891,58,1130,207,111,150,11,0,50,218,5,26,19,36,31,55,133,272,3,943,52,0,2,6,0,0
38892,58,1130,410,198,237,31,55,97,441,11,63,38,72,74,110,414,683,6,4293,238,0,2,6,0,0
38893,235,4848,2,2,2,0,0,0,2,0,0,0,0,0,0,0,0,0,0,0,0,2,1,1,0
38894,235,4848,99,48,90,1,3,5,100,0,0,0,0,0,0,0,0,0,0,0,0,2,1,1,0
38895,235,4848,8,5,5,2,0,1,10,0,0,0,0,0,0,0,0,0,0,0,0,2,1,1,0
38896,235,4848,1217,716,841,84,126,174,1301,14,185,118,215,199,333,1446,2542,8,20687,1149,0,2,1,1,0
38897,235,4848,160,89,115,0,13,31,160,7,15,11,17,22,28,78,124,3,495,27,0,2,1,1,0
38898,235,4848,10,10,9,9,0,0,19,0,0,0,0,0,0,0,0,0,0,0,0,2,1,1,0
38899,235,4848,173,84,99,8,29,36,181,5,12,7,13,17,20,54,81,2,221,12,0,2,1,1,0
38900,235,4848,3,1,1,3,0,0,6,0,0,0,0,0,0,0,0,0,0,0,0,2,1,1,0
38901,113,2243,463,295,324,28,62,57,491,12,134,82,154,146,236,989,1696,6,11700,650,0,2,1,1,0
38902,106,4545,1289,550,1043,56,32,155,1345,10,167,93,185,177,278,1266,2075,5,11498,638,0,2,1,1,0
38903,121,4918,1450,624,1228,12,26,181,1462,14,306,186,354,320,540,2580,4493,8,36391,2021,1,2,2,1,0
38904,102,5285,1457,730,1242,11,6,188,1468,10,292,166,329,302,495,2424,4078,5,22973,1276,1,2,1,2,0
38905,2,48,7,6,5,0,0,2,7,1,1,1,2,2,3,0,3,1,3,0,0,2,1,1,0
38906,12,226,127,75,83,2,11,30,129,4,14,7,14,18,21,61,87,2,175,9,0,2,1,1,0
38907,12,226,652,304,544,16,6,88,668,6,89,51,101,95,152,591,998,3,3399,188,0,2,1,1,0
38908,12,226,2,2,2,0,0,0,2,0,0,0,0,0,0,0,0,0,0,0,0,2,1,1,0
38909,12,226,8,5,5,0,0,3,8,0,0,0,0,0,0,0,0,0,0,0,0,2,1,1,0
38910,12,226,2,2,2,0,0,0,2,0,0,0,0,0,0,0,0,0,0,0,0,2,1,1,0
38911,12,226,14,8,8,0,0,6,14,0,0,0,0,0,0,0,0,0,0,0,0,2,1,1,0
38912,12,226,6,4,4,0,0,2,6,0,0,0,0,0,0,0,0,0,0,0,0,2,1,1,0
38913,12,226,6,4,4,0,0,2,6,1,2,1,2,3,3,2,4,0,2,0,0,2,1,1,0
38914,12,226,6,4,4,0,0,2,6,0,0,0,0,0,0,0,0,0,0,0,0,2,1,1,0
38915,12,226,7,5,5,0,0,2,7,0,0,0,0,0,0,0,0,0,0,0,0,2,1,1,0
38916,12,226,6,4,4,0,0,2,6,0,0,0,0,0,0,0,0,0,0,0,0,2,1,1,0
38917,12,226,10,6,6,0,0,4,10,0,0,0,0,0,0,0,0,0,0,0,0,2,1,1,0
38918,12,226,1,1,1,0,0,0,1,0,0,0,0,0,0,0,0,0,0,0,0,2,1,1,0
38919,12,226,1,1,1,0,0,0,1,0,0,0,0,0,0,0,0,0,0,0,0,2,1,1,0
38920,12,226,14,10,10,0,0,4,14,1,1,1,1,2,2,0,2,0,1,0,0,2,1,1,0
38921,12,226,46,26,30,3,0,12,49,3,6,3,6,9,9,20,28,1,42,2,0,2,1,1,0
38922,219,4669,182,127,129,0,0,53,182,5,39,21,42,44,63,217,343,2,926,51,0,2,1,1,0
38923,219,4669,1165,710,800,67,119,181,1232,18,243,153,282,261,435,2000,3492,10,36473,2026,1,2,1,1,0
38924,25,429,219,78,157,11,5,46,230,3,24,20,34,27,54,114,256,2,545,30,0,2,1,1,0
38925,25,429,108,64,79,9,0,20,117,5,15,11,19,20,30,70,129,3,410,22,0,2,1,1,0
38926,33,1013,256,139,192,9,7,47,265,4,23,12,24,27,36,112,171,2,357,19,0,2,8,1,0
38927,11,631,219,78,157,11,5,46,230,3,24,20,34,27,54,114,256,2,545,30,0,2,53,0,0
38928,25,429,219,78,157,11,5,46,230,3,24,20,34,27,54,114,256,2,545,30,0,2,0,1,0
38929,25,429,108,64,79,9,0,20,117,5,15,11,19,20,30,70,129,3,410,22,0,2,0,1,0
38930,25,429,219,78,157,11,5,46,230,3,24,20,34,27,54,114,256,2,545,30,0,2,0,1,0
38931,25,429,108,64,79,9,0,20,117,5,15,11,19,20,30,70,129,3,410,22,0,2,0,1,0
38932,117,3137,1523,757,1297,19,12,193,1542,12,193,117,230,205,347,1508,2664,7,19053,1058,0,2,10,11,0
38933,117,3137,701,378,504,33,58,109,734,13,110,68,126,123,194,794,1346,7,10027,557,0,2,10,11,0
38934,111,5221,1523,757,1297,19,12,193,1542,12,193,117,230,205,347,1508,2664,7,19053,1058,0,2,27,3,0
38935,14,836,75,38,59,1,3,12,76,2,4,2,4,6,6,10,15,1,15,0,0,2,1,1,0
38936,235,4868,2,2,2,0,0,0,2,0,0,0,0,0,0,0,0,0,0,0,0,2,20,6,0
38937,235,4868,99,48,90,1,3,5,100,0,0,0,0,0,0,0,0,0,0,0,0,2,20,6,0
38938,235,4868,8,5,5,2,0,1,10,0,0,0,0,0,0,0,0,0,0,0,0,2,20,6,0
38939,235,4868,1217,716,841,84,126,174,1301,14,185,118,215,199,333,1446,2542,8,20687,1149,0,2,20,6,0
38940,235,4868,160,89,115,0,13,31,160,7,15,11,17,22,28,78,124,3,495,27,0,2,20,6,0
38941,235,4868,10,10,9,9,0,0,19,0,0,0,0,0,0,0,0,0,0,0,0,2,20,6,0
38942,235,4868,173,84,99,8,29,36,181,5,12,7,13,17,20,54,81,2,221,12,0,2,20,6,0
38943,235,4868,3,1,1,3,0,0,6,0,0,0,0,0,0,0,0,0,0,0,0,2,20,6,0
38944,103,5394,1457,730,1242,11,6,188,1468,10,292,166,329,302,495,2424,4078,5,22973,1276,1,2,22,0,0
38945,237,4975,2,2,2,0,0,0,2,0,0,0,0,0,0,0,0,0,0,0,0,2,38,12,0
38946,237,4975,99,48,90,1,3,5,100,0,0,0,0,0,0,0,0,0,0,0,0,2,38,12,0
38947,237,4975,8,5,5,2,0,1,10,0,0,0,0,0,0,0,0,0,0,0,0,2,38,12,0
38948,237,4975,1217,716,841,84,126,174,1301,14,185,118,215,199,333,1446,2542,8,20687,1149,0,2,38,12,0
38949,237,4975,160,89,115,0,13,31,160,7,15,11,17,22,28,78,124,3,495,27,0,2,38,12,0
38950,237,4975,10,10,9,9,0,0,19,0,0,0,0,0,0,0,0,0,0,0,0,2,38,12,0
38951,237,4975,173,84,99,8,29,36,181,5,12,7,13,17,20,54,81,2,221,12,0,2,38,12,0
38952,237,4975,3,1,1,3,0,0,6,0,0,0,0,0,0,0,0,0,0,0,0,2,38,12,0
38953,103,5415,1457,730,1242,11,6,188,1468,10,292,166,329,302,495,2424,4078,5,22973,1276,1,2,4,2,0
38954,237,4975,2,2,2,0,0,0,2,0,0,0,0,0,0,0,0,0,0,0,0,2,9,1,0
38955,237,4975,99,48,90,1,3,5,100,0,0,0,0,0,0,0,0,0,0,0,0,2,9,1,0
38956,237,4975,8,5,5,2,0,1,10,0,0,0,0,0,0,0,0,0,0,0,0,2,9,1,0
38957,237,4975,1217,716,841,84,126,174,1301,14,185,118,215,199,333,1446,2542,8,20687,1149,0,2,9,1,0
38958,237,4975,160,89,115,0,13,31,160,7,15,11,17,22,28,78,124,3,495,27,0,2,9,1,0
38959,237,4975,10,10,9,9,0,0,19,0,0,0,0,0,0,0,0,0,0,0,0,2,9,1,0
38960,237,4975,173,84,99,8,29,36,181,5,12,7,13,17,20,54,81,2,221,12,0,2,9,1,0
38961,237,4975,3,1,1,3,0,0,6,0,0,0,0,0,0,0,0,0,0,0,0,2,9,1,0
38962,103,5418,1457,730,1242,11,6,188,1468,10,292,166,329,302,495,2424,4078,5,22973,1276,1,2,2,2,0
38963,1,302,382,65,130,157,2,92,539,4,10,5,10,14,15,41,57,2,114,6,0,2,1,2,0
38964,1,313,382,65,130,157,2,92,539,4,10,5,10,14,15,41,57,2,114,6,0,2,2,2,0
38965,101,2578,1455,414,1257,16,76,112,1471,5,41,23,46,46,69,231,381,2,1069,59,0,2,91,24,1
38966,101,2578,669,365,481,22,61,110,691,15,103,63,122,118,185,747,1273,8,11311,628,0,2,91,24,1
38967,81,3701,1455,414,1257,16,76,112,1471,5,41,23,46,46,69,231,381,2,1069,59,0,2,144,0,1
38968,12,226,127,75,83,2,11,30,129,4,14,7,14,18,21,61,87,2,175,9,0,2,1,1,0
38969,12,226,652,304,544,16,6,88,668,6,89,51,101,95,152,591,998,3,3399,188,0,2,1,1,0
38970,12,226,2,2,2,0,0,0,2,0,0,0,0,0,0,0,0,0,0,0,0,2,1,1,0
38971,12,226,8,5,5,0,0,3,8,0,0,0,0,0,0,0,0,0,0,0,0,2,1,1,0
38972,12,226,2,2,2,0,0,0,2,0,0,0,0,0,0,0,0,0,0,0,0,2,1,1,0
38973,12,226,14,8,8,0,0,6,14,0,0,0,0,0,0,0,0,0,0,0,0,2,1,1,0
38974,12,226,6,4,4,0,0,2,6,0,0,0,0,0,0,0,0,0,0,0,0,2,1,1,0
38975,12,226,6,4,4,0,0,2,6,1,2,1,2,3,3,2,4,0,2,0,0,2,1,1,0
38976,12,226,6,4,4,0,0,2,6,0,0,0,0,0,0,0,0,0,0,0,0,2,1,1,0
38977,12,226,7,5,5,0,0,2,7,0,0,0,0,0,0,0,0,0,0,0,0,2,1,1,0
38978,12,226,6,4,4,0,0,2,6,0,0,0,0,0,0,0,0,0,0,0,0,2,1,1,0
38979,12,226,10,6,6,0,0,4,10,0,0,0,0,0,0,0,0,0,0,0,0,2,1,1,0
38980,12,226,1,1,1,0,0,0,1,0,0,0,0,0,0,0,0,0,0,0,0,2,1,1,0
38981,12,226,1,1,1,0,0,0,1,0,0,0,0,0,0,0,0,0,0,0,0,2,1,1,0
38982,12,226,14,10,10,0,0,4,14,1,1,1,1,2,2,0,2,0,1,0,0,2,1,1,0
38983,12,226,46,26,30,3,0,12,49,3,6,3,6,9,9,20,28,1,42,2,0,2,1,1,0
38984,219,4669,182,127,129,0,0,53,182,5,39,21,42,44,63,217,343,2,926,51,0,2,1,1,0
38985,219,4669,1165,710,800,67,119,181,1232,18,243,153,282,261,435,2000,3492,10,36473,2026,1,2,1,1,0
38986,25,429,219,78,157,11,5,46,230,3,24,20,34,27,54,114,256,2,545,30,0,2,1,1,0
38987,25,429,108,64,79,9,0,20,117,5,15,11,19,20,30,70,129,3,410,22,0,2,1,1,0
38988,33,1013,256,139,192,9,7,47,265,4,23,12,24,27,36,112,171,2,357,19,0,2,8,1,0
38989,11,631,219,78,157,11,5,46,230,3,24,20,34,27,54,114,256,2,545,30,0,2,53,0,0
38990,1,300,382,65,130,157,2,92,539,4,10,5,10,14,15,41,57,2,114,6,0,2,0,1,0
38991,14,836,75,38,59,1,3,12,76,2,4,2,4,6,6,10,15,1,15,0,0,2,1,1,0
38992,1,300,382,65,130,157,2,92,539,4,10,5,10,14,15,41,57,2,114,6,0,2,1,3,0
38993,1,300,382,65,130,157,2,92,539,4,10,5,10,14,15,41,57,2,114,6,0,2,2,2,0
38994,11,231,19,8,11,5,0,4,24,2,5,3,6,7,9,13,25,1,30,1,0,2,2,1,1
38995,11,231,102,59,69,5,3,24,107,6,22,15,28,28,43,113,206,3,789,43,0,2,2,1,1
38996,11,231,106,40,36,3,49,17,109,8,17,13,23,25,36,93,167,5,904,50,0,2,2,1,1
38997,219,4648,182,127,129,0,0,53,182,5,39,21,42,44,63,217,343,2,926,51,0,2,7,6,1
38998,219,4648,1165,710,800,67,119,181,1232,18,243,153,282,261,435,2000,3492,10,36473,2026,1,2,7,6,1
38999,67,1551,773,419,590,28,0,166,801,10,204,113,217,214,330,1598,2554,5,13587,754,0,2,2,1,1
39000,67,1551,421,273,302,44,34,57,465,17,81,59,107,98,166,583,1098,11,12329,684,0,2,2,1,1
39001,180,5401,1660,832,1314,41,38,274,1701,20,312,209,395,332,604,2671,5058,12,64042,3557,1,2,15,10,1
39002,180,5401,1057,646,719,113,100,145,1170,18,215,134,248,233,382,1740,3004,10,31186,1732,1,2,15,10,1
39003,160,3425,1513,682,1277,25,13,200,1538,11,199,116,219,210,335,1557,2584,6,15641,868,0,2,8,4,1
39004,160,3425,819,519,539,24,98,155,843,15,96,57,106,111,163,690,1107,8,9171,509,0,2,8,4,1
39005,57,1484,339,213,244,17,9,65,356,10,42,26,48,52,74,259,421,5,2410,133,0,2,1,1,1
39006,251,5824,4293,999,3693,19,54,507,4312,9,155,88,170,164,258,1156,1898,4,9368,520,0,2,9,3,1
39007,251,5824,1482,859,1002,125,135,219,1607,16,219,134,251,235,385,1766,3032,9,27804,1544,1,2,9,3,1
39008,24,600,2,2,2,0,0,0,2,0,0,0,0,0,0,0,0,0,0,0,0,2,2,1,1
39009,24,600,99,48,90,1,3,5,100,0,0,0,0,0,0,0,0,0,0,0,0,2,2,1,1
39010,24,600,8,5,5,2,0,1,10,0,0,0,0,0,0,0,0,0,0,0,0,2,2,1,1
39011,24,600,1217,716,841,84,126,174,1301,14,185,118,215,199,333,1446,2542,8,20687,1149,0,2,2,1,1
39012,24,600,160,89,115,0,13,31,160,7,15,11,17,22,28,78,124,3,495,27,0,2,2,1,1
39013,24,600,10,10,9,9,0,0,19,0,0,0,0,0,0,0,0,0,0,0,0,2,2,1,1
39014,24,600,173,84,99,8,29,36,181,5,12,7,13,17,20,54,81,2,221,12,0,2,2,1,1
39015,24,600,3,1,1,3,0,0,6,0,0,0,0,0,0,0,0,0,0,0,0,2,2,1,1
39016,71,1566,402,202,227,24,74,80,426,12,52,33,61,64,94,339,564,7,3969,220,0,2,2,1,1
39017,76,1623,53,23,39,0,0,13,53,2,8,4,8,10,12,26,39,1,39,2,0,2,2,1,1
39018,76,1623,515,298,307,33,80,99,548,12,63,44,77,75,121,419,753,7,5527,307,0,2,2,1,1
39019,17,467,205,80,86,16,53,53,221,7,18,10,19,25,29,94,134,3,497,27,0,2,8,4,1
39020,88,1786,757,253,292,73,244,162,830,13,61,38,67,74,105,409,651,7,4654,258,0,2,10,5,1
39021,67,1751,466,257,367,18,25,50,484,7,126,86,171,133,257,898,1813,4,8612,478,0,2,2,1,1
39022,67,1751,507,281,342,29,59,88,536,10,53,29,57,63,86,336,514,5,2764,153,0,2,2,1,1
39023,19,699,442,244,305,14,16,103,456,11,68,45,75,79,120,452,756,6,4588,254,0,2,4,1,1
39024,19,699,182,102,99,11,40,35,193,3,11,6,11,14,17,42,64,1,97,5,0,2,4,1,1
39025,150,7150,1392,870,1177,35,17,170,1427,14,494,280,531,508,811,4473,7289,7,54850,3047,2,2,2,1,1
39026,32,968,256,139,192,9,7,47,265,4,23,12,24,27,36,112,171,2,357,19,0,2,2,1,1
39027,20,449,207,111,150,11,0,50,218,5,26,19,36,31,55,133,272,3,943,52,0,2,2,1,1
39028,75,3937,1293,570,1093,25,15,163,1318,10,195,123,241,205,364,1516,2795,6,17273,959,0,2,2,1,1
39029,11,231,19,8,11,5,0,4,24,2,5,3,6,7,9,13,25,1,30,1,0,2,2,1,0
39030,11,231,102,59,69,5,3,24,107,6,22,15,28,28,43,113,206,3,789,43,0,2,2,1,0
39031,11,231,106,40,36,3,49,17,109,8,17,13,23,25,36,93,167,5,904,50,0,2,2,1,0
39032,219,4651,182,127,129,0,0,53,182,5,39,21,42,44,63,217,343,2,926,51,0,2,7,6,0
39033,219,4651,1165,710,800,67,119,181,1232,18,243,153,282,261,435,2000,3492,10,36473,2026,1,2,7,6,0
39034,67,1551,773,419,590,28,0,166,801,10,204,113,217,214,330,1598,2554,5,13587,754,0,2,2,1,0
39035,67,1551,421,273,302,44,34,57,465,17,81,59,107,98,166,583,1098,11,12329,684,0,2,2,1,0
39036,180,5401,1660,832,1314,41,38,274,1701,20,312,209,395,332,604,2671,5058,12,64042,3557,1,2,15,10,0
39037,180,5401,1057,646,719,113,100,145,1170,18,215,134,248,233,382,1740,3004,10,31186,1732,1,2,15,10,0
39038,160,3425,1513,682,1277,25,13,200,1538,11,199,116,219,210,335,1557,2584,6,15641,868,0,2,8,4,0
39039,160,3425,819,519,539,24,98,155,843,15,96,57,106,111,163,690,1107,8,9171,509,0,2,8,4,0
39040,57,1484,339,213,244,17,9,65,356,10,42,26,48,52,74,259,421,5,2410,133,0,2,1,1,0
39041,251,5824,4293,999,3693,19,54,507,4312,9,155,88,170,164,258,1156,1898,4,9368,520,0,2,9,3,0
39042,251,5824,1482,859,1002,125,135,219,1607,16,219,134,251,235,385,1766,3032,9,27804,1544,1,2,9,3,0
39043,24,600,2,2,2,0,0,0,2,0,0,0,0,0,0,0,0,0,0,0,0,2,2,1,0
39044,24,600,99,48,90,1,3,5,100,0,0,0,0,0,0,0,0,0,0,0,0,2,2,1,0
39045,24,600,8,5,5,2,0,1,10,0,0,0,0,0,0,0,0,0,0,0,0,2,2,1,0
39046,24,600,1217,716,841,84,126,174,1301,14,185,118,215,199,333,1446,2542,8,20687,1149,0,2,2,1,0
39047,24,600,160,89,115,0,13,31,160,7,15,11,17,22,28,78,124,3,495,27,0,2,2,1,0
39048,24,600,10,10,9,9,0,0,19,0,0,0,0,0,0,0,0,0,0,0,0,2,2,1,0
39049,24,600,173,84,99,8,29,36,181,5,12,7,13,17,20,54,81,2,221,12,0,2,2,1,0
39050,24,600,3,1,1,3,0,0,6,0,0,0,0,0,0,0,0,0,0,0,0,2,2,1,0
39051,71,1566,402,202,227,24,74,80,426,12,52,33,61,64,94,339,564,7,3969,220,0,2,2,1,0
39052,76,1623,53,23,39,0,0,13,53,2,8,4,8,10,12,26,39,1,39,2,0,2,2,1,0
39053,76,1623,515,298,307,33,80,99,548,12,63,44,77,75,121,419,753,7,5527,307,0,2,2,1,0
39054,17,467,205,80,86,16,53,53,221,7,18,10,19,25,29,94,134,3,497,27,0,2,8,4,0
39055,88,1786,757,253,292,73,244,162,830,13,61,38,67,74,105,409,651,7,4654,258,0,2,10,5,0
39056,67,1751,466,257,367,18,25,50,484,7,126,86,171,133,257,898,1813,4,8612,478,0,2,2,1,0
39057,67,1751,507,281,342,29,59,88,536,10,53,29,57,63,86,336,514,5,2764,153,0,2,2,1,0
39058,19,699,442,244,305,14,16,103,456,11,68,45,75,79,120,452,756,6,4588,254,0,2,4,1,0
39059,19,699,182,102,99,11,40,35,193,3,11,6,11,14,17,42,64,1,97,5,0,2,4,1,0
39060,150,7150,1392,870,1177,35,17,170,1427,14,494,280,531,508,811,4473,7289,7,54850,3047,2,2,2,1,0
39061,33,1013,256,139,192,9,7,47,265,4,23,12,24,27,36,112,171,2,357,19,0,2,2,1,0
39062,20,449,207,111,150,11,0,50,218,5,26,19,36,31,55,133,272,3,943,52,0,2,2,1,0
39063,75,3937,1293,570,1093,25,15,163,1318,10,195,123,241,205,364,1516,2795,6,17273,959,0,2,2,1,0
39064,11,231,19,8,11,5,0,4,24,2,5,3,6,7,9,13,25,1,30,1,0,2,2,1,0
39065,11,231,102,59,69,5,3,24,107,6,22,15,28,28,43,113,206,3,789,43,0,2,2,1,0
39066,11,231,106,40,36,3,49,17,109,8,17,13,23,25,36,93,167,5,904,50,0,2,2,1,0
39067,219,4651,182,127,129,0,0,53,182,5,39,21,42,44,63,217,343,2,926,51,0,2,7,6,0
39068,219,4651,1165,710,800,67,119,181,1232,18,243,153,282,261,435,2000,3492,10,36473,2026,1,2,7,6,0
39069,67,1551,773,419,590,28,0,166,801,10,204,113,217,214,330,1598,2554,5,13587,754,0,2,2,1,0
39070,67,1551,421,273,302,44,34,57,465,17,81,59,107,98,166,583,1098,11,12329,684,0,2,2,1,0
39071,180,5401,1660,832,1314,41,38,274,1701,20,312,209,395,332,604,2671,5058,12,64042,3557,1,2,15,10,0
39072,180,5401,1057,646,719,113,100,145,1170,18,215,134,248,233,382,1740,3004,10,31186,1732,1,2,15,10,0
39073,160,3425,1513,682,1277,25,13,200,1538,11,199,116,219,210,335,1557,2584,6,15641,868,0,2,8,4,0
39074,160,3425,819,519,539,24,98,155,843,15,96,57,106,111,163,690,1107,8,9171,509,0,2,8,4,0
39075,57,1484,339,213,244,17,9,65,356,10,42,26,48,52,74,259,421,5,2410,133,0,2,1,1,0
39076,251,5824,4293,999,3693,19,54,507,4312,9,155,88,170,164,258,1156,1898,4,9368,520,0,2,9,3,0
39077,251,5824,1482,859,1002,125,135,219,1607,16,219,134,251,235,385,1766,3032,9,27804,1544,1,2,9,3,0
39078,24,600,2,2,2,0,0,0,2,0,0,0,0,0,0,0,0,0,0,0,0,2,2,1,0
39079,24,600,99,48,90,1,3,5,100,0,0,0,0,0,0,0,0,0,0,0,0,2,2,1,0
39080,24,600,8,5,5,2,0,1,10,0,0,0,0,0,0,0,0,0,0,0,0,2,2,1,0
39081,24,600,1217,716,841,84,126,174,1301,14,185,118,215,199,333,1446,2542,8,20687,1149,0,2,2,1,0
39082,24,600,160,89,115,0,13,31,160,7,15,11,17,22,28,78,124,3,495,27,0,2,2,1,0
39083,24,600,10,10,9,9,0,0,19,0,0,0,0,0,0,0,0,0,0,0,0,2,2,1,0
39084,24,600,173,84,99,8,29,36,181,5,12,7,13,17,20,54,81,2,221,12,0,2,2,1,0
39085,24,600,3,1,1,3,0,0,6,0,0,0,0,0,0,0,0,0,0,0,0,2,2,1,0
39086,71,1566,402,202,227,24,74,80,426,12,52,33,61,64,94,339,564,7,3969,220,0,2,2,1,0
39087,76,1623,53,23,39,0,0,13,53,2,8,4,8,10,12,26,39,1,39,2,0,2,2,1,0
39088,76,1623,515,298,307,33,80,99,548,12,63,44,77,75,121,419,753,7,5527,307,0,2,2,1,0
39089,17,467,205,80,86,16,53,53,221,7,18,10,19,25,29,94,134,3,497,27,0,2,8,4,0
39090,88,1786,757,253,292,73,244,162,830,13,61,38,67,74,105,409,651,7,4654,258,0,2,10,5,0
39091,67,1751,466,257,367,18,25,50,484,7,126,86,171,133,257,898,1813,4,8612,478,0,2,2,1,0
39092,67,1751,507,281,342,29,59,88,536,10,53,29,57,63,86,336,514,5,2764,153,0,2,2,1,0
39093,19,699,442,244,305,14,16,103,456,11,68,45,75,79,120,452,756,6,4588,254,0,2,4,1,0
39094,19,699,182,102,99,11,40,35,193,3,11,6,11,14,17,42,64,1,97,5,0,2,4,1,0
39095,150,7150,1392,870,1177,35,17,170,1427,14,494,280,531,508,811,4473,7289,7,54850,3047,2,2,2,1,0
39096,33,1013,256,139,192,9,7,47,265,4,23,12,24,27,36,112,171,2,357,19,0,2,2,1,0
39097,20,449,207,111,150,11,0,50,218,5,26,19,36,31,55,133,272,3,943,52,0,2,2,1,0
39098,75,3937,1293,570,1093,25,15,163,1318,10,195,123,241,205,364,1516,2795,6,17273,959,0,2,2,1,0
39099,18,486,205,80,86,16,53,53,221,7,18,10,19,25,29,94,134,3,497,27,0,2,7,4,1
39100,87,3393,1043,504,840,53,9,147,1096,9,180,112,198,189,310,1377,2344,4,11604,644,0,2,16,0,1
39101,79,3071,1178,367,1042,6,15,115,1184,9,94,51,95,103,146,644,976,4,4439,246,0,2,2,1,1
39102,59,1137,207,111,150,11,0,50,218,5,26,19,36,31,55,133,272,3,943,52,0,2,2,2,0
39103,59,1137,410,198,237,31,55,97,441,11,63,38,72,74,110,414,683,6,4293,238,0,2,2,2,0
39104,236,4867,2,2,2,0,0,0,2,0,0,0,0,0,0,0,0,0,0,0,0,2,15,10,0
39105,236,4867,99,48,90,1,3,5,100,0,0,0,0,0,0,0,0,0,0,0,0,2,15,10,0
39106,236,4867,8,5,5,2,0,1,10,0,0,0,0,0,0,0,0,0,0,0,0,2,15,10,0
39107,236,4867,1217,716,841,84,126,174,1301,14,185,118,215,199,333,1446,2542,8,20687,1149,0,2,15,10,0
39108,236,4867,160,89,115,0,13,31,160,7,15,11,17,22,28,78,124,3,495,27,0,2,15,10,0
39109,236,4867,10,10,9,9,0,0,19,0,0,0,0,0,0,0,0,0,0,0,0,2,15,10,0
39110,236,4867,173,84,99,8,29,36,181,5,12,7,13,17,20,54,81,2,221,12,0,2,15,10,0
39111,236,4867,3,1,1,3,0,0,6,0,0,0,0,0,0,0,0,0,0,0,0,2,15,10,0
39112,55,761,167,116,138,4,5,22,171,8,48,30,56,56,86,292,499,4,2330,129,0,2,3,4,0
39113,250,5797,4293,999,3693,19,54,507,4312,9,155,88,170,164,258,1156,1898,4,9368,520,0,2,13,14,0
39114,250,5797,1482,859,1002,125,135,219,1607,16,219,134,251,235,385,1766,3032,9,27804,1544,1,2,13,14,0
39115,54,640,647,139,84,35,284,233,682,0,0,0,0,0,0,0,0,0,0,0,0,2,0,22,0
39116,141,3466,77,34,69,0,0,8,77,3,24,16,29,27,45,114,213,1,387,21,0,2,0,22,0
39117,141,3466,712,438,573,51,9,84,763,14,102,71,128,116,199,733,1364,8,11988,666,0,2,0,22,0
39118,70,1522,402,202,227,24,74,80,426,12,52,33,61,64,94,339,564,7,3969,220,0,2,6,14,0
39119,314,6847,72,33,56,0,4,12,72,1,1,1,1,2,2,0,2,0,1,0,0,2,3,2,0
39120,314,6847,1454,835,1044,76,110,219,1530,17,275,158,296,292,454,2297,3718,9,34017,1889,1,2,3,2,0
39121,84,1649,757,253,292,73,244,162,830,13,61,38,67,74,105,409,651,7,4654,258,0,2,8,32,0
39122,37,680,386,256,301,16,9,68,402,4,59,35,69,63,104,355,621,2,1453,80,0,2,6,22,0
39123,37,680,264,131,164,11,41,46,275,6,38,22,40,44,62,214,338,3,1068,59,0,2,6,22,0
39124,18,638,442,244,305,14,16,103,456,11,68,45,75,79,120,452,756,6,4588,254,0,2,0,15,0
39125,18,638,182,102,99,11,40,35,193,3,11,6,11,14,17,42,64,1,97,5,0,2,0,15,0
39126,2,173,37,13,25,0,6,6,37,1,2,1,2,3,3,2,4,0,2,0,0,2,0,10,0
39127,2,173,133,47,40,1,43,49,134,0,0,0,0,0,0,0,0,0,0,0,0,2,0,10,0
39128,23,615,601,196,481,2,23,85,603,8,63,36,72,71,108,400,664,4,3036,168,0,2,0,5,0
39129,23,615,156,79,106,5,16,28,161,5,14,8,15,19,23,64,97,2,261,14,0,2,0,5,0
39130,106,4535,1289,550,1043,56,32,155,1345,10,167,93,185,177,278,1266,2075,5,11498,638,0,2,2,5,0
39131,4,178,75,38,59,1,3,12,76,2,4,2,4,6,6,10,15,1,15,0,0,2,0,173,0
39132,170,7527,4293,999,3693,19,54,507,4312,9,155,88,170,164,258,1156,1898,4,9368,520,0,2,28,47,0
39133,170,7527,1482,859,1002,125,135,219,1607,16,219,134,251,235,385,1766,3032,9,27804,1544,1,2,28,47,0
39134,145,5874,1782,648,1425,9,47,279,1791,8,171,97,189,179,286,1292,2140,4,9462,525,0,2,13,14,0
39135,29,865,256,139,192,9,7,47,265,4,23,12,24,27,36,112,171,2,357,19,0,2,8,34,0
39136,108,5769,1457,730,1242,11,6,188,1468,10,292,166,329,302,495,2424,4078,5,22973,1276,1,2,138,0,0
39137,69,3090,1020,354,843,12,15,144,1032,8,134,77,144,142,221,970,1580,4,6792,377,0,2,5,23,0
39138,55,2824,722,423,573,19,0,135,741,12,172,101,199,184,300,1320,2257,6,15668,870,0,2,1,2,0
39139,45,1930,386,256,301,16,9,68,402,4,59,35,69,63,104,355,621,2,1453,80,0,2,10,16,0
39140,34,1424,442,244,305,14,16,103,456,11,68,45,75,79,120,452,756,6,4588,254,0,2,4,11,0
39141,48,1651,601,196,481,2,23,85,603,8,63,36,72,71,108,400,664,4,3036,168,0,2,8,31,0
39142,18,486,205,80,86,16,53,53,221,7,18,10,19,25,29,94,134,3,497,27,0,2,7,4,0
39143,87,3393,1043,504,840,53,9,147,1096,9,180,112,198,189,310,1377,2344,4,11604,644,0,2,16,0,0
39144,79,3071,1178,367,1042,6,15,115,1184,9,94,51,95,103,146,644,976,4,4439,246,0,2,2,1,0
39145,238,4994,2,2,2,0,0,0,2,0,0,0,0,0,0,0,0,0,0,0,0,2,58,10,0
39146,238,4994,99,48,90,1,3,5,100,0,0,0,0,0,0,0,0,0,0,0,0,2,58,10,0
39147,238,4994,8,5,5,2,0,1,10,0,0,0,0,0,0,0,0,0,0,0,0,2,58,10,0
39148,238,4994,1217,716,841,84,126,174,1301,14,185,118,215,199,333,1446,2542,8,20687,1149,0,2,58,10,0
39149,238,4994,160,89,115,0,13,31,160,7,15,11,17,22,28,78,124,3,495,27,0,2,58,10,0
39150,238,4994,10,10,9,9,0,0,19,0,0,0,0,0,0,0,0,0,0,0,0,2,58,10,0
39151,238,4994,173,84,99,8,29,36,181,5,12,7,13,17,20,54,81,2,221,12,0,2,58,10,0
39152,238,4994,3,1,1,3,0,0,6,0,0,0,0,0,0,0,0,0,0,0,0,2,58,10,0
39153,109,5902,1457,730,1242,11,6,188,1468,10,292,166,329,302,495,2424,4078,5,22973,1276,1,2,24,0,0
39154,11,231,19,8,11,5,0,4,24,2,5,3,6,7,9,13,25,1,30,1,0,2,2,1,0
39155,11,231,102,59,69,5,3,24,107,6,22,15,28,28,43,113,206,3,789,43,0,2,2,1,0
39156,11,231,106,40,36,3,49,17,109,8,17,13,23,25,36,93,167,5,904,50,0,2,2,1,0
39157,219,4651,182,127,129,0,0,53,182,5,39,21,42,44,63,217,343,2,926,51,0,2,7,6,0
39158,219,4651,1165,710,800,67,119,181,1232,18,243,153,282,261,435,2000,3492,10,36473,2026,1,2,7,6,0
39159,67,1551,773,419,590,28,0,166,801,10,204,113,217,214,330,1598,2554,5,13587,754,0,2,2,1,0
39160,67,1551,421,273,302,44,34,57,465,17,81,59,107,98,166,583,1098,11,12329,684,0,2,2,1,0
39161,180,5401,1660,832,1314,41,38,274,1701,20,312,209,395,332,604,2671,5058,12,64042,3557,1,2,15,10,0
39162,180,5401,1057,646,719,113,100,145,1170,18,215,134,248,233,382,1740,3004,10,31186,1732,1,2,15,10,0
39163,160,3425,1513,682,1277,25,13,200,1538,11,199,116,219,210,335,1557,2584,6,15641,868,0,2,8,4,0
39164,160,3425,819,519,539,24,98,155,843,15,96,57,106,111,163,690,1107,8,9171,509,0,2,8,4,0
39165,57,1484,339,213,244,17,9,65,356,10,42,26,48,52,74,259,421,5,2410,133,0,2,1,1,0
39166,251,5824,4293,999,3693,19,54,507,4312,9,155,88,170,164,258,1156,1898,4,9368,520,0,2,9,3,0
39167,251,5824,1482,859,1002,125,135,219,1607,16,219,134,251,235,385,1766,3032,9,27804,1544,1,2,9,3,0
39168,24,600,2,2,2,0,0,0,2,0,0,0,0,0,0,0,0,0,0,0,0,2,2,1,0
39169,24,600,99,48,90,1,3,5,100,0,0,0,0,0,0,0,0,0,0,0,0,2,2,1,0
39170,24,600,8,5,5,2,0,1,10,0,0,0,0,0,0,0,0,0,0,0,0,2,2,1,0
39171,24,600,1217,716,841,84,126,174,1301,14,185,118,215,199,333,1446,2542,8,20687,1149,0,2,2,1,0
39172,24,600,160,89,115,0,13,31,160,7,15,11,17,22,28,78,124,3,495,27,0,2,2,1,0
39173,24,600,10,10,9,9,0,0,19,0,0,0,0,0,0,0,0,0,0,0,0,2,2,1,0
39174,24,600,173,84,99,8,29,36,181,5,12,7,13,17,20,54,81,2,221,12,0,2,2,1,0
39175,24,600,3,1,1,3,0,0,6,0,0,0,0,0,0,0,0,0,0,0,0,2,2,1,0
39176,71,1566,402,202,227,24,74,80,426,12,52,33,61,64,94,339,564,7,3969,220,0,2,2,1,0
39177,76,1623,53,23,39,0,0,13,53,2,8,4,8,10,12,26,39,1,39,2,0,2,2,1,0
39178,76,1623,515,298,307,33,80,99,548,12,63,44,77,75,121,419,753,7,5527,307,0,2,2,1,0
39179,18,486,205,80,86,16,53,53,221,7,18,10,19,25,29,94,134,3,497,27,0,2,8,4,0
39180,88,1786,757,253,292,73,244,162,830,13,61,38,67,74,105,409,651,7,4654,258,0,2,10,5,0
39181,67,1751,466,257,367,18,25,50,484,7,126,86,171,133,257,898,1813,4,8612,478,0,2,2,1,0
39182,67,1751,507,281,342,29,59,88,536,10,53,29,57,63,86,336,514,5,2764,153,0,2,2,1,0
39183,19,699,442,244,305,14,16,103,456,11,68,45,75,79,120,452,756,6,4588,254,0,2,4,1,0
39184,19,699,182,102,99,11,40,35,193,3,11,6,11,14,17,42,64,1,97,5,0,2,4,1,0
39185,150,7150,1392,870,1177,35,17,170,1427,14,494,280,531,508,811,4473,7289,7,54850,3047,2,2,2,1,0
39186,33,1013,256,139,192,9,7,47,265,4,23,12,24,27,36,112,171,2,357,19,0,2,2,1,0
39187,20,449,207,111,150,11,0,50,218,5,26,19,36,31,55,133,272,3,943,52,0,2,2,1,0
39188,75,3937,1293,570,1093,25,15,163,1318,10,195,123,241,205,364,1516,2795,6,17273,959,0,2,2,1,0
39189,84,1646,757,253,292,73,244,162,830,13,61,38,67,74,105,409,651,7,4654,258,0,2,1,4,0
39190,37,680,386,256,301,16,9,68,402,4,59,35,69,63,104,355,621,2,1453,80,0,2,1,1,0
39191,37,680,264,131,164,11,41,46,275,6,38,22,40,44,62,214,338,3,1068,59,0,2,1,1,0
39192,81,3712,1455,414,1257,16,76,112,1471,5,41,23,46,46,69,231,381,2,1069,59,0,2,4,2,0
39193,81,3729,1455,414,1257,16,76,112,1471,5,41,23,46,46,69,231,381,2,1069,59,0,2,3,0,0
39194,101,2578,1455,414,1257,16,76,112,1471,5,41,23,46,46,69,231,381,2,1069,59,0,2,91,24,0
39195,101,2578,669,365,481,22,61,110,691,15,103,63,122,118,185,747,1273,8,11311,628,0,2,91,24,0
39196,81,3729,1455,414,1257,16,76,112,1471,5,41,23,46,46,69,231,381,2,1069,59,0,2,149,0,0
39197,90,2013,996,429,845,24,10,117,1020,7,76,50,88,83,138,494,879,4,3565,198,0,2,2,2,0
39198,90,2013,456,277,329,12,42,72,468,13,85,50,97,98,147,592,972,7,7212,400,0,2,2,2,0
39199,64,1298,91,45,69,0,3,18,91,3,9,6,10,12,16,33,57,1,95,5,0,2,36,9,0
39200,64,1298,367,234,237,17,34,68,384,16,55,34,61,71,95,381,584,8,5183,287,0,2,36,9,0
39201,38,1654,442,244,305,14,16,103,456,11,68,45,75,79,120,452,756,6,4588,254,0,2,57,3,0
39202,90,2013,996,429,845,24,10,117,1020,7,76,50,88,83,138,494,879,4,3565,198,0,2,2,2,0
39203,90,2013,456,277,329,12,42,72,468,13,85,50,97,98,147,592,972,7,7212,400,0,2,2,2,0
39204,64,1298,91,45,69,0,3,18,91,3,9,6,10,12,16,33,57,1,95,5,0,2,36,9,0
39205,64,1298,367,234,237,17,34,68,384,16,55,34,61,71,95,381,584,8,5183,287,0,2,36,9,0
39206,38,1654,442,244,305,14,16,103,456,11,68,45,75,79,120,452,756,6,4588,254,0,2,57,3,0
39207,12,177,424,94,331,4,0,89,428,1,5,5,5,6,10,11,25,0,12,0,0,2,0,25,0
39208,12,177,38,23,23,6,0,8,44,3,11,7,11,14,18,42,68,1,102,5,0,2,0,25,0
39209,90,1912,1043,504,840,53,9,147,1096,9,180,112,198,189,310,1377,2344,4,11604,644,0,2,5,4,0
39210,90,1912,383,288,292,26,6,62,409,11,65,38,67,76,105,429,656,5,3719,206,0,2,5,4,0
39211,68,1337,1098,241,925,5,10,155,1103,7,46,25,49,53,74,273,423,3,1580,87,0,2,9,0,0
39212,68,1337,282,202,222,14,2,44,296,8,42,24,43,50,67,250,378,4,1548,86,0,2,9,0,0
39213,49,1966,1098,241,925,5,10,155,1103,7,46,25,49,53,74,273,423,3,1580,87,0,2,1,3,0
39214,64,1298,91,45,69,0,3,18,91,3,9,6,10,12,16,33,57,1,95,5,0,2,2,2,0
39215,64,1298,367,234,237,17,34,68,384,16,55,34,61,71,95,381,584,8,5183,287,0,2,2,2,0
39216,313,6823,72,33,56,0,4,12,72,1,1,1,1,2,2,0,2,0,1,0,0,2,0,3,0
39217,313,6823,1454,835,1044,76,110,219,1530,17,275,158,296,292,454,2297,3718,9,34017,1889,1,2,0,3,0
39218,313,6817,72,33,56,0,4,12,72,1,1,1,1,2,2,0,2,0,1,0,0,2,5,8,0
39219,313,6817,1454,835,1044,76,110,219,1530,17,275,158,296,292,454,2297,3718,9,34017,1889,1,2,5,8,0
39220,64,1298,91,45,69,0,3,18,91,3,9,6,10,12,16,33,57,1,95,5,0,2,2,2,0
39221,64,1298,367,234,237,17,34,68,384,16,55,34,61,71,95,381,584,8,5183,287,0,2,2,2,0
39222,12,177,424,94,331,4,0,89,428,1,5,5,5,6,10,11,25,0,12,0,0,2,0,25,0
39223,12,177,38,23,23,6,0,8,44,3,11,7,11,14,18,42,68,1,102,5,0,2,0,25,0
39224,90,1912,1043,504,840,53,9,147,1096,9,180,112,198,189,310,1377,2344,4,11604,644,0,2,5,4,0
39225,90,1912,383,288,292,26,6,62,409,11,65,38,67,76,105,429,656,5,3719,206,0,2,5,4,0
39226,68,1337,1098,241,925,5,10,155,1103,7,46,25,49,53,74,273,423,3,1580,87,0,2,9,0,0
39227,68,1337,282,202,222,14,2,44,296,8,42,24,43,50,67,250,378,4,1548,86,0,2,9,0,0
39228,49,1966,1098,241,925,5,10,155,1103,7,46,25,49,53,74,273,423,3,1580,87,0,2,1,3,0
39229,312,6802,72,33,56,0,4,12,72,1,1,1,1,2,2,0,2,0,1,0,0,2,2,6,0
39230,312,6802,1454,835,1044,76,110,219,1530,17,275,158,296,292,454,2297,3718,9,34017,1889,1,2,2,6,0
39231,307,6733,72,33,56,0,4,12,72,1,1,1,1,2,2,0,2,0,1,0,0,2,0,21,0
39232,307,6733,1454,835,1044,76,110,219,1530,17,275,158,296,292,454,2297,3718,9,34017,1889,1,2,0,21,0
39233,117,3137,1523,757,1297,19,12,193,1542,12,193,117,230,205,347,1508,2664,7,19053,1058,0,2,10,11,0
39234,117,3137,701,378,504,33,58,109,734,13,110,68,126,123,194,794,1346,7,10027,557,0,2,10,11,0
39235,111,5221,1523,757,1297,19,12,193,1542,12,193,117,230,205,347,1508,2664,7,19053,1058,0,2,27,3,0
39236,307,6751,72,33,56,0,4,12,72,1,1,1,1,2,2,0,2,0,1,0,0,2,13,8,0
39237,307,6751,1454,835,1044,76,110,219,1530,17,275,158,296,292,454,2297,3718,9,34017,1889,1,2,13,8,0
39238,147,5933,1782,648,1425,9,47,279,1791,8,171,97,189,179,286,1292,2140,4,9462,525,0,2,11,0,0
39239,305,6729,72,33,56,0,4,12,72,1,1,1,1,2,2,0,2,0,1,0,0,2,23,21,0
39240,305,6729,1454,835,1044,76,110,219,1530,17,275,158,296,292,454,2297,3718,9,34017,1889,1,2,23,21,0
39241,7,140,38,22,22,1,0,15,39,1,2,1,2,3,3,2,4,0,2,0,0,0,38,0,1
39242,7,140,38,22,22,1,0,15,39,1,2,1,2,3,3,2,4,0,2,0,0,0,38,0,0
39243,85,1664,757,253,292,73,244,162,830,13,61,38,67,74,105,409,651,7,4654,258,0,2,6,3,1
39244,38,702,386,256,301,16,9,68,402,4,59,35,69,63,104,355,621,2,1453,80,0,2,6,1,1
39245,38,702,264,131,164,11,41,46,275,6,38,22,40,44,62,214,338,3,1068,59,0,2,6,1,1
39246,30,903,256,139,192,9,7,47,265,4,23,12,24,27,36,112,171,2,357,19,0,2,6,0,1
39247,46,1968,386,256,301,16,9,68,402,4,59,35,69,63,104,355,621,2,1453,80,0,2,6,0,1
39248,11,553,205,80,86,16,53,53,221,7,18,10,19,25,29,94,134,3,497,27,0,2,23,9,0
39249,20,993,386,256,301,16,9,68,402,4,59,35,69,63,104,355,621,2,1453,80,0,2,87,23,1
39250,20,993,264,131,164,11,41,46,275,6,38,22,40,44,62,214,338,3,1068,59,0,2,87,23,1
39251,219,4842,182,127,129,0,0,53,182,5,39,21,42,44,63,217,343,2,926,51,0,2,50,25,1
39252,219,4842,1165,710,800,67,119,181,1232,18,243,153,282,261,435,2000,3492,10,36473,2026,1,2,50,25,1
39253,79,1897,757,253,292,73,244,162,830,13,61,38,67,74,105,409,651,7,4654,258,0,2,56,7,1
39254,214,4866,182,127,129,0,0,53,182,5,39,21,42,44,63,217,343,2,926,51,0,2,13,8,0
39255,214,4866,1165,710,800,67,119,181,1232,18,243,153,282,261,435,2000,3492,10,36473,2026,1,2,13,8,0
39256,79,1947,757,253,292,73,244,162,830,13,61,38,67,74,105,409,651,7,4654,258,0,2,20,13,0
39257,215,4899,182,127,129,0,0,53,182,5,39,21,42,44,63,217,343,2,926,51,0,2,5,0,0
39258,215,4899,1165,710,800,67,119,181,1232,18,243,153,282,261,435,2000,3492,10,36473,2026,1,2,5,0,0
39259,79,1959,757,253,292,73,244,162,830,13,61,38,67,74,105,409,651,7,4654,258,0,2,9,5,0
39260,216,4938,182,127,129,0,0,53,182,5,39,21,42,44,63,217,343,2,926,51,0,2,32,13,0
39261,216,4938,1165,710,800,67,119,181,1232,18,243,153,282,261,435,2000,3492,10,36473,2026,1,2,32,13,0
39262,79,1967,757,253,292,73,244,162,830,13,61,38,67,74,105,409,651,7,4654,258,0,2,5,5,0
39263,152,7195,1392,870,1177,35,17,170,1427,14,494,280,531,508,811,4473,7289,7,54850,3047,2,2,9,1,0
39264,9,261,149,95,105,2,0,41,151,8,54,28,55,62,83,334,494,4,2013,111,0,2,0,18,0
39265,9,261,82,56,54,0,13,15,82,4,13,8,16,17,24,56,98,2,241,13,0,2,0,18,0
39266,10,274,149,95,105,2,0,41,151,8,54,28,55,62,83,334,494,4,2013,111,0,2,7,6,0
39267,10,274,82,56,54,0,13,15,82,4,13,8,16,17,24,56,98,2,241,13,0,2,7,6,0
39268,12,315,149,95,105,2,0,41,151,8,54,28,55,62,83,334,494,4,2013,111,0,2,1,1,0
39269,10,269,149,95,105,2,0,41,151,8,54,28,55,62,83,334,494,4,2013,111,0,2,0,1,0
39270,10,269,82,56,54,0,13,15,82,4,13,8,16,17,24,56,98,2,241,13,0,2,0,1,0
39271,305,6729,72,33,56,0,4,12,72,1,1,1,1,2,2,0,2,0,1,0,0,2,43,67,0
39272,305,6729,1454,835,1044,76,110,219,1530,17,275,158,296,292,454,2297,3718,9,34017,1889,1,2,43,67,0
39273,147,5933,1782,648,1425,9,47,279,1791,8,171,97,189,179,286,1292,2140,4,9462,525,0,2,11,0,0
39274,12,280,149,95,105,2,0,41,151,8,54,28,55,62,83,334,494,4,2013,111,0,2,30,23,0
39275,12,280,82,56,54,0,13,15,82,4,13,8,16,17,24,56,98,2,241,13,0,2,30,23,0
39276,14,343,149,95,105,2,0,41,151,8,54,28,55,62,83,334,494,4,2013,111,0,2,11,0,0
39277,71,1566,402,202,227,24,74,80,426,12,52,33,61,64,94,339,564,7,3969,220,0,2,12,11,0
39278,88,1786,757,253,292,73,244,162,830,13,61,38,67,74,105,409,651,7,4654,258,0,2,1,1,0
39279,33,966,465,148,393,5,8,60,470,4,31,20,31,35,51,161,261,2,523,29,0,2,0,3,0
39280,33,966,16,12,9,0,0,6,16,1,2,1,2,3,3,2,4,0,2,0,0,2,0,3,0
39281,32,954,465,148,393,5,8,60,470,4,31,20,31,35,51,161,261,2,523,29,0,2,5,11,0
39282,32,954,16,12,9,0,0,6,16,1,2,1,2,3,3,2,4,0,2,0,0,2,5,11,0
39283,32,954,465,148,393,5,8,60,470,4,31,20,31,35,51,161,261,2,523,29,0,2,5,14,0
39284,32,954,16,12,9,0,0,6,16,1,2,1,2,3,3,2,4,0,2,0,0,2,5,14,0
39285,12,280,149,95,105,2,0,41,151,8,54,28,55,62,83,334,494,4,2013,111,0,2,36,47,0
39286,12,280,82,56,54,0,13,15,82,4,13,8,16,17,24,56,98,2,241,13,0,2,36,47,0
39287,14,343,149,95,105,2,0,41,151,8,54,28,55,62,83,334,494,4,2013,111,0,2,12,1,0
39288,216,4938,182,127,129,0,0,53,182,5,39,21,42,44,63,217,343,2,926,51,0,2,85,31,0
39289,216,4938,1165,710,800,67,119,181,1232,18,243,153,282,261,435,2000,3492,10,36473,2026,1,2,85,31,0
39290,11,553,205,80,86,16,53,53,221,7,18,10,19,25,29,94,134,3,497,27,0,2,23,9,0
39291,79,1967,757,253,292,73,244,162,830,13,61,38,67,74,105,409,651,7,4654,258,0,2,80,20,0
39292,20,993,386,256,301,16,9,68,402,4,59,35,69,63,104,355,621,2,1453,80,0,2,94,25,0
39293,20,993,264,131,164,11,41,46,275,6,38,22,40,44,62,214,338,3,1068,59,0,2,94,25,0
39294,152,7195,1392,870,1177,35,17,170,1427,14,494,280,531,508,811,4473,7289,7,54850,3047,2,2,9,1,0
39295,30,903,256,139,192,9,7,47,265,4,23,12,24,27,36,112,171,2,357,19,0,2,6,0,0
39296,46,1968,386,256,301,16,9,68,402,4,59,35,69,63,104,355,621,2,1453,80,0,2,6,0,0
39297,71,1566,402,202,227,24,74,80,426,12,52,33,61,64,94,339,564,7,3969,220,0,2,12,11,0
39298,88,1786,757,253,292,73,244,162,830,13,61,38,67,74,105,409,651,7,4654,258,0,2,1,1,0
39299,216,4948,182,127,129,0,0,53,182,5,39,21,42,44,63,217,343,2,926,51,0,2,3,1,0
39300,216,4948,1165,710,800,67,119,181,1232,18,243,153,282,261,435,2000,3492,10,36473,2026,1,2,3,1,0
39301,11,562,205,80,86,16,53,53,221,7,18,10,19,25,29,94,134,3,497,27,0,2,4,1,1
39302,304,6724,72,33,56,0,4,12,72,1,1,1,1,2,2,0,2,0,1,0,0,2,1,1,0
39303,304,6724,1454,835,1044,76,110,219,1530,17,275,158,296,292,454,2297,3718,9,34017,1889,1,2,1,1,0
39304,87,1891,1043,504,840,53,9,147,1096,9,180,112,198,189,310,1377,2344,4,11604,644,0,2,3,9,0
39305,87,1891,383,288,292,26,6,62,409,11,65,38,67,76,105,429,656,5,3719,206,0,2,3,9,0
39306,10,530,205,80,86,16,53,53,221,7,18,10,19,25,29,94,134,3,497,27,0,2,2,8,0
39307,102,2603,1455,414,1257,16,76,112,1471,5,41,23,46,46,69,231,381,2,1069,59,0,2,4,0,1
39308,102,2603,669,365,481,22,61,110,691,15,103,63,122,118,185,747,1273,8,11311,628,0,2,4,0,1
39309,76,4016,1293,570,1093,25,15,163,1318,10,195,123,241,205,364,1516,2795,6,17273,959,0,2,23,1,1
39310,216,4948,182,127,129,0,0,53,182,5,39,21,42,44,63,217,343,2,926,51,0,2,3,1,0
39311,216,4948,1165,710,800,67,119,181,1232,18,243,153,282,261,435,2000,3492,10,36473,2026,1,2,3,1,0
39312,10,530,205,80,86,16,53,53,221,7,18,10,19,25,29,94,134,3,497,27,0,2,1,4,0
39313,304,6724,72,33,56,0,4,12,72,1,1,1,1,2,2,0,2,0,1,0,0,2,1,1,0
39314,304,6724,1454,835,1044,76,110,219,1530,17,275,158,296,292,454,2297,3718,9,34017,1889,1,2,1,1,0
39315,87,1891,1043,504,840,53,9,147,1096,9,180,112,198,189,310,1377,2344,4,11604,644,0,2,3,9,0
39316,87,1891,383,288,292,26,6,62,409,11,65,38,67,76,105,429,656,5,3719,206,0,2,3,9,0
39317,67,1304,1098,241,925,5,10,155,1103,7,46,25,49,53,74,273,423,3,1580,87,0,2,6,0,0
39318,67,1304,282,202,222,14,2,44,296,8,42,24,43,50,67,250,378,4,1548,86,0,2,6,0,0
39319,51,2027,1098,241,925,5,10,155,1103,7,46,25,49,53,74,273,423,3,1580,87,0,2,36,0,0
39320,55,2829,722,423,573,19,0,135,741,12,172,101,199,184,300,1320,2257,6,15668,870,0,2,1,1,0
39321,33,992,465,148,393,5,8,60,470,4,31,20,31,35,51,161,261,2,523,29,0,2,28,0,0
39322,33,992,16,12,9,0,0,6,16,1,2,1,2,3,3,2,4,0,2,0,0,2,28,0,0
39323,56,1107,207,111,150,11,0,50,218,5,26,19,36,31,55,133,272,3,943,52,0,2,12,7,0
39324,56,1107,410,198,237,31,55,97,441,11,63,38,72,74,110,414,683,6,4293,238,0,2,12,7,0
39325,55,2829,722,423,573,19,0,135,741,12,172,101,199,184,300,1320,2257,6,15668,870,0,2,1,1,0
39326,238,4997,2,2,2,0,0,0,2,0,0,0,0,0,0,0,0,0,0,0,0,2,3,3,0
39327,238,4997,99,48,90,1,3,5,100,0,0,0,0,0,0,0,0,0,0,0,0,2,3,3,0
39328,238,4997,8,5,5,2,0,1,10,0,0,0,0,0,0,0,0,0,0,0,0,2,3,3,0
39329,238,4997,1217,716,841,84,126,174,1301,14,185,118,215,199,333,1446,2542,8,20687,1149,0,2,3,3,0
39330,238,4997,160,89,115,0,13,31,160,7,15,11,17,22,28,78,124,3,495,27,0,2,3,3,0
39331,238,4997,10,10,9,9,0,0,19,0,0,0,0,0,0,0,0,0,0,0,0,2,3,3,0
39332,238,4997,173,84,99,8,29,36,181,5,12,7,13,17,20,54,81,2,221,12,0,2,3,3,0
39333,238,4997,3,1,1,3,0,0,6,0,0,0,0,0,0,0,0,0,0,0,0,2,3,3,0
39334,31,1080,74,35,59,1,0,14,75,3,14,7,14,17,21,58,85,1,128,7,0,2,1,1,0
39335,31,1080,245,125,200,5,7,34,250,7,30,17,34,37,51,166,265,3,1053,58,0,2,1,1,0
39336,109,5904,1457,730,1242,11,6,188,1468,10,292,166,329,302,495,2424,4078,5,22973,1276,1,2,2,2,0
39337,71,1566,402,202,227,24,74,80,426,12,52,33,61,64,94,339,564,7,3969,220,0,2,1,3,0
39338,56,1107,207,111,150,11,0,50,218,5,26,19,36,31,55,133,272,3,943,52,0,2,12,7,0
39339,56,1107,410,198,237,31,55,97,441,11,63,38,72,74,110,414,683,6,4293,238,0,2,12,7,0
39340,33,992,465,148,393,5,8,60,470,4,31,20,31,35,51,161,261,2,523,29,0,2,28,0,0
39341,33,992,16,12,9,0,0,6,16,1,2,1,2,3,3,2,4,0,2,0,0,2,28,0,0
39342,51,2030,1098,241,925,5,10,155,1103,7,46,25,49,53,74,273,423,3,1580,87,0,2,3,3,1
39343,67,1304,1098,241,925,5,10,155,1103,7,46,25,49,53,74,273,423,3,1580,87,0,2,6,0,0
39344,67,1304,282,202,222,14,2,44,296,8,42,24,43,50,67,250,378,4,1548,86,0,2,6,0,0
39345,51,2030,1098,241,925,5,10,155,1103,7,46,25,49,53,74,273,423,3,1580,87,0,2,36,0,0
39346,56,789,167,116,138,4,5,22,171,8,48,30,56,56,86,292,499,4,2330,129,0,2,5,1,0
39347,103,5325,1457,730,1242,11,6,188,1468,10,292,166,329,302,495,2424,4078,5,22973,1276,1,2,8,0,0
39348,103,5325,1457,730,1242,11,6,188,1468,10,292,166,329,302,495,2424,4078,5,22973,1276,1,2,2,4,0
39349,238,4997,2,2,2,0,0,0,2,0,0,0,0,0,0,0,0,0,0,0,0,2,3,3,0
39350,238,4997,99,48,90,1,3,5,100,0,0,0,0,0,0,0,0,0,0,0,0,2,3,3,0
39351,238,4997,8,5,5,2,0,1,10,0,0,0,0,0,0,0,0,0,0,0,0,2,3,3,0
39352,238,4997,1217,716,841,84,126,174,1301,14,185,118,215,199,333,1446,2542,8,20687,1149,0,2,3,3,0
39353,238,4997,160,89,115,0,13,31,160,7,15,11,17,22,28,78,124,3,495,27,0,2,3,3,0
39354,238,4997,10,10,9,9,0,0,19,0,0,0,0,0,0,0,0,0,0,0,0,2,3,3,0
39355,238,4997,173,84,99,8,29,36,181,5,12,7,13,17,20,54,81,2,221,12,0,2,3,3,0
39356,238,4997,3,1,1,3,0,0,6,0,0,0,0,0,0,0,0,0,0,0,0,2,3,3,0
39357,31,1080,74,35,59,1,0,14,75,3,14,7,14,17,21,58,85,1,128,7,0,2,1,1,0
39358,31,1080,245,125,200,5,7,34,250,7,30,17,34,37,51,166,265,3,1053,58,0,2,1,1,0
39359,109,5904,1457,730,1242,11,6,188,1468,10,292,166,329,302,495,2424,4078,5,22973,1276,1,2,2,2,0
39360,56,789,167,116,138,4,5,22,171,8,48,30,56,56,86,292,499,4,2330,129,0,2,5,1,0
39361,103,5325,1457,730,1242,11,6,188,1468,10,292,166,329,302,495,2424,4078,5,22973,1276,1,2,6,0,0
39362,51,2034,1098,241,925,5,10,155,1103,7,46,25,49,53,74,273,423,3,1580,87,0,2,1,1,0
39363,51,2034,1098,241,925,5,10,155,1103,7,46,25,49,53,74,273,423,3,1580,87,0,2,1,1,0
39364,71,1566,402,202,227,24,74,80,426,12,52,33,61,64,94,339,564,7,3969,220,0,2,1,3,0
39365,56,1107,207,111,150,11,0,50,218,5,26,19,36,31,55,133,272,3,943,52,0,2,12,7,0
39366,56,1107,410,198,237,31,55,97,441,11,63,38,72,74,110,414,683,6,4293,238,0,2,12,7,0
39367,56,789,167,116,138,4,5,22,171,8,48,30,56,56,86,292,499,4,2330,129,0,2,5,1,0
39368,71,1566,402,202,227,24,74,80,426,12,52,33,61,64,94,339,564,7,3969,220,0,2,13,14,0
39369,88,1786,757,253,292,73,244,162,830,13,61,38,67,74,105,409,651,7,4654,258,0,2,1,1,0
39370,67,1304,1098,241,925,5,10,155,1103,7,46,25,49,53,74,273,423,3,1580,87,0,2,6,0,0
39371,67,1304,282,202,222,14,2,44,296,8,42,24,43,50,67,250,378,4,1548,86,0,2,6,0,0
39372,33,992,465,148,393,5,8,60,470,4,31,20,31,35,51,161,261,2,523,29,0,2,33,14,0
39373,33,992,16,12,9,0,0,6,16,1,2,1,2,3,3,2,4,0,2,0,0,2,33,14,0
39374,103,5325,1457,730,1242,11,6,188,1468,10,292,166,329,302,495,2424,4078,5,22973,1276,1,2,6,0,0
39375,55,2829,722,423,573,19,0,135,741,12,172,101,199,184,300,1320,2257,6,15668,870,0,2,1,1,0
39376,51,2034,1098,241,925,5,10,155,1103,7,46,25,49,53,74,273,423,3,1580,87,0,2,36,0,0
39377,12,645,219,78,157,11,5,46,230,3,24,20,34,27,54,114,256,2,545,30,0,2,2,1,1
39378,12,645,219,78,157,11,5,46,230,3,24,20,34,27,54,114,256,2,545,30,0,2,2,1,0
39379,280,5856,1943,715,1694,26,18,214,1969,12,185,120,237,197,357,1436,2721,7,20915,1161,0,2,1,1,0
39380,280,5856,1168,838,957,57,25,144,1225,19,348,224,416,367,640,3018,5452,11,61921,3440,1,2,1,1,0
39381,280,5856,1943,715,1694,26,18,214,1969,12,185,120,237,197,357,1436,2721,7,20915,1161,0,2,2,2,0
39382,280,5856,1168,838,957,57,25,144,1225,19,348,224,416,367,640,3018,5452,11,61921,3440,1,2,2,2,0
39383,111,6050,1943,715,1694,26,18,214,1969,12,185,120,237,197,357,1436,2721,7,20915,1161,0,2,1,1,0
39384,150,7150,1392,870,1177,35,17,170,1427,14,494,280,531,508,811,4473,7289,7,54850,3047,2,2,1,1,0
39385,107,5128,1523,757,1297,19,12,193,1542,12,193,117,230,205,347,1508,2664,7,19053,1058,0,2,1,1,0
39386,107,5128,1523,757,1297,19,12,193,1542,12,193,117,230,205,347,1508,2664,7,19053,1058,0,2,1,1,0
39387,70,3179,1020,354,843,12,15,144,1032,8,134,77,144,142,221,970,1580,4,6792,377,0,2,1,1,0
39388,21,637,424,94,331,4,0,89,428,1,5,5,5,6,10,11,25,0,12,0,0,2,1,1,0
39389,113,2243,463,295,324,28,62,57,491,12,134,82,154,146,236,989,1696,6,11700,650,0,2,1,1,0
39390,280,5856,1943,715,1694,26,18,214,1969,12,185,120,237,197,357,1436,2721,7,20915,1161,0,2,1,1,0
39391,280,5856,1168,838,957,57,25,144,1225,19,348,224,416,367,640,3018,5452,11,61921,3440,1,2,1,1,0
39392,111,6050,1943,715,1694,26,18,214,1969,12,185,120,237,197,357,1436,2721,7,20915,1161,0,2,1,1,0
39393,113,2243,463,295,324,28,62,57,491,12,134,82,154,146,236,989,1696,6,11700,650,0,2,1,1,0
39394,150,7150,1392,870,1177,35,17,170,1427,14,494,280,531,508,811,4473,7289,7,54850,3047,2,2,1,1,0
39395,107,5128,1523,757,1297,19,12,193,1542,12,193,117,230,205,347,1508,2664,7,19053,1058,0,2,2,2,0
39396,70,3179,1020,354,843,12,15,144,1032,8,134,77,144,142,221,970,1580,4,6792,377,0,2,1,1,0
39397,21,637,424,94,331,4,0,89,428,1,5,5,5,6,10,11,25,0,12,0,0,2,1,1,0
39398,76,1637,53,23,39,0,0,13,53,2,8,4,8,10,12,26,39,1,39,2,0,2,5,2,0
39399,76,1637,515,298,307,33,80,99,548,12,63,44,77,75,121,419,753,7,5527,307,0,2,5,2,0
39400,76,1637,53,23,39,0,0,13,53,2,8,4,8,10,12,26,39,1,39,2,0,2,5,2,0
39401,76,1637,515,298,307,33,80,99,548,12,63,44,77,75,121,419,753,7,5527,307,0,2,5,2,0
39402,65,1368,91,45,69,0,3,18,91,3,9,6,10,12,16,33,57,1,95,5,0,2,38,26,0
39403,65,1368,367,234,237,17,34,68,384,16,55,34,61,71,95,381,584,8,5183,287,0,2,38,26,0
39404,40,1809,442,244,305,14,16,103,456,11,68,45,75,79,120,452,756,6,4588,254,0,2,46,16,0
39405,65,1368,91,45,69,0,3,18,91,3,9,6,10,12,16,33,57,1,95,5,0,2,38,26,0
39406,65,1368,367,234,237,17,34,68,384,16,55,34,61,71,95,381,584,8,5183,287,0,2,38,26,0
39407,40,1809,442,244,305,14,16,103,456,11,68,45,75,79,120,452,756,6,4588,254,0,2,46,16,0
39408,1,300,382,65,130,157,2,92,539,4,10,5,10,14,15,41,57,2,114,6,0,2,3,5,0
39409,7,140,38,22,22,1,0,15,39,1,2,1,2,3,3,2,4,0,2,0,0,0,38,0,0
39410,90,2013,996,429,845,24,10,117,1020,7,76,50,88,83,138,494,879,4,3565,198,0,2,2,2,0
39411,90,2013,456,277,329,12,42,72,468,13,85,50,97,98,147,592,972,7,7212,400,0,2,2,2,0
39412,57,1135,207,111,150,11,0,50,218,5,26,19,36,31,55,133,272,3,943,52,0,2,12,7,0
39413,57,1135,410,198,237,31,55,97,441,11,63,38,72,74,110,414,683,6,4293,238,0,2,12,7,0
39414,113,2243,463,295,324,28,62,57,491,12,134,82,154,146,236,989,1696,6,11700,650,0,2,1,1,0
39415,56,780,167,116,138,4,5,22,171,8,48,30,56,56,86,292,499,4,2330,129,0,2,5,1,0
39416,70,1522,402,202,227,24,74,80,426,12,52,33,61,64,94,339,564,7,3969,220,0,2,13,14,0
39417,76,1637,53,23,39,0,0,13,53,2,8,4,8,10,12,26,39,1,39,2,0,2,5,2,0
39418,76,1637,515,298,307,33,80,99,548,12,63,44,77,75,121,419,753,7,5527,307,0,2,5,2,0
39419,12,572,205,80,86,16,53,53,221,7,18,10,19,25,29,94,134,3,497,27,0,2,6,0,0
39420,65,1368,91,45,69,0,3,18,91,3,9,6,10,12,16,33,57,1,95,5,0,2,50,11,0
39421,65,1368,367,234,237,17,34,68,384,16,55,34,61,71,95,381,584,8,5183,287,0,2,50,11,0
39422,79,1967,757,253,292,73,244,162,830,13,61,38,67,74,105,409,651,7,4654,258,0,2,1,1,0
39423,25,429,219,78,157,11,5,46,230,3,24,20,34,27,54,114,256,2,545,30,0,2,0,1,0
39424,25,429,108,64,79,9,0,20,117,5,15,11,19,20,30,70,129,3,410,22,0,2,0,1,0
39425,280,5856,1943,715,1694,26,18,214,1969,12,185,120,237,197,357,1436,2721,7,20915,1161,0,2,1,1,0
39426,280,5856,1168,838,957,57,25,144,1225,19,348,224,416,367,640,3018,5452,11,61921,3440,1,2,1,1,0
39427,70,1371,1098,241,925,5,10,155,1103,7,46,25,49,53,74,273,423,3,1580,87,0,2,6,0,0
39428,70,1371,282,202,222,14,2,44,296,8,42,24,43,50,67,250,378,4,1548,86,0,2,6,0,0
39429,152,7195,1392,870,1177,35,17,170,1427,14,494,280,531,508,811,4473,7289,7,54850,3047,2,2,1,1,0
39430,4,181,75,38,59,1,3,12,76,2,4,2,4,6,6,10,15,1,15,0,0,2,1,1,0
39431,33,992,465,148,393,5,8,60,470,4,31,20,31,35,51,161,261,2,523,29,0,2,33,14,0
39432,33,992,16,12,9,0,0,6,16,1,2,1,2,3,3,2,4,0,2,0,0,2,33,14,0
39433,110,5948,1457,730,1242,11,6,188,1468,10,292,166,329,302,495,2424,4078,5,22973,1276,1,2,6,0,0
39434,111,5221,1523,757,1297,19,12,193,1542,12,193,117,230,205,347,1508,2664,7,19053,1058,0,2,2,2,0
39435,69,3090,1020,354,843,12,15,144,1032,8,134,77,144,142,221,970,1580,4,6792,377,0,2,1,1,0
39436,21,637,424,94,331,4,0,89,428,1,5,5,5,6,10,11,25,0,12,0,0,2,1,1,0
39437,55,2824,722,423,573,19,0,135,741,12,172,101,199,184,300,1320,2257,6,15668,870,0,2,1,1,0
39438,87,3393,1043,504,840,53,9,147,1096,9,180,112,198,189,310,1377,2344,4,11604,644,0,2,16,0,0
39439,79,3071,1178,367,1042,6,15,115,1184,9,94,51,95,103,146,644,976,4,4439,246,0,2,2,1,0
39440,12,645,219,78,157,11,5,46,230,3,24,20,34,27,54,114,256,2,545,30,0,2,2,1,0
39441,111,6050,1943,715,1694,26,18,214,1969,12,185,120,237,197,357,1436,2721,7,20915,1161,0,2,1,1,0
39442,39,1770,442,244,305,14,16,103,456,11,68,45,75,79,120,452,756,6,4588,254,0,2,97,13,0
39443,51,2032,1098,241,925,5,10,155,1103,7,46,25,49,53,74,273,423,3,1580,87,0,2,36,0,0
39444,183,5400,1660,832,1314,41,38,274,1701,20,312,209,395,332,604,2671,5058,12,64042,3557,1,2,28,18,1
39445,183,5400,1057,646,719,113,100,145,1170,18,215,134,248,233,382,1740,3004,10,31186,1732,1,2,28,18,1
39446,63,1284,91,45,69,0,3,18,91,3,9,6,10,12,16,33,57,1,95,5,0,2,2,9,1
39447,63,1284,367,234,237,17,34,68,384,16,55,34,61,71,95,381,584,8,5183,287,0,2,2,9,1
39448,181,5925,1660,832,1314,41,38,274,1701,20,312,209,395,332,604,2671,5058,12,64042,3557,1,2,42,0,1
39449,1,300,382,65,130,157,2,92,539,4,10,5,10,14,15,41,57,2,114,6,0,2,3,5,0
39450,7,140,38,22,22,1,0,15,39,1,2,1,2,3,3,2,4,0,2,0,0,0,38,0,0
39451,90,2013,996,429,845,24,10,117,1020,7,76,50,88,83,138,494,879,4,3565,198,0,2,2,2,0
39452,90,2013,456,277,329,12,42,72,468,13,85,50,97,98,147,592,972,7,7212,400,0,2,2,2,0
39453,57,1135,207,111,150,11,0,50,218,5,26,19,36,31,55,133,272,3,943,52,0,2,12,7,0
39454,57,1135,410,198,237,31,55,97,441,11,63,38,72,74,110,414,683,6,4293,238,0,2,12,7,0
39455,113,2243,463,295,324,28,62,57,491,12,134,82,154,146,236,989,1696,6,11700,650,0,2,1,1,0
39456,56,780,167,116,138,4,5,22,171,8,48,30,56,56,86,292,499,4,2330,129,0,2,5,1,0
39457,70,1522,402,202,227,24,74,80,426,12,52,33,61,64,94,339,564,7,3969,220,0,2,13,14,0
39458,76,1637,53,23,39,0,0,13,53,2,8,4,8,10,12,26,39,1,39,2,0,2,5,2,0
39459,76,1637,515,298,307,33,80,99,548,12,63,44,77,75,121,419,753,7,5527,307,0,2,5,2,0
39460,12,572,205,80,86,16,53,53,221,7,18,10,19,25,29,94,134,3,497,27,0,2,6,0,0
39461,65,1368,91,45,69,0,3,18,91,3,9,6,10,12,16,33,57,1,95,5,0,2,50,11,0
39462,65,1368,367,234,237,17,34,68,384,16,55,34,61,71,95,381,584,8,5183,287,0,2,50,11,0
39463,79,1967,757,253,292,73,244,162,830,13,61,38,67,74,105,409,651,7,4654,258,0,2,1,1,0
39464,25,429,219,78,157,11,5,46,230,3,24,20,34,27,54,114,256,2,545,30,0,2,0,1,0
39465,25,429,108,64,79,9,0,20,117,5,15,11,19,20,30,70,129,3,410,22,0,2,0,1,0
39466,280,5856,1943,715,1694,26,18,214,1969,12,185,120,237,197,357,1436,2721,7,20915,1161,0,2,1,1,0
39467,280,5856,1168,838,957,57,25,144,1225,19,348,224,416,367,640,3018,5452,11,61921,3440,1,2,1,1,0
39468,70,1371,1098,241,925,5,10,155,1103,7,46,25,49,53,74,273,423,3,1580,87,0,2,6,0,0
39469,70,1371,282,202,222,14,2,44,296,8,42,24,43,50,67,250,378,4,1548,86,0,2,6,0,0
39470,152,7195,1392,870,1177,35,17,170,1427,14,494,280,531,508,811,4473,7289,7,54850,3047,2,2,1,1,0
39471,4,181,75,38,59,1,3,12,76,2,4,2,4,6,6,10,15,1,15,0,0,2,1,1,0
39472,33,992,465,148,393,5,8,60,470,4,31,20,31,35,51,161,261,2,523,29,0,2,33,14,0
39473,33,992,16,12,9,0,0,6,16,1,2,1,2,3,3,2,4,0,2,0,0,2,33,14,0
39474,110,5948,1457,730,1242,11,6,188,1468,10,292,166,329,302,495,2424,4078,5,22973,1276,1,2,6,0,0
39475,111,5221,1523,757,1297,19,12,193,1542,12,193,117,230,205,347,1508,2664,7,19053,1058,0,2,2,2,0
39476,69,3090,1020,354,843,12,15,144,1032,8,134,77,144,142,221,970,1580,4,6792,377,0,2,1,1,0
39477,21,637,424,94,331,4,0,89,428,1,5,5,5,6,10,11,25,0,12,0,0,2,1,1,0
39478,55,2824,722,423,573,19,0,135,741,12,172,101,199,184,300,1320,2257,6,15668,870,0,2,1,1,0
39479,87,3393,1043,504,840,53,9,147,1096,9,180,112,198,189,310,1377,2344,4,11604,644,0,2,16,0,0
39480,79,3071,1178,367,1042,6,15,115,1184,9,94,51,95,103,146,644,976,4,4439,246,0,2,2,1,0
39481,12,645,219,78,157,11,5,46,230,3,24,20,34,27,54,114,256,2,545,30,0,2,2,1,0
39482,111,6050,1943,715,1694,26,18,214,1969,12,185,120,237,197,357,1436,2721,7,20915,1161,0,2,1,1,0
39483,39,1770,442,244,305,14,16,103,456,11,68,45,75,79,120,452,756,6,4588,254,0,2,97,13,0
39484,51,2032,1098,241,925,5,10,155,1103,7,46,25,49,53,74,273,423,3,1580,87,0,2,36,0,0
39485,117,3166,1523,757,1297,19,12,193,1542,12,193,117,230,205,347,1508,2664,7,19053,1058,0,2,4,0,0
39486,117,3166,701,378,504,33,58,109,734,13,110,68,126,123,194,794,1346,7,10027,557,0,2,4,0,0
39487,113,5329,1523,757,1297,19,12,193,1542,12,193,117,230,205,347,1508,2664,7,19053,1058,0,2,26,0,0
39488,183,5400,1660,832,1314,41,38,274,1701,20,312,209,395,332,604,2671,5058,12,64042,3557,1,2,28,18,0
39489,183,5400,1057,646,719,113,100,145,1170,18,215,134,248,233,382,1740,3004,10,31186,1732,1,2,28,18,0
39490,64,1354,91,45,69,0,3,18,91,3,9,6,10,12,16,33,57,1,95,5,0,2,2,9,0
39491,64,1354,367,234,237,17,34,68,384,16,55,34,61,71,95,381,584,8,5183,287,0,2,2,9,0
39492,181,5925,1660,832,1314,41,38,274,1701,20,312,209,395,332,604,2671,5058,12,64042,3557,1,2,42,0,0
39493,117,3166,1523,757,1297,19,12,193,1542,12,193,117,230,205,347,1508,2664,7,19053,1058,0,2,4,0,0
39494,117,3166,701,378,504,33,58,109,734,13,110,68,126,123,194,794,1346,7,10027,557,0,2,4,0,0
39495,113,5329,1523,757,1297,19,12,193,1542,12,193,117,230,205,347,1508,2664,7,19053,1058,0,2,26,0,0
39496,147,3596,77,34,69,0,0,8,77,3,24,16,29,27,45,114,213,1,387,21,0,2,7,1,0
39497,147,3596,712,438,573,51,9,84,763,14,102,71,128,116,199,733,1364,8,11988,666,0,2,7,1,0
39498,85,4953,1296,573,1062,40,33,157,1336,8,201,118,231,209,349,1561,2689,4,12365,686,0,2,12,0,0
39499,147,3596,77,34,69,0,0,8,77,3,24,16,29,27,45,114,213,1,387,21,0,2,7,1,0
39500,147,3596,712,438,573,51,9,84,763,14,102,71,128,116,199,733,1364,8,11988,666,0,2,7,1,0
39501,85,4953,1296,573,1062,40,33,157,1336,8,201,118,231,209,349,1561,2689,4,12365,686,0,2,12,0,0
39502,183,5400,1660,832,1314,41,38,274,1701,20,312,209,395,332,604,2671,5058,12,64042,3557,1,2,28,18,0
39503,183,5400,1057,646,719,113,100,145,1170,18,215,134,248,233,382,1740,3004,10,31186,1732,1,2,28,18,0
39504,142,3472,77,34,69,0,0,8,77,3,24,16,29,27,45,114,213,1,387,21,0,2,7,1,0
39505,142,3472,712,438,573,51,9,84,763,14,102,71,128,116,199,733,1364,8,11988,666,0,2,7,1,0
39506,64,1354,91,45,69,0,3,18,91,3,9,6,10,12,16,33,57,1,95,5,0,2,2,9,0
39507,64,1354,367,234,237,17,34,68,384,16,55,34,61,71,95,381,584,8,5183,287,0,2,2,9,0
39508,181,5925,1660,832,1314,41,38,274,1701,20,312,209,395,332,604,2671,5058,12,64042,3557,1,2,42,0,0
39509,85,4953,1296,573,1062,40,33,157,1336,8,201,118,231,209,349,1561,2689,4,12365,686,0,2,12,0,0
39510,183,5400,1660,832,1314,41,38,274,1701,20,312,209,395,332,604,2671,5058,12,64042,3557,1,2,28,18,0
39511,183,5400,1057,646,719,113,100,145,1170,18,215,134,248,233,382,1740,3004,10,31186,1732,1,2,28,18,0
39512,142,3472,77,34,69,0,0,8,77,3,24,16,29,27,45,114,213,1,387,21,0,2,7,1,0
39513,142,3472,712,438,573,51,9,84,763,14,102,71,128,116,199,733,1364,8,11988,666,0,2,7,1,0
39514,64,1354,91,45,69,0,3,18,91,3,9,6,10,12,16,33,57,1,95,5,0,2,2,9,0
39515,64,1354,367,234,237,17,34,68,384,16,55,34,61,71,95,381,584,8,5183,287,0,2,2,9,0
39516,181,5925,1660,832,1314,41,38,274,1701,20,312,209,395,332,604,2671,5058,12,64042,3557,1,2,42,0,0
39517,85,4953,1296,573,1062,40,33,157,1336,8,201,118,231,209,349,1561,2689,4,12365,686,0,2,12,0,0
39518,90,3963,1338,495,1086,10,64,173,1348,11,122,82,157,133,239,883,1686,7,11934,663,0,2,1,1,0
39519,90,3963,1338,495,1086,10,64,173,1348,11,122,82,157,133,239,883,1686,7,11934,663,0,2,1,1,0
39520,1,93,42,7,35,4,0,5,46,1,2,1,2,3,3,2,4,0,2,0,0,2,2,3,1
39521,1,93,11,6,10,0,0,1,11,2,4,2,4,6,6,10,15,1,15,0,0,2,2,3,1
39522,113,5706,1523,757,1297,19,12,193,1542,12,193,117,230,205,347,1508,2664,7,19053,1058,0,2,189,116,1
39523,113,5691,1523,757,1297,19,12,193,1542,12,193,117,230,205,347,1508,2664,7,19053,1058,0,2,0,1,0
39524,299,6647,72,33,56,0,4,12,72,1,1,1,1,2,2,0,2,0,1,0,0,2,0,12,0
39525,299,6647,1454,835,1044,76,110,219,1530,17,275,158,296,292,454,2297,3718,9,34017,1889,1,2,0,12,0
39526,1,93,42,7,35,4,0,5,46,1,2,1,2,3,3,2,4,0,2,0,0,2,2,3,0
39527,1,93,11,6,10,0,0,1,11,2,4,2,4,6,6,10,15,1,15,0,0,2,2,3,0
39528,113,5691,1523,757,1297,19,12,193,1542,12,193,117,230,205,347,1508,2664,7,19053,1058,0,2,189,117,0
39529,299,6647,72,33,56,0,4,12,72,1,1,1,1,2,2,0,2,0,1,0,0,2,0,12,0
39530,299,6647,1454,835,1044,76,110,219,1530,17,275,158,296,292,454,2297,3718,9,34017,1889,1,2,0,12,0
39531,90,3963,1338,495,1086,10,64,173,1348,11,122,82,157,133,239,883,1686,7,11934,663,0,2,1,1,0
39532,18,486,205,80,86,16,53,53,221,7,18,10,19,25,29,94,134,3,497,27,0,2,13,6,0
39533,18,486,205,80,86,16,53,53,221,7,18,10,19,25,29,94,134,3,497,27,0,2,13,6,0
39534,225,5726,722,423,573,19,0,135,741,12,172,101,199,184,300,1320,2257,6,15668,870,0,2,6,0,1
39535,225,5726,1508,847,911,44,250,301,1552,14,148,88,169,162,257,1120,1886,7,15077,837,0,2,6,0,1
39536,225,5726,722,423,573,19,0,135,741,12,172,101,199,184,300,1320,2257,6,15668,870,0,2,1,1,0
39537,225,5726,1508,847,911,44,250,301,1552,14,148,88,169,162,257,1120,1886,7,15077,837,0,2,1,1,0
39538,225,5726,722,423,573,19,0,135,741,12,172,101,199,184,300,1320,2257,6,15668,870,0,2,6,0,0
39539,225,5726,1508,847,911,44,250,301,1552,14,148,88,169,162,257,1120,1886,7,15077,837,0,2,6,0,0
39540,224,5729,722,423,573,19,0,135,741,12,172,101,199,184,300,1320,2257,6,15668,870,0,2,8,8,1
39541,224,5729,1508,847,911,44,250,301,1552,14,148,88,169,162,257,1120,1886,7,15077,837,0,2,8,8,1
39542,282,5904,1943,715,1694,26,18,214,1969,12,185,120,237,197,357,1436,2721,7,20915,1161,0,2,11,1,1
39543,282,5904,1168,838,957,57,25,144,1225,19,348,224,416,367,640,3018,5452,11,61921,3440,1,2,11,1,1
39544,42,2613,1157,318,931,29,22,177,1186,6,104,63,125,110,188,712,1274,3,4596,255,0,2,1,1,1
39545,55,2824,722,423,573,19,0,135,741,12,172,101,199,184,300,1320,2257,6,15668,870,0,2,1,1,1
39546,112,6136,1943,715,1694,26,18,214,1969,12,185,120,237,197,357,1436,2721,7,20915,1161,0,2,18,1,1
39547,90,3963,1338,495,1086,10,64,173,1348,11,122,82,157,133,239,883,1686,7,11934,663,0,2,1,1,0
39548,9,432,184,100,137,2,15,30,186,6,38,20,39,44,59,214,322,3,991,55,0,2,2,1,0
39549,224,5729,722,423,573,19,0,135,741,12,172,101,199,184,300,1320,2257,6,15668,870,0,2,8,8,0
39550,224,5729,1508,847,911,44,250,301,1552,14,148,88,169,162,257,1120,1886,7,15077,837,0,2,8,8,0
39551,282,5904,1943,715,1694,26,18,214,1969,12,185,120,237,197,357,1436,2721,7,20915,1161,0,2,11,1,0
39552,282,5904,1168,838,957,57,25,144,1225,19,348,224,416,367,640,3018,5452,11,61921,3440,1,2,11,1,0
39553,42,2613,1157,318,931,29,22,177,1186,6,104,63,125,110,188,712,1274,3,4596,255,0,2,1,1,0
39554,55,2824,722,423,573,19,0,135,741,12,172,101,199,184,300,1320,2257,6,15668,870,0,2,1,1,0
39555,112,6136,1943,715,1694,26,18,214,1969,12,185,120,237,197,357,1436,2721,7,20915,1161,0,2,18,1,0
39556,114,2087,477,336,357,30,23,73,507,16,194,134,250,210,384,1538,2962,10,30538,1696,0,2,3,3,0
39557,183,5967,1660,832,1314,41,38,274,1701,20,312,209,395,332,604,2671,5058,12,64042,3557,1,2,10,0,0
39558,183,5396,1660,832,1314,41,38,274,1701,20,312,209,395,332,604,2671,5058,12,64042,3557,1,2,4,4,1
39559,183,5396,1057,646,719,113,100,145,1170,18,215,134,248,233,382,1740,3004,10,31186,1732,1,2,4,4,1
39560,60,1139,282,196,195,3,0,86,285,8,130,71,141,138,212,936,1507,4,6538,363,0,2,1,1,0
39561,7,292,72,33,56,0,4,12,72,1,1,1,1,2,2,0,2,0,1,0,0,2,1,1,0
39562,12,228,127,75,83,2,11,30,129,4,14,7,14,18,21,61,87,2,175,9,0,2,2,2,0
39563,12,228,652,304,544,16,6,88,668,6,89,51,101,95,152,591,998,3,3399,188,0,2,2,2,0
39564,12,228,2,2,2,0,0,0,2,0,0,0,0,0,0,0,0,0,0,0,0,2,2,2,0
39565,12,228,8,5,5,0,0,3,8,0,0,0,0,0,0,0,0,0,0,0,0,2,2,2,0
39566,12,228,2,2,2,0,0,0,2,0,0,0,0,0,0,0,0,0,0,0,0,2,2,2,0
39567,12,228,14,8,8,0,0,6,14,0,0,0,0,0,0,0,0,0,0,0,0,2,2,2,0
39568,12,228,6,4,4,0,0,2,6,0,0,0,0,0,0,0,0,0,0,0,0,2,2,2,0
39569,12,228,6,4,4,0,0,2,6,1,2,1,2,3,3,2,4,0,2,0,0,2,2,2,0
39570,12,228,6,4,4,0,0,2,6,0,0,0,0,0,0,0,0,0,0,0,0,2,2,2,0
39571,12,228,7,5,5,0,0,2,7,0,0,0,0,0,0,0,0,0,0,0,0,2,2,2,0
39572,12,228,6,4,4,0,0,2,6,0,0,0,0,0,0,0,0,0,0,0,0,2,2,2,0
39573,12,228,10,6,6,0,0,4,10,0,0,0,0,0,0,0,0,0,0,0,0,2,2,2,0
39574,12,228,1,1,1,0,0,0,1,0,0,0,0,0,0,0,0,0,0,0,0,2,2,2,0
39575,12,228,1,1,1,0,0,0,1,0,0,0,0,0,0,0,0,0,0,0,0,2,2,2,0
39576,12,228,14,10,10,0,0,4,14,1,1,1,1,2,2,0,2,0,1,0,0,2,2,2,0
39577,12,228,46,26,30,3,0,12,49,3,6,3,6,9,9,20,28,1,42,2,0,2,2,2,0
39578,183,5396,1660,832,1314,41,38,274,1701,20,312,209,395,332,604,2671,5058,12,64042,3557,1,2,4,4,0
39579,183,5396,1057,646,719,113,100,145,1170,18,215,134,248,233,382,1740,3004,10,31186,1732,1,2,4,4,0
39580,60,1139,282,196,195,3,0,86,285,8,130,71,141,138,212,936,1507,4,6538,363,0,2,1,1,0
39581,7,292,72,33,56,0,4,12,72,1,1,1,1,2,2,0,2,0,1,0,0,2,1,1,0
39582,12,228,127,75,83,2,11,30,129,4,14,7,14,18,21,61,87,2,175,9,0,2,2,2,0
39583,12,228,652,304,544,16,6,88,668,6,89,51,101,95,152,591,998,3,3399,188,0,2,2,2,0
39584,12,228,2,2,2,0,0,0,2,0,0,0,0,0,0,0,0,0,0,0,0,2,2,2,0
39585,12,228,8,5,5,0,0,3,8,0,0,0,0,0,0,0,0,0,0,0,0,2,2,2,0
39586,12,228,2,2,2,0,0,0,2,0,0,0,0,0,0,0,0,0,0,0,0,2,2,2,0
39587,12,228,14,8,8,0,0,6,14,0,0,0,0,0,0,0,0,0,0,0,0,2,2,2,0
39588,12,228,6,4,4,0,0,2,6,0,0,0,0,0,0,0,0,0,0,0,0,2,2,2,0
39589,12,228,6,4,4,0,0,2,6,1,2,1,2,3,3,2,4,0,2,0,0,2,2,2,0
39590,12,228,6,4,4,0,0,2,6,0,0,0,0,0,0,0,0,0,0,0,0,2,2,2,0
39591,12,228,7,5,5,0,0,2,7,0,0,0,0,0,0,0,0,0,0,0,0,2,2,2,0
39592,12,228,6,4,4,0,0,2,6,0,0,0,0,0,0,0,0,0,0,0,0,2,2,2,0
39593,12,228,10,6,6,0,0,4,10,0,0,0,0,0,0,0,0,0,0,0,0,2,2,2,0
39594,12,228,1,1,1,0,0,0,1,0,0,0,0,0,0,0,0,0,0,0,0,2,2,2,0
39595,12,228,1,1,1,0,0,0,1,0,0,0,0,0,0,0,0,0,0,0,0,2,2,2,0
39596,12,228,14,10,10,0,0,4,14,1,1,1,1,2,2,0,2,0,1,0,0,2,2,2,0
39597,12,228,46,26,30,3,0,12,49,3,6,3,6,9,9,20,28,1,42,2,0,2,2,2,0
39598,9,432,184,100,137,2,15,30,186,6,38,20,39,44,59,214,322,3,991,55,0,2,2,1,0
39599,114,2087,477,336,357,30,23,73,507,16,194,134,250,210,384,1538,2962,10,30538,1696,0,2,3,3,0
39600,183,5967,1660,832,1314,41,38,274,1701,20,312,209,395,332,604,2671,5058,12,64042,3557,1,2,10,0,0
39601,225,5744,722,423,573,19,0,135,741,12,172,101,199,184,300,1320,2257,6,15668,870,0,2,2,0,0
39602,225,5744,1508,847,911,44,250,301,1552,14,148,88,169,162,257,1120,1886,7,15077,837,0,2,2,0,0
39603,225,5744,722,423,573,19,0,135,741,12,172,101,199,184,300,1320,2257,6,15668,870,0,2,2,0,0
39604,225,5744,1508,847,911,44,250,301,1552,14,148,88,169,162,257,1120,1886,7,15077,837,0,2,2,0,0
39605,235,4857,2,2,2,0,0,0,2,0,0,0,0,0,0,0,0,0,0,0,0,2,3,1,0
39606,235,4857,99,48,90,1,3,5,100,0,0,0,0,0,0,0,0,0,0,0,0,2,3,1,0
39607,235,4857,8,5,5,2,0,1,10,0,0,0,0,0,0,0,0,0,0,0,0,2,3,1,0
39608,235,4857,1217,716,841,84,126,174,1301,14,185,118,215,199,333,1446,2542,8,20687,1149,0,2,3,1,0
39609,235,4857,160,89,115,0,13,31,160,7,15,11,17,22,28,78,124,3,495,27,0,2,3,1,0
39610,235,4857,10,10,9,9,0,0,19,0,0,0,0,0,0,0,0,0,0,0,0,2,3,1,0
39611,235,4857,173,84,99,8,29,36,181,5,12,7,13,17,20,54,81,2,221,12,0,2,3,1,0
39612,235,4857,3,1,1,3,0,0,6,0,0,0,0,0,0,0,0,0,0,0,0,2,3,1,0
39613,53,1795,601,196,481,2,23,85,603,8,63,36,72,71,108,400,664,4,3036,168,0,2,18,0,0
39614,55,1098,207,111,150,11,0,50,218,5,26,19,36,31,55,133,272,3,943,52,0,2,8,6,0
39615,55,1098,410,198,237,31,55,97,441,11,63,38,72,74,110,414,683,6,4293,238,0,2,8,6,0
39616,315,6863,72,33,56,0,4,12,72,1,1,1,1,2,2,0,2,0,1,0,0,2,6,4,0
39617,315,6863,1454,835,1044,76,110,219,1530,17,275,158,296,292,454,2297,3718,9,34017,1889,1,2,6,4,0
39618,107,4626,1289,550,1043,56,32,155,1345,10,167,93,185,177,278,1266,2075,5,11498,638,0,2,30,2,0
39619,21,478,207,111,150,11,0,50,218,5,26,19,36,31,55,133,272,3,943,52,0,2,23,3,0
39620,57,1122,207,111,150,11,0,50,218,5,26,19,36,31,55,133,272,3,943,52,0,2,8,4,1
39621,57,1122,410,198,237,31,55,97,441,11,63,38,72,74,110,414,683,6,4293,238,0,2,8,4,1
39622,251,5834,4293,999,3693,19,54,507,4312,9,155,88,170,164,258,1156,1898,4,9368,520,0,2,2,2,1
39623,251,5834,1482,859,1002,125,135,219,1607,16,219,134,251,235,385,1766,3032,9,27804,1544,1,2,2,2,1
39624,89,3931,1338,495,1086,10,64,173,1348,11,122,82,157,133,239,883,1686,7,11934,663,0,2,0,46,1
39625,178,7721,4293,999,3693,19,54,507,4312,9,155,88,170,164,258,1156,1898,4,9368,520,0,2,43,3,1
39626,178,7721,1482,859,1002,125,135,219,1607,16,219,134,251,235,385,1766,3032,9,27804,1544,1,2,43,3,1
39627,22,484,207,111,150,11,0,50,218,5,26,19,36,31,55,133,272,3,943,52,0,2,11,0,1
39628,235,4857,2,2,2,0,0,0,2,0,0,0,0,0,0,0,0,0,0,0,0,2,3,1,0
39629,235,4857,99,48,90,1,3,5,100,0,0,0,0,0,0,0,0,0,0,0,0,2,3,1,0
39630,235,4857,8,5,5,2,0,1,10,0,0,0,0,0,0,0,0,0,0,0,0,2,3,1,0
39631,235,4857,1217,716,841,84,126,174,1301,14,185,118,215,199,333,1446,2542,8,20687,1149,0,2,3,1,0
39632,235,4857,160,89,115,0,13,31,160,7,15,11,17,22,28,78,124,3,495,27,0,2,3,1,0
39633,235,4857,10,10,9,9,0,0,19,0,0,0,0,0,0,0,0,0,0,0,0,2,3,1,0
39634,235,4857,173,84,99,8,29,36,181,5,12,7,13,17,20,54,81,2,221,12,0,2,3,1,0
39635,235,4857,3,1,1,3,0,0,6,0,0,0,0,0,0,0,0,0,0,0,0,2,3,1,0
39636,53,1795,601,196,481,2,23,85,603,8,63,36,72,71,108,400,664,4,3036,168,0,2,18,0,0
39637,55,1098,207,111,150,11,0,50,218,5,26,19,36,31,55,133,272,3,943,52,0,2,8,6,0
39638,55,1098,410,198,237,31,55,97,441,11,63,38,72,74,110,414,683,6,4293,238,0,2,8,6,0
39639,315,6863,72,33,56,0,4,12,72,1,1,1,1,2,2,0,2,0,1,0,0,2,6,4,0
39640,315,6863,1454,835,1044,76,110,219,1530,17,275,158,296,292,454,2297,3718,9,34017,1889,1,2,6,4,0
39641,107,4626,1289,550,1043,56,32,155,1345,10,167,93,185,177,278,1266,2075,5,11498,638,0,2,30,2,0
39642,21,478,207,111,150,11,0,50,218,5,26,19,36,31,55,133,272,3,943,52,0,2,23,3,0
39643,318,6891,72,33,56,0,4,12,72,1,1,1,1,2,2,0,2,0,1,0,0,2,10,5,0
39644,318,6891,1454,835,1044,76,110,219,1530,17,275,158,296,292,454,2297,3718,9,34017,1889,1,2,10,5,0
39645,107,4630,1289,550,1043,56,32,155,1345,10,167,93,185,177,278,1266,2075,5,11498,638,0,2,8,2,0
39646,56,1113,207,111,150,11,0,50,218,5,26,19,36,31,55,133,272,3,943,52,0,2,8,4,0
39647,56,1113,410,198,237,31,55,97,441,11,63,38,72,74,110,414,683,6,4293,238,0,2,8,4,0
39648,251,5834,4293,999,3693,19,54,507,4312,9,155,88,170,164,258,1156,1898,4,9368,520,0,2,2,2,0
39649,251,5834,1482,859,1002,125,135,219,1607,16,219,134,251,235,385,1766,3032,9,27804,1544,1,2,2,2,0
39650,89,3931,1338,495,1086,10,64,173,1348,11,122,82,157,133,239,883,1686,7,11934,663,0,2,0,46,0
39651,178,7721,4293,999,3693,19,54,507,4312,9,155,88,170,164,258,1156,1898,4,9368,520,0,2,43,3,0
39652,178,7721,1482,859,1002,125,135,219,1607,16,219,134,251,235,385,1766,3032,9,27804,1544,1,2,43,3,0
39653,23,513,207,111,150,11,0,50,218,5,26,19,36,31,55,133,272,3,943,52,0,2,11,0,0
39654,318,6891,72,33,56,0,4,12,72,1,1,1,1,2,2,0,2,0,1,0,0,2,10,5,0
39655,318,6891,1454,835,1044,76,110,219,1530,17,275,158,296,292,454,2297,3718,9,34017,1889,1,2,10,5,0
39656,107,4630,1289,550,1043,56,32,155,1345,10,167,93,185,177,278,1266,2075,5,11498,638,0,2,8,2,0
39657,60,1139,282,196,195,3,0,86,285,8,130,71,141,138,212,936,1507,4,6538,363,0,2,1,1,0
39658,7,292,72,33,56,0,4,12,72,1,1,1,1,2,2,0,2,0,1,0,0,2,1,1,0
39659,12,228,127,75,83,2,11,30,129,4,14,7,14,18,21,61,87,2,175,9,0,2,2,2,0
39660,12,228,652,304,544,16,6,88,668,6,89,51,101,95,152,591,998,3,3399,188,0,2,2,2,0
39661,12,228,2,2,2,0,0,0,2,0,0,0,0,0,0,0,0,0,0,0,0,2,2,2,0
39662,12,228,8,5,5,0,0,3,8,0,0,0,0,0,0,0,0,0,0,0,0,2,2,2,0
39663,12,228,2,2,2,0,0,0,2,0,0,0,0,0,0,0,0,0,0,0,0,2,2,2,0
39664,12,228,14,8,8,0,0,6,14,0,0,0,0,0,0,0,0,0,0,0,0,2,2,2,0
39665,12,228,6,4,4,0,0,2,6,0,0,0,0,0,0,0,0,0,0,0,0,2,2,2,0
39666,12,228,6,4,4,0,0,2,6,1,2,1,2,3,3,2,4,0,2,0,0,2,2,2,0
39667,12,228,6,4,4,0,0,2,6,0,0,0,0,0,0,0,0,0,0,0,0,2,2,2,0
39668,12,228,7,5,5,0,0,2,7,0,0,0,0,0,0,0,0,0,0,0,0,2,2,2,0
39669,12,228,6,4,4,0,0,2,6,0,0,0,0,0,0,0,0,0,0,0,0,2,2,2,0
39670,12,228,10,6,6,0,0,4,10,0,0,0,0,0,0,0,0,0,0,0,0,2,2,2,0
39671,12,228,1,1,1,0,0,0,1,0,0,0,0,0,0,0,0,0,0,0,0,2,2,2,0
39672,12,228,1,1,1,0,0,0,1,0,0,0,0,0,0,0,0,0,0,0,0,2,2,2,0
39673,12,228,14,10,10,0,0,4,14,1,1,1,1,2,2,0,2,0,1,0,0,2,2,2,0
39674,12,228,46,26,30,3,0,12,49,3,6,3,6,9,9,20,28,1,42,2,0,2,2,2,0
39675,57,1141,207,111,150,11,0,50,218,5,26,19,36,31,55,133,272,3,943,52,0,2,16,10,0
39676,57,1141,410,198,237,31,55,97,441,11,63,38,72,74,110,414,683,6,4293,238,0,2,16,10,0
39677,238,5010,2,2,2,0,0,0,2,0,0,0,0,0,0,0,0,0,0,0,0,2,3,1,0
39678,238,5010,99,48,90,1,3,5,100,0,0,0,0,0,0,0,0,0,0,0,0,2,3,1,0
39679,238,5010,8,5,5,2,0,1,10,0,0,0,0,0,0,0,0,0,0,0,0,2,3,1,0
39680,238,5010,1217,716,841,84,126,174,1301,14,185,118,215,199,333,1446,2542,8,20687,1149,0,2,3,1,0
39681,238,5010,160,89,115,0,13,31,160,7,15,11,17,22,28,78,124,3,495,27,0,2,3,1,0
39682,238,5010,10,10,9,9,0,0,19,0,0,0,0,0,0,0,0,0,0,0,0,2,3,1,0
39683,238,5010,173,84,99,8,29,36,181,5,12,7,13,17,20,54,81,2,221,12,0,2,3,1,0
39684,238,5010,3,1,1,3,0,0,6,0,0,0,0,0,0,0,0,0,0,0,0,2,3,1,0
39685,250,5807,4293,999,3693,19,54,507,4312,9,155,88,170,164,258,1156,1898,4,9368,520,0,2,2,2,0
39686,250,5807,1482,859,1002,125,135,219,1607,16,219,134,251,235,385,1766,3032,9,27804,1544,1,2,2,2,0
39687,12,572,205,80,86,16,53,53,221,7,18,10,19,25,29,94,134,3,497,27,0,2,13,6,0
39688,225,5745,722,423,573,19,0,135,741,12,172,101,199,184,300,1320,2257,6,15668,870,0,2,6,0,0
39689,225,5745,1508,847,911,44,250,301,1552,14,148,88,169,162,257,1120,1886,7,15077,837,0,2,6,0,0
39690,303,6685,72,33,56,0,4,12,72,1,1,1,1,2,2,0,2,0,1,0,0,2,13,6,0
39691,303,6685,1454,835,1044,76,110,219,1530,17,275,158,296,292,454,2297,3718,9,34017,1889,1,2,13,6,0
39692,107,4624,1289,550,1043,56,32,155,1345,10,167,93,185,177,278,1266,2075,5,11498,638,0,2,37,3,0
39693,89,3931,1338,495,1086,10,64,173,1348,11,122,82,157,133,239,883,1686,7,11934,663,0,2,0,46,0
39694,176,7666,4293,999,3693,19,54,507,4312,9,155,88,170,164,258,1156,1898,4,9368,520,0,2,43,3,0
39695,176,7666,1482,859,1002,125,135,219,1607,16,219,134,251,235,385,1766,3032,9,27804,1544,1,2,43,3,0
39696,23,513,207,111,150,11,0,50,218,5,26,19,36,31,55,133,272,3,943,52,0,2,34,3,0
39697,9,432,184,100,137,2,15,30,186,6,38,20,39,44,59,214,322,3,991,55,0,2,2,1,0
39698,49,1706,601,196,481,2,23,85,603,8,63,36,72,71,108,400,664,4,3036,168,0,2,18,0,0
39699,12,572,205,80,86,16,53,53,221,7,18,10,19,25,29,94,134,3,497,27,0,2,1,1,0
39700,225,5745,722,423,573,19,0,135,741,12,172,101,199,184,300,1320,2257,6,15668,870,0,2,1,1,0
39701,225,5745,1508,847,911,44,250,301,1552,14,148,88,169,162,257,1120,1886,7,15077,837,0,2,1,1,0
39702,60,1139,282,196,195,3,0,86,285,8,130,71,141,138,212,936,1507,4,6538,363,0,2,1,1,0
39703,7,292,72,33,56,0,4,12,72,1,1,1,1,2,2,0,2,0,1,0,0,2,1,1,0
39704,12,228,127,75,83,2,11,30,129,4,14,7,14,18,21,61,87,2,175,9,0,2,2,2,0
39705,12,228,652,304,544,16,6,88,668,6,89,51,101,95,152,591,998,3,3399,188,0,2,2,2,0
39706,12,228,2,2,2,0,0,0,2,0,0,0,0,0,0,0,0,0,0,0,0,2,2,2,0
39707,12,228,8,5,5,0,0,3,8,0,0,0,0,0,0,0,0,0,0,0,0,2,2,2,0
39708,12,228,2,2,2,0,0,0,2,0,0,0,0,0,0,0,0,0,0,0,0,2,2,2,0
39709,12,228,14,8,8,0,0,6,14,0,0,0,0,0,0,0,0,0,0,0,0,2,2,2,0
39710,12,228,6,4,4,0,0,2,6,0,0,0,0,0,0,0,0,0,0,0,0,2,2,2,0
39711,12,228,6,4,4,0,0,2,6,1,2,1,2,3,3,2,4,0,2,0,0,2,2,2,0
39712,12,228,6,4,4,0,0,2,6,0,0,0,0,0,0,0,0,0,0,0,0,2,2,2,0
39713,12,228,7,5,5,0,0,2,7,0,0,0,0,0,0,0,0,0,0,0,0,2,2,2,0
39714,12,228,6,4,4,0,0,2,6,0,0,0,0,0,0,0,0,0,0,0,0,2,2,2,0
39715,12,228,10,6,6,0,0,4,10,0,0,0,0,0,0,0,0,0,0,0,0,2,2,2,0
39716,12,228,1,1,1,0,0,0,1,0,0,0,0,0,0,0,0,0,0,0,0,2,2,2,0
39717,12,228,1,1,1,0,0,0,1,0,0,0,0,0,0,0,0,0,0,0,0,2,2,2,0
39718,12,228,14,10,10,0,0,4,14,1,1,1,1,2,2,0,2,0,1,0,0,2,2,2,0
39719,12,228,46,26,30,3,0,12,49,3,6,3,6,9,9,20,28,1,42,2,0,2,2,2,0
39720,57,1141,207,111,150,11,0,50,218,5,26,19,36,31,55,133,272,3,943,52,0,2,16,10,0
39721,57,1141,410,198,237,31,55,97,441,11,63,38,72,74,110,414,683,6,4293,238,0,2,16,10,0
39722,238,5010,2,2,2,0,0,0,2,0,0,0,0,0,0,0,0,0,0,0,0,2,3,1,0
39723,238,5010,99,48,90,1,3,5,100,0,0,0,0,0,0,0,0,0,0,0,0,2,3,1,0
39724,238,5010,8,5,5,2,0,1,10,0,0,0,0,0,0,0,0,0,0,0,0,2,3,1,0
39725,238,5010,1217,716,841,84,126,174,1301,14,185,118,215,199,333,1446,2542,8,20687,1149,0,2,3,1,0
39726,238,5010,160,89,115,0,13,31,160,7,15,11,17,22,28,78,124,3,495,27,0,2,3,1,0
39727,238,5010,10,10,9,9,0,0,19,0,0,0,0,0,0,0,0,0,0,0,0,2,3,1,0
39728,238,5010,173,84,99,8,29,36,181,5,12,7,13,17,20,54,81,2,221,12,0,2,3,1,0
39729,238,5010,3,1,1,3,0,0,6,0,0,0,0,0,0,0,0,0,0,0,0,2,3,1,0
39730,250,5807,4293,999,3693,19,54,507,4312,9,155,88,170,164,258,1156,1898,4,9368,520,0,2,2,2,0
39731,250,5807,1482,859,1002,125,135,219,1607,16,219,134,251,235,385,1766,3032,9,27804,1544,1,2,2,2,0
39732,12,572,205,80,86,16,53,53,221,7,18,10,19,25,29,94,134,3,497,27,0,2,13,6,0
39733,225,5745,722,423,573,19,0,135,741,12,172,101,199,184,300,1320,2257,6,15668,870,0,2,6,0,0
39734,225,5745,1508,847,911,44,250,301,1552,14,148,88,169,162,257,1120,1886,7,15077,837,0,2,6,0,0
39735,303,6685,72,33,56,0,4,12,72,1,1,1,1,2,2,0,2,0,1,0,0,2,13,6,0
39736,303,6685,1454,835,1044,76,110,219,1530,17,275,158,296,292,454,2297,3718,9,34017,1889,1,2,13,6,0
39737,107,4624,1289,550,1043,56,32,155,1345,10,167,93,185,177,278,1266,2075,5,11498,638,0,2,37,3,0
39738,89,3931,1338,495,1086,10,64,173,1348,11,122,82,157,133,239,883,1686,7,11934,663,0,2,0,46,0
39739,176,7666,4293,999,3693,19,54,507,4312,9,155,88,170,164,258,1156,1898,4,9368,520,0,2,43,3,0
39740,176,7666,1482,859,1002,125,135,219,1607,16,219,134,251,235,385,1766,3032,9,27804,1544,1,2,43,3,0
39741,23,513,207,111,150,11,0,50,218,5,26,19,36,31,55,133,272,3,943,52,0,2,34,3,0
39742,9,432,184,100,137,2,15,30,186,6,38,20,39,44,59,214,322,3,991,55,0,2,2,1,0
39743,49,1706,601,196,481,2,23,85,603,8,63,36,72,71,108,400,664,4,3036,168,0,2,18,0,0
39744,178,7750,4293,999,3693,19,54,507,4312,9,155,88,170,164,258,1156,1898,4,9368,520,0,2,10,10,0
39745,178,7750,1482,859,1002,125,135,219,1607,16,219,134,251,235,385,1766,3032,9,27804,1544,1,2,10,10,0
39746,178,7750,4293,999,3693,19,54,507,4312,9,155,88,170,164,258,1156,1898,4,9368,520,0,2,10,10,0
39747,178,7750,1482,859,1002,125,135,219,1607,16,219,134,251,235,385,1766,3032,9,27804,1544,1,2,10,10,0
39748,1,93,42,7,35,4,0,5,46,1,2,1,2,3,3,2,4,0,2,0,0,2,3,4,0
39749,1,93,11,6,10,0,0,1,11,2,4,2,4,6,6,10,15,1,15,0,0,2,3,4,0
39750,216,4948,182,127,129,0,0,53,182,5,39,21,42,44,63,217,343,2,926,51,0,2,87,31,0
39751,216,4948,1165,710,800,67,119,181,1232,18,243,153,282,261,435,2000,3492,10,36473,2026,1,2,87,31,0
39752,12,280,149,95,105,2,0,41,151,8,54,28,55,62,83,334,494,4,2013,111,0,2,36,47,0
39753,12,280,82,56,54,0,13,15,82,4,13,8,16,17,24,56,98,2,241,13,0,2,36,47,0
39754,183,5396,1660,832,1314,41,38,274,1701,20,312,209,395,332,604,2671,5058,12,64042,3557,1,2,4,4,0
39755,183,5396,1057,646,719,113,100,145,1170,18,215,134,248,233,382,1740,3004,10,31186,1732,1,2,4,4,0
39756,114,2087,477,336,357,30,23,73,507,16,194,134,250,210,384,1538,2962,10,30538,1696,0,2,3,3,0
39757,57,1141,207,111,150,11,0,50,218,5,26,19,36,31,55,133,272,3,943,52,0,2,8,2,0
39758,57,1141,410,198,237,31,55,97,441,11,63,38,72,74,110,414,683,6,4293,238,0,2,8,2,0
39759,238,5010,2,2,2,0,0,0,2,0,0,0,0,0,0,0,0,0,0,0,0,2,75,22,0
39760,238,5010,99,48,90,1,3,5,100,0,0,0,0,0,0,0,0,0,0,0,0,2,75,22,0
39761,238,5010,8,5,5,2,0,1,10,0,0,0,0,0,0,0,0,0,0,0,0,2,75,22,0
39762,238,5010,1217,716,841,84,126,174,1301,14,185,118,215,199,333,1446,2542,8,20687,1149,0,2,75,22,0
39763,238,5010,160,89,115,0,13,31,160,7,15,11,17,22,28,78,124,3,495,27,0,2,75,22,0
39764,238,5010,10,10,9,9,0,0,19,0,0,0,0,0,0,0,0,0,0,0,0,2,75,22,0
39765,238,5010,173,84,99,8,29,36,181,5,12,7,13,17,20,54,81,2,221,12,0,2,75,22,0
39766,238,5010,3,1,1,3,0,0,6,0,0,0,0,0,0,0,0,0,0,0,0,2,75,22,0
39767,56,780,167,116,138,4,5,22,171,8,48,30,56,56,86,292,499,4,2330,129,0,2,3,4,0
39768,101,2578,1455,414,1257,16,76,112,1471,5,41,23,46,46,69,231,381,2,1069,59,0,2,91,24,0
39769,101,2578,669,365,481,22,61,110,691,15,103,63,122,118,185,747,1273,8,11311,628,0,2,91,24,0
39770,250,5807,4293,999,3693,19,54,507,4312,9,155,88,170,164,258,1156,1898,4,9368,520,0,2,13,14,0
39771,250,5807,1482,859,1002,125,135,219,1607,16,219,134,251,235,385,1766,3032,9,27804,1544,1,2,13,14,0
39772,31,1080,74,35,59,1,0,14,75,3,14,7,14,17,21,58,85,1,128,7,0,2,1,1,0
39773,31,1080,245,125,200,5,7,34,250,7,30,17,34,37,51,166,265,3,1053,58,0,2,1,1,0
39774,54,640,647,139,84,35,284,233,682,0,0,0,0,0,0,0,0,0,0,0,0,2,0,22,0
39775,117,3166,1523,757,1297,19,12,193,1542,12,193,117,230,205,347,1508,2664,7,19053,1058,0,2,14,11,0
39776,117,3166,701,378,504,33,58,109,734,13,110,68,126,123,194,794,1346,7,10027,557,0,2,14,11,0
39777,142,3472,77,34,69,0,0,8,77,3,24,16,29,27,45,114,213,1,387,21,0,2,0,22,0
39778,142,3472,712,438,573,51,9,84,763,14,102,71,128,116,199,733,1364,8,11988,666,0,2,0,22,0
39779,70,1522,402,202,227,24,74,80,426,12,52,33,61,64,94,339,564,7,3969,220,0,2,6,14,0
39780,12,177,424,94,331,4,0,89,428,1,5,5,5,6,10,11,25,0,12,0,0,2,0,25,0
39781,12,177,38,23,23,6,0,8,44,3,11,7,11,14,18,42,68,1,102,5,0,2,0,25,0
39782,12,572,205,80,86,16,53,53,221,7,18,10,19,25,29,94,134,3,497,27,0,2,24,10,0
39783,225,5745,722,423,573,19,0,135,741,12,172,101,199,184,300,1320,2257,6,15668,870,0,2,11,9,0
39784,225,5745,1508,847,911,44,250,301,1552,14,148,88,169,162,257,1120,1886,7,15077,837,0,2,11,9,0
39785,303,6685,72,33,56,0,4,12,72,1,1,1,1,2,2,0,2,0,1,0,0,2,47,82,0
39786,303,6685,1454,835,1044,76,110,219,1530,17,275,158,296,292,454,2297,3718,9,34017,1889,1,2,47,82,0
39787,79,1967,757,253,292,73,244,162,830,13,61,38,67,74,105,409,651,7,4654,258,0,2,80,44,0
39788,20,993,386,256,301,16,9,68,402,4,59,35,69,63,104,355,621,2,1453,80,0,2,97,44,0
39789,20,993,264,131,164,11,41,46,275,6,38,22,40,44,62,214,338,3,1068,59,0,2,97,44,0
39790,87,1891,1043,504,840,53,9,147,1096,9,180,112,198,189,310,1377,2344,4,11604,644,0,2,8,13,0
39791,87,1891,383,288,292,26,6,62,409,11,65,38,67,76,105,429,656,5,3719,206,0,2,8,13,0
39792,282,5904,1943,715,1694,26,18,214,1969,12,185,120,237,197,357,1436,2721,7,20915,1161,0,2,11,1,0
39793,282,5904,1168,838,957,57,25,144,1225,19,348,224,416,367,640,3018,5452,11,61921,3440,1,2,11,1,0
39794,18,638,442,244,305,14,16,103,456,11,68,45,75,79,120,452,756,6,4588,254,0,2,0,15,0
39795,18,638,182,102,99,11,40,35,193,3,11,6,11,14,17,42,64,1,97,5,0,2,0,15,0
39796,70,1371,1098,241,925,5,10,155,1103,7,46,25,49,53,74,273,423,3,1580,87,0,2,9,0,0
39797,70,1371,282,202,222,14,2,44,296,8,42,24,43,50,67,250,378,4,1548,86,0,2,9,0,0
39798,2,173,37,13,25,0,6,6,37,1,2,1,2,3,3,2,4,0,2,0,0,2,0,10,0
39799,2,173,133,47,40,1,43,49,134,0,0,0,0,0,0,0,0,0,0,0,0,2,0,10,0
39800,23,615,601,196,481,2,23,85,603,8,63,36,72,71,108,400,664,4,3036,168,0,2,0,5,0
39801,23,615,156,79,106,5,16,28,161,5,14,8,15,19,23,64,97,2,261,14,0,2,0,5,0
39802,107,4624,1289,550,1043,56,32,155,1345,10,167,93,185,177,278,1266,2075,5,11498,638,0,2,3,6,0
39803,152,7195,1392,870,1177,35,17,170,1427,14,494,280,531,508,811,4473,7289,7,54850,3047,2,2,9,1,0
39804,4,181,75,38,59,1,3,12,76,2,4,2,4,6,6,10,15,1,15,0,0,2,0,173,0
39805,14,343,149,95,105,2,0,41,151,8,54,28,55,62,83,334,494,4,2013,111,0,2,12,1,0
39806,42,2613,1157,318,931,29,22,177,1186,6,104,63,125,110,188,712,1274,3,4596,255,0,2,1,1,0
39807,176,7695,4293,999,3693,19,54,507,4312,9,155,88,170,164,258,1156,1898,4,9368,520,0,2,28,47,0
39808,176,7695,1482,859,1002,125,135,219,1607,16,219,134,251,235,385,1766,3032,9,27804,1544,1,2,28,47,0
39809,147,5933,1782,648,1425,9,47,279,1791,8,171,97,189,179,286,1292,2140,4,9462,525,0,2,24,14,0
39810,30,903,256,139,192,9,7,47,265,4,23,12,24,27,36,112,171,2,357,19,0,2,14,34,0
39811,121,4918,1450,624,1228,12,26,181,1462,14,306,186,354,320,540,2580,4493,8,36391,2021,1,2,2,1,0
39812,183,5967,1660,832,1314,41,38,274,1701,20,312,209,395,332,604,2671,5058,12,64042,3557,1,2,10,0,0
39813,110,5948,1457,730,1242,11,6,188,1468,10,292,166,329,302,495,2424,4078,5,22973,1276,1,2,165,4,0
39814,81,3729,1455,414,1257,16,76,112,1471,5,41,23,46,46,69,231,381,2,1069,59,0,2,149,0,0
39815,2,48,7,6,5,0,0,2,7,1,1,1,2,2,3,0,3,1,3,0,0,2,1,1,0
39816,113,5691,1523,757,1297,19,12,193,1542,12,193,117,230,205,347,1508,2664,7,19053,1058,0,2,236,114,0
39817,69,3090,1020,354,843,12,15,144,1032,8,134,77,144,142,221,970,1580,4,6792,377,0,2,5,23,0
39818,55,2824,722,423,573,19,0,135,741,12,172,101,199,184,300,1320,2257,6,15668,870,0,2,2,3,0
39819,46,1968,386,256,301,16,9,68,402,4,59,35,69,63,104,355,621,2,1453,80,0,2,16,16,0
39820,112,6136,1943,715,1694,26,18,214,1969,12,185,120,237,197,357,1436,2721,7,20915,1161,0,2,18,1,0
39821,39,1770,442,244,305,14,16,103,456,11,68,45,75,79,120,452,756,6,4588,254,0,2,4,11,0
39822,51,2032,1098,241,925,5,10,155,1103,7,46,25,49,53,74,273,423,3,1580,87,0,2,1,3,0
39823,49,1706,601,196,481,2,23,85,603,8,63,36,72,71,108,400,664,4,3036,168,0,2,8,31,0
39824,183,5407,1660,832,1314,41,38,274,1701,20,312,209,395,332,604,2671,5058,12,64042,3557,1,2,2,1,0
39825,183,5407,1057,646,719,113,100,145,1170,18,215,134,248,233,382,1740,3004,10,31186,1732,1,2,2,1,0
39826,216,4979,182,127,129,0,0,53,182,5,39,21,42,44,63,217,343,2,926,51,0,2,17,10,1
39827,216,4979,1165,710,800,67,119,181,1232,18,243,153,282,261,435,2000,3492,10,36473,2026,1,2,17,10,1
39828,67,1549,773,419,590,28,0,166,801,10,204,113,217,214,330,1598,2554,5,13587,754,0,2,7,6,1
39829,67,1549,421,273,302,44,34,57,465,17,81,59,107,98,166,583,1098,11,12329,684,0,2,7,6,1
39830,27,568,2,2,2,0,0,0,2,0,0,0,0,0,0,0,0,0,0,0,0,2,8,3,1
39831,27,568,99,48,90,1,3,5,100,0,0,0,0,0,0,0,0,0,0,0,0,2,8,3,1
39832,27,568,8,5,5,2,0,1,10,0,0,0,0,0,0,0,0,0,0,0,0,2,8,3,1
39833,27,568,1217,716,841,84,126,174,1301,14,185,118,215,199,333,1446,2542,8,20687,1149,0,2,8,3,1
39834,27,568,160,89,115,0,13,31,160,7,15,11,17,22,28,78,124,3,495,27,0,2,8,3,1
39835,27,568,10,10,9,9,0,0,19,0,0,0,0,0,0,0,0,0,0,0,0,2,8,3,1
39836,27,568,173,84,99,8,29,36,181,5,12,7,13,17,20,54,81,2,221,12,0,2,8,3,1
39837,27,568,3,1,1,3,0,0,6,0,0,0,0,0,0,0,0,0,0,0,0,2,8,3,1
39838,183,5421,1660,832,1314,41,38,274,1701,20,312,209,395,332,604,2671,5058,12,64042,3557,1,2,26,21,1
39839,183,5421,1057,646,719,113,100,145,1170,18,215,134,248,233,382,1740,3004,10,31186,1732,1,2,26,21,1
39840,114,2099,477,336,357,30,23,73,507,16,194,134,250,210,384,1538,2962,10,30538,1696,0,2,9,6,1
39841,238,5067,2,2,2,0,0,0,2,0,0,0,0,0,0,0,0,0,0,0,0,2,33,17,1
39842,238,5067,99,48,90,1,3,5,100,0,0,0,0,0,0,0,0,0,0,0,0,2,33,17,1
39843,238,5067,8,5,5,2,0,1,10,0,0,0,0,0,0,0,0,0,0,0,0,2,33,17,1
39844,238,5067,1217,716,841,84,126,174,1301,14,185,118,215,199,333,1446,2542,8,20687,1149,0,2,33,17,1
39845,238,5067,160,89,115,0,13,31,160,7,15,11,17,22,28,78,124,3,495,27,0,2,33,17,1
39846,238,5067,10,10,9,9,0,0,19,0,0,0,0,0,0,0,0,0,0,0,0,2,33,17,1
39847,238,5067,173,84,99,8,29,36,181,5,12,7,13,17,20,54,81,2,221,12,0,2,33,17,1
39848,238,5067,3,1,1,3,0,0,6,0,0,0,0,0,0,0,0,0,0,0,0,2,33,17,1
39849,111,2283,463,295,324,28,62,57,491,12,134,82,154,146,236,989,1696,6,11700,650,0,2,24,14,1
39850,37,813,167,116,138,4,5,22,171,8,48,30,56,56,86,292,499,4,2330,129,0,2,11,1,1
39851,30,669,125,97,103,3,0,19,128,9,25,17,27,34,44,144,223,4,1087,60,0,2,2,0,1
39852,70,1526,402,202,227,24,74,80,426,12,52,33,61,64,94,339,564,7,3969,220,0,2,1,1,1
39853,73,1707,53,23,39,0,0,13,53,2,8,4,8,10,12,26,39,1,39,2,0,2,35,17,1
39854,73,1707,515,298,307,33,80,99,548,12,63,44,77,75,121,419,753,7,5527,307,0,2,35,17,1
39855,67,1752,466,257,367,18,25,50,484,7,126,86,171,133,257,898,1813,4,8612,478,0,2,4,3,1
39856,67,1752,507,281,342,29,59,88,536,10,53,29,57,63,86,336,514,5,2764,153,0,2,4,3,1
39857,87,1935,1043,504,840,53,9,147,1096,9,180,112,198,189,310,1377,2344,4,11604,644,0,2,17,5,1
39858,87,1935,383,288,292,26,6,62,409,11,65,38,67,76,105,429,656,5,3719,206,0,2,17,5,1
39859,216,4943,182,127,129,0,0,53,182,5,39,21,42,44,63,217,343,2,926,51,0,2,1,1,0
39860,216,4943,1165,710,800,67,119,181,1232,18,243,153,282,261,435,2000,3492,10,36473,2026,1,2,1,1,0
39861,80,1982,757,253,292,73,244,162,830,13,61,38,67,74,105,409,651,7,4654,258,0,2,12,5,0
39862,21,1008,386,256,301,16,9,68,402,4,59,35,69,63,104,355,621,2,1453,80,0,2,12,6,0
39863,21,1008,264,131,164,11,41,46,275,6,38,22,40,44,62,214,338,3,1068,59,0,2,12,6,0
39864,115,2286,463,295,324,28,62,57,491,12,134,82,154,146,236,989,1696,6,11700,650,0,2,6,0,1
39865,111,6022,1457,730,1242,11,6,188,1468,10,292,166,329,302,495,2424,4078,5,22973,1276,1,2,15,0,1
39866,183,5390,1660,832,1314,41,38,274,1701,20,312,209,395,332,604,2671,5058,12,64042,3557,1,2,1,4,0
39867,183,5390,1057,646,719,113,100,145,1170,18,215,134,248,233,382,1740,3004,10,31186,1732,1,2,1,4,0
39868,122,4961,1450,624,1228,12,26,181,1462,14,306,186,354,320,540,2580,4493,8,36391,2021,1,2,20,0,0
39869,122,4963,1450,624,1228,12,26,181,1462,14,306,186,354,320,540,2580,4493,8,36391,2021,1,2,7,5,0
39870,115,2286,463,295,324,28,62,57,491,12,134,82,154,146,236,989,1696,6,11700,650,0,2,6,0,0
39871,111,6022,1457,730,1242,11,6,188,1468,10,292,166,329,302,495,2424,4078,5,22973,1276,1,2,15,0,0
39872,183,5390,1660,832,1314,41,38,274,1701,20,312,209,395,332,604,2671,5058,12,64042,3557,1,2,1,4,0
39873,183,5390,1057,646,719,113,100,145,1170,18,215,134,248,233,382,1740,3004,10,31186,1732,1,2,1,4,0
39874,122,4963,1450,624,1228,12,26,181,1462,14,306,186,354,320,540,2580,4493,8,36391,2021,1,2,27,5,0
39875,57,1141,207,111,150,11,0,50,218,5,26,19,36,31,55,133,272,3,943,52,0,2,2,2,1
39876,57,1141,410,198,237,31,55,97,441,11,63,38,72,74,110,414,683,6,4293,238,0,2,2,2,1
39877,57,1141,207,111,150,11,0,50,218,5,26,19,36,31,55,133,272,3,943,52,0,2,2,2,0
39878,57,1141,410,198,237,31,55,97,441,11,63,38,72,74,110,414,683,6,4293,238,0,2,2,2,0
39879,58,1166,207,111,150,11,0,50,218,5,26,19,36,31,55,133,272,3,943,52,0,2,7,0,0
39880,58,1166,410,198,237,31,55,97,441,11,63,38,72,74,110,414,683,6,4293,238,0,2,7,0,0
39881,79,1961,757,253,292,73,244,162,830,13,61,38,67,74,105,409,651,7,4654,258,0,2,1,7,0
39882,20,987,386,256,301,16,9,68,402,4,59,35,69,63,104,355,621,2,1453,80,0,2,1,7,0
39883,20,987,264,131,164,11,41,46,275,6,38,22,40,44,62,214,338,3,1068,59,0,2,1,7,0
39884,252,5831,4293,999,3693,19,54,507,4312,9,155,88,170,164,258,1156,1898,4,9368,520,0,2,4,0,0
39885,252,5831,1482,859,1002,125,135,219,1607,16,219,134,251,235,385,1766,3032,9,27804,1544,1,2,4,0,0
39886,177,7730,4293,999,3693,19,54,507,4312,9,155,88,170,164,258,1156,1898,4,9368,520,0,2,29,0,0
39887,177,7730,1482,859,1002,125,135,219,1607,16,219,134,251,235,385,1766,3032,9,27804,1544,1,2,29,0,0
39888,30,911,256,139,192,9,7,47,265,4,23,12,24,27,36,112,171,2,357,19,0,2,8,9,0
39889,30,919,256,139,192,9,7,47,265,4,23,12,24,27,36,112,171,2,357,19,0,2,3,2,0
39890,58,1166,207,111,150,11,0,50,218,5,26,19,36,31,55,133,272,3,943,52,0,2,1,1,0
39891,58,1166,410,198,237,31,55,97,441,11,63,38,72,74,110,414,683,6,4293,238,0,2,1,1,0
39892,30,919,256,139,192,9,7,47,265,4,23,12,24,27,36,112,171,2,357,19,0,2,1,1,0
39893,216,4979,182,127,129,0,0,53,182,5,39,21,42,44,63,217,343,2,926,51,0,2,17,10,0
39894,216,4979,1165,710,800,67,119,181,1232,18,243,153,282,261,435,2000,3492,10,36473,2026,1,2,17,10,0
39895,67,1549,773,419,590,28,0,166,801,10,204,113,217,214,330,1598,2554,5,13587,754,0,2,7,6,0
39896,67,1549,421,273,302,44,34,57,465,17,81,59,107,98,166,583,1098,11,12329,684,0,2,7,6,0
39897,27,568,2,2,2,0,0,0,2,0,0,0,0,0,0,0,0,0,0,0,0,2,8,3,0
39898,27,568,99,48,90,1,3,5,100,0,0,0,0,0,0,0,0,0,0,0,0,2,8,3,0
39899,27,568,8,5,5,2,0,1,10,0,0,0,0,0,0,0,0,0,0,0,0,2,8,3,0
39900,27,568,1217,716,841,84,126,174,1301,14,185,118,215,199,333,1446,2542,8,20687,1149,0,2,8,3,0
39901,27,568,160,89,115,0,13,31,160,7,15,11,17,22,28,78,124,3,495,27,0,2,8,3,0
39902,27,568,10,10,9,9,0,0,19,0,0,0,0,0,0,0,0,0,0,0,0,2,8,3,0
39903,27,568,173,84,99,8,29,36,181,5,12,7,13,17,20,54,81,2,221,12,0,2,8,3,0
39904,27,568,3,1,1,3,0,0,6,0,0,0,0,0,0,0,0,0,0,0,0,2,8,3,0
39905,183,5421,1660,832,1314,41,38,274,1701,20,312,209,395,332,604,2671,5058,12,64042,3557,1,2,28,22,0
39906,183,5421,1057,646,719,113,100,145,1170,18,215,134,248,233,382,1740,3004,10,31186,1732,1,2,28,22,0
39907,114,2099,477,336,357,30,23,73,507,16,194,134,250,210,384,1538,2962,10,30538,1696,0,2,9,6,0
39908,238,5067,2,2,2,0,0,0,2,0,0,0,0,0,0,0,0,0,0,0,0,2,33,17,0
39909,238,5067,99,48,90,1,3,5,100,0,0,0,0,0,0,0,0,0,0,0,0,2,33,17,0
39910,238,5067,8,5,5,2,0,1,10,0,0,0,0,0,0,0,0,0,0,0,0,2,33,17,0
39911,238,5067,1217,716,841,84,126,174,1301,14,185,118,215,199,333,1446,2542,8,20687,1149,0,2,33,17,0
39912,238,5067,160,89,115,0,13,31,160,7,15,11,17,22,28,78,124,3,495,27,0,2,33,17,0
39913,238,5067,10,10,9,9,0,0,19,0,0,0,0,0,0,0,0,0,0,0,0,2,33,17,0
39914,238,5067,173,84,99,8,29,36,181,5,12,7,13,17,20,54,81,2,221,12,0,2,33,17,0
39915,238,5067,3,1,1,3,0,0,6,0,0,0,0,0,0,0,0,0,0,0,0,2,33,17,0
39916,113,2326,463,295,324,28,62,57,491,12,134,82,154,146,236,989,1696,6,11700,650,0,2,24,14,0
39917,37,813,167,116,138,4,5,22,171,8,48,30,56,56,86,292,499,4,2330,129,0,2,11,1,0
39918,30,669,125,97,103,3,0,19,128,9,25,17,27,34,44,144,223,4,1087,60,0,2,2,0,0
39919,70,1526,402,202,227,24,74,80,426,12,52,33,61,64,94,339,564,7,3969,220,0,2,1,1,0
39920,73,1707,53,23,39,0,0,13,53,2,8,4,8,10,12,26,39,1,39,2,0,2,35,17,0
39921,73,1707,515,298,307,33,80,99,548,12,63,44,77,75,121,419,753,7,5527,307,0,2,35,17,0
39922,67,1752,466,257,367,18,25,50,484,7,126,86,171,133,257,898,1813,4,8612,478,0,2,4,3,0
39923,67,1752,507,281,342,29,59,88,536,10,53,29,57,63,86,336,514,5,2764,153,0,2,4,3,0
39924,87,1935,1043,504,840,53,9,147,1096,9,180,112,198,189,310,1377,2344,4,11604,644,0,2,17,5,0
39925,87,1935,383,288,292,26,6,62,409,11,65,38,67,76,105,429,656,5,3719,206,0,2,17,5,0
39926,216,4943,182,127,129,0,0,53,182,5,39,21,42,44,63,217,343,2,926,51,0,2,1,1,0
39927,216,4943,1165,710,800,67,119,181,1232,18,243,153,282,261,435,2000,3492,10,36473,2026,1,2,1,1,0
39928,58,1166,207,111,150,11,0,50,218,5,26,19,36,31,55,133,272,3,943,52,0,2,7,0,0
39929,58,1166,410,198,237,31,55,97,441,11,63,38,72,74,110,414,683,6,4293,238,0,2,7,0,0
39930,79,1961,757,253,292,73,244,162,830,13,61,38,67,74,105,409,651,7,4654,258,0,2,7,6,0
39931,20,987,386,256,301,16,9,68,402,4,59,35,69,63,104,355,621,2,1453,80,0,2,7,7,0
39932,20,987,264,131,164,11,41,46,275,6,38,22,40,44,62,214,338,3,1068,59,0,2,7,7,0
39933,30,919,256,139,192,9,7,47,265,4,23,12,24,27,36,112,171,2,357,19,0,2,8,8,0
39934,15,481,184,100,137,2,15,30,186,6,38,20,39,44,59,214,322,3,991,55,0,2,1,1,0
39935,15,481,103,65,74,8,5,16,111,7,17,9,17,24,26,89,119,3,417,23,0,2,1,1,0
39936,11,492,184,100,137,2,15,30,186,6,38,20,39,44,59,214,322,3,991,55,0,2,12,0,0
39937,15,481,184,100,137,2,15,30,186,6,38,20,39,44,59,214,322,3,991,55,0,2,1,1,0
39938,15,481,103,65,74,8,5,16,111,7,17,9,17,24,26,89,119,3,417,23,0,2,1,1,0
39939,11,492,184,100,137,2,15,30,186,6,38,20,39,44,59,214,322,3,991,55,0,2,12,0,0
39940,75,1811,466,257,367,18,25,50,484,7,126,86,171,133,257,898,1813,4,8612,478,0,2,116,89,0
39941,75,1811,507,281,342,29,59,88,536,10,53,29,57,63,86,336,514,5,2764,153,0,2,116,89,0
39942,31,956,182,127,129,0,0,53,182,5,39,21,42,44,63,217,343,2,926,51,0,2,3,7,0
39943,146,7027,1392,870,1177,35,17,170,1427,14,494,280,531,508,811,4473,7289,7,54850,3047,2,2,158,196,0
39944,15,359,127,75,83,2,11,30,129,4,14,7,14,18,21,61,87,2,175,9,0,2,33,0,0
39945,15,359,652,304,544,16,6,88,668,6,89,51,101,95,152,591,998,3,3399,188,0,2,33,0,0
39946,15,359,2,2,2,0,0,0,2,0,0,0,0,0,0,0,0,0,0,0,0,2,33,0,0
39947,15,359,8,5,5,0,0,3,8,0,0,0,0,0,0,0,0,0,0,0,0,2,33,0,0
39948,15,359,2,2,2,0,0,0,2,0,0,0,0,0,0,0,0,0,0,0,0,2,33,0,0
39949,15,359,14,8,8,0,0,6,14,0,0,0,0,0,0,0,0,0,0,0,0,2,33,0,0
39950,15,359,6,4,4,0,0,2,6,0,0,0,0,0,0,0,0,0,0,0,0,2,33,0,0
39951,15,359,6,4,4,0,0,2,6,1,2,1,2,3,3,2,4,0,2,0,0,2,33,0,0
39952,15,359,6,4,4,0,0,2,6,0,0,0,0,0,0,0,0,0,0,0,0,2,33,0,0
39953,15,359,7,5,5,0,0,2,7,0,0,0,0,0,0,0,0,0,0,0,0,2,33,0,0
39954,15,359,6,4,4,0,0,2,6,0,0,0,0,0,0,0,0,0,0,0,0,2,33,0,0
39955,15,359,10,6,6,0,0,4,10,0,0,0,0,0,0,0,0,0,0,0,0,2,33,0,0
39956,15,359,1,1,1,0,0,0,1,0,0,0,0,0,0,0,0,0,0,0,0,2,33,0,0
39957,15,359,1,1,1,0,0,0,1,0,0,0,0,0,0,0,0,0,0,0,0,2,33,0,0
39958,15,359,14,10,10,0,0,4,14,1,1,1,1,2,2,0,2,0,1,0,0,2,33,0,0
39959,15,359,46,26,30,3,0,12,49,3,6,3,6,9,9,20,28,1,42,2,0,2,33,0,0
39960,239,5045,2,2,2,0,0,0,2,0,0,0,0,0,0,0,0,0,0,0,0,2,13,6,1
39961,239,5045,99,48,90,1,3,5,100,0,0,0,0,0,0,0,0,0,0,0,0,2,13,6,1
39962,239,5045,8,5,5,2,0,1,10,0,0,0,0,0,0,0,0,0,0,0,0,2,13,6,1
39963,239,5045,1217,716,841,84,126,174,1301,14,185,118,215,199,333,1446,2542,8,20687,1149,0,2,13,6,1
39964,239,5045,160,89,115,0,13,31,160,7,15,11,17,22,28,78,124,3,495,27,0,2,13,6,1
39965,239,5045,10,10,9,9,0,0,19,0,0,0,0,0,0,0,0,0,0,0,0,2,13,6,1
39966,239,5045,173,84,99,8,29,36,181,5,12,7,13,17,20,54,81,2,221,12,0,2,13,6,1
39967,239,5045,3,1,1,3,0,0,6,0,0,0,0,0,0,0,0,0,0,0,0,2,13,6,1
39968,45,2802,652,304,544,16,6,88,668,6,89,51,101,95,152,591,998,3,3399,188,0,2,24,5,1
39969,216,4974,182,127,129,0,0,53,182,5,39,21,42,44,63,217,343,2,926,51,0,2,1,1,0
39970,216,4974,1165,710,800,67,119,181,1232,18,243,153,282,261,435,2000,3492,10,36473,2026,1,2,1,1,0
39971,183,5415,1660,832,1314,41,38,274,1701,20,312,209,395,332,604,2671,5058,12,64042,3557,1,2,1,4,0
39972,183,5415,1057,646,719,113,100,145,1170,18,215,134,248,233,382,1740,3004,10,31186,1732,1,2,1,4,0
39973,58,1166,207,111,150,11,0,50,218,5,26,19,36,31,55,133,272,3,943,52,0,2,9,2,0
39974,58,1166,410,198,237,31,55,97,441,11,63,38,72,74,110,414,683,6,4293,238,0,2,9,2,0
39975,15,481,184,100,137,2,15,30,186,6,38,20,39,44,59,214,322,3,991,55,0,2,1,1,0
39976,15,481,103,65,74,8,5,16,111,7,17,9,17,24,26,89,119,3,417,23,0,2,1,1,0
39977,79,1961,757,253,292,73,244,162,830,13,61,38,67,74,105,409,651,7,4654,258,0,2,7,6,0
39978,20,987,386,256,301,16,9,68,402,4,59,35,69,63,104,355,621,2,1453,80,0,2,7,7,0
39979,20,987,264,131,164,11,41,46,275,6,38,22,40,44,62,214,338,3,1068,59,0,2,7,7,0
39980,176,7695,4293,999,3693,19,54,507,4312,9,155,88,170,164,258,1156,1898,4,9368,520,0,2,10,10,0
39981,176,7695,1482,859,1002,125,135,219,1607,16,219,134,251,235,385,1766,3032,9,27804,1544,1,2,10,10,0
39982,30,919,256,139,192,9,7,47,265,4,23,12,24,27,36,112,171,2,357,19,0,2,8,8,0
39983,122,4963,1450,624,1228,12,26,181,1462,14,306,186,354,320,540,2580,4493,8,36391,2021,1,2,27,5,0
39984,11,492,184,100,137,2,15,30,186,6,38,20,39,44,59,214,322,3,991,55,0,2,12,0,0
39985,216,4974,182,127,129,0,0,53,182,5,39,21,42,44,63,217,343,2,926,51,0,2,1,1,0
39986,216,4974,1165,710,800,67,119,181,1232,18,243,153,282,261,435,2000,3492,10,36473,2026,1,2,1,1,0
39987,183,5415,1660,832,1314,41,38,274,1701,20,312,209,395,332,604,2671,5058,12,64042,3557,1,2,1,4,0
39988,183,5415,1057,646,719,113,100,145,1170,18,215,134,248,233,382,1740,3004,10,31186,1732,1,2,1,4,0
39989,58,1166,207,111,150,11,0,50,218,5,26,19,36,31,55,133,272,3,943,52,0,2,9,2,0
39990,58,1166,410,198,237,31,55,97,441,11,63,38,72,74,110,414,683,6,4293,238,0,2,9,2,0
39991,15,481,184,100,137,2,15,30,186,6,38,20,39,44,59,214,322,3,991,55,0,2,1,1,0
39992,15,481,103,65,74,8,5,16,111,7,17,9,17,24,26,89,119,3,417,23,0,2,1,1,0
39993,79,1961,757,253,292,73,244,162,830,13,61,38,67,74,105,409,651,7,4654,258,0,2,7,6,0
39994,20,987,386,256,301,16,9,68,402,4,59,35,69,63,104,355,621,2,1453,80,0,2,7,7,0
39995,20,987,264,131,164,11,41,46,275,6,38,22,40,44,62,214,338,3,1068,59,0,2,7,7,0
39996,176,7695,4293,999,3693,19,54,507,4312,9,155,88,170,164,258,1156,1898,4,9368,520,0,2,10,10,0
39997,176,7695,1482,859,1002,125,135,219,1607,16,219,134,251,235,385,1766,3032,9,27804,1544,1,2,10,10,0
39998,30,919,256,139,192,9,7,47,265,4,23,12,24,27,36,112,171,2,357,19,0,2,8,8,0
39999,122,4963,1450,624,1228,12,26,181,1462,14,306,186,354,320,540,2580,4493,8,36391,2021,1,2,27,5,0
40000,11,492,184,100,137,2,15,30,186,6,38,20,39,44,59,214,322,3,991,55,0,2,12,0,0
40001,16,491,184,100,137,2,15,30,186,6,38,20,39,44,59,214,322,3,991,55,0,2,9,4,0
40002,16,491,103,65,74,8,5,16,111,7,17,9,17,24,26,89,119,3,417,23,0,2,9,4,0
40003,18,697,184,100,137,2,15,30,186,6,38,20,39,44,59,214,322,3,991,55,0,2,55,1,0
40004,45,2806,652,304,544,16,6,88,668,6,89,51,101,95,152,591,998,3,3399,188,0,2,6,8,1
40005,238,5023,2,2,2,0,0,0,2,0,0,0,0,0,0,0,0,0,0,0,0,2,4,7,1
40006,238,5023,99,48,90,1,3,5,100,0,0,0,0,0,0,0,0,0,0,0,0,2,4,7,1
40007,238,5023,8,5,5,2,0,1,10,0,0,0,0,0,0,0,0,0,0,0,0,2,4,7,1
40008,238,5023,1217,716,841,84,126,174,1301,14,185,118,215,199,333,1446,2542,8,20687,1149,0,2,4,7,1
40009,238,5023,160,89,115,0,13,31,160,7,15,11,17,22,28,78,124,3,495,27,0,2,4,7,1
40010,238,5023,10,10,9,9,0,0,19,0,0,0,0,0,0,0,0,0,0,0,0,2,4,7,1
40011,238,5023,173,84,99,8,29,36,181,5,12,7,13,17,20,54,81,2,221,12,0,2,4,7,1
40012,238,5023,3,1,1,3,0,0,6,0,0,0,0,0,0,0,0,0,0,0,0,2,4,7,1
40013,65,1385,91,45,69,0,3,18,91,3,9,6,10,12,16,33,57,1,95,5,0,2,10,0,1
40014,65,1385,367,234,237,17,34,68,384,16,55,34,61,71,95,381,584,8,5183,287,0,2,10,0,1
40015,45,2806,652,304,544,16,6,88,668,6,89,51,101,95,152,591,998,3,3399,188,0,2,5,5,1
40016,238,5023,2,2,2,0,0,0,2,0,0,0,0,0,0,0,0,0,0,0,0,2,10,6,0
40017,238,5023,99,48,90,1,3,5,100,0,0,0,0,0,0,0,0,0,0,0,0,2,10,6,0
40018,238,5023,8,5,5,2,0,1,10,0,0,0,0,0,0,0,0,0,0,0,0,2,10,6,0
40019,238,5023,1217,716,841,84,126,174,1301,14,185,118,215,199,333,1446,2542,8,20687,1149,0,2,10,6,0
40020,238,5023,160,89,115,0,13,31,160,7,15,11,17,22,28,78,124,3,495,27,0,2,10,6,0
40021,238,5023,10,10,9,9,0,0,19,0,0,0,0,0,0,0,0,0,0,0,0,2,10,6,0
40022,238,5023,173,84,99,8,29,36,181,5,12,7,13,17,20,54,81,2,221,12,0,2,10,6,0
40023,238,5023,3,1,1,3,0,0,6,0,0,0,0,0,0,0,0,0,0,0,0,2,10,6,0
40024,65,1385,91,45,69,0,3,18,91,3,9,6,10,12,16,33,57,1,95,5,0,2,10,0,0
40025,65,1385,367,234,237,17,34,68,384,16,55,34,61,71,95,381,584,8,5183,287,0,2,10,0,0
40026,45,2806,652,304,544,16,6,88,668,6,89,51,101,95,152,591,998,3,3399,188,0,2,21,4,0
40027,252,5837,4293,999,3693,19,54,507,4312,9,155,88,170,164,258,1156,1898,4,9368,520,0,2,5,2,0
40028,252,5837,1482,859,1002,125,135,219,1607,16,219,134,251,235,385,1766,3032,9,27804,1544,1,2,5,2,0
40029,177,7722,4293,999,3693,19,54,507,4312,9,155,88,170,164,258,1156,1898,4,9368,520,0,2,44,1,0
40030,177,7722,1482,859,1002,125,135,219,1607,16,219,134,251,235,385,1766,3032,9,27804,1544,1,2,44,1,0
40031,79,1938,466,257,367,18,25,50,484,7,126,86,171,133,257,898,1813,4,8612,478,0,2,46,19,0
40032,79,1938,507,281,342,29,59,88,536,10,53,29,57,63,86,336,514,5,2764,153,0,2,46,19,0
40033,31,1843,466,257,367,18,25,50,484,7,126,86,171,133,257,898,1813,4,8612,478,0,2,72,2,0
40034,16,491,184,100,137,2,15,30,186,6,38,20,39,44,59,214,322,3,991,55,0,2,9,4,0
40035,16,491,103,65,74,8,5,16,111,7,17,9,17,24,26,89,119,3,417,23,0,2,9,4,0
40036,18,697,184,100,137,2,15,30,186,6,38,20,39,44,59,214,322,3,991,55,0,2,55,1,0
40037,79,1938,466,257,367,18,25,50,484,7,126,86,171,133,257,898,1813,4,8612,478,0,2,143,89,0
40038,79,1938,507,281,342,29,59,88,536,10,53,29,57,63,86,336,514,5,2764,153,0,2,143,89,0
40039,31,956,182,127,129,0,0,53,182,5,39,21,42,44,63,217,343,2,926,51,0,2,3,7,0
40040,146,7027,1392,870,1177,35,17,170,1427,14,494,280,531,508,811,4473,7289,7,54850,3047,2,2,158,196,0
40041,15,359,127,75,83,2,11,30,129,4,14,7,14,18,21,61,87,2,175,9,0,2,33,0,0
40042,15,359,652,304,544,16,6,88,668,6,89,51,101,95,152,591,998,3,3399,188,0,2,33,0,0
40043,15,359,2,2,2,0,0,0,2,0,0,0,0,0,0,0,0,0,0,0,0,2,33,0,0
40044,15,359,8,5,5,0,0,3,8,0,0,0,0,0,0,0,0,0,0,0,0,2,33,0,0
40045,15,359,2,2,2,0,0,0,2,0,0,0,0,0,0,0,0,0,0,0,0,2,33,0,0
40046,15,359,14,8,8,0,0,6,14,0,0,0,0,0,0,0,0,0,0,0,0,2,33,0,0
40047,15,359,6,4,4,0,0,2,6,0,0,0,0,0,0,0,0,0,0,0,0,2,33,0,0
40048,15,359,6,4,4,0,0,2,6,1,2,1,2,3,3,2,4,0,2,0,0,2,33,0,0
40049,15,359,6,4,4,0,0,2,6,0,0,0,0,0,0,0,0,0,0,0,0,2,33,0,0
40050,15,359,7,5,5,0,0,2,7,0,0,0,0,0,0,0,0,0,0,0,0,2,33,0,0
40051,15,359,6,4,4,0,0,2,6,0,0,0,0,0,0,0,0,0,0,0,0,2,33,0,0
40052,15,359,10,6,6,0,0,4,10,0,0,0,0,0,0,0,0,0,0,0,0,2,33,0,0
40053,15,359,1,1,1,0,0,0,1,0,0,0,0,0,0,0,0,0,0,0,0,2,33,0,0
40054,15,359,1,1,1,0,0,0,1,0,0,0,0,0,0,0,0,0,0,0,0,2,33,0,0
40055,15,359,14,10,10,0,0,4,14,1,1,1,1,2,2,0,2,0,1,0,0,2,33,0,0
40056,15,359,46,26,30,3,0,12,49,3,6,3,6,9,9,20,28,1,42,2,0,2,33,0,0
40057,31,1843,466,257,367,18,25,50,484,7,126,86,171,133,257,898,1813,4,8612,478,0,2,72,2,0
40058,177,7723,4293,999,3693,19,54,507,4312,9,155,88,170,164,258,1156,1898,4,9368,520,0,2,28,18,0
40059,177,7723,1482,859,1002,125,135,219,1607,16,219,134,251,235,385,1766,3032,9,27804,1544,1,2,28,18,0
40060,252,5831,4293,999,3693,19,54,507,4312,9,155,88,170,164,258,1156,1898,4,9368,520,0,2,2,0,0
40061,252,5831,1482,859,1002,125,135,219,1607,16,219,134,251,235,385,1766,3032,9,27804,1544,1,2,2,0,0
40062,177,7731,4293,999,3693,19,54,507,4312,9,155,88,170,164,258,1156,1898,4,9368,520,0,2,3,0,0
40063,177,7731,1482,859,1002,125,135,219,1607,16,219,134,251,235,385,1766,3032,9,27804,1544,1,2,3,0,0
40064,216,4943,182,127,129,0,0,53,182,5,39,21,42,44,63,217,343,2,926,51,0,2,1,1,0
40065,216,4943,1165,710,800,67,119,181,1232,18,243,153,282,261,435,2000,3492,10,36473,2026,1,2,1,1,0
40066,58,1166,207,111,150,11,0,50,218,5,26,19,36,31,55,133,272,3,943,52,0,2,7,0,0
40067,58,1166,410,198,237,31,55,97,441,11,63,38,72,74,110,414,683,6,4293,238,0,2,7,0,0
40068,238,5023,2,2,2,0,0,0,2,0,0,0,0,0,0,0,0,0,0,0,0,2,10,6,0
40069,238,5023,99,48,90,1,3,5,100,0,0,0,0,0,0,0,0,0,0,0,0,2,10,6,0
40070,238,5023,8,5,5,2,0,1,10,0,0,0,0,0,0,0,0,0,0,0,0,2,10,6,0
40071,238,5023,1217,716,841,84,126,174,1301,14,185,118,215,199,333,1446,2542,8,20687,1149,0,2,10,6,0
40072,238,5023,160,89,115,0,13,31,160,7,15,11,17,22,28,78,124,3,495,27,0,2,10,6,0
40073,238,5023,10,10,9,9,0,0,19,0,0,0,0,0,0,0,0,0,0,0,0,2,10,6,0
40074,238,5023,173,84,99,8,29,36,181,5,12,7,13,17,20,54,81,2,221,12,0,2,10,6,0
40075,238,5023,3,1,1,3,0,0,6,0,0,0,0,0,0,0,0,0,0,0,0,2,10,6,0
40076,15,481,184,100,137,2,15,30,186,6,38,20,39,44,59,214,322,3,991,55,0,2,1,1,0
40077,15,481,103,65,74,8,5,16,111,7,17,9,17,24,26,89,119,3,417,23,0,2,1,1,0
40078,65,1385,91,45,69,0,3,18,91,3,9,6,10,12,16,33,57,1,95,5,0,2,10,0,0
40079,65,1385,367,234,237,17,34,68,384,16,55,34,61,71,95,381,584,8,5183,287,0,2,10,0,0
40080,79,1961,757,253,292,73,244,162,830,13,61,38,67,74,105,409,651,7,4654,258,0,2,7,6,0
40081,20,987,386,256,301,16,9,68,402,4,59,35,69,63,104,355,621,2,1453,80,0,2,7,7,0
40082,20,987,264,131,164,11,41,46,275,6,38,22,40,44,62,214,338,3,1068,59,0,2,7,7,0
40083,79,1938,466,257,367,18,25,50,484,7,126,86,171,133,257,898,1813,4,8612,478,0,2,143,89,0
40084,79,1938,507,281,342,29,59,88,536,10,53,29,57,63,86,336,514,5,2764,153,0,2,143,89,0
40085,31,956,182,127,129,0,0,53,182,5,39,21,42,44,63,217,343,2,926,51,0,2,3,7,0
40086,146,7027,1392,870,1177,35,17,170,1427,14,494,280,531,508,811,4473,7289,7,54850,3047,2,2,158,196,0
40087,15,359,127,75,83,2,11,30,129,4,14,7,14,18,21,61,87,2,175,9,0,2,33,0,0
40088,15,359,652,304,544,16,6,88,668,6,89,51,101,95,152,591,998,3,3399,188,0,2,33,0,0
40089,15,359,2,2,2,0,0,0,2,0,0,0,0,0,0,0,0,0,0,0,0,2,33,0,0
40090,15,359,8,5,5,0,0,3,8,0,0,0,0,0,0,0,0,0,0,0,0,2,33,0,0
40091,15,359,2,2,2,0,0,0,2,0,0,0,0,0,0,0,0,0,0,0,0,2,33,0,0
40092,15,359,14,8,8,0,0,6,14,0,0,0,0,0,0,0,0,0,0,0,0,2,33,0,0
40093,15,359,6,4,4,0,0,2,6,0,0,0,0,0,0,0,0,0,0,0,0,2,33,0,0
40094,15,359,6,4,4,0,0,2,6,1,2,1,2,3,3,2,4,0,2,0,0,2,33,0,0
40095,15,359,6,4,4,0,0,2,6,0,0,0,0,0,0,0,0,0,0,0,0,2,33,0,0
40096,15,359,7,5,5,0,0,2,7,0,0,0,0,0,0,0,0,0,0,0,0,2,33,0,0
40097,15,359,6,4,4,0,0,2,6,0,0,0,0,0,0,0,0,0,0,0,0,2,33,0,0
40098,15,359,10,6,6,0,0,4,10,0,0,0,0,0,0,0,0,0,0,0,0,2,33,0,0
40099,15,359,1,1,1,0,0,0,1,0,0,0,0,0,0,0,0,0,0,0,0,2,33,0,0
40100,15,359,1,1,1,0,0,0,1,0,0,0,0,0,0,0,0,0,0,0,0,2,33,0,0
40101,15,359,14,10,10,0,0,4,14,1,1,1,1,2,2,0,2,0,1,0,0,2,33,0,0
40102,15,359,46,26,30,3,0,12,49,3,6,3,6,9,9,20,28,1,42,2,0,2,33,0,0
40103,30,919,256,139,192,9,7,47,265,4,23,12,24,27,36,112,171,2,357,19,0,2,8,8,0
40104,45,2806,652,304,544,16,6,88,668,6,89,51,101,95,152,591,998,3,3399,188,0,2,21,4,0
40105,11,492,184,100,137,2,15,30,186,6,38,20,39,44,59,214,322,3,991,55,0,2,12,0,0
40106,31,1843,466,257,367,18,25,50,484,7,126,86,171,133,257,898,1813,4,8612,478,0,2,72,2,0
40107,252,5837,4293,999,3693,19,54,507,4312,9,155,88,170,164,258,1156,1898,4,9368,520,0,2,5,2,0
40108,252,5837,1482,859,1002,125,135,219,1607,16,219,134,251,235,385,1766,3032,9,27804,1544,1,2,5,2,0
40109,177,7723,4293,999,3693,19,54,507,4312,9,155,88,170,164,258,1156,1898,4,9368,520,0,2,54,1,0
40110,177,7723,1482,859,1002,125,135,219,1607,16,219,134,251,235,385,1766,3032,9,27804,1544,1,2,54,1,0
40111,254,5861,4293,999,3693,19,54,507,4312,9,155,88,170,164,258,1156,1898,4,9368,520,0,2,6,0,0
40112,254,5861,1482,859,1002,125,135,219,1607,16,219,134,251,235,385,1766,3032,9,27804,1544,1,2,6,0,0
40113,178,7759,4293,999,3693,19,54,507,4312,9,155,88,170,164,258,1156,1898,4,9368,520,0,2,32,0,0
40114,178,7759,1482,859,1002,125,135,219,1607,16,219,134,251,235,385,1766,3032,9,27804,1544,1,2,32,0,0
40115,16,491,184,100,137,2,15,30,186,6,38,20,39,44,59,214,322,3,991,55,0,2,1,1,0
40116,16,491,103,65,74,8,5,16,111,7,17,9,17,24,26,89,119,3,417,23,0,2,1,1,0
40117,18,697,184,100,137,2,15,30,186,6,38,20,39,44,59,214,322,3,991,55,0,2,1,1,0
40118,3,65,127,75,83,2,11,30,129,4,14,7,14,18,21,61,87,2,175,9,0,2,1,1,1
40119,3,65,652,304,544,16,6,88,668,6,89,51,101,95,152,591,998,3,3399,188,0,2,1,1,1
40120,3,65,2,2,2,0,0,0,2,0,0,0,0,0,0,0,0,0,0,0,0,2,1,1,1
40121,3,65,8,5,5,0,0,3,8,0,0,0,0,0,0,0,0,0,0,0,0,2,1,1,1
40122,3,65,2,2,2,0,0,0,2,0,0,0,0,0,0,0,0,0,0,0,0,2,1,1,1
40123,3,65,14,8,8,0,0,6,14,0,0,0,0,0,0,0,0,0,0,0,0,2,1,1,1
40124,3,65,6,4,4,0,0,2,6,0,0,0,0,0,0,0,0,0,0,0,0,2,1,1,1
40125,3,65,6,4,4,0,0,2,6,1,2,1,2,3,3,2,4,0,2,0,0,2,1,1,1
40126,3,65,6,4,4,0,0,2,6,0,0,0,0,0,0,0,0,0,0,0,0,2,1,1,1
40127,3,65,7,5,5,0,0,2,7,0,0,0,0,0,0,0,0,0,0,0,0,2,1,1,1
40128,3,65,6,4,4,0,0,2,6,0,0,0,0,0,0,0,0,0,0,0,0,2,1,1,1
40129,3,65,10,6,6,0,0,4,10,0,0,0,0,0,0,0,0,0,0,0,0,2,1,1,1
40130,3,65,1,1,1,0,0,0,1,0,0,0,0,0,0,0,0,0,0,0,0,2,1,1,1
40131,3,65,1,1,1,0,0,0,1,0,0,0,0,0,0,0,0,0,0,0,0,2,1,1,1
40132,3,65,14,10,10,0,0,4,14,1,1,1,1,2,2,0,2,0,1,0,0,2,1,1,1
40133,3,65,46,26,30,3,0,12,49,3,6,3,6,9,9,20,28,1,42,2,0,2,1,1,1
40134,260,6091,4293,999,3693,19,54,507,4312,9,155,88,170,164,258,1156,1898,4,9368,520,0,2,73,6,1
40135,260,6091,1482,859,1002,125,135,219,1607,16,219,134,251,235,385,1766,3032,9,27804,1544,1,2,73,6,1
40136,180,7835,4293,999,3693,19,54,507,4312,9,155,88,170,164,258,1156,1898,4,9368,520,0,2,113,0,1
40137,180,7835,1482,859,1002,125,135,219,1607,16,219,134,251,235,385,1766,3032,9,27804,1544,1,2,113,0,1
40138,16,491,184,100,137,2,15,30,186,6,38,20,39,44,59,214,322,3,991,55,0,2,1,1,0
40139,16,491,103,65,74,8,5,16,111,7,17,9,17,24,26,89,119,3,417,23,0,2,1,1,0
40140,18,697,184,100,137,2,15,30,186,6,38,20,39,44,59,214,322,3,991,55,0,2,1,1,0
40141,74,3931,1293,570,1093,25,15,163,1318,10,195,123,241,205,364,1516,2795,6,17273,959,0,2,1,1,0
40142,74,3931,1293,570,1093,25,15,163,1318,10,195,123,241,205,364,1516,2795,6,17273,959,0,2,1,1,0
40143,161,3434,1513,682,1277,25,13,200,1538,11,199,116,219,210,335,1557,2584,6,15641,868,0,2,5,1,0
40144,161,3434,819,519,539,24,98,155,843,15,96,57,106,111,163,690,1107,8,9171,509,0,2,5,1,0
40145,161,3434,1513,682,1277,25,13,200,1538,11,199,116,219,210,335,1557,2584,6,15641,868,0,2,5,1,0
40146,161,3434,819,519,539,24,98,155,843,15,96,57,106,111,163,690,1107,8,9171,509,0,2,5,1,0
40147,257,6183,4293,999,3693,19,54,507,4312,9,155,88,170,164,258,1156,1898,4,9368,520,0,2,44,5,0
40148,257,6183,1482,859,1002,125,135,219,1607,16,219,134,251,235,385,1766,3032,9,27804,1544,1,2,44,5,0
40149,238,5010,2,2,2,0,0,0,2,0,0,0,0,0,0,0,0,0,0,0,0,2,6,10,0
40150,238,5010,99,48,90,1,3,5,100,0,0,0,0,0,0,0,0,0,0,0,0,2,6,10,0
40151,238,5010,8,5,5,2,0,1,10,0,0,0,0,0,0,0,0,0,0,0,0,2,6,10,0
40152,238,5010,1217,716,841,84,126,174,1301,14,185,118,215,199,333,1446,2542,8,20687,1149,0,2,6,10,0
40153,238,5010,160,89,115,0,13,31,160,7,15,11,17,22,28,78,124,3,495,27,0,2,6,10,0
40154,238,5010,10,10,9,9,0,0,19,0,0,0,0,0,0,0,0,0,0,0,0,2,6,10,0
40155,238,5010,173,84,99,8,29,36,181,5,12,7,13,17,20,54,81,2,221,12,0,2,6,10,0
40156,238,5010,3,1,1,3,0,0,6,0,0,0,0,0,0,0,0,0,0,0,0,2,6,10,0
40157,64,1354,91,45,69,0,3,18,91,3,9,6,10,12,16,33,57,1,95,5,0,2,0,10,0
40158,64,1354,367,234,237,17,34,68,384,16,55,34,61,71,95,381,584,8,5183,287,0,2,0,10,0
40159,43,2669,652,304,544,16,6,88,668,6,89,51,101,95,152,591,998,3,3399,188,0,2,4,21,0
40160,238,5019,2,2,2,0,0,0,2,0,0,0,0,0,0,0,0,0,0,0,0,2,9,6,0
40161,238,5019,99,48,90,1,3,5,100,0,0,0,0,0,0,0,0,0,0,0,0,2,9,6,0
40162,238,5019,8,5,5,2,0,1,10,0,0,0,0,0,0,0,0,0,0,0,0,2,9,6,0
40163,238,5019,1217,716,841,84,126,174,1301,14,185,118,215,199,333,1446,2542,8,20687,1149,0,2,9,6,0
40164,238,5019,160,89,115,0,13,31,160,7,15,11,17,22,28,78,124,3,495,27,0,2,9,6,0
40165,238,5019,10,10,9,9,0,0,19,0,0,0,0,0,0,0,0,0,0,0,0,2,9,6,0
40166,238,5019,173,84,99,8,29,36,181,5,12,7,13,17,20,54,81,2,221,12,0,2,9,6,0
40167,238,5019,3,1,1,3,0,0,6,0,0,0,0,0,0,0,0,0,0,0,0,2,9,6,0
40168,46,2854,652,304,544,16,6,88,668,6,89,51,101,95,152,591,998,3,3399,188,0,2,30,2,0
40169,238,5019,2,2,2,0,0,0,2,0,0,0,0,0,0,0,0,0,0,0,0,2,8,9,0
40170,238,5019,99,48,90,1,3,5,100,0,0,0,0,0,0,0,0,0,0,0,0,2,8,9,0
40171,238,5019,8,5,5,2,0,1,10,0,0,0,0,0,0,0,0,0,0,0,0,2,8,9,0
40172,238,5019,1217,716,841,84,126,174,1301,14,185,118,215,199,333,1446,2542,8,20687,1149,0,2,8,9,0
40173,238,5019,160,89,115,0,13,31,160,7,15,11,17,22,28,78,124,3,495,27,0,2,8,9,0
40174,238,5019,10,10,9,9,0,0,19,0,0,0,0,0,0,0,0,0,0,0,0,2,8,9,0
40175,238,5019,173,84,99,8,29,36,181,5,12,7,13,17,20,54,81,2,221,12,0,2,8,9,0
40176,238,5019,3,1,1,3,0,0,6,0,0,0,0,0,0,0,0,0,0,0,0,2,8,9,0
40177,64,1354,91,45,69,0,3,18,91,3,9,6,10,12,16,33,57,1,95,5,0,2,0,10,0
40178,64,1354,367,234,237,17,34,68,384,16,55,34,61,71,95,381,584,8,5183,287,0,2,0,10,0
40179,46,2854,652,304,544,16,6,88,668,6,89,51,101,95,152,591,998,3,3399,188,0,2,19,8,0
40180,76,1631,53,23,39,0,0,13,53,2,8,4,8,10,12,26,39,1,39,2,0,2,1,3,0
40181,76,1631,515,298,307,33,80,99,548,12,63,44,77,75,121,419,753,7,5527,307,0,2,1,3,0
40182,146,7064,1392,870,1177,35,17,170,1427,14,494,280,531,508,811,4473,7289,7,54850,3047,2,2,7,0,0
40183,76,1631,53,23,39,0,0,13,53,2,8,4,8,10,12,26,39,1,39,2,0,2,1,3,0
40184,76,1631,515,298,307,33,80,99,548,12,63,44,77,75,121,419,753,7,5527,307,0,2,1,3,0
40185,146,7064,1392,870,1177,35,17,170,1427,14,494,280,531,508,811,4473,7289,7,54850,3047,2,2,7,0,0
40186,161,3434,1513,682,1277,25,13,200,1538,11,199,116,219,210,335,1557,2584,6,15641,868,0,2,5,1,0
40187,161,3434,819,519,539,24,98,155,843,15,96,57,106,111,163,690,1107,8,9171,509,0,2,5,1,0
40188,238,5076,2,2,2,0,0,0,2,0,0,0,0,0,0,0,0,0,0,0,0,2,9,6,0
40189,238,5076,99,48,90,1,3,5,100,0,0,0,0,0,0,0,0,0,0,0,0,2,9,6,0
40190,238,5076,8,5,5,2,0,1,10,0,0,0,0,0,0,0,0,0,0,0,0,2,9,6,0
40191,238,5076,1217,716,841,84,126,174,1301,14,185,118,215,199,333,1446,2542,8,20687,1149,0,2,9,6,0
40192,238,5076,160,89,115,0,13,31,160,7,15,11,17,22,28,78,124,3,495,27,0,2,9,6,0
40193,238,5076,10,10,9,9,0,0,19,0,0,0,0,0,0,0,0,0,0,0,0,2,9,6,0
40194,238,5076,173,84,99,8,29,36,181,5,12,7,13,17,20,54,81,2,221,12,0,2,9,6,0
40195,238,5076,3,1,1,3,0,0,6,0,0,0,0,0,0,0,0,0,0,0,0,2,9,6,0
40196,254,5861,4293,999,3693,19,54,507,4312,9,155,88,170,164,258,1156,1898,4,9368,520,0,2,11,2,0
40197,254,5861,1482,859,1002,125,135,219,1607,16,219,134,251,235,385,1766,3032,9,27804,1544,1,2,11,2,0
40198,73,1701,53,23,39,0,0,13,53,2,8,4,8,10,12,26,39,1,39,2,0,2,1,3,0
40199,73,1701,515,298,307,33,80,99,548,12,63,44,77,75,121,419,753,7,5527,307,0,2,1,3,0
40200,79,1942,466,257,367,18,25,50,484,7,126,86,171,133,257,898,1813,4,8612,478,0,2,143,88,0
40201,79,1942,507,281,342,29,59,88,536,10,53,29,57,63,86,336,514,5,2764,153,0,2,143,88,0
40202,31,956,182,127,129,0,0,53,182,5,39,21,42,44,63,217,343,2,926,51,0,2,3,7,0
40203,146,7064,1392,870,1177,35,17,170,1427,14,494,280,531,508,811,4473,7289,7,54850,3047,2,2,165,196,0
40204,15,359,127,75,83,2,11,30,129,4,14,7,14,18,21,61,87,2,175,9,0,2,33,0,0
40205,15,359,652,304,544,16,6,88,668,6,89,51,101,95,152,591,998,3,3399,188,0,2,33,0,0
40206,15,359,2,2,2,0,0,0,2,0,0,0,0,0,0,0,0,0,0,0,0,2,33,0,0
40207,15,359,8,5,5,0,0,3,8,0,0,0,0,0,0,0,0,0,0,0,0,2,33,0,0
40208,15,359,2,2,2,0,0,0,2,0,0,0,0,0,0,0,0,0,0,0,0,2,33,0,0
40209,15,359,14,8,8,0,0,6,14,0,0,0,0,0,0,0,0,0,0,0,0,2,33,0,0
40210,15,359,6,4,4,0,0,2,6,0,0,0,0,0,0,0,0,0,0,0,0,2,33,0,0
40211,15,359,6,4,4,0,0,2,6,1,2,1,2,3,3,2,4,0,2,0,0,2,33,0,0
40212,15,359,6,4,4,0,0,2,6,0,0,0,0,0,0,0,0,0,0,0,0,2,33,0,0
40213,15,359,7,5,5,0,0,2,7,0,0,0,0,0,0,0,0,0,0,0,0,2,33,0,0
40214,15,359,6,4,4,0,0,2,6,0,0,0,0,0,0,0,0,0,0,0,0,2,33,0,0
40215,15,359,10,6,6,0,0,4,10,0,0,0,0,0,0,0,0,0,0,0,0,2,33,0,0
40216,15,359,1,1,1,0,0,0,1,0,0,0,0,0,0,0,0,0,0,0,0,2,33,0,0
40217,15,359,1,1,1,0,0,0,1,0,0,0,0,0,0,0,0,0,0,0,0,2,33,0,0
40218,15,359,14,10,10,0,0,4,14,1,1,1,1,2,2,0,2,0,1,0,0,2,33,0,0
40219,15,359,46,26,30,3,0,12,49,3,6,3,6,9,9,20,28,1,42,2,0,2,33,0,0
40220,178,7759,4293,999,3693,19,54,507,4312,9,155,88,170,164,258,1156,1898,4,9368,520,0,2,86,1,0
40221,178,7759,1482,859,1002,125,135,219,1607,16,219,134,251,235,385,1766,3032,9,27804,1544,1,2,86,1,0
40222,46,2854,652,304,544,16,6,88,668,6,89,51,101,95,152,591,998,3,3399,188,0,2,30,2,0
40223,74,3931,1293,570,1093,25,15,163,1318,10,195,123,241,205,364,1516,2795,6,17273,959,0,2,1,1,0
40224,31,1843,466,257,367,18,25,50,484,7,126,86,171,133,257,898,1813,4,8612,478,0,2,72,2,0
40225,161,3434,1513,682,1277,25,13,200,1538,11,199,116,219,210,335,1557,2584,6,15641,868,0,2,5,1,0
40226,161,3434,819,519,539,24,98,155,843,15,96,57,106,111,163,690,1107,8,9171,509,0,2,5,1,0
40227,238,5076,2,2,2,0,0,0,2,0,0,0,0,0,0,0,0,0,0,0,0,2,9,6,0
40228,238,5076,99,48,90,1,3,5,100,0,0,0,0,0,0,0,0,0,0,0,0,2,9,6,0
40229,238,5076,8,5,5,2,0,1,10,0,0,0,0,0,0,0,0,0,0,0,0,2,9,6,0
40230,238,5076,1217,716,841,84,126,174,1301,14,185,118,215,199,333,1446,2542,8,20687,1149,0,2,9,6,0
40231,238,5076,160,89,115,0,13,31,160,7,15,11,17,22,28,78,124,3,495,27,0,2,9,6,0
40232,238,5076,10,10,9,9,0,0,19,0,0,0,0,0,0,0,0,0,0,0,0,2,9,6,0
40233,238,5076,173,84,99,8,29,36,181,5,12,7,13,17,20,54,81,2,221,12,0,2,9,6,0
40234,238,5076,3,1,1,3,0,0,6,0,0,0,0,0,0,0,0,0,0,0,0,2,9,6,0
40235,254,5861,4293,999,3693,19,54,507,4312,9,155,88,170,164,258,1156,1898,4,9368,520,0,2,11,2,0
40236,254,5861,1482,859,1002,125,135,219,1607,16,219,134,251,235,385,1766,3032,9,27804,1544,1,2,11,2,0
40237,73,1701,53,23,39,0,0,13,53,2,8,4,8,10,12,26,39,1,39,2,0,2,1,3,0
40238,73,1701,515,298,307,33,80,99,548,12,63,44,77,75,121,419,753,7,5527,307,0,2,1,3,0
40239,79,1942,466,257,367,18,25,50,484,7,126,86,171,133,257,898,1813,4,8612,478,0,2,143,88,0
40240,79,1942,507,281,342,29,59,88,536,10,53,29,57,63,86,336,514,5,2764,153,0,2,143,88,0
40241,31,956,182,127,129,0,0,53,182,5,39,21,42,44,63,217,343,2,926,51,0,2,3,7,0
40242,146,7064,1392,870,1177,35,17,170,1427,14,494,280,531,508,811,4473,7289,7,54850,3047,2,2,165,196,0
40243,15,359,127,75,83,2,11,30,129,4,14,7,14,18,21,61,87,2,175,9,0,2,33,0,0
40244,15,359,652,304,544,16,6,88,668,6,89,51,101,95,152,591,998,3,3399,188,0,2,33,0,0
40245,15,359,2,2,2,0,0,0,2,0,0,0,0,0,0,0,0,0,0,0,0,2,33,0,0
40246,15,359,8,5,5,0,0,3,8,0,0,0,0,0,0,0,0,0,0,0,0,2,33,0,0
40247,15,359,2,2,2,0,0,0,2,0,0,0,0,0,0,0,0,0,0,0,0,2,33,0,0
40248,15,359,14,8,8,0,0,6,14,0,0,0,0,0,0,0,0,0,0,0,0,2,33,0,0
40249,15,359,6,4,4,0,0,2,6,0,0,0,0,0,0,0,0,0,0,0,0,2,33,0,0
40250,15,359,6,4,4,0,0,2,6,1,2,1,2,3,3,2,4,0,2,0,0,2,33,0,0
40251,15,359,6,4,4,0,0,2,6,0,0,0,0,0,0,0,0,0,0,0,0,2,33,0,0
40252,15,359,7,5,5,0,0,2,7,0,0,0,0,0,0,0,0,0,0,0,0,2,33,0,0
40253,15,359,6,4,4,0,0,2,6,0,0,0,0,0,0,0,0,0,0,0,0,2,33,0,0
40254,15,359,10,6,6,0,0,4,10,0,0,0,0,0,0,0,0,0,0,0,0,2,33,0,0
40255,15,359,1,1,1,0,0,0,1,0,0,0,0,0,0,0,0,0,0,0,0,2,33,0,0
40256,15,359,1,1,1,0,0,0,1,0,0,0,0,0,0,0,0,0,0,0,0,2,33,0,0
40257,15,359,14,10,10,0,0,4,14,1,1,1,1,2,2,0,2,0,1,0,0,2,33,0,0
40258,15,359,46,26,30,3,0,12,49,3,6,3,6,9,9,20,28,1,42,2,0,2,33,0,0
40259,178,7759,4293,999,3693,19,54,507,4312,9,155,88,170,164,258,1156,1898,4,9368,520,0,2,86,1,0
40260,178,7759,1482,859,1002,125,135,219,1607,16,219,134,251,235,385,1766,3032,9,27804,1544,1,2,86,1,0
40261,46,2854,652,304,544,16,6,88,668,6,89,51,101,95,152,591,998,3,3399,188,0,2,30,2,0
40262,74,3931,1293,570,1093,25,15,163,1318,10,195,123,241,205,364,1516,2795,6,17273,959,0,2,1,1,0
40263,31,1843,466,257,367,18,25,50,484,7,126,86,171,133,257,898,1813,4,8612,478,0,2,72,2,0
40264,161,3434,1513,682,1277,25,13,200,1538,11,199,116,219,210,335,1557,2584,6,15641,868,0,2,5,1,0
40265,161,3434,819,519,539,24,98,155,843,15,96,57,106,111,163,690,1107,8,9171,509,0,2,5,1,0
40266,238,5076,2,2,2,0,0,0,2,0,0,0,0,0,0,0,0,0,0,0,0,2,9,6,0
40267,238,5076,99,48,90,1,3,5,100,0,0,0,0,0,0,0,0,0,0,0,0,2,9,6,0
40268,238,5076,8,5,5,2,0,1,10,0,0,0,0,0,0,0,0,0,0,0,0,2,9,6,0
40269,238,5076,1217,716,841,84,126,174,1301,14,185,118,215,199,333,1446,2542,8,20687,1149,0,2,9,6,0
40270,238,5076,160,89,115,0,13,31,160,7,15,11,17,22,28,78,124,3,495,27,0,2,9,6,0
40271,238,5076,10,10,9,9,0,0,19,0,0,0,0,0,0,0,0,0,0,0,0,2,9,6,0
40272,238,5076,173,84,99,8,29,36,181,5,12,7,13,17,20,54,81,2,221,12,0,2,9,6,0
40273,238,5076,3,1,1,3,0,0,6,0,0,0,0,0,0,0,0,0,0,0,0,2,9,6,0
40274,261,6237,4293,999,3693,19,54,507,4312,9,155,88,170,164,258,1156,1898,4,9368,520,0,2,11,2,0
40275,261,6237,1482,859,1002,125,135,219,1607,16,219,134,251,235,385,1766,3032,9,27804,1544,1,2,11,2,0
40276,73,1701,53,23,39,0,0,13,53,2,8,4,8,10,12,26,39,1,39,2,0,2,1,3,0
40277,73,1701,515,298,307,33,80,99,548,12,63,44,77,75,121,419,753,7,5527,307,0,2,1,3,0
40278,16,491,184,100,137,2,15,30,186,6,38,20,39,44,59,214,322,3,991,55,0,2,1,1,0
40279,16,491,103,65,74,8,5,16,111,7,17,9,17,24,26,89,119,3,417,23,0,2,1,1,0
40280,79,1942,466,257,367,18,25,50,484,7,126,86,171,133,257,898,1813,4,8612,478,0,2,143,88,0
40281,79,1942,507,281,342,29,59,88,536,10,53,29,57,63,86,336,514,5,2764,153,0,2,143,88,0
40282,31,956,182,127,129,0,0,53,182,5,39,21,42,44,63,217,343,2,926,51,0,2,3,7,0
40283,146,7064,1392,870,1177,35,17,170,1427,14,494,280,531,508,811,4473,7289,7,54850,3047,2,2,165,196,0
40284,15,359,127,75,83,2,11,30,129,4,14,7,14,18,21,61,87,2,175,9,0,2,33,0,0
40285,15,359,652,304,544,16,6,88,668,6,89,51,101,95,152,591,998,3,3399,188,0,2,33,0,0
40286,15,359,2,2,2,0,0,0,2,0,0,0,0,0,0,0,0,0,0,0,0,2,33,0,0
40287,15,359,8,5,5,0,0,3,8,0,0,0,0,0,0,0,0,0,0,0,0,2,33,0,0
40288,15,359,2,2,2,0,0,0,2,0,0,0,0,0,0,0,0,0,0,0,0,2,33,0,0
40289,15,359,14,8,8,0,0,6,14,0,0,0,0,0,0,0,0,0,0,0,0,2,33,0,0
40290,15,359,6,4,4,0,0,2,6,0,0,0,0,0,0,0,0,0,0,0,0,2,33,0,0
40291,15,359,6,4,4,0,0,2,6,1,2,1,2,3,3,2,4,0,2,0,0,2,33,0,0
40292,15,359,6,4,4,0,0,2,6,0,0,0,0,0,0,0,0,0,0,0,0,2,33,0,0
40293,15,359,7,5,5,0,0,2,7,0,0,0,0,0,0,0,0,0,0,0,0,2,33,0,0
40294,15,359,6,4,4,0,0,2,6,0,0,0,0,0,0,0,0,0,0,0,0,2,33,0,0
40295,15,359,10,6,6,0,0,4,10,0,0,0,0,0,0,0,0,0,0,0,0,2,33,0,0
40296,15,359,1,1,1,0,0,0,1,0,0,0,0,0,0,0,0,0,0,0,0,2,33,0,0
40297,15,359,1,1,1,0,0,0,1,0,0,0,0,0,0,0,0,0,0,0,0,2,33,0,0
40298,15,359,14,10,10,0,0,4,14,1,1,1,1,2,2,0,2,0,1,0,0,2,33,0,0
40299,15,359,46,26,30,3,0,12,49,3,6,3,6,9,9,20,28,1,42,2,0,2,33,0,0
40300,182,7900,4293,999,3693,19,54,507,4312,9,155,88,170,164,258,1156,1898,4,9368,520,0,2,87,2,0
40301,182,7900,1482,859,1002,125,135,219,1607,16,219,134,251,235,385,1766,3032,9,27804,1544,1,2,87,2,0
40302,46,2854,652,304,544,16,6,88,668,6,89,51,101,95,152,591,998,3,3399,188,0,2,30,2,0
40303,18,697,184,100,137,2,15,30,186,6,38,20,39,44,59,214,322,3,991,55,0,2,1,1,0
40304,74,3931,1293,570,1093,25,15,163,1318,10,195,123,241,205,364,1516,2795,6,17273,959,0,2,1,1,0
40305,31,1843,466,257,367,18,25,50,484,7,126,86,171,133,257,898,1813,4,8612,478,0,2,72,2,0
40306,184,7983,4293,999,3693,19,54,507,4312,9,155,88,170,164,258,1156,1898,4,9368,520,0,2,17,37,0
40307,184,7983,1482,859,1002,125,135,219,1607,16,219,134,251,235,385,1766,3032,9,27804,1544,1,2,17,37,0
40308,184,7975,4293,999,3693,19,54,507,4312,9,155,88,170,164,258,1156,1898,4,9368,520,0,2,5,5,0
40309,184,7975,1482,859,1002,125,135,219,1607,16,219,134,251,235,385,1766,3032,9,27804,1544,1,2,5,5,0
40310,3,65,127,75,83,2,11,30,129,4,14,7,14,18,21,61,87,2,175,9,0,2,1,1,0
40311,3,65,652,304,544,16,6,88,668,6,89,51,101,95,152,591,998,3,3399,188,0,2,1,1,0
40312,3,65,2,2,2,0,0,0,2,0,0,0,0,0,0,0,0,0,0,0,0,2,1,1,0
40313,3,65,8,5,5,0,0,3,8,0,0,0,0,0,0,0,0,0,0,0,0,2,1,1,0
40314,3,65,2,2,2,0,0,0,2,0,0,0,0,0,0,0,0,0,0,0,0,2,1,1,0
40315,3,65,14,8,8,0,0,6,14,0,0,0,0,0,0,0,0,0,0,0,0,2,1,1,0
40316,3,65,6,4,4,0,0,2,6,0,0,0,0,0,0,0,0,0,0,0,0,2,1,1,0
40317,3,65,6,4,4,0,0,2,6,1,2,1,2,3,3,2,4,0,2,0,0,2,1,1,0
40318,3,65,6,4,4,0,0,2,6,0,0,0,0,0,0,0,0,0,0,0,0,2,1,1,0
40319,3,65,7,5,5,0,0,2,7,0,0,0,0,0,0,0,0,0,0,0,0,2,1,1,0
40320,3,65,6,4,4,0,0,2,6,0,0,0,0,0,0,0,0,0,0,0,0,2,1,1,0
40321,3,65,10,6,6,0,0,4,10,0,0,0,0,0,0,0,0,0,0,0,0,2,1,1,0
40322,3,65,1,1,1,0,0,0,1,0,0,0,0,0,0,0,0,0,0,0,0,2,1,1,0
40323,3,65,1,1,1,0,0,0,1,0,0,0,0,0,0,0,0,0,0,0,0,2,1,1,0
40324,3,65,14,10,10,0,0,4,14,1,1,1,1,2,2,0,2,0,1,0,0,2,1,1,0
40325,3,65,46,26,30,3,0,12,49,3,6,3,6,9,9,20,28,1,42,2,0,2,1,1,0
40326,261,6237,4293,999,3693,19,54,507,4312,9,155,88,170,164,258,1156,1898,4,9368,520,0,2,112,6,0
40327,261,6237,1482,859,1002,125,135,219,1607,16,219,134,251,235,385,1766,3032,9,27804,1544,1,2,112,6,0
40328,184,7975,4293,999,3693,19,54,507,4312,9,155,88,170,164,258,1156,1898,4,9368,520,0,2,94,1,0
40329,184,7975,1482,859,1002,125,135,219,1607,16,219,134,251,235,385,1766,3032,9,27804,1544,1,2,94,1,0
40330,38,2308,334,251,279,10,4,40,344,5,127,74,143,132,217,899,1528,2,4303,239,0,2,5,1,0
40331,38,2308,334,251,279,10,4,40,344,5,127,74,143,132,217,899,1528,2,4303,239,0,2,5,1,0
40332,3,65,127,75,83,2,11,30,129,4,14,7,14,18,21,61,87,2,175,9,0,2,1,1,0
40333,3,65,652,304,544,16,6,88,668,6,89,51,101,95,152,591,998,3,3399,188,0,2,1,1,0
40334,3,65,2,2,2,0,0,0,2,0,0,0,0,0,0,0,0,0,0,0,0,2,1,1,0
40335,3,65,8,5,5,0,0,3,8,0,0,0,0,0,0,0,0,0,0,0,0,2,1,1,0
40336,3,65,2,2,2,0,0,0,2,0,0,0,0,0,0,0,0,0,0,0,0,2,1,1,0
40337,3,65,14,8,8,0,0,6,14,0,0,0,0,0,0,0,0,0,0,0,0,2,1,1,0
40338,3,65,6,4,4,0,0,2,6,0,0,0,0,0,0,0,0,0,0,0,0,2,1,1,0
40339,3,65,6,4,4,0,0,2,6,1,2,1,2,3,3,2,4,0,2,0,0,2,1,1,0
40340,3,65,6,4,4,0,0,2,6,0,0,0,0,0,0,0,0,0,0,0,0,2,1,1,0
40341,3,65,7,5,5,0,0,2,7,0,0,0,0,0,0,0,0,0,0,0,0,2,1,1,0
40342,3,65,6,4,4,0,0,2,6,0,0,0,0,0,0,0,0,0,0,0,0,2,1,1,0
40343,3,65,10,6,6,0,0,4,10,0,0,0,0,0,0,0,0,0,0,0,0,2,1,1,0
40344,3,65,1,1,1,0,0,0,1,0,0,0,0,0,0,0,0,0,0,0,0,2,1,1,0
40345,3,65,1,1,1,0,0,0,1,0,0,0,0,0,0,0,0,0,0,0,0,2,1,1,0
40346,3,65,14,10,10,0,0,4,14,1,1,1,1,2,2,0,2,0,1,0,0,2,1,1,0
40347,3,65,46,26,30,3,0,12,49,3,6,3,6,9,9,20,28,1,42,2,0,2,1,1,0
40348,216,4974,182,127,129,0,0,53,182,5,39,21,42,44,63,217,343,2,926,51,0,2,17,10,0
40349,216,4974,1165,710,800,67,119,181,1232,18,243,153,282,261,435,2000,3492,10,36473,2026,1,2,17,10,0
40350,67,1549,773,419,590,28,0,166,801,10,204,113,217,214,330,1598,2554,5,13587,754,0,2,7,6,0
40351,67,1549,421,273,302,44,34,57,465,17,81,59,107,98,166,583,1098,11,12329,684,0,2,7,6,0
40352,27,568,2,2,2,0,0,0,2,0,0,0,0,0,0,0,0,0,0,0,0,2,8,3,0
40353,27,568,99,48,90,1,3,5,100,0,0,0,0,0,0,0,0,0,0,0,0,2,8,3,0
40354,27,568,8,5,5,2,0,1,10,0,0,0,0,0,0,0,0,0,0,0,0,2,8,3,0
40355,27,568,1217,716,841,84,126,174,1301,14,185,118,215,199,333,1446,2542,8,20687,1149,0,2,8,3,0
40356,27,568,160,89,115,0,13,31,160,7,15,11,17,22,28,78,124,3,495,27,0,2,8,3,0
40357,27,568,10,10,9,9,0,0,19,0,0,0,0,0,0,0,0,0,0,0,0,2,8,3,0
40358,27,568,173,84,99,8,29,36,181,5,12,7,13,17,20,54,81,2,221,12,0,2,8,3,0
40359,27,568,3,1,1,3,0,0,6,0,0,0,0,0,0,0,0,0,0,0,0,2,8,3,0
40360,183,5415,1660,832,1314,41,38,274,1701,20,312,209,395,332,604,2671,5058,12,64042,3557,1,2,28,22,0
40361,183,5415,1057,646,719,113,100,145,1170,18,215,134,248,233,382,1740,3004,10,31186,1732,1,2,28,22,0
40362,114,2099,477,336,357,30,23,73,507,16,194,134,250,210,384,1538,2962,10,30538,1696,0,2,9,6,0
40363,238,5076,2,2,2,0,0,0,2,0,0,0,0,0,0,0,0,0,0,0,0,2,33,17,0
40364,238,5076,99,48,90,1,3,5,100,0,0,0,0,0,0,0,0,0,0,0,0,2,33,17,0
40365,238,5076,8,5,5,2,0,1,10,0,0,0,0,0,0,0,0,0,0,0,0,2,33,17,0
40366,238,5076,1217,716,841,84,126,174,1301,14,185,118,215,199,333,1446,2542,8,20687,1149,0,2,33,17,0
40367,238,5076,160,89,115,0,13,31,160,7,15,11,17,22,28,78,124,3,495,27,0,2,33,17,0
40368,238,5076,10,10,9,9,0,0,19,0,0,0,0,0,0,0,0,0,0,0,0,2,33,17,0
40369,238,5076,173,84,99,8,29,36,181,5,12,7,13,17,20,54,81,2,221,12,0,2,33,17,0
40370,238,5076,3,1,1,3,0,0,6,0,0,0,0,0,0,0,0,0,0,0,0,2,33,17,0
40371,113,2326,463,295,324,28,62,57,491,12,134,82,154,146,236,989,1696,6,11700,650,0,2,30,14,0
40372,37,813,167,116,138,4,5,22,171,8,48,30,56,56,86,292,499,4,2330,129,0,2,11,1,0
40373,261,6237,4293,999,3693,19,54,507,4312,9,155,88,170,164,258,1156,1898,4,9368,520,0,2,112,6,0
40374,261,6237,1482,859,1002,125,135,219,1607,16,219,134,251,235,385,1766,3032,9,27804,1544,1,2,112,6,0
40375,30,669,125,97,103,3,0,19,128,9,25,17,27,34,44,144,223,4,1087,60,0,2,2,0,0
40376,70,1526,402,202,227,24,74,80,426,12,52,33,61,64,94,339,564,7,3969,220,0,2,1,1,0
40377,73,1701,53,23,39,0,0,13,53,2,8,4,8,10,12,26,39,1,39,2,0,2,35,17,0
40378,73,1701,515,298,307,33,80,99,548,12,63,44,77,75,121,419,753,7,5527,307,0,2,35,17,0
40379,16,491,184,100,137,2,15,30,186,6,38,20,39,44,59,214,322,3,991,55,0,2,10,5,0
40380,16,491,103,65,74,8,5,16,111,7,17,9,17,24,26,89,119,3,417,23,0,2,10,5,0
40381,79,1942,466,257,367,18,25,50,484,7,126,86,171,133,257,898,1813,4,8612,478,0,2,4,2,0
40382,79,1942,507,281,342,29,59,88,536,10,53,29,57,63,86,336,514,5,2764,153,0,2,4,2,0
40383,87,1935,1043,504,840,53,9,147,1096,9,180,112,198,189,310,1377,2344,4,11604,644,0,2,17,5,0
40384,87,1935,383,288,292,26,6,62,409,11,65,38,67,76,105,429,656,5,3719,206,0,2,17,5,0
40385,184,7975,4293,999,3693,19,54,507,4312,9,155,88,170,164,258,1156,1898,4,9368,520,0,2,94,1,0
40386,184,7975,1482,859,1002,125,135,219,1607,16,219,134,251,235,385,1766,3032,9,27804,1544,1,2,94,1,0
40387,111,6022,1457,730,1242,11,6,188,1468,10,292,166,329,302,495,2424,4078,5,22973,1276,1,2,15,0,0
40388,18,697,184,100,137,2,15,30,186,6,38,20,39,44,59,214,322,3,991,55,0,2,56,2,0
40389,38,2315,334,251,279,10,4,40,344,5,127,74,143,132,217,899,1528,2,4303,239,0,2,2,1,0
40390,38,2315,334,251,279,10,4,40,344,5,127,74,143,132,217,899,1528,2,4303,239,0,2,2,1,0
40391,87,1935,1043,504,840,53,9,147,1096,9,180,112,198,189,310,1377,2344,4,11604,644,0,2,2,2,0
40392,87,1935,383,288,292,26,6,62,409,11,65,38,67,76,105,429,656,5,3719,206,0,2,2,2,0
40393,16,386,127,75,83,2,11,30,129,4,14,7,14,18,21,61,87,2,175,9,0,2,27,0,0
40394,16,386,652,304,544,16,6,88,668,6,89,51,101,95,152,591,998,3,3399,188,0,2,27,0,0
40395,16,386,2,2,2,0,0,0,2,0,0,0,0,0,0,0,0,0,0,0,0,2,27,0,0
40396,16,386,8,5,5,0,0,3,8,0,0,0,0,0,0,0,0,0,0,0,0,2,27,0,0
40397,16,386,2,2,2,0,0,0,2,0,0,0,0,0,0,0,0,0,0,0,0,2,27,0,0
40398,16,386,14,8,8,0,0,6,14,0,0,0,0,0,0,0,0,0,0,0,0,2,27,0,0
40399,16,386,6,4,4,0,0,2,6,0,0,0,0,0,0,0,0,0,0,0,0,2,27,0,0
40400,16,386,6,4,4,0,0,2,6,1,2,1,2,3,3,2,4,0,2,0,0,2,27,0,0
40401,16,386,6,4,4,0,0,2,6,0,0,0,0,0,0,0,0,0,0,0,0,2,27,0,0
40402,16,386,7,5,5,0,0,2,7,0,0,0,0,0,0,0,0,0,0,0,0,2,27,0,0
40403,16,386,6,4,4,0,0,2,6,0,0,0,0,0,0,0,0,0,0,0,0,2,27,0,0
40404,16,386,10,6,6,0,0,4,10,0,0,0,0,0,0,0,0,0,0,0,0,2,27,0,0
40405,16,386,1,1,1,0,0,0,1,0,0,0,0,0,0,0,0,0,0,0,0,2,27,0,0
40406,16,386,1,1,1,0,0,0,1,0,0,0,0,0,0,0,0,0,0,0,0,2,27,0,0
40407,16,386,14,10,10,0,0,4,14,1,1,1,1,2,2,0,2,0,1,0,0,2,27,0,0
40408,16,386,46,26,30,3,0,12,49,3,6,3,6,9,9,20,28,1,42,2,0,2,27,0,0
40409,87,1935,1043,504,840,53,9,147,1096,9,180,112,198,189,310,1377,2344,4,11604,644,0,2,2,2,0
40410,87,1935,383,288,292,26,6,62,409,11,65,38,67,76,105,429,656,5,3719,206,0,2,2,2,0
40411,16,386,127,75,83,2,11,30,129,4,14,7,14,18,21,61,87,2,175,9,0,2,27,0,0
40412,16,386,652,304,544,16,6,88,668,6,89,51,101,95,152,591,998,3,3399,188,0,2,27,0,0
40413,16,386,2,2,2,0,0,0,2,0,0,0,0,0,0,0,0,0,0,0,0,2,27,0,0
40414,16,386,8,5,5,0,0,3,8,0,0,0,0,0,0,0,0,0,0,0,0,2,27,0,0
40415,16,386,2,2,2,0,0,0,2,0,0,0,0,0,0,0,0,0,0,0,0,2,27,0,0
40416,16,386,14,8,8,0,0,6,14,0,0,0,0,0,0,0,0,0,0,0,0,2,27,0,0
40417,16,386,6,4,4,0,0,2,6,0,0,0,0,0,0,0,0,0,0,0,0,2,27,0,0
40418,16,386,6,4,4,0,0,2,6,1,2,1,2,3,3,2,4,0,2,0,0,2,27,0,0
40419,16,386,6,4,4,0,0,2,6,0,0,0,0,0,0,0,0,0,0,0,0,2,27,0,0
40420,16,386,7,5,5,0,0,2,7,0,0,0,0,0,0,0,0,0,0,0,0,2,27,0,0
40421,16,386,6,4,4,0,0,2,6,0,0,0,0,0,0,0,0,0,0,0,0,2,27,0,0
40422,16,386,10,6,6,0,0,4,10,0,0,0,0,0,0,0,0,0,0,0,0,2,27,0,0
40423,16,386,1,1,1,0,0,0,1,0,0,0,0,0,0,0,0,0,0,0,0,2,27,0,0
40424,16,386,1,1,1,0,0,0,1,0,0,0,0,0,0,0,0,0,0,0,0,2,27,0,0
40425,16,386,14,10,10,0,0,4,14,1,1,1,1,2,2,0,2,0,1,0,0,2,27,0,0
40426,16,386,46,26,30,3,0,12,49,3,6,3,6,9,9,20,28,1,42,2,0,2,27,0,0
40427,225,5745,722,423,573,19,0,135,741,12,172,101,199,184,300,1320,2257,6,15668,870,0,2,8,9,0
40428,225,5745,1508,847,911,44,250,301,1552,14,148,88,169,162,257,1120,1886,7,15077,837,0,2,8,9,0
40429,225,5745,722,423,573,19,0,135,741,12,172,101,199,184,300,1320,2257,6,15668,870,0,2,8,9,0
40430,225,5745,1508,847,911,44,250,301,1552,14,148,88,169,162,257,1120,1886,7,15077,837,0,2,8,9,0
40431,116,2131,477,336,357,30,23,73,507,16,194,134,250,210,384,1538,2962,10,30538,1696,0,2,14,1,0
40432,58,1205,207,111,150,11,0,50,218,5,26,19,36,31,55,133,272,3,943,52,0,2,7,0,0
40433,58,1205,410,198,237,31,55,97,441,11,63,38,72,74,110,414,683,6,4293,238,0,2,7,0,0
40434,70,1531,402,202,227,24,74,80,426,12,52,33,61,64,94,339,564,7,3969,220,0,2,2,1,0
40435,122,4968,1450,624,1228,12,26,181,1462,14,306,186,354,320,540,2580,4493,8,36391,2021,1,2,2,1,0
40436,114,2108,477,336,357,30,23,73,507,16,194,134,250,210,384,1538,2962,10,30538,1696,0,2,4,14,0
40437,58,1191,207,111,150,11,0,50,218,5,26,19,36,31,55,133,272,3,943,52,0,2,3,4,0
40438,58,1191,410,198,237,31,55,97,441,11,63,38,72,74,110,414,683,6,4293,238,0,2,3,4,0
40439,70,1535,402,202,227,24,74,80,426,12,52,33,61,64,94,339,564,7,3969,220,0,2,3,2,0
40440,122,4972,1450,624,1228,12,26,181,1462,14,306,186,354,320,540,2580,4493,8,36391,2021,1,2,2,2,0
40441,114,2108,477,336,357,30,23,73,507,16,194,134,250,210,384,1538,2962,10,30538,1696,0,2,4,1,0
40442,58,1191,207,111,150,11,0,50,218,5,26,19,36,31,55,133,272,3,943,52,0,2,6,0,0
40443,58,1191,410,198,237,31,55,97,441,11,63,38,72,74,110,414,683,6,4293,238,0,2,6,0,0
40444,70,1535,402,202,227,24,74,80,426,12,52,33,61,64,94,339,564,7,3969,220,0,2,3,1,0
40445,122,4972,1450,624,1228,12,26,181,1462,14,306,186,354,320,540,2580,4493,8,36391,2021,1,2,2,1,0
40446,1,93,42,7,35,4,0,5,46,1,2,1,2,3,3,2,4,0,2,0,0,2,1,1,0
40447,1,93,11,6,10,0,0,1,11,2,4,2,4,6,6,10,15,1,15,0,0,2,1,1,0
40448,1,93,42,7,35,4,0,5,46,1,2,1,2,3,3,2,4,0,2,0,0,2,1,1,0
40449,1,93,11,6,10,0,0,1,11,2,4,2,4,6,6,10,15,1,15,0,0,2,1,1,0
40450,1,93,42,7,35,4,0,5,46,1,2,1,2,3,3,2,4,0,2,0,0,2,1,1,0
40451,1,93,11,6,10,0,0,1,11,2,4,2,4,6,6,10,15,1,15,0,0,2,1,1,0
40452,114,2108,477,336,357,30,23,73,507,16,194,134,250,210,384,1538,2962,10,30538,1696,0,2,4,1,0
40453,58,1191,207,111,150,11,0,50,218,5,26,19,36,31,55,133,272,3,943,52,0,2,6,0,0
40454,58,1191,410,198,237,31,55,97,441,11,63,38,72,74,110,414,683,6,4293,238,0,2,6,0,0
40455,70,1535,402,202,227,24,74,80,426,12,52,33,61,64,94,339,564,7,3969,220,0,2,3,1,0
40456,225,5745,722,423,573,19,0,135,741,12,172,101,199,184,300,1320,2257,6,15668,870,0,2,8,9,0
40457,225,5745,1508,847,911,44,250,301,1552,14,148,88,169,162,257,1120,1886,7,15077,837,0,2,8,9,0
40458,87,1935,1043,504,840,53,9,147,1096,9,180,112,198,189,310,1377,2344,4,11604,644,0,2,2,2,0
40459,87,1935,383,288,292,26,6,62,409,11,65,38,67,76,105,429,656,5,3719,206,0,2,2,2,0
40460,16,386,127,75,83,2,11,30,129,4,14,7,14,18,21,61,87,2,175,9,0,2,27,0,0
40461,16,386,652,304,544,16,6,88,668,6,89,51,101,95,152,591,998,3,3399,188,0,2,27,0,0
40462,16,386,2,2,2,0,0,0,2,0,0,0,0,0,0,0,0,0,0,0,0,2,27,0,0
40463,16,386,8,5,5,0,0,3,8,0,0,0,0,0,0,0,0,0,0,0,0,2,27,0,0
40464,16,386,2,2,2,0,0,0,2,0,0,0,0,0,0,0,0,0,0,0,0,2,27,0,0
40465,16,386,14,8,8,0,0,6,14,0,0,0,0,0,0,0,0,0,0,0,0,2,27,0,0
40466,16,386,6,4,4,0,0,2,6,0,0,0,0,0,0,0,0,0,0,0,0,2,27,0,0
40467,16,386,6,4,4,0,0,2,6,1,2,1,2,3,3,2,4,0,2,0,0,2,27,0,0
40468,16,386,6,4,4,0,0,2,6,0,0,0,0,0,0,0,0,0,0,0,0,2,27,0,0
40469,16,386,7,5,5,0,0,2,7,0,0,0,0,0,0,0,0,0,0,0,0,2,27,0,0
40470,16,386,6,4,4,0,0,2,6,0,0,0,0,0,0,0,0,0,0,0,0,2,27,0,0
40471,16,386,10,6,6,0,0,4,10,0,0,0,0,0,0,0,0,0,0,0,0,2,27,0,0
40472,16,386,1,1,1,0,0,0,1,0,0,0,0,0,0,0,0,0,0,0,0,2,27,0,0
40473,16,386,1,1,1,0,0,0,1,0,0,0,0,0,0,0,0,0,0,0,0,2,27,0,0
40474,16,386,14,10,10,0,0,4,14,1,1,1,1,2,2,0,2,0,1,0,0,2,27,0,0
40475,16,386,46,26,30,3,0,12,49,3,6,3,6,9,9,20,28,1,42,2,0,2,27,0,0
40476,122,4972,1450,624,1228,12,26,181,1462,14,306,186,354,320,540,2580,4493,8,36391,2021,1,2,2,1,0
40477,38,2315,334,251,279,10,4,40,344,5,127,74,143,132,217,899,1528,2,4303,239,0,2,6,1,0
40478,57,1488,339,213,244,17,9,65,356,10,42,26,48,52,74,259,421,5,2410,133,0,2,8,2,0
40479,108,4697,1289,550,1043,56,32,155,1345,10,167,93,185,177,278,1266,2075,5,11498,638,0,2,37,0,0
40480,232,5908,722,423,573,19,0,135,741,12,172,101,199,184,300,1320,2257,6,15668,870,0,2,39,4,1
40481,232,5908,1508,847,911,44,250,301,1552,14,148,88,169,162,257,1120,1886,7,15077,837,0,2,39,4,1
40482,59,2994,722,423,573,19,0,135,741,12,172,101,199,184,300,1320,2257,6,15668,870,0,2,46,0,1
40483,107,4615,1289,550,1043,56,32,155,1345,10,167,93,185,177,278,1266,2075,5,11498,638,0,2,3,3,0
40484,146,7058,1392,870,1177,35,17,170,1427,14,494,280,531,508,811,4473,7289,7,54850,3047,2,2,3,2,0
40485,15,696,139,89,101,2,0,35,141,7,54,34,62,61,96,330,569,4,2287,127,0,2,1,1,0
40486,42,2589,1157,318,931,29,22,177,1186,6,104,63,125,110,188,712,1274,3,4596,255,0,2,8,8,0
40487,89,3928,1338,495,1086,10,64,173,1348,11,122,82,157,133,239,883,1686,7,11934,663,0,2,1,1,0
40488,184,7966,4293,999,3693,19,54,507,4312,9,155,88,170,164,258,1156,1898,4,9368,520,0,2,3,3,0
40489,184,7966,1482,859,1002,125,135,219,1607,16,219,134,251,235,385,1766,3032,9,27804,1544,1,2,3,3,0
40490,6,322,180,34,164,0,0,16,180,1,12,6,12,13,18,43,66,0,33,1,0,2,2,2,0
40491,122,4966,1450,624,1228,12,26,181,1462,14,306,186,354,320,540,2580,4493,8,36391,2021,1,2,2,2,0
40492,183,5958,1660,832,1314,41,38,274,1701,20,312,209,395,332,604,2671,5058,12,64042,3557,1,2,3,3,0
40493,49,3773,996,429,845,24,10,117,1020,7,76,50,88,83,138,494,879,4,3565,198,0,2,3,3,0
40494,120,5064,1513,682,1277,25,13,200,1538,11,199,116,219,210,335,1557,2584,6,15641,868,0,2,7,7,0
40495,85,4935,1296,573,1062,40,33,157,1336,8,201,118,231,209,349,1561,2689,4,12365,686,0,2,6,6,0
40496,46,2848,652,304,544,16,6,88,668,6,89,51,101,95,152,591,998,3,3399,188,0,2,2,2,0
40497,81,3714,1455,414,1257,16,76,112,1471,5,41,23,46,46,69,231,381,2,1069,59,0,2,4,4,0
40498,113,5682,1523,757,1297,19,12,193,1542,12,193,117,230,205,347,1508,2664,7,19053,1058,0,2,3,3,0
40499,87,3375,1043,504,840,53,9,147,1096,9,180,112,198,189,310,1377,2344,4,11604,644,0,2,6,6,0
40500,12,463,295,56,236,0,4,54,295,2,9,5,10,11,15,30,51,1,57,3,0,2,1,1,0
40501,79,3068,1178,367,1042,6,15,115,1184,9,94,51,95,103,146,644,976,4,4439,246,0,2,1,1,0
40502,112,6100,1943,715,1694,26,18,214,1969,12,185,120,237,197,357,1436,2721,7,20915,1161,0,2,12,12,0
40503,51,2017,1098,241,925,5,10,155,1103,7,46,25,49,53,74,273,423,3,1580,87,0,2,5,5,0
40504,3,90,35,12,22,4,5,6,39,1,2,1,2,3,3,2,4,0,2,0,0,0,28,0,0
40505,57,1488,339,213,244,17,9,65,356,10,42,26,48,52,74,259,421,5,2410,133,0,2,8,2,0
40506,108,4697,1289,550,1043,56,32,155,1345,10,167,93,185,177,278,1266,2075,5,11498,638,0,2,37,0,0
40507,232,5908,722,423,573,19,0,135,741,12,172,101,199,184,300,1320,2257,6,15668,870,0,2,39,4,0
40508,232,5908,1508,847,911,44,250,301,1552,14,148,88,169,162,257,1120,1886,7,15077,837,0,2,39,4,0
40509,108,4688,1289,550,1043,56,32,155,1345,10,167,93,185,177,278,1266,2075,5,11498,638,0,2,3,3,0
40510,146,7058,1392,870,1177,35,17,170,1427,14,494,280,531,508,811,4473,7289,7,54850,3047,2,2,3,2,0
40511,15,696,139,89,101,2,0,35,141,7,54,34,62,61,96,330,569,4,2287,127,0,2,1,1,0
40512,42,2589,1157,318,931,29,22,177,1186,6,104,63,125,110,188,712,1274,3,4596,255,0,2,8,8,0
40513,89,3928,1338,495,1086,10,64,173,1348,11,122,82,157,133,239,883,1686,7,11934,663,0,2,1,1,0
40514,184,7966,4293,999,3693,19,54,507,4312,9,155,88,170,164,258,1156,1898,4,9368,520,0,2,3,3,0
40515,184,7966,1482,859,1002,125,135,219,1607,16,219,134,251,235,385,1766,3032,9,27804,1544,1,2,3,3,0
40516,6,322,180,34,164,0,0,16,180,1,12,6,12,13,18,43,66,0,33,1,0,2,2,2,0
40517,122,4966,1450,624,1228,12,26,181,1462,14,306,186,354,320,540,2580,4493,8,36391,2021,1,2,2,2,0
40518,183,5958,1660,832,1314,41,38,274,1701,20,312,209,395,332,604,2671,5058,12,64042,3557,1,2,3,3,0
40519,49,3773,996,429,845,24,10,117,1020,7,76,50,88,83,138,494,879,4,3565,198,0,2,3,3,0
40520,120,5064,1513,682,1277,25,13,200,1538,11,199,116,219,210,335,1557,2584,6,15641,868,0,2,7,7,0
40521,85,4935,1296,573,1062,40,33,157,1336,8,201,118,231,209,349,1561,2689,4,12365,686,0,2,6,6,0
40522,46,2848,652,304,544,16,6,88,668,6,89,51,101,95,152,591,998,3,3399,188,0,2,2,2,0
40523,81,3714,1455,414,1257,16,76,112,1471,5,41,23,46,46,69,231,381,2,1069,59,0,2,4,4,0
40524,113,5682,1523,757,1297,19,12,193,1542,12,193,117,230,205,347,1508,2664,7,19053,1058,0,2,3,3,0
40525,59,2994,722,423,573,19,0,135,741,12,172,101,199,184,300,1320,2257,6,15668,870,0,2,46,0,0
40526,87,3375,1043,504,840,53,9,147,1096,9,180,112,198,189,310,1377,2344,4,11604,644,0,2,6,6,0
40527,12,463,295,56,236,0,4,54,295,2,9,5,10,11,15,30,51,1,57,3,0,2,1,1,0
40528,79,3068,1178,367,1042,6,15,115,1184,9,94,51,95,103,146,644,976,4,4439,246,0,2,1,1,0
40529,112,6100,1943,715,1694,26,18,214,1969,12,185,120,237,197,357,1436,2721,7,20915,1161,0,2,12,12,0
40530,51,2017,1098,241,925,5,10,155,1103,7,46,25,49,53,74,273,423,3,1580,87,0,2,5,5,0
40531,87,3404,1043,504,840,53,9,147,1096,9,180,112,198,189,310,1377,2344,4,11604,644,0,2,18,11,0
40532,3,90,35,12,22,4,5,6,39,1,2,1,2,3,3,2,4,0,2,0,0,0,28,0,0
40533,87,3404,1043,504,840,53,9,147,1096,9,180,112,198,189,310,1377,2344,4,11604,644,0,2,18,11,0
40534,123,2323,477,336,357,30,23,73,507,16,194,134,250,210,384,1538,2962,10,30538,1696,0,2,31,1,1
40535,124,5157,1450,624,1228,12,26,181,1462,14,306,186,354,320,540,2580,4493,8,36391,2021,1,2,49,0,1
40536,123,2323,477,336,357,30,23,73,507,16,194,134,250,210,384,1538,2962,10,30538,1696,0,2,31,1,0
40537,124,5157,1450,624,1228,12,26,181,1462,14,306,186,354,320,540,2580,4493,8,36391,2021,1,2,49,0,0
40538,3,90,35,12,22,4,5,6,39,1,2,1,2,3,3,2,4,0,2,0,0,0,28,0,0
40539,87,3386,1043,504,840,53,9,147,1096,9,180,112,198,189,310,1377,2344,4,11604,644,0,2,18,11,0
40540,3,90,35,12,22,4,5,6,39,1,2,1,2,3,3,2,4,0,2,0,0,0,28,0,0
40541,87,3386,1043,504,840,53,9,147,1096,9,180,112,198,189,310,1377,2344,4,11604,644,0,2,18,11,0
40542,216,4987,182,127,129,0,0,53,182,5,39,21,42,44,63,217,343,2,926,51,0,2,3,1,0
40543,216,4987,1165,710,800,67,119,181,1232,18,243,153,282,261,435,2000,3492,10,36473,2026,1,2,3,1,0
40544,148,7105,1392,870,1177,35,17,170,1427,14,494,280,531,508,811,4473,7289,7,54850,3047,2,2,13,2,0
40545,216,4987,182,127,129,0,0,53,182,5,39,21,42,44,63,217,343,2,926,51,0,2,3,1,0
40546,216,4987,1165,710,800,67,119,181,1232,18,243,153,282,261,435,2000,3492,10,36473,2026,1,2,3,1,0
40547,148,7105,1392,870,1177,35,17,170,1427,14,494,280,531,508,811,4473,7289,7,54850,3047,2,2,13,2,0
40548,124,5153,1450,624,1228,12,26,181,1462,14,306,186,354,320,540,2580,4493,8,36391,2021,1,2,8,11,0
40549,124,5153,1450,624,1228,12,26,181,1462,14,306,186,354,320,540,2580,4493,8,36391,2021,1,2,8,11,0
40550,1,95,42,7,35,4,0,5,46,1,2,1,2,3,3,2,4,0,2,0,0,2,1,0,0
40551,1,95,11,6,10,0,0,1,11,2,4,2,4,6,6,10,15,1,15,0,0,2,1,0,0
40552,261,6237,4293,999,3693,19,54,507,4312,9,155,88,170,164,258,1156,1898,4,9368,520,0,2,3,2,0
40553,261,6237,1482,859,1002,125,135,219,1607,16,219,134,251,235,385,1766,3032,9,27804,1544,1,2,3,2,0
40554,185,8002,4293,999,3693,19,54,507,4312,9,155,88,170,164,258,1156,1898,4,9368,520,0,2,18,0,0
40555,185,8002,1482,859,1002,125,135,219,1607,16,219,134,251,235,385,1766,3032,9,27804,1544,1,2,18,0,0
40556,185,8002,4293,999,3693,19,54,507,4312,9,155,88,170,164,258,1156,1898,4,9368,520,0,2,1,1,0
40557,185,8002,1482,859,1002,125,135,219,1607,16,219,134,251,235,385,1766,3032,9,27804,1544,1,2,1,1,0
40558,261,6225,4293,999,3693,19,54,507,4312,9,155,88,170,164,258,1156,1898,4,9368,520,0,2,1,1,0
40559,261,6225,1482,859,1002,125,135,219,1607,16,219,134,251,235,385,1766,3032,9,27804,1544,1,2,1,1,0
40560,1,95,42,7,35,4,0,5,46,1,2,1,2,3,3,2,4,0,2,0,0,2,1,0,0
40561,1,95,11,6,10,0,0,1,11,2,4,2,4,6,6,10,15,1,15,0,0,2,1,0,0
40562,261,6225,4293,999,3693,19,54,507,4312,9,155,88,170,164,258,1156,1898,4,9368,520,0,2,3,2,0
40563,261,6225,1482,859,1002,125,135,219,1607,16,219,134,251,235,385,1766,3032,9,27804,1544,1,2,3,2,0
40564,185,8002,4293,999,3693,19,54,507,4312,9,155,88,170,164,258,1156,1898,4,9368,520,0,2,18,0,0
40565,185,8002,1482,859,1002,125,135,219,1607,16,219,134,251,235,385,1766,3032,9,27804,1544,1,2,18,0,0
40566,113,5657,1523,757,1297,19,12,193,1542,12,193,117,230,205,347,1508,2664,7,19053,1058,0,2,14,11,0
40567,105,2754,773,422,505,30,103,129,803,14,77,46,83,91,129,535,839,7,6334,351,0,2,1,0,0
40568,105,2754,773,422,505,30,103,129,803,14,77,46,83,91,129,535,839,7,6334,351,0,2,1,0,0
40569,238,5076,2,2,2,0,0,0,2,0,0,0,0,0,0,0,0,0,0,0,0,2,2,0,0
40570,238,5076,99,48,90,1,3,5,100,0,0,0,0,0,0,0,0,0,0,0,0,2,2,0,0
40571,238,5076,8,5,5,2,0,1,10,0,0,0,0,0,0,0,0,0,0,0,0,2,2,0,0
40572,238,5076,1217,716,841,84,126,174,1301,14,185,118,215,199,333,1446,2542,8,20687,1149,0,2,2,0,0
40573,238,5076,160,89,115,0,13,31,160,7,15,11,17,22,28,78,124,3,495,27,0,2,2,0,0
40574,238,5076,10,10,9,9,0,0,19,0,0,0,0,0,0,0,0,0,0,0,0,2,2,0,0
40575,238,5076,173,84,99,8,29,36,181,5,12,7,13,17,20,54,81,2,221,12,0,2,2,0,0
40576,238,5076,3,1,1,3,0,0,6,0,0,0,0,0,0,0,0,0,0,0,0,2,2,0,0
40577,261,6225,4293,999,3693,19,54,507,4312,9,155,88,170,164,258,1156,1898,4,9368,520,0,2,6,2,0
40578,261,6225,1482,859,1002,125,135,219,1607,16,219,134,251,235,385,1766,3032,9,27804,1544,1,2,6,2,0
40579,54,640,647,139,84,35,284,233,682,0,0,0,0,0,0,0,0,0,0,0,0,2,2,0,0
40580,142,3472,77,34,69,0,0,8,77,3,24,16,29,27,45,114,213,1,387,21,0,2,2,0,0
40581,142,3472,712,438,573,51,9,84,763,14,102,71,128,116,199,733,1364,8,11988,666,0,2,2,0,0
40582,113,5657,1523,757,1297,19,12,193,1542,12,193,117,230,205,347,1508,2664,7,19053,1058,0,2,14,11,0
40583,238,5076,2,2,2,0,0,0,2,0,0,0,0,0,0,0,0,0,0,0,0,2,2,0,0
40584,238,5076,99,48,90,1,3,5,100,0,0,0,0,0,0,0,0,0,0,0,0,2,2,0,0
40585,238,5076,8,5,5,2,0,1,10,0,0,0,0,0,0,0,0,0,0,0,0,2,2,0,0
40586,238,5076,1217,716,841,84,126,174,1301,14,185,118,215,199,333,1446,2542,8,20687,1149,0,2,2,0,0
40587,238,5076,160,89,115,0,13,31,160,7,15,11,17,22,28,78,124,3,495,27,0,2,2,0,0
40588,238,5076,10,10,9,9,0,0,19,0,0,0,0,0,0,0,0,0,0,0,0,2,2,0,0
40589,238,5076,173,84,99,8,29,36,181,5,12,7,13,17,20,54,81,2,221,12,0,2,2,0,0
40590,238,5076,3,1,1,3,0,0,6,0,0,0,0,0,0,0,0,0,0,0,0,2,2,0,0
40591,261,6225,4293,999,3693,19,54,507,4312,9,155,88,170,164,258,1156,1898,4,9368,520,0,2,6,2,0
40592,261,6225,1482,859,1002,125,135,219,1607,16,219,134,251,235,385,1766,3032,9,27804,1544,1,2,6,2,0
40593,54,640,647,139,84,35,284,233,682,0,0,0,0,0,0,0,0,0,0,0,0,2,2,0,0
40594,142,3472,77,34,69,0,0,8,77,3,24,16,29,27,45,114,213,1,387,21,0,2,2,0,0
40595,142,3472,712,438,573,51,9,84,763,14,102,71,128,116,199,733,1364,8,11988,666,0,2,2,0,0
40596,1,93,42,7,35,4,0,5,46,1,2,1,2,3,3,2,4,0,2,0,0,2,0,1,0
40597,1,93,11,6,10,0,0,1,11,2,4,2,4,6,6,10,15,1,15,0,0,2,0,1,0
40598,185,8008,4293,999,3693,19,54,507,4312,9,155,88,170,164,258,1156,1898,4,9368,520,0,2,2,0,0
40599,185,8008,1482,859,1002,125,135,219,1607,16,219,134,251,235,385,1766,3032,9,27804,1544,1,2,2,0,0
40600,1,93,42,7,35,4,0,5,46,1,2,1,2,3,3,2,4,0,2,0,0,2,0,1,0
40601,1,93,11,6,10,0,0,1,11,2,4,2,4,6,6,10,15,1,15,0,0,2,0,1,0
40602,185,8008,4293,999,3693,19,54,507,4312,9,155,88,170,164,258,1156,1898,4,9368,520,0,2,2,0,0
40603,185,8008,1482,859,1002,125,135,219,1607,16,219,134,251,235,385,1766,3032,9,27804,1544,1,2,2,0,0
40604,76,3969,1293,570,1093,25,15,163,1318,10,195,123,241,205,364,1516,2795,6,17273,959,0,2,8,0,0
40605,76,3969,1293,570,1093,25,15,163,1318,10,195,123,241,205,364,1516,2795,6,17273,959,0,2,8,0,0
40606,238,5076,2,2,2,0,0,0,2,0,0,0,0,0,0,0,0,0,0,0,0,2,2,0,0
40607,238,5076,99,48,90,1,3,5,100,0,0,0,0,0,0,0,0,0,0,0,0,2,2,0,0
40608,238,5076,8,5,5,2,0,1,10,0,0,0,0,0,0,0,0,0,0,0,0,2,2,0,0
40609,238,5076,1217,716,841,84,126,174,1301,14,185,118,215,199,333,1446,2542,8,20687,1149,0,2,2,0,0
40610,238,5076,160,89,115,0,13,31,160,7,15,11,17,22,28,78,124,3,495,27,0,2,2,0,0
40611,238,5076,10,10,9,9,0,0,19,0,0,0,0,0,0,0,0,0,0,0,0,2,2,0,0
40612,238,5076,173,84,99,8,29,36,181,5,12,7,13,17,20,54,81,2,221,12,0,2,2,0,0
40613,238,5076,3,1,1,3,0,0,6,0,0,0,0,0,0,0,0,0,0,0,0,2,2,0,0
40614,261,6225,4293,999,3693,19,54,507,4312,9,155,88,170,164,258,1156,1898,4,9368,520,0,2,9,4,0
40615,261,6225,1482,859,1002,125,135,219,1607,16,219,134,251,235,385,1766,3032,9,27804,1544,1,2,9,4,0
40616,54,640,647,139,84,35,284,233,682,0,0,0,0,0,0,0,0,0,0,0,0,2,2,0,0
40617,105,2754,773,422,505,30,103,129,803,14,77,46,83,91,129,535,839,7,6334,351,0,2,1,0,0
40618,142,3472,77,34,69,0,0,8,77,3,24,16,29,27,45,114,213,1,387,21,0,2,2,0,0
40619,142,3472,712,438,573,51,9,84,763,14,102,71,128,116,199,733,1364,8,11988,666,0,2,2,0,0
40620,185,7999,4293,999,3693,19,54,507,4312,9,155,88,170,164,258,1156,1898,4,9368,520,0,2,20,0,0
40621,185,7999,1482,859,1002,125,135,219,1607,16,219,134,251,235,385,1766,3032,9,27804,1544,1,2,20,0,0
40622,76,3969,1293,570,1093,25,15,163,1318,10,195,123,241,205,364,1516,2795,6,17273,959,0,2,8,0,0
40623,238,5076,2,2,2,0,0,0,2,0,0,0,0,0,0,0,0,0,0,0,0,2,2,0,0
40624,238,5076,99,48,90,1,3,5,100,0,0,0,0,0,0,0,0,0,0,0,0,2,2,0,0
40625,238,5076,8,5,5,2,0,1,10,0,0,0,0,0,0,0,0,0,0,0,0,2,2,0,0
40626,238,5076,1217,716,841,84,126,174,1301,14,185,118,215,199,333,1446,2542,8,20687,1149,0,2,2,0,0
40627,238,5076,160,89,115,0,13,31,160,7,15,11,17,22,28,78,124,3,495,27,0,2,2,0,0
40628,238,5076,10,10,9,9,0,0,19,0,0,0,0,0,0,0,0,0,0,0,0,2,2,0,0
40629,238,5076,173,84,99,8,29,36,181,5,12,7,13,17,20,54,81,2,221,12,0,2,2,0,0
40630,238,5076,3,1,1,3,0,0,6,0,0,0,0,0,0,0,0,0,0,0,0,2,2,0,0
40631,261,6225,4293,999,3693,19,54,507,4312,9,155,88,170,164,258,1156,1898,4,9368,520,0,2,9,4,0
40632,261,6225,1482,859,1002,125,135,219,1607,16,219,134,251,235,385,1766,3032,9,27804,1544,1,2,9,4,0
40633,54,640,647,139,84,35,284,233,682,0,0,0,0,0,0,0,0,0,0,0,0,2,2,0,0
40634,105,2754,773,422,505,30,103,129,803,14,77,46,83,91,129,535,839,7,6334,351,0,2,1,0,0
40635,142,3472,77,34,69,0,0,8,77,3,24,16,29,27,45,114,213,1,387,21,0,2,2,0,0
40636,142,3472,712,438,573,51,9,84,763,14,102,71,128,116,199,733,1364,8,11988,666,0,2,2,0,0
40637,185,7999,4293,999,3693,19,54,507,4312,9,155,88,170,164,258,1156,1898,4,9368,520,0,2,20,0,0
40638,185,7999,1482,859,1002,125,135,219,1607,16,219,134,251,235,385,1766,3032,9,27804,1544,1,2,20,0,0
40639,76,3969,1293,570,1093,25,15,163,1318,10,195,123,241,205,364,1516,2795,6,17273,959,0,2,8,0,0
40640,282,5905,1943,715,1694,26,18,214,1969,12,185,120,237,197,357,1436,2721,7,20915,1161,0,2,5,1,0
40641,282,5905,1168,838,957,57,25,144,1225,19,348,224,416,367,640,3018,5452,11,61921,3440,1,2,5,1,0
40642,237,5050,2,2,2,0,0,0,2,0,0,0,0,0,0,0,0,0,0,0,0,2,0,5,0
40643,237,5050,99,48,90,1,3,5,100,0,0,0,0,0,0,0,0,0,0,0,0,2,0,5,0
40644,237,5050,8,5,5,2,0,1,10,0,0,0,0,0,0,0,0,0,0,0,0,2,0,5,0
40645,237,5050,1217,716,841,84,126,174,1301,14,185,118,215,199,333,1446,2542,8,20687,1149,0,2,0,5,0
40646,237,5050,160,89,115,0,13,31,160,7,15,11,17,22,28,78,124,3,495,27,0,2,0,5,0
40647,237,5050,10,10,9,9,0,0,19,0,0,0,0,0,0,0,0,0,0,0,0,2,0,5,0
40648,237,5050,173,84,99,8,29,36,181,5,12,7,13,17,20,54,81,2,221,12,0,2,0,5,0
40649,237,5050,3,1,1,3,0,0,6,0,0,0,0,0,0,0,0,0,0,0,0,2,0,5,0
40650,282,5905,1943,715,1694,26,18,214,1969,12,185,120,237,197,357,1436,2721,7,20915,1161,0,2,5,1,0
40651,282,5905,1168,838,957,57,25,144,1225,19,348,224,416,367,640,3018,5452,11,61921,3440,1,2,5,1,0
40652,237,5050,2,2,2,0,0,0,2,0,0,0,0,0,0,0,0,0,0,0,0,2,0,5,0
40653,237,5050,99,48,90,1,3,5,100,0,0,0,0,0,0,0,0,0,0,0,0,2,0,5,0
40654,237,5050,8,5,5,2,0,1,10,0,0,0,0,0,0,0,0,0,0,0,0,2,0,5,0
40655,237,5050,1217,716,841,84,126,174,1301,14,185,118,215,199,333,1446,2542,8,20687,1149,0,2,0,5,0
40656,237,5050,160,89,115,0,13,31,160,7,15,11,17,22,28,78,124,3,495,27,0,2,0,5,0
40657,237,5050,10,10,9,9,0,0,19,0,0,0,0,0,0,0,0,0,0,0,0,2,0,5,0
40658,237,5050,173,84,99,8,29,36,181,5,12,7,13,17,20,54,81,2,221,12,0,2,0,5,0
40659,237,5050,3,1,1,3,0,0,6,0,0,0,0,0,0,0,0,0,0,0,0,2,0,5,0
40660,216,4989,182,127,129,0,0,53,182,5,39,21,42,44,63,217,343,2,926,51,0,2,1,1,0
40661,216,4989,1165,710,800,67,119,181,1232,18,243,153,282,261,435,2000,3492,10,36473,2026,1,2,1,1,0
40662,90,2024,996,429,845,24,10,117,1020,7,76,50,88,83,138,494,879,4,3565,198,0,2,6,2,0
40663,90,2024,456,277,329,12,42,72,468,13,85,50,97,98,147,592,972,7,7212,400,0,2,6,2,0
40664,49,3806,996,429,845,24,10,117,1020,7,76,50,88,83,138,494,879,4,3565,198,0,2,6,1,0
40665,51,2040,1098,241,925,5,10,155,1103,7,46,25,49,53,74,273,423,3,1580,87,0,2,19,7,0
40666,87,1918,1043,504,840,53,9,147,1096,9,180,112,198,189,310,1377,2344,4,11604,644,0,2,3,10,0
40667,87,1918,383,288,292,26,6,62,409,11,65,38,67,76,105,429,656,5,3719,206,0,2,3,10,0
40668,88,3446,1043,504,840,53,9,147,1096,9,180,112,198,189,310,1377,2344,4,11604,644,0,2,11,2,0
40669,216,4989,182,127,129,0,0,53,182,5,39,21,42,44,63,217,343,2,926,51,0,2,1,1,0
40670,216,4989,1165,710,800,67,119,181,1232,18,243,153,282,261,435,2000,3492,10,36473,2026,1,2,1,1,0
40671,20,381,294,64,250,0,0,43,294,1,20,10,20,21,30,86,131,0,65,3,0,2,0,5,0
40672,20,381,78,46,62,3,0,14,81,3,8,4,8,11,12,28,41,1,62,3,0,2,0,5,0
40673,239,5074,2,2,2,0,0,0,2,0,0,0,0,0,0,0,0,0,0,0,0,2,5,6,0
40674,239,5074,99,48,90,1,3,5,100,0,0,0,0,0,0,0,0,0,0,0,0,2,5,6,0
40675,239,5074,8,5,5,2,0,1,10,0,0,0,0,0,0,0,0,0,0,0,0,2,5,6,0
40676,239,5074,1217,716,841,84,126,174,1301,14,185,118,215,199,333,1446,2542,8,20687,1149,0,2,5,6,0
40677,239,5074,160,89,115,0,13,31,160,7,15,11,17,22,28,78,124,3,495,27,0,2,5,6,0
40678,239,5074,10,10,9,9,0,0,19,0,0,0,0,0,0,0,0,0,0,0,0,2,5,6,0
40679,239,5074,173,84,99,8,29,36,181,5,12,7,13,17,20,54,81,2,221,12,0,2,5,6,0
40680,239,5074,3,1,1,3,0,0,6,0,0,0,0,0,0,0,0,0,0,0,0,2,5,6,0
40681,111,6057,1457,730,1242,11,6,188,1468,10,292,166,329,302,495,2424,4078,5,22973,1276,1,2,7,2,0
40682,87,1918,1043,504,840,53,9,147,1096,9,180,112,198,189,310,1377,2344,4,11604,644,0,2,3,10,0
40683,87,1918,383,288,292,26,6,62,409,11,65,38,67,76,105,429,656,5,3719,206,0,2,3,10,0
40684,88,3446,1043,504,840,53,9,147,1096,9,180,112,198,189,310,1377,2344,4,11604,644,0,2,11,2,0
40685,239,5074,2,2,2,0,0,0,2,0,0,0,0,0,0,0,0,0,0,0,0,2,5,6,0
40686,239,5074,99,48,90,1,3,5,100,0,0,0,0,0,0,0,0,0,0,0,0,2,5,6,0
40687,239,5074,8,5,5,2,0,1,10,0,0,0,0,0,0,0,0,0,0,0,0,2,5,6,0
40688,239,5074,1217,716,841,84,126,174,1301,14,185,118,215,199,333,1446,2542,8,20687,1149,0,2,5,6,0
40689,239,5074,160,89,115,0,13,31,160,7,15,11,17,22,28,78,124,3,495,27,0,2,5,6,0
40690,239,5074,10,10,9,9,0,0,19,0,0,0,0,0,0,0,0,0,0,0,0,2,5,6,0
40691,239,5074,173,84,99,8,29,36,181,5,12,7,13,17,20,54,81,2,221,12,0,2,5,6,0
40692,239,5074,3,1,1,3,0,0,6,0,0,0,0,0,0,0,0,0,0,0,0,2,5,6,0
40693,111,6057,1457,730,1242,11,6,188,1468,10,292,166,329,302,495,2424,4078,5,22973,1276,1,2,7,2,0
40694,90,2013,996,429,845,24,10,117,1020,7,76,50,88,83,138,494,879,4,3565,198,0,2,1,1,0
40695,90,2013,456,277,329,12,42,72,468,13,85,50,97,98,147,592,972,7,7212,400,0,2,1,1,0
40696,49,3782,996,429,845,24,10,117,1020,7,76,50,88,83,138,494,879,4,3565,198,0,2,1,1,0
40697,90,2013,996,429,845,24,10,117,1020,7,76,50,88,83,138,494,879,4,3565,198,0,2,1,1,0
40698,90,2013,456,277,329,12,42,72,468,13,85,50,97,98,147,592,972,7,7212,400,0,2,1,1,0
40699,49,3782,996,429,845,24,10,117,1020,7,76,50,88,83,138,494,879,4,3565,198,0,2,1,1,0
40700,51,2040,1098,241,925,5,10,155,1103,7,46,25,49,53,74,273,423,3,1580,87,0,2,19,7,0
40701,23,615,601,196,481,2,23,85,603,8,63,36,72,71,108,400,664,4,3036,168,0,2,1,1,0
40702,23,615,156,79,106,5,16,28,161,5,14,8,15,19,23,64,97,2,261,14,0,2,1,1,0
40703,20,405,294,64,250,0,0,43,294,1,20,10,20,21,30,86,131,0,65,3,0,2,1,2,0
40704,20,405,78,46,62,3,0,14,81,3,8,4,8,11,12,28,41,1,62,3,0,2,1,2,0
40705,20,381,294,64,250,0,0,43,294,1,20,10,20,21,30,86,131,0,65,3,0,2,0,5,0
40706,20,381,78,46,62,3,0,14,81,3,8,4,8,11,12,28,41,1,62,3,0,2,0,5,0
40707,124,2350,477,336,357,30,23,73,507,16,194,134,250,210,384,1538,2962,10,30538,1696,0,2,13,4,0
40708,185,6013,1660,832,1314,41,38,274,1701,20,312,209,395,332,604,2671,5058,12,64042,3557,1,2,15,6,0
40709,90,2013,996,429,845,24,10,117,1020,7,76,50,88,83,138,494,879,4,3565,198,0,2,1,1,0
40710,90,2013,456,277,329,12,42,72,468,13,85,50,97,98,147,592,972,7,7212,400,0,2,1,1,0
40711,238,5048,2,2,2,0,0,0,2,0,0,0,0,0,0,0,0,0,0,0,0,2,0,5,0
40712,238,5048,99,48,90,1,3,5,100,0,0,0,0,0,0,0,0,0,0,0,0,2,0,5,0
40713,238,5048,8,5,5,2,0,1,10,0,0,0,0,0,0,0,0,0,0,0,0,2,0,5,0
40714,238,5048,1217,716,841,84,126,174,1301,14,185,118,215,199,333,1446,2542,8,20687,1149,0,2,0,5,0
40715,238,5048,160,89,115,0,13,31,160,7,15,11,17,22,28,78,124,3,495,27,0,2,0,5,0
40716,238,5048,10,10,9,9,0,0,19,0,0,0,0,0,0,0,0,0,0,0,0,2,0,5,0
40717,238,5048,173,84,99,8,29,36,181,5,12,7,13,17,20,54,81,2,221,12,0,2,0,5,0
40718,238,5048,3,1,1,3,0,0,6,0,0,0,0,0,0,0,0,0,0,0,0,2,0,5,0
40719,20,381,294,64,250,0,0,43,294,1,20,10,20,21,30,86,131,0,65,3,0,2,0,5,0
40720,20,381,78,46,62,3,0,14,81,3,8,4,8,11,12,28,41,1,62,3,0,2,0,5,0
40721,49,3773,996,429,845,24,10,117,1020,7,76,50,88,83,138,494,879,4,3565,198,0,2,1,1,0
40722,12,572,294,64,250,0,0,43,294,1,20,10,20,21,30,86,131,0,65,3,0,2,25,0,0
40723,304,6701,72,33,56,0,4,12,72,1,1,1,1,2,2,0,2,0,1,0,0,2,10,6,1
40724,304,6701,1454,835,1044,76,110,219,1530,17,275,158,296,292,454,2297,3718,9,34017,1889,1,2,10,6,1
40725,80,3116,1178,367,1042,6,15,115,1184,9,94,51,95,103,146,644,976,4,4439,246,0,2,23,0,1
40726,306,6750,72,33,56,0,4,12,72,1,1,1,1,2,2,0,2,0,1,0,0,2,10,1,0
40727,306,6750,1454,835,1044,76,110,219,1530,17,275,158,296,292,454,2297,3718,9,34017,1889,1,2,10,1,0
40728,306,6763,72,33,56,0,4,12,72,1,1,1,1,2,2,0,2,0,1,0,0,2,9,10,1
40729,306,6763,1454,835,1044,76,110,219,1530,17,275,158,296,292,454,2297,3718,9,34017,1889,1,2,9,10,1
40730,232,5898,722,423,573,19,0,135,741,12,172,101,199,184,300,1320,2257,6,15668,870,0,2,0,2,0
40731,232,5898,1508,847,911,44,250,301,1552,14,148,88,169,162,257,1120,1886,7,15077,837,0,2,0,2,0
40732,161,3433,1513,682,1277,25,13,200,1538,11,199,116,219,210,335,1557,2584,6,15641,868,0,2,0,7,0
40733,161,3433,819,519,539,24,98,155,843,15,96,57,106,111,163,690,1107,8,9171,509,0,2,0,7,0
40734,288,6093,1943,715,1694,26,18,214,1969,12,185,120,237,197,357,1436,2721,7,20915,1161,0,2,60,23,0
40735,288,6093,1168,838,957,57,25,144,1225,19,348,224,416,367,640,3018,5452,11,61921,3440,1,2,60,23,0
40736,76,3969,1293,570,1093,25,15,163,1318,10,195,123,241,205,364,1516,2795,6,17273,959,0,2,5,5,0
40737,112,6632,1943,715,1694,26,18,214,1969,12,185,120,237,197,357,1436,2721,7,20915,1161,0,2,106,25,0
40738,90,2013,996,429,845,24,10,117,1020,7,76,50,88,83,138,494,879,4,3565,198,0,2,1,1,0
40739,90,2013,456,277,329,12,42,72,468,13,85,50,97,98,147,592,972,7,7212,400,0,2,1,1,0
40740,238,5048,2,2,2,0,0,0,2,0,0,0,0,0,0,0,0,0,0,0,0,2,0,5,0
40741,238,5048,99,48,90,1,3,5,100,0,0,0,0,0,0,0,0,0,0,0,0,2,0,5,0
40742,238,5048,8,5,5,2,0,1,10,0,0,0,0,0,0,0,0,0,0,0,0,2,0,5,0
40743,238,5048,1217,716,841,84,126,174,1301,14,185,118,215,199,333,1446,2542,8,20687,1149,0,2,0,5,0
40744,238,5048,160,89,115,0,13,31,160,7,15,11,17,22,28,78,124,3,495,27,0,2,0,5,0
40745,238,5048,10,10,9,9,0,0,19,0,0,0,0,0,0,0,0,0,0,0,0,2,0,5,0
40746,238,5048,173,84,99,8,29,36,181,5,12,7,13,17,20,54,81,2,221,12,0,2,0,5,0
40747,238,5048,3,1,1,3,0,0,6,0,0,0,0,0,0,0,0,0,0,0,0,2,0,5,0
40748,20,381,294,64,250,0,0,43,294,1,20,10,20,21,30,86,131,0,65,3,0,2,0,5,0
40749,20,381,78,46,62,3,0,14,81,3,8,4,8,11,12,28,41,1,62,3,0,2,0,5,0
40750,49,3773,996,429,845,24,10,117,1020,7,76,50,88,83,138,494,879,4,3565,198,0,2,1,1,0
40751,12,572,294,64,250,0,0,43,294,1,20,10,20,21,30,86,131,0,65,3,0,2,25,0,0
40752,161,3434,1513,682,1277,25,13,200,1538,11,199,116,219,210,335,1557,2584,6,15641,868,0,2,3,1,0
40753,161,3434,819,519,539,24,98,155,843,15,96,57,106,111,163,690,1107,8,9171,509,0,2,3,1,0
40754,3,96,35,12,22,4,5,6,39,1,2,1,2,3,3,2,4,0,2,0,0,2,1,0,0
40755,1,300,382,65,130,157,2,92,539,4,10,5,10,14,15,41,57,2,114,6,0,2,3,5,0
40756,60,1139,282,196,195,3,0,86,285,8,130,71,141,138,212,936,1507,4,6538,363,0,2,1,1,0
40757,3,65,127,75,83,2,11,30,129,4,14,7,14,18,21,61,87,2,175,9,0,2,1,1,0
40758,3,65,652,304,544,16,6,88,668,6,89,51,101,95,152,591,998,3,3399,188,0,2,1,1,0
40759,3,65,2,2,2,0,0,0,2,0,0,0,0,0,0,0,0,0,0,0,0,2,1,1,0
40760,3,65,8,5,5,0,0,3,8,0,0,0,0,0,0,0,0,0,0,0,0,2,1,1,0
40761,3,65,2,2,2,0,0,0,2,0,0,0,0,0,0,0,0,0,0,0,0,2,1,1,0
40762,3,65,14,8,8,0,0,6,14,0,0,0,0,0,0,0,0,0,0,0,0,2,1,1,0
40763,3,65,6,4,4,0,0,2,6,0,0,0,0,0,0,0,0,0,0,0,0,2,1,1,0
40764,3,65,6,4,4,0,0,2,6,1,2,1,2,3,3,2,4,0,2,0,0,2,1,1,0
40765,3,65,6,4,4,0,0,2,6,0,0,0,0,0,0,0,0,0,0,0,0,2,1,1,0
40766,3,65,7,5,5,0,0,2,7,0,0,0,0,0,0,0,0,0,0,0,0,2,1,1,0
40767,3,65,6,4,4,0,0,2,6,0,0,0,0,0,0,0,0,0,0,0,0,2,1,1,0
40768,3,65,10,6,6,0,0,4,10,0,0,0,0,0,0,0,0,0,0,0,0,2,1,1,0
40769,3,65,1,1,1,0,0,0,1,0,0,0,0,0,0,0,0,0,0,0,0,2,1,1,0
40770,3,65,1,1,1,0,0,0,1,0,0,0,0,0,0,0,0,0,0,0,0,2,1,1,0
40771,3,65,14,10,10,0,0,4,14,1,1,1,1,2,2,0,2,0,1,0,0,2,1,1,0
40772,3,65,46,26,30,3,0,12,49,3,6,3,6,9,9,20,28,1,42,2,0,2,1,1,0
40773,7,140,38,22,22,1,0,15,39,1,2,1,2,3,3,2,4,0,2,0,0,0,38,0,0
40774,7,292,72,33,56,0,4,12,72,1,1,1,1,2,2,0,2,0,1,0,0,2,1,1,0
40775,12,228,127,75,83,2,11,30,129,4,14,7,14,18,21,61,87,2,175,9,0,2,2,2,0
40776,12,228,652,304,544,16,6,88,668,6,89,51,101,95,152,591,998,3,3399,188,0,2,2,2,0
40777,12,228,2,2,2,0,0,0,2,0,0,0,0,0,0,0,0,0,0,0,0,2,2,2,0
40778,12,228,8,5,5,0,0,3,8,0,0,0,0,0,0,0,0,0,0,0,0,2,2,2,0
40779,12,228,2,2,2,0,0,0,2,0,0,0,0,0,0,0,0,0,0,0,0,2,2,2,0
40780,12,228,14,8,8,0,0,6,14,0,0,0,0,0,0,0,0,0,0,0,0,2,2,2,0
40781,12,228,6,4,4,0,0,2,6,0,0,0,0,0,0,0,0,0,0,0,0,2,2,2,0
40782,12,228,6,4,4,0,0,2,6,1,2,1,2,3,3,2,4,0,2,0,0,2,2,2,0
40783,12,228,6,4,4,0,0,2,6,0,0,0,0,0,0,0,0,0,0,0,0,2,2,2,0
40784,12,228,7,5,5,0,0,2,7,0,0,0,0,0,0,0,0,0,0,0,0,2,2,2,0
40785,12,228,6,4,4,0,0,2,6,0,0,0,0,0,0,0,0,0,0,0,0,2,2,2,0
40786,12,228,10,6,6,0,0,4,10,0,0,0,0,0,0,0,0,0,0,0,0,2,2,2,0
40787,12,228,1,1,1,0,0,0,1,0,0,0,0,0,0,0,0,0,0,0,0,2,2,2,0
40788,12,228,1,1,1,0,0,0,1,0,0,0,0,0,0,0,0,0,0,0,0,2,2,2,0
40789,12,228,14,10,10,0,0,4,14,1,1,1,1,2,2,0,2,0,1,0,0,2,2,2,0
40790,12,228,46,26,30,3,0,12,49,3,6,3,6,9,9,20,28,1,42,2,0,2,2,2,0
40791,1,93,42,7,35,4,0,5,46,1,2,1,2,3,3,2,4,0,2,0,0,2,3,4,0
40792,1,93,11,6,10,0,0,1,11,2,4,2,4,6,6,10,15,1,15,0,0,2,3,4,0
40793,216,4989,182,127,129,0,0,53,182,5,39,21,42,44,63,217,343,2,926,51,0,2,25,14,0
40794,216,4989,1165,710,800,67,119,181,1232,18,243,153,282,261,435,2000,3492,10,36473,2026,1,2,25,14,0
40795,67,1549,773,419,590,28,0,166,801,10,204,113,217,214,330,1598,2554,5,13587,754,0,2,7,6,0
40796,67,1549,421,273,302,44,34,57,465,17,81,59,107,98,166,583,1098,11,12329,684,0,2,7,6,0
40797,27,568,2,2,2,0,0,0,2,0,0,0,0,0,0,0,0,0,0,0,0,2,8,3,0
40798,27,568,99,48,90,1,3,5,100,0,0,0,0,0,0,0,0,0,0,0,0,2,8,3,0
40799,27,568,8,5,5,2,0,1,10,0,0,0,0,0,0,0,0,0,0,0,0,2,8,3,0
40800,27,568,1217,716,841,84,126,174,1301,14,185,118,215,199,333,1446,2542,8,20687,1149,0,2,8,3,0
40801,27,568,160,89,115,0,13,31,160,7,15,11,17,22,28,78,124,3,495,27,0,2,8,3,0
40802,27,568,10,10,9,9,0,0,19,0,0,0,0,0,0,0,0,0,0,0,0,2,8,3,0
40803,27,568,173,84,99,8,29,36,181,5,12,7,13,17,20,54,81,2,221,12,0,2,8,3,0
40804,27,568,3,1,1,3,0,0,6,0,0,0,0,0,0,0,0,0,0,0,0,2,8,3,0
40805,183,5415,1660,832,1314,41,38,274,1701,20,312,209,395,332,604,2671,5058,12,64042,3557,1,2,57,44,0
40806,183,5415,1057,646,719,113,100,145,1170,18,215,134,248,233,382,1740,3004,10,31186,1732,1,2,57,44,0
40807,123,2323,477,336,357,30,23,73,507,16,194,134,250,210,384,1538,2962,10,30538,1696,0,2,47,11,0
40808,90,2013,996,429,845,24,10,117,1020,7,76,50,88,83,138,494,879,4,3565,198,0,2,3,3,0
40809,90,2013,456,277,329,12,42,72,468,13,85,50,97,98,147,592,972,7,7212,400,0,2,3,3,0
40810,161,3434,1513,682,1277,25,13,200,1538,11,199,116,219,210,335,1557,2584,6,15641,868,0,2,5,1,0
40811,161,3434,819,519,539,24,98,155,843,15,96,57,106,111,163,690,1107,8,9171,509,0,2,5,1,0
40812,58,1191,207,111,150,11,0,50,218,5,26,19,36,31,55,133,272,3,943,52,0,2,43,19,0
40813,58,1191,410,198,237,31,55,97,441,11,63,38,72,74,110,414,683,6,4293,238,0,2,43,19,0
40814,238,5048,2,2,2,0,0,0,2,0,0,0,0,0,0,0,0,0,0,0,0,2,54,37,0
40815,238,5048,99,48,90,1,3,5,100,0,0,0,0,0,0,0,0,0,0,0,0,2,54,37,0
40816,238,5048,8,5,5,2,0,1,10,0,0,0,0,0,0,0,0,0,0,0,0,2,54,37,0
40817,238,5048,1217,716,841,84,126,174,1301,14,185,118,215,199,333,1446,2542,8,20687,1149,0,2,54,37,0
40818,238,5048,160,89,115,0,13,31,160,7,15,11,17,22,28,78,124,3,495,27,0,2,54,37,0
40819,238,5048,10,10,9,9,0,0,19,0,0,0,0,0,0,0,0,0,0,0,0,2,54,37,0
40820,238,5048,173,84,99,8,29,36,181,5,12,7,13,17,20,54,81,2,221,12,0,2,54,37,0
40821,238,5048,3,1,1,3,0,0,6,0,0,0,0,0,0,0,0,0,0,0,0,2,54,37,0
40822,113,2326,463,295,324,28,62,57,491,12,134,82,154,146,236,989,1696,6,11700,650,0,2,31,15,0
40823,37,813,167,116,138,4,5,22,171,8,48,30,56,56,86,292,499,4,2330,129,0,2,16,2,0
40824,57,1488,339,213,244,17,9,65,356,10,42,26,48,52,74,259,421,5,2410,133,0,2,8,2,0
40825,261,6225,4293,999,3693,19,54,507,4312,9,155,88,170,164,258,1156,1898,4,9368,520,0,2,134,14,0
40826,261,6225,1482,859,1002,125,135,219,1607,16,219,134,251,235,385,1766,3032,9,27804,1544,1,2,134,14,0
40827,31,1080,74,35,59,1,0,14,75,3,14,7,14,17,21,58,85,1,128,7,0,2,1,1,0
40828,31,1080,245,125,200,5,7,34,250,7,30,17,34,37,51,166,265,3,1053,58,0,2,1,1,0
40829,54,640,647,139,84,35,284,233,682,0,0,0,0,0,0,0,0,0,0,0,0,2,2,0,0
40830,117,3166,1523,757,1297,19,12,193,1542,12,193,117,230,205,347,1508,2664,7,19053,1058,0,2,4,0,0
40831,117,3166,701,378,504,33,58,109,734,13,110,68,126,123,194,794,1346,7,10027,557,0,2,4,0,0
40832,105,2754,773,422,505,30,103,129,803,14,77,46,83,91,129,535,839,7,6334,351,0,2,1,0,0
40833,142,3472,77,34,69,0,0,8,77,3,24,16,29,27,45,114,213,1,387,21,0,2,9,1,0
40834,142,3472,712,438,573,51,9,84,763,14,102,71,128,116,199,733,1364,8,11988,666,0,2,9,1,0
40835,30,669,125,97,103,3,0,19,128,9,25,17,27,34,44,144,223,4,1087,60,0,2,2,0,0
40836,70,1535,402,202,227,24,74,80,426,12,52,33,61,64,94,339,564,7,3969,220,0,2,17,16,0
40837,73,1701,53,23,39,0,0,13,53,2,8,4,8,10,12,26,39,1,39,2,0,2,41,22,0
40838,73,1701,515,298,307,33,80,99,548,12,63,44,77,75,121,419,753,7,5527,307,0,2,41,22,0
40839,12,572,205,80,86,16,53,53,221,7,18,10,19,25,29,94,134,3,497,27,0,2,20,10,0
40840,16,491,184,100,137,2,15,30,186,6,38,20,39,44,59,214,322,3,991,55,0,2,10,5,0
40841,16,491,103,65,74,8,5,16,111,7,17,9,17,24,26,89,119,3,417,23,0,2,10,5,0
40842,64,1354,91,45,69,0,3,18,91,3,9,6,10,12,16,33,57,1,95,5,0,2,52,20,0
40843,64,1354,367,234,237,17,34,68,384,16,55,34,61,71,95,381,584,8,5183,287,0,2,52,20,0
40844,232,5908,722,423,573,19,0,135,741,12,172,101,199,184,300,1320,2257,6,15668,870,0,2,63,21,0
40845,232,5908,1508,847,911,44,250,301,1552,14,148,88,169,162,257,1120,1886,7,15077,837,0,2,63,21,0
40846,303,6685,72,33,56,0,4,12,72,1,1,1,1,2,2,0,2,0,1,0,0,2,14,19,0
40847,303,6685,1454,835,1044,76,110,219,1530,17,275,158,296,292,454,2297,3718,9,34017,1889,1,2,14,19,0
40848,79,1961,757,253,292,73,244,162,830,13,61,38,67,74,105,409,651,7,4654,258,0,2,8,7,0
40849,20,987,386,256,301,16,9,68,402,4,59,35,69,63,104,355,621,2,1453,80,0,2,7,7,0
40850,20,987,264,131,164,11,41,46,275,6,38,22,40,44,62,214,338,3,1068,59,0,2,7,7,0
40851,79,1942,466,257,367,18,25,50,484,7,126,86,171,133,257,898,1813,4,8612,478,0,2,146,90,0
40852,79,1942,507,281,342,29,59,88,536,10,53,29,57,63,86,336,514,5,2764,153,0,2,146,90,0
40853,87,1918,1043,504,840,53,9,147,1096,9,180,112,198,189,310,1377,2344,4,11604,644,0,2,25,26,0
40854,87,1918,383,288,292,26,6,62,409,11,65,38,67,76,105,429,656,5,3719,206,0,2,25,26,0
40855,20,381,294,64,250,0,0,43,294,1,20,10,20,21,30,86,131,0,65,3,0,2,0,5,0
40856,20,381,78,46,62,3,0,14,81,3,8,4,8,11,12,28,41,1,62,3,0,2,0,5,0
40857,25,429,219,78,157,11,5,46,230,3,24,20,34,27,54,114,256,2,545,30,0,2,0,1,0
40858,25,429,108,64,79,9,0,20,117,5,15,11,19,20,30,70,129,3,410,22,0,2,0,1,0
40859,282,5905,1943,715,1694,26,18,214,1969,12,185,120,237,197,357,1436,2721,7,20915,1161,0,2,17,3,0
40860,282,5905,1168,838,957,57,25,144,1225,19,348,224,416,367,640,3018,5452,11,61921,3440,1,2,17,3,0
40861,70,1371,1098,241,925,5,10,155,1103,7,46,25,49,53,74,273,423,3,1580,87,0,2,6,0,0
40862,70,1371,282,202,222,14,2,44,296,8,42,24,43,50,67,250,378,4,1548,86,0,2,6,0,0
40863,108,4688,1289,550,1043,56,32,155,1345,10,167,93,185,177,278,1266,2075,5,11498,638,0,2,77,6,0
40864,31,956,182,127,129,0,0,53,182,5,39,21,42,44,63,217,343,2,926,51,0,2,3,7,0
40865,148,7105,1392,870,1177,35,17,170,1427,14,494,280,531,508,811,4473,7289,7,54850,3047,2,2,181,200,0
40866,16,386,127,75,83,2,11,30,129,4,14,7,14,18,21,61,87,2,175,9,0,2,60,0,0
40867,16,386,652,304,544,16,6,88,668,6,89,51,101,95,152,591,998,3,3399,188,0,2,60,0,0
40868,16,386,2,2,2,0,0,0,2,0,0,0,0,0,0,0,0,0,0,0,0,2,60,0,0
40869,16,386,8,5,5,0,0,3,8,0,0,0,0,0,0,0,0,0,0,0,0,2,60,0,0
40870,16,386,2,2,2,0,0,0,2,0,0,0,0,0,0,0,0,0,0,0,0,2,60,0,0
40871,16,386,14,8,8,0,0,6,14,0,0,0,0,0,0,0,0,0,0,0,0,2,60,0,0
40872,16,386,6,4,4,0,0,2,6,0,0,0,0,0,0,0,0,0,0,0,0,2,60,0,0
40873,16,386,6,4,4,0,0,2,6,1,2,1,2,3,3,2,4,0,2,0,0,2,60,0,0
40874,16,386,6,4,4,0,0,2,6,0,0,0,0,0,0,0,0,0,0,0,0,2,60,0,0
40875,16,386,7,5,5,0,0,2,7,0,0,0,0,0,0,0,0,0,0,0,0,2,60,0,0
40876,16,386,6,4,4,0,0,2,6,0,0,0,0,0,0,0,0,0,0,0,0,2,60,0,0
40877,16,386,10,6,6,0,0,4,10,0,0,0,0,0,0,0,0,0,0,0,0,2,60,0,0
40878,16,386,1,1,1,0,0,0,1,0,0,0,0,0,0,0,0,0,0,0,0,2,60,0,0
40879,16,386,1,1,1,0,0,0,1,0,0,0,0,0,0,0,0,0,0,0,0,2,60,0,0
40880,16,386,14,10,10,0,0,4,14,1,1,1,1,2,2,0,2,0,1,0,0,2,60,0,0
40881,16,386,46,26,30,3,0,12,49,3,6,3,6,9,9,20,28,1,42,2,0,2,60,0,0
40882,4,181,75,38,59,1,3,12,76,2,4,2,4,6,6,10,15,1,15,0,0,2,1,1,0
40883,15,696,139,89,101,2,0,35,141,7,54,34,62,61,96,330,569,4,2287,127,0,2,1,1,0
40884,42,2589,1157,318,931,29,22,177,1186,6,104,63,125,110,188,712,1274,3,4596,255,0,2,9,9,0
40885,89,3928,1338,495,1086,10,64,173,1348,11,122,82,157,133,239,883,1686,7,11934,663,0,2,1,47,0
40886,185,7999,4293,999,3693,19,54,507,4312,9,155,88,170,164,258,1156,1898,4,9368,520,0,2,253,15,0
40887,185,7999,1482,859,1002,125,135,219,1607,16,219,134,251,235,385,1766,3032,9,27804,1544,1,2,253,15,0
40888,33,992,465,148,393,5,8,60,470,4,31,20,31,35,51,161,261,2,523,29,0,2,33,14,0
40889,33,992,16,12,9,0,0,6,16,1,2,1,2,3,3,2,4,0,2,0,0,2,33,14,0
40890,30,919,256,139,192,9,7,47,265,4,23,12,24,27,36,112,171,2,357,19,0,2,8,8,0
40891,6,322,180,34,164,0,0,16,180,1,12,6,12,13,18,43,66,0,33,1,0,2,2,2,0
40892,124,5153,1450,624,1228,12,26,181,1462,14,306,186,354,320,540,2580,4493,8,36391,2021,1,2,88,19,0
40893,183,5958,1660,832,1314,41,38,274,1701,20,312,209,395,332,604,2671,5058,12,64042,3557,1,2,55,3,0
40894,49,3773,996,429,845,24,10,117,1020,7,76,50,88,83,138,494,879,4,3565,198,0,2,4,4,0
40895,120,5064,1513,682,1277,25,13,200,1538,11,199,116,219,210,335,1557,2584,6,15641,868,0,2,7,7,0
40896,85,4935,1296,573,1062,40,33,157,1336,8,201,118,231,209,349,1561,2689,4,12365,686,0,2,18,6,0
40897,23,513,207,111,150,11,0,50,218,5,26,19,36,31,55,133,272,3,943,52,0,2,34,3,0
40898,111,6057,1457,730,1242,11,6,188,1468,10,292,166,329,302,495,2424,4078,5,22973,1276,1,2,29,3,0
40899,46,2848,652,304,544,16,6,88,668,6,89,51,101,95,152,591,998,3,3399,188,0,2,32,4,0
40900,81,3714,1455,414,1257,16,76,112,1471,5,41,23,46,46,69,231,381,2,1069,59,0,2,4,4,0
40901,113,5657,1523,757,1297,19,12,193,1542,12,193,117,230,205,347,1508,2664,7,19053,1058,0,2,228,127,0
40902,69,3090,1020,354,843,12,15,144,1032,8,134,77,144,142,221,970,1580,4,6792,377,0,2,1,1,0
40903,3,90,35,12,22,4,5,6,39,1,2,1,2,3,3,2,4,0,2,0,0,0,28,0,0
40904,21,637,424,94,331,4,0,89,428,1,5,5,5,6,10,11,25,0,12,0,0,2,1,1,0
40905,38,2315,334,251,279,10,4,40,344,5,127,74,143,132,217,899,1528,2,4303,239,0,2,6,1,0
40906,18,697,184,100,137,2,15,30,186,6,38,20,39,44,59,214,322,3,991,55,0,2,69,2,0
40907,77,4048,1293,570,1093,25,15,163,1318,10,195,123,241,205,364,1516,2795,6,17273,959,0,2,9,1,0
40908,59,2994,722,423,573,19,0,135,741,12,172,101,199,184,300,1320,2257,6,15668,870,0,2,48,2,0
40909,31,1843,466,257,367,18,25,50,484,7,126,86,171,133,257,898,1813,4,8612,478,0,2,72,2,0
40910,88,3446,1043,504,840,53,9,147,1096,9,180,112,198,189,310,1377,2344,4,11604,644,0,2,51,19,0
40911,12,463,295,56,236,0,4,54,295,2,9,5,10,11,15,30,51,1,57,3,0,2,1,1,0
40912,12,572,294,64,250,0,0,43,294,1,20,10,20,21,30,86,131,0,65,3,0,3,29,4,0
40913,1,43,110,30,77,3,13,16,113,4,21,15,30,25,45,100,208,2,597,33,0,3,3,3,0
40914,79,3068,1178,367,1042,6,15,115,1184,9,94,51,95,103,146,644,976,4,4439,246,0,2,3,2,0
40915,12,645,219,78,157,11,5,46,230,3,24,20,34,27,54,114,256,2,545,30,0,2,2,1,0
40916,112,6100,1943,715,1694,26,18,214,1969,12,185,120,237,197,357,1436,2721,7,20915,1161,0,2,31,14,0
40917,39,1770,442,244,305,14,16,103,456,11,68,45,75,79,120,452,756,6,4588,254,0,2,97,13,0
40918,51,2040,1098,241,925,5,10,155,1103,7,46,25,49,53,74,273,423,3,1580,87,0,2,60,12,0
40919,49,1706,601,196,481,2,23,85,603,8,63,36,72,71,108,400,664,4,3036,168,0,2,18,0,0
40920,90,2024,996,429,845,24,10,117,1020,7,76,50,88,83,138,494,879,4,3565,198,0,2,6,2,0
40921,90,2024,456,277,329,12,42,72,468,13,85,50,97,98,147,592,972,7,7212,400,0,2,6,2,0
40922,49,3806,996,429,845,24,10,117,1020,7,76,50,88,83,138,494,879,4,3565,198,0,2,6,1,0
40923,161,3433,1513,682,1277,25,13,200,1538,11,199,116,219,210,335,1557,2584,6,15641,868,0,2,0,7,0
40924,161,3433,819,519,539,24,98,155,843,15,96,57,106,111,163,690,1107,8,9171,509,0,2,0,7,0
40925,102,2603,1455,414,1257,16,76,112,1471,5,41,23,46,46,69,231,381,2,1069,59,0,2,4,0,0
40926,102,2603,669,365,481,22,61,110,691,15,103,63,122,118,185,747,1273,8,11311,628,0,2,4,0,0
40927,77,4048,1293,570,1093,25,15,163,1318,10,195,123,241,205,364,1516,2795,6,17273,959,0,2,23,1,0
40928,20,378,294,64,250,0,0,43,294,1,20,10,20,21,30,86,131,0,65,3,0,2,1,2,0
40929,20,378,78,46,62,3,0,14,81,3,8,4,8,11,12,28,41,1,62,3,0,2,1,2,0
40930,23,615,601,196,481,2,23,85,603,8,63,36,72,71,108,400,664,4,3036,168,0,2,1,1,0
40931,23,615,156,79,106,5,16,28,161,5,14,8,15,19,23,64,97,2,261,14,0,2,1,1,0
40932,232,5898,722,423,573,19,0,135,741,12,172,101,199,184,300,1320,2257,6,15668,870,0,2,0,2,0
40933,232,5898,1508,847,911,44,250,301,1552,14,148,88,169,162,257,1120,1886,7,15077,837,0,2,0,2,0
40934,103,2613,1455,414,1257,16,76,112,1471,5,41,23,46,46,69,231,381,2,1069,59,0,2,6,0,0
40935,103,2613,669,365,481,22,61,110,691,15,103,63,122,118,185,747,1273,8,11311,628,0,2,6,0,0
40936,106,4670,1289,550,1043,56,32,155,1345,10,167,93,185,177,278,1266,2075,5,11498,638,0,2,15,10,0
40937,288,6093,1943,715,1694,26,18,214,1969,12,185,120,237,197,357,1436,2721,7,20915,1161,0,2,60,23,0
40938,288,6093,1168,838,957,57,25,144,1225,19,348,224,416,367,640,3018,5452,11,61921,3440,1,2,60,23,0
40939,77,4048,1293,570,1093,25,15,163,1318,10,195,123,241,205,364,1516,2795,6,17273,959,0,2,5,5,0
40940,112,6632,1943,715,1694,26,18,214,1969,12,185,120,237,197,357,1436,2721,7,20915,1161,0,2,106,25,0
40941,77,4048,1293,570,1093,25,15,163,1318,10,195,123,241,205,364,1516,2795,6,17273,959,0,2,1,1,0
40942,77,4048,1293,570,1093,25,15,163,1318,10,195,123,241,205,364,1516,2795,6,17273,959,0,2,1,1,0
40943,239,5069,2,2,2,0,0,0,2,0,0,0,0,0,0,0,0,0,0,0,0,2,10,3,0
40944,239,5069,99,48,90,1,3,5,100,0,0,0,0,0,0,0,0,0,0,0,0,2,10,3,0
40945,239,5069,8,5,5,2,0,1,10,0,0,0,0,0,0,0,0,0,0,0,0,2,10,3,0
40946,239,5069,1217,716,841,84,126,174,1301,14,185,118,215,199,333,1446,2542,8,20687,1149,0,2,10,3,0
40947,239,5069,160,89,115,0,13,31,160,7,15,11,17,22,28,78,124,3,495,27,0,2,10,3,0
40948,239,5069,10,10,9,9,0,0,19,0,0,0,0,0,0,0,0,0,0,0,0,2,10,3,0
40949,239,5069,173,84,99,8,29,36,181,5,12,7,13,17,20,54,81,2,221,12,0,2,10,3,0
40950,239,5069,3,1,1,3,0,0,6,0,0,0,0,0,0,0,0,0,0,0,0,2,10,3,0
40951,232,5896,722,423,573,19,0,135,741,12,172,101,199,184,300,1320,2257,6,15668,870,0,2,3,1,0
40952,232,5896,1508,847,911,44,250,301,1552,14,148,88,169,162,257,1120,1886,7,15077,837,0,2,3,1,0
40953,111,6056,1457,730,1242,11,6,188,1468,10,292,166,329,302,495,2424,4078,5,22973,1276,1,2,1,1,0
40954,88,3442,1043,504,840,53,9,147,1096,9,180,112,198,189,310,1377,2344,4,11604,644,0,2,2,3,0
40955,239,5069,2,2,2,0,0,0,2,0,0,0,0,0,0,0,0,0,0,0,0,2,10,3,0
40956,239,5069,99,48,90,1,3,5,100,0,0,0,0,0,0,0,0,0,0,0,0,2,10,3,0
40957,239,5069,8,5,5,2,0,1,10,0,0,0,0,0,0,0,0,0,0,0,0,2,10,3,0
40958,239,5069,1217,716,841,84,126,174,1301,14,185,118,215,199,333,1446,2542,8,20687,1149,0,2,10,3,0
40959,239,5069,160,89,115,0,13,31,160,7,15,11,17,22,28,78,124,3,495,27,0,2,10,3,0
40960,239,5069,10,10,9,9,0,0,19,0,0,0,0,0,0,0,0,0,0,0,0,2,10,3,0
40961,239,5069,173,84,99,8,29,36,181,5,12,7,13,17,20,54,81,2,221,12,0,2,10,3,0
40962,239,5069,3,1,1,3,0,0,6,0,0,0,0,0,0,0,0,0,0,0,0,2,10,3,0
40963,20,983,386,256,301,16,9,68,402,4,59,35,69,63,104,355,621,2,1453,80,0,2,2,5,0
40964,20,983,264,131,164,11,41,46,275,6,38,22,40,44,62,214,338,3,1068,59,0,2,2,5,0
40965,102,2626,1455,414,1257,16,76,112,1471,5,41,23,46,46,69,231,381,2,1069,59,0,2,6,3,0
40966,102,2626,669,365,481,22,61,110,691,15,103,63,122,118,185,747,1273,8,11311,628,0,2,6,3,0
40967,103,2613,1455,414,1257,16,76,112,1471,5,41,23,46,46,69,231,381,2,1069,59,0,2,6,0,0
40968,103,2613,669,365,481,22,61,110,691,15,103,63,122,118,185,747,1273,8,11311,628,0,2,6,0,0
40969,106,4670,1289,550,1043,56,32,155,1345,10,167,93,185,177,278,1266,2075,5,11498,638,0,2,15,10,0
40970,103,2636,1455,414,1257,16,76,112,1471,5,41,23,46,46,69,231,381,2,1069,59,0,2,6,3,0
40971,103,2636,669,365,481,22,61,110,691,15,103,63,122,118,185,747,1273,8,11311,628,0,2,6,3,0
40972,20,983,386,256,301,16,9,68,402,4,59,35,69,63,104,355,621,2,1453,80,0,2,2,5,0
40973,20,983,264,131,164,11,41,46,275,6,38,22,40,44,62,214,338,3,1068,59,0,2,2,5,0
40974,103,2720,1455,414,1257,16,76,112,1471,5,41,23,46,46,69,231,381,2,1069,59,0,2,61,34,1
40975,103,2720,669,365,481,22,61,110,691,15,103,63,122,118,185,747,1273,8,11311,628,0,2,61,34,1
40976,81,3715,1455,414,1257,16,76,112,1471,5,41,23,46,46,69,231,381,2,1069,59,0,2,4,3,1
40977,105,2793,773,422,505,30,103,129,803,14,77,46,83,91,129,535,839,7,6334,351,0,2,16,11,0
40978,23,625,601,196,481,2,23,85,603,8,63,36,72,71,108,400,664,4,3036,168,0,2,4,0,0
40979,23,625,156,79,106,5,16,28,161,5,14,8,15,19,23,64,97,2,261,14,0,2,4,0,0
40980,85,2046,996,429,845,24,10,117,1020,7,76,50,88,83,138,494,879,4,3565,198,0,2,9,3,0
40981,85,2046,456,277,329,12,42,72,468,13,85,50,97,98,147,592,972,7,7212,400,0,2,9,3,0
40982,288,6168,1943,715,1694,26,18,214,1969,12,185,120,237,197,357,1436,2721,7,20915,1161,0,2,26,16,0
40983,288,6168,1168,838,957,57,25,144,1225,19,348,224,416,367,640,3018,5452,11,61921,3440,1,2,26,16,0
40984,161,3438,1513,682,1277,25,13,200,1538,11,199,116,219,210,335,1557,2584,6,15641,868,0,2,5,5,0
40985,161,3438,819,519,539,24,98,155,843,15,96,57,106,111,163,690,1107,8,9171,509,0,2,5,5,0
40986,120,5074,1513,682,1277,25,13,200,1538,11,199,116,219,210,335,1557,2584,6,15641,868,0,2,4,2,0
40987,65,1379,91,45,69,0,3,18,91,3,9,6,10,12,16,33,57,1,95,5,0,2,22,7,0
40988,65,1379,367,234,237,17,34,68,384,16,55,34,61,71,95,381,584,8,5183,287,0,2,22,7,0
40989,39,1798,442,244,305,14,16,103,456,11,68,45,75,79,120,452,756,6,4588,254,0,2,4,0,0
40990,184,5417,1660,832,1314,41,38,274,1701,20,312,209,395,332,604,2671,5058,12,64042,3557,1,2,3,3,0
40991,184,5417,1057,646,719,113,100,145,1170,18,215,134,248,233,382,1740,3004,10,31186,1732,1,2,3,3,0
40992,103,2720,1455,414,1257,16,76,112,1471,5,41,23,46,46,69,231,381,2,1069,59,0,2,1,3,0
40993,103,2720,669,365,481,22,61,110,691,15,103,63,122,118,185,747,1273,8,11311,628,0,2,1,3,0
40994,73,1701,53,23,39,0,0,13,53,2,8,4,8,10,12,26,39,1,39,2,0,2,1,2,0
40995,73,1701,515,298,307,33,80,99,548,12,63,44,77,75,121,419,753,7,5527,307,0,2,1,2,0
40996,233,5923,722,423,573,19,0,135,741,12,172,101,199,184,300,1320,2257,6,15668,870,0,2,5,2,1
40997,233,5923,1508,847,911,44,250,301,1552,14,148,88,169,162,257,1120,1886,7,15077,837,0,2,5,2,1
40998,59,3032,722,423,573,19,0,135,741,12,172,101,199,184,300,1320,2257,6,15668,870,0,2,19,11,1
40999,233,5913,722,423,573,19,0,135,741,12,172,101,199,184,300,1320,2257,6,15668,870,0,2,5,2,0
41000,233,5913,1508,847,911,44,250,301,1552,14,148,88,169,162,257,1120,1886,7,15077,837,0,2,5,2,0
41001,59,3032,722,423,573,19,0,135,741,12,172,101,199,184,300,1320,2257,6,15668,870,0,2,19,11,0
41002,233,5911,722,423,573,19,0,135,741,12,172,101,199,184,300,1320,2257,6,15668,870,0,2,3,1,0
41003,233,5911,1508,847,911,44,250,301,1552,14,148,88,169,162,257,1120,1886,7,15077,837,0,2,3,1,0
41004,111,6056,1457,730,1242,11,6,188,1468,10,292,166,329,302,495,2424,4078,5,22973,1276,1,2,1,1,0
41005,88,3442,1043,504,840,53,9,147,1096,9,180,112,198,189,310,1377,2344,4,11604,644,0,2,2,3,0
41006,184,5417,1660,832,1314,41,38,274,1701,20,312,209,395,332,604,2671,5058,12,64042,3557,1,2,3,3,0
41007,184,5417,1057,646,719,113,100,145,1170,18,215,134,248,233,382,1740,3004,10,31186,1732,1,2,3,3,0
41008,85,2046,996,429,845,24,10,117,1020,7,76,50,88,83,138,494,879,4,3565,198,0,2,9,3,0
41009,85,2046,456,277,329,12,42,72,468,13,85,50,97,98,147,592,972,7,7212,400,0,2,9,3,0
41010,161,3438,1513,682,1277,25,13,200,1538,11,199,116,219,210,335,1557,2584,6,15641,868,0,2,5,5,0
41011,161,3438,819,519,539,24,98,155,843,15,96,57,106,111,163,690,1107,8,9171,509,0,2,5,5,0
41012,103,2720,1455,414,1257,16,76,112,1471,5,41,23,46,46,69,231,381,2,1069,59,0,2,58,33,0
41013,103,2720,669,365,481,22,61,110,691,15,103,63,122,118,185,747,1273,8,11311,628,0,2,58,33,0
41014,105,2793,773,422,505,30,103,129,803,14,77,46,83,91,129,535,839,7,6334,351,0,2,16,11,0
41015,73,1701,53,23,39,0,0,13,53,2,8,4,8,10,12,26,39,1,39,2,0,2,1,2,0
41016,73,1701,515,298,307,33,80,99,548,12,63,44,77,75,121,419,753,7,5527,307,0,2,1,2,0
41017,288,6168,1943,715,1694,26,18,214,1969,12,185,120,237,197,357,1436,2721,7,20915,1161,0,2,26,16,0
41018,288,6168,1168,838,957,57,25,144,1225,19,348,224,416,367,640,3018,5452,11,61921,3440,1,2,26,16,0
41019,23,625,601,196,481,2,23,85,603,8,63,36,72,71,108,400,664,4,3036,168,0,2,4,0,0
41020,23,625,156,79,106,5,16,28,161,5,14,8,15,19,23,64,97,2,261,14,0,2,4,0,0
41021,120,5074,1513,682,1277,25,13,200,1538,11,199,116,219,210,335,1557,2584,6,15641,868,0,2,4,2,0
41022,81,3715,1455,414,1257,16,76,112,1471,5,41,23,46,46,69,231,381,2,1069,59,0,2,4,3,0
41023,161,3438,1513,682,1277,25,13,200,1538,11,199,116,219,210,335,1557,2584,6,15641,868,0,2,3,1,0
41024,161,3438,819,519,539,24,98,155,843,15,96,57,106,111,163,690,1107,8,9171,509,0,2,3,1,0
41025,65,1379,91,45,69,0,3,18,91,3,9,6,10,12,16,33,57,1,95,5,0,2,22,7,0
41026,65,1379,367,234,237,17,34,68,384,16,55,34,61,71,95,381,584,8,5183,287,0,2,22,7,0
41027,39,1798,442,244,305,14,16,103,456,11,68,45,75,79,120,452,756,6,4588,254,0,2,4,0,0
41028,124,2350,477,336,357,30,23,73,507,16,194,134,250,210,384,1538,2962,10,30538,1696,0,2,13,4,0
41029,185,6013,1660,832,1314,41,38,274,1701,20,312,209,395,332,604,2671,5058,12,64042,3557,1,2,15,6,0
41030,3,96,35,12,22,4,5,6,39,1,2,1,2,3,3,2,4,0,2,0,0,2,1,0,0
41031,232,5986,722,423,573,19,0,135,741,12,172,101,199,184,300,1320,2257,6,15668,870,0,2,16,9,1
41032,232,5986,1508,847,911,44,250,301,1552,14,148,88,169,162,257,1120,1886,7,15077,837,0,2,16,9,1
41033,60,3137,722,423,573,19,0,135,741,12,172,101,199,184,300,1320,2257,6,15668,870,0,2,44,15,1
41034,233,5989,722,423,573,19,0,135,741,12,172,101,199,184,300,1320,2257,6,15668,870,0,2,16,9,0
41035,233,5989,1508,847,911,44,250,301,1552,14,148,88,169,162,257,1120,1886,7,15077,837,0,2,16,9,0
41036,60,3175,722,423,573,19,0,135,741,12,172,101,199,184,300,1320,2257,6,15668,870,0,2,44,15,0
41037,85,2057,996,429,845,24,10,117,1020,7,76,50,88,83,138,494,879,4,3565,198,0,2,6,2,0
41038,85,2057,456,277,329,12,42,72,468,13,85,50,97,98,147,592,972,7,7212,400,0,2,6,2,0
41039,65,1379,91,45,69,0,3,18,91,3,9,6,10,12,16,33,57,1,95,5,0,2,22,7,0
41040,65,1379,367,234,237,17,34,68,384,16,55,34,61,71,95,381,584,8,5183,287,0,2,22,7,0
41041,49,3797,996,429,845,24,10,117,1020,7,76,50,88,83,138,494,879,4,3565,198,0,2,6,1,0
41042,39,1798,442,244,305,14,16,103,456,11,68,45,75,79,120,452,756,6,4588,254,0,2,4,0,0
41043,80,1970,757,253,292,73,244,162,830,13,61,38,67,74,105,409,651,7,4654,258,0,2,5,7,0
41044,66,4451,520,294,400,33,13,81,553,10,261,204,367,271,571,2128,4614,7,32445,1802,1,2,15,1,0
41045,65,4328,520,294,400,33,13,81,553,10,261,204,367,271,571,2128,4614,7,32445,1802,1,2,16,35,0
41046,290,6183,1943,715,1694,26,18,214,1969,12,185,120,237,197,357,1436,2721,7,20915,1161,0,2,7,1,0
41047,290,6183,1168,838,957,57,25,144,1225,19,348,224,416,367,640,3018,5452,11,61921,3440,1,2,7,1,0
41048,113,6684,1943,715,1694,26,18,214,1969,12,185,120,237,197,357,1436,2721,7,20915,1161,0,2,17,0,0
41049,117,2936,773,422,505,30,103,129,803,14,77,46,83,91,129,535,839,7,6334,351,0,2,87,12,0
41050,3,501,149,67,118,4,0,27,153,1,17,14,28,18,42,69,175,0,144,8,0,2,66,2,0
41051,80,1970,757,253,292,73,244,162,830,13,61,38,67,74,105,409,651,7,4654,258,0,2,1,1,0
41052,85,2057,996,429,845,24,10,117,1020,7,76,50,88,83,138,494,879,4,3565,198,0,2,6,2,0
41053,85,2057,456,277,329,12,42,72,468,13,85,50,97,98,147,592,972,7,7212,400,0,2,6,2,0
41054,65,1379,91,45,69,0,3,18,91,3,9,6,10,12,16,33,57,1,95,5,0,2,22,7,0
41055,65,1379,367,234,237,17,34,68,384,16,55,34,61,71,95,381,584,8,5183,287,0,2,22,7,0
41056,49,3797,996,429,845,24,10,117,1020,7,76,50,88,83,138,494,879,4,3565,198,0,2,6,1,0
41057,39,1798,442,244,305,14,16,103,456,11,68,45,75,79,120,452,756,6,4588,254,0,2,4,0,0
41058,80,1970,757,253,292,73,244,162,830,13,61,38,67,74,105,409,651,7,4654,258,0,2,6,8,0
41059,65,4328,520,294,400,33,13,81,553,10,261,204,367,271,571,2128,4614,7,32445,1802,1,2,31,36,0
41060,187,5471,1660,832,1314,41,38,274,1701,20,312,209,395,332,604,2671,5058,12,64042,3557,1,2,31,15,1
41061,187,5471,1057,646,719,113,100,145,1170,18,215,134,248,233,382,1740,3004,10,31186,1732,1,2,31,15,1
41062,189,6306,1660,832,1314,41,38,274,1701,20,312,209,395,332,604,2671,5058,12,64042,3557,1,2,60,1,1
41063,89,3931,1338,495,1086,10,64,173,1348,11,122,82,157,133,239,883,1686,7,11934,663,0,2,1,1,0
41064,31,1843,466,257,367,18,25,50,484,7,126,86,171,133,257,898,1813,4,8612,478,0,2,5,5,0
41065,216,4974,182,127,129,0,0,53,182,5,39,21,42,44,63,217,343,2,926,51,0,2,2,1,0
41066,216,4974,1165,710,800,67,119,181,1232,18,243,153,282,261,435,2000,3492,10,36473,2026,1,2,2,1,0
41067,105,2748,773,422,505,30,103,129,803,14,77,46,83,91,129,535,839,7,6334,351,0,2,3,4,0
41068,225,5745,722,423,573,19,0,135,741,12,172,101,199,184,300,1320,2257,6,15668,870,0,2,2,1,0
41069,225,5745,1508,847,911,44,250,301,1552,14,148,88,169,162,257,1120,1886,7,15077,837,0,2,2,1,0
41070,79,1942,466,257,367,18,25,50,484,7,126,86,171,133,257,898,1813,4,8612,478,0,2,2,1,0
41071,79,1942,507,281,342,29,59,88,536,10,53,29,57,63,86,336,514,5,2764,153,0,2,2,1,0
41072,120,5083,1513,682,1277,25,13,200,1538,11,199,116,219,210,335,1557,2584,6,15641,868,0,2,4,5,0
41073,15,1033,215,129,180,6,0,29,221,8,65,43,72,73,115,415,711,4,3153,175,0,2,6,7,0
41074,112,6136,1943,715,1694,26,18,214,1969,12,185,120,237,197,357,1436,2721,7,20915,1161,0,2,2,1,0
41075,186,5480,1660,832,1314,41,38,274,1701,20,312,209,395,332,604,2671,5058,12,64042,3557,1,2,16,18,0
41076,186,5480,1057,646,719,113,100,145,1170,18,215,134,248,233,382,1740,3004,10,31186,1732,1,2,16,18,0
41077,59,1223,207,111,150,11,0,50,218,5,26,19,36,31,55,133,272,3,943,52,0,2,14,0,0
41078,59,1223,410,198,237,31,55,97,441,11,63,38,72,74,110,414,683,6,4293,238,0,2,14,0,0
41079,189,6308,1660,832,1314,41,38,274,1701,20,312,209,395,332,604,2671,5058,12,64042,3557,1,2,15,15,0
41080,186,5480,1660,832,1314,41,38,274,1701,20,312,209,395,332,604,2671,5058,12,64042,3557,1,2,39,25,0
41081,186,5480,1057,646,719,113,100,145,1170,18,215,134,248,233,382,1740,3004,10,31186,1732,1,2,39,25,0
41082,59,1223,207,111,150,11,0,50,218,5,26,19,36,31,55,133,272,3,943,52,0,2,14,0,0
41083,59,1223,410,198,237,31,55,97,441,11,63,38,72,74,110,414,683,6,4293,238,0,2,14,0,0
41084,189,6308,1660,832,1314,41,38,274,1701,20,312,209,395,332,604,2671,5058,12,64042,3557,1,2,74,15,0
41085,216,4974,182,127,129,0,0,53,182,5,39,21,42,44,63,217,343,2,926,51,0,2,2,1,0
41086,216,4974,1165,710,800,67,119,181,1232,18,243,153,282,261,435,2000,3492,10,36473,2026,1,2,2,1,0
41087,105,2748,773,422,505,30,103,129,803,14,77,46,83,91,129,535,839,7,6334,351,0,2,3,4,0
41088,225,5745,722,423,573,19,0,135,741,12,172,101,199,184,300,1320,2257,6,15668,870,0,2,2,1,0
41089,225,5745,1508,847,911,44,250,301,1552,14,148,88,169,162,257,1120,1886,7,15077,837,0,2,2,1,0
41090,79,1942,466,257,367,18,25,50,484,7,126,86,171,133,257,898,1813,4,8612,478,0,2,2,1,0
41091,79,1942,507,281,342,29,59,88,536,10,53,29,57,63,86,336,514,5,2764,153,0,2,2,1,0
41092,120,5083,1513,682,1277,25,13,200,1538,11,199,116,219,210,335,1557,2584,6,15641,868,0,2,4,5,0
41093,15,1033,215,129,180,6,0,29,221,8,65,43,72,73,115,415,711,4,3153,175,0,2,6,7,0
41094,112,6136,1943,715,1694,26,18,214,1969,12,185,120,237,197,357,1436,2721,7,20915,1161,0,2,2,1,0
41095,89,3931,1338,495,1086,10,64,173,1348,11,122,82,157,133,239,883,1686,7,11934,663,0,2,1,1,0
41096,31,1843,466,257,367,18,25,50,484,7,126,86,171,133,257,898,1813,4,8612,478,0,2,5,5,0
41097,60,1550,91,45,69,0,3,18,91,3,9,6,10,12,16,33,57,1,95,5,0,2,38,23,0
41098,60,1550,367,234,237,17,34,68,384,16,55,34,61,71,95,381,584,8,5183,287,0,2,38,23,0
41099,18,704,442,244,305,14,16,103,456,11,68,45,75,79,120,452,756,6,4588,254,0,2,20,15,0
41100,18,704,182,102,99,11,40,35,193,3,11,6,11,14,17,42,64,1,97,5,0,2,20,15,0
41101,232,5973,722,423,573,19,0,135,741,12,172,101,199,184,300,1320,2257,6,15668,870,0,2,0,2,0
41102,232,5973,1508,847,911,44,250,301,1552,14,148,88,169,162,257,1120,1886,7,15077,837,0,2,0,2,0
41103,216,4989,182,127,129,0,0,53,182,5,39,21,42,44,63,217,343,2,926,51,0,2,2,1,0
41104,216,4989,1165,710,800,67,119,181,1232,18,243,153,282,261,435,2000,3492,10,36473,2026,1,2,2,1,0
41105,105,2787,773,422,505,30,103,129,803,14,77,46,83,91,129,535,839,7,6334,351,0,2,3,4,0
41106,233,5989,722,423,573,19,0,135,741,12,172,101,199,184,300,1320,2257,6,15668,870,0,2,2,1,0
41107,233,5989,1508,847,911,44,250,301,1552,14,148,88,169,162,257,1120,1886,7,15077,837,0,2,2,1,0
41108,79,1942,466,257,367,18,25,50,484,7,126,86,171,133,257,898,1813,4,8612,478,0,2,2,1,0
41109,79,1942,507,281,342,29,59,88,536,10,53,29,57,63,86,336,514,5,2764,153,0,2,2,1,0
41110,89,3928,1338,495,1086,10,64,173,1348,11,122,82,157,133,239,883,1686,7,11934,663,0,2,1,1,0
41111,120,5072,1513,682,1277,25,13,200,1538,11,199,116,219,210,335,1557,2584,6,15641,868,0,2,4,5,0
41112,31,1843,466,257,367,18,25,50,484,7,126,86,171,133,257,898,1813,4,8612,478,0,2,5,5,0
41113,15,1033,215,129,180,6,0,29,221,8,65,43,72,73,115,415,711,4,3153,175,0,2,6,7,0
41114,112,6632,1943,715,1694,26,18,214,1969,12,185,120,237,197,357,1436,2721,7,20915,1161,0,2,2,1,0
41115,216,4989,182,127,129,0,0,53,182,5,39,21,42,44,63,217,343,2,926,51,0,2,2,1,0
41116,216,4989,1165,710,800,67,119,181,1232,18,243,153,282,261,435,2000,3492,10,36473,2026,1,2,2,1,0
41117,105,2787,773,422,505,30,103,129,803,14,77,46,83,91,129,535,839,7,6334,351,0,2,3,4,0
41118,233,5989,722,423,573,19,0,135,741,12,172,101,199,184,300,1320,2257,6,15668,870,0,2,2,1,0
41119,233,5989,1508,847,911,44,250,301,1552,14,148,88,169,162,257,1120,1886,7,15077,837,0,2,2,1,0
41120,79,1942,466,257,367,18,25,50,484,7,126,86,171,133,257,898,1813,4,8612,478,0,2,2,1,0
41121,79,1942,507,281,342,29,59,88,536,10,53,29,57,63,86,336,514,5,2764,153,0,2,2,1,0
41122,89,3928,1338,495,1086,10,64,173,1348,11,122,82,157,133,239,883,1686,7,11934,663,0,2,1,1,0
41123,120,5072,1513,682,1277,25,13,200,1538,11,199,116,219,210,335,1557,2584,6,15641,868,0,2,4,5,0
41124,31,1843,466,257,367,18,25,50,484,7,126,86,171,133,257,898,1813,4,8612,478,0,2,5,5,0
41125,15,1033,215,129,180,6,0,29,221,8,65,43,72,73,115,415,711,4,3153,175,0,2,6,7,0
41126,112,6632,1943,715,1694,26,18,214,1969,12,185,120,237,197,357,1436,2721,7,20915,1161,0,2,2,1,0
41127,120,5076,1513,682,1277,25,13,200,1538,11,199,116,219,210,335,1557,2584,6,15641,868,0,2,1,5,0
41128,24,608,2,2,2,0,0,0,2,0,0,0,0,0,0,0,0,0,0,0,0,2,2,4,0
41129,24,608,99,48,90,1,3,5,100,0,0,0,0,0,0,0,0,0,0,0,0,2,2,4,0
41130,24,608,8,5,5,2,0,1,10,0,0,0,0,0,0,0,0,0,0,0,0,2,2,4,0
41131,24,608,1217,716,841,84,126,174,1301,14,185,118,215,199,333,1446,2542,8,20687,1149,0,2,2,4,0
41132,24,608,160,89,115,0,13,31,160,7,15,11,17,22,28,78,124,3,495,27,0,2,2,4,0
41133,24,608,10,10,9,9,0,0,19,0,0,0,0,0,0,0,0,0,0,0,0,2,2,4,0
41134,24,608,173,84,99,8,29,36,181,5,12,7,13,17,20,54,81,2,221,12,0,2,2,4,0
41135,24,608,3,1,1,3,0,0,6,0,0,0,0,0,0,0,0,0,0,0,0,2,2,4,0
41136,24,608,2,2,2,0,0,0,2,0,0,0,0,0,0,0,0,0,0,0,0,2,2,4,0
41137,24,608,99,48,90,1,3,5,100,0,0,0,0,0,0,0,0,0,0,0,0,2,2,4,0
41138,24,608,8,5,5,2,0,1,10,0,0,0,0,0,0,0,0,0,0,0,0,2,2,4,0
41139,24,608,1217,716,841,84,126,174,1301,14,185,118,215,199,333,1446,2542,8,20687,1149,0,2,2,4,0
41140,24,608,160,89,115,0,13,31,160,7,15,11,17,22,28,78,124,3,495,27,0,2,2,4,0
41141,24,608,10,10,9,9,0,0,19,0,0,0,0,0,0,0,0,0,0,0,0,2,2,4,0
41142,24,608,173,84,99,8,29,36,181,5,12,7,13,17,20,54,81,2,221,12,0,2,2,4,0
41143,24,608,3,1,1,3,0,0,6,0,0,0,0,0,0,0,0,0,0,0,0,2,2,4,0
41144,235,6063,722,423,573,19,0,135,741,12,172,101,199,184,300,1320,2257,6,15668,870,0,2,31,21,0
41145,235,6063,1508,847,911,44,250,301,1552,14,148,88,169,162,257,1120,1886,7,15077,837,0,2,31,21,0
41146,62,3231,722,423,573,19,0,135,741,12,172,101,199,184,300,1320,2257,6,15668,870,0,2,21,0,0
41147,143,3484,77,34,69,0,0,8,77,3,24,16,29,27,45,114,213,1,387,21,0,2,4,1,0
41148,143,3484,712,438,573,51,9,84,763,14,102,71,128,116,199,733,1364,8,11988,666,0,2,4,1,0
41149,292,6223,1943,715,1694,26,18,214,1969,12,185,120,237,197,357,1436,2721,7,20915,1161,0,2,15,2,0
41150,292,6223,1168,838,957,57,25,144,1225,19,348,224,416,367,640,3018,5452,11,61921,3440,1,2,15,2,0
41151,106,4670,1289,550,1043,56,32,155,1345,10,167,93,185,177,278,1266,2075,5,11498,638,0,2,2,2,0
41152,89,3928,1338,495,1086,10,64,173,1348,11,122,82,157,133,239,883,1686,7,11934,663,0,2,1,1,0
41153,185,7999,4293,999,3693,19,54,507,4312,9,155,88,170,164,258,1156,1898,4,9368,520,0,2,1,1,0
41154,185,7999,1482,859,1002,125,135,219,1607,16,219,134,251,235,385,1766,3032,9,27804,1544,1,2,1,1,0
41155,189,6308,1660,832,1314,41,38,274,1701,20,312,209,395,332,604,2671,5058,12,64042,3557,1,2,1,1,0
41156,120,5072,1513,682,1277,25,13,200,1538,11,199,116,219,210,335,1557,2584,6,15641,868,0,2,1,1,0
41157,85,4935,1296,573,1062,40,33,157,1336,8,201,118,231,209,349,1561,2689,4,12365,686,0,2,3,3,0
41158,81,3715,1455,414,1257,16,76,112,1471,5,41,23,46,46,69,231,381,2,1069,59,0,2,1,1,0
41159,69,3090,1020,354,843,12,15,144,1032,8,134,77,144,142,221,970,1580,4,6792,377,0,2,1,1,0
41160,12,463,295,56,236,0,4,54,295,2,9,5,10,11,15,30,51,1,57,3,0,2,1,1,0
41161,79,3068,1178,367,1042,6,15,115,1184,9,94,51,95,103,146,644,976,4,4439,246,0,2,1,1,0
41162,12,645,219,78,157,11,5,46,230,3,24,20,34,27,54,114,256,2,545,30,0,2,1,1,0
41163,112,6661,1943,715,1694,26,18,214,1969,12,185,120,237,197,357,1436,2721,7,20915,1161,0,2,4,7,0
41164,49,1706,601,196,481,2,23,85,603,8,63,36,72,71,108,400,664,4,3036,168,0,2,6,6,0
41165,119,4999,1513,682,1277,25,13,200,1538,11,199,116,219,210,335,1557,2584,6,15641,868,0,2,1,14,0
41166,232,5973,722,423,573,19,0,135,741,12,172,101,199,184,300,1320,2257,6,15668,870,0,2,0,2,0
41167,232,5973,1508,847,911,44,250,301,1552,14,148,88,169,162,257,1120,1886,7,15077,837,0,2,0,2,0
41168,234,6047,722,423,573,19,0,135,741,12,172,101,199,184,300,1320,2257,6,15668,870,0,2,31,21,0
41169,234,6047,1508,847,911,44,250,301,1552,14,148,88,169,162,257,1120,1886,7,15077,837,0,2,31,21,0
41170,62,3231,722,423,573,19,0,135,741,12,172,101,199,184,300,1320,2257,6,15668,870,0,2,21,0,0
41171,69,4366,520,294,400,33,13,81,553,10,261,204,367,271,571,2128,4614,7,32445,1802,1,2,27,12,0
41172,69,4372,520,294,400,33,13,81,553,10,261,204,367,271,571,2128,4614,7,32445,1802,1,2,5,2,0
41173,17,400,127,75,83,2,11,30,129,4,14,7,14,18,21,61,87,2,175,9,0,2,4,1,0
41174,17,400,652,304,544,16,6,88,668,6,89,51,101,95,152,591,998,3,3399,188,0,2,4,1,0
41175,17,400,2,2,2,0,0,0,2,0,0,0,0,0,0,0,0,0,0,0,0,2,4,1,0
41176,17,400,8,5,5,0,0,3,8,0,0,0,0,0,0,0,0,0,0,0,0,2,4,1,0
41177,17,400,2,2,2,0,0,0,2,0,0,0,0,0,0,0,0,0,0,0,0,2,4,1,0
41178,17,400,14,8,8,0,0,6,14,0,0,0,0,0,0,0,0,0,0,0,0,2,4,1,0
41179,17,400,6,4,4,0,0,2,6,0,0,0,0,0,0,0,0,0,0,0,0,2,4,1,0
41180,17,400,6,4,4,0,0,2,6,1,2,1,2,3,3,2,4,0,2,0,0,2,4,1,0
41181,17,400,6,4,4,0,0,2,6,0,0,0,0,0,0,0,0,0,0,0,0,2,4,1,0
41182,17,400,7,5,5,0,0,2,7,0,0,0,0,0,0,0,0,0,0,0,0,2,4,1,0
41183,17,400,6,4,4,0,0,2,6,0,0,0,0,0,0,0,0,0,0,0,0,2,4,1,0
41184,17,400,10,6,6,0,0,4,10,0,0,0,0,0,0,0,0,0,0,0,0,2,4,1,0
41185,17,400,1,1,1,0,0,0,1,0,0,0,0,0,0,0,0,0,0,0,0,2,4,1,0
41186,17,400,1,1,1,0,0,0,1,0,0,0,0,0,0,0,0,0,0,0,0,2,4,1,0
41187,17,400,14,10,10,0,0,4,14,1,1,1,1,2,2,0,2,0,1,0,0,2,4,1,0
41188,17,400,46,26,30,3,0,12,49,3,6,3,6,9,9,20,28,1,42,2,0,2,4,1,0
41189,8,310,103,47,73,2,12,15,105,5,16,9,17,21,26,75,114,2,303,16,0,2,2,2,0
41190,60,1550,91,45,69,0,3,18,91,3,9,6,10,12,16,33,57,1,95,5,0,2,38,23,0
41191,60,1550,367,234,237,17,34,68,384,16,55,34,61,71,95,381,584,8,5183,287,0,2,38,23,0
41192,18,704,442,244,305,14,16,103,456,11,68,45,75,79,120,452,756,6,4588,254,0,2,20,15,0
41193,18,704,182,102,99,11,40,35,193,3,11,6,11,14,17,42,64,1,97,5,0,2,20,15,0
41194,120,5072,1513,682,1277,25,13,200,1538,11,199,116,219,210,335,1557,2584,6,15641,868,0,2,1,3,0
41195,17,400,127,75,83,2,11,30,129,4,14,7,14,18,21,61,87,2,175,9,0,2,4,1,0
41196,17,400,652,304,544,16,6,88,668,6,89,51,101,95,152,591,998,3,3399,188,0,2,4,1,0
41197,17,400,2,2,2,0,0,0,2,0,0,0,0,0,0,0,0,0,0,0,0,2,4,1,0
41198,17,400,8,5,5,0,0,3,8,0,0,0,0,0,0,0,0,0,0,0,0,2,4,1,0
41199,17,400,2,2,2,0,0,0,2,0,0,0,0,0,0,0,0,0,0,0,0,2,4,1,0
41200,17,400,14,8,8,0,0,6,14,0,0,0,0,0,0,0,0,0,0,0,0,2,4,1,0
41201,17,400,6,4,4,0,0,2,6,0,0,0,0,0,0,0,0,0,0,0,0,2,4,1,0
41202,17,400,6,4,4,0,0,2,6,1,2,1,2,3,3,2,4,0,2,0,0,2,4,1,0
41203,17,400,6,4,4,0,0,2,6,0,0,0,0,0,0,0,0,0,0,0,0,2,4,1,0
41204,17,400,7,5,5,0,0,2,7,0,0,0,0,0,0,0,0,0,0,0,0,2,4,1,0
41205,17,400,6,4,4,0,0,2,6,0,0,0,0,0,0,0,0,0,0,0,0,2,4,1,0
41206,17,400,10,6,6,0,0,4,10,0,0,0,0,0,0,0,0,0,0,0,0,2,4,1,0
41207,17,400,1,1,1,0,0,0,1,0,0,0,0,0,0,0,0,0,0,0,0,2,4,1,0
41208,17,400,1,1,1,0,0,0,1,0,0,0,0,0,0,0,0,0,0,0,0,2,4,1,0
41209,17,400,14,10,10,0,0,4,14,1,1,1,1,2,2,0,2,0,1,0,0,2,4,1,0
41210,17,400,46,26,30,3,0,12,49,3,6,3,6,9,9,20,28,1,42,2,0,2,4,1,0
41211,120,5072,1513,682,1277,25,13,200,1538,11,199,116,219,210,335,1557,2584,6,15641,868,0,2,1,3,0
41212,143,3484,77,34,69,0,0,8,77,3,24,16,29,27,45,114,213,1,387,21,0,2,4,1,0
41213,143,3484,712,438,573,51,9,84,763,14,102,71,128,116,199,733,1364,8,11988,666,0,2,4,1,0
41214,292,6223,1943,715,1694,26,18,214,1969,12,185,120,237,197,357,1436,2721,7,20915,1161,0,2,15,2,0
41215,292,6223,1168,838,957,57,25,144,1225,19,348,224,416,367,640,3018,5452,11,61921,3440,1,2,15,2,0
41216,106,4670,1289,550,1043,56,32,155,1345,10,167,93,185,177,278,1266,2075,5,11498,638,0,2,2,2,0
41217,89,3928,1338,495,1086,10,64,173,1348,11,122,82,157,133,239,883,1686,7,11934,663,0,2,1,1,0
41218,185,7999,4293,999,3693,19,54,507,4312,9,155,88,170,164,258,1156,1898,4,9368,520,0,2,1,1,0
41219,185,7999,1482,859,1002,125,135,219,1607,16,219,134,251,235,385,1766,3032,9,27804,1544,1,2,1,1,0
41220,189,6308,1660,832,1314,41,38,274,1701,20,312,209,395,332,604,2671,5058,12,64042,3557,1,2,1,1,0
41221,120,5072,1513,682,1277,25,13,200,1538,11,199,116,219,210,335,1557,2584,6,15641,868,0,2,1,1,0
41222,85,4935,1296,573,1062,40,33,157,1336,8,201,118,231,209,349,1561,2689,4,12365,686,0,2,3,3,0
41223,81,3715,1455,414,1257,16,76,112,1471,5,41,23,46,46,69,231,381,2,1069,59,0,2,1,1,0
41224,69,3090,1020,354,843,12,15,144,1032,8,134,77,144,142,221,970,1580,4,6792,377,0,2,1,1,0
41225,12,463,295,56,236,0,4,54,295,2,9,5,10,11,15,30,51,1,57,3,0,2,1,1,0
41226,79,3068,1178,367,1042,6,15,115,1184,9,94,51,95,103,146,644,976,4,4439,246,0,2,1,1,0
41227,12,645,219,78,157,11,5,46,230,3,24,20,34,27,54,114,256,2,545,30,0,2,1,1,0
41228,112,6661,1943,715,1694,26,18,214,1969,12,185,120,237,197,357,1436,2721,7,20915,1161,0,2,4,7,0
41229,49,1706,601,196,481,2,23,85,603,8,63,36,72,71,108,400,664,4,3036,168,0,2,6,6,0
41230,40,786,1178,367,1042,6,15,115,1184,9,94,51,95,103,146,644,976,4,4439,246,0,2,2,2,0
41231,40,786,177,108,140,8,0,27,185,6,30,16,32,36,48,162,248,3,794,44,0,2,2,2,0
41232,292,6221,1943,715,1694,26,18,214,1969,12,185,120,237,197,357,1436,2721,7,20915,1161,0,2,1,1,0
41233,292,6221,1168,838,957,57,25,144,1225,19,348,224,416,367,640,3018,5452,11,61921,3440,1,2,1,1,0
41234,79,3071,1178,367,1042,6,15,115,1184,9,94,51,95,103,146,644,976,4,4439,246,0,2,17,3,0
41235,120,5079,1513,682,1277,25,13,200,1538,11,199,116,219,210,335,1557,2584,6,15641,868,0,2,2,2,0
41236,239,5071,2,2,2,0,0,0,2,0,0,0,0,0,0,0,0,0,0,0,0,2,1,0,0
41237,239,5071,99,48,90,1,3,5,100,0,0,0,0,0,0,0,0,0,0,0,0,2,1,0,0
41238,239,5071,8,5,5,2,0,1,10,0,0,0,0,0,0,0,0,0,0,0,0,2,1,0,0
41239,239,5071,1217,716,841,84,126,174,1301,14,185,118,215,199,333,1446,2542,8,20687,1149,0,2,1,0,0
41240,239,5071,160,89,115,0,13,31,160,7,15,11,17,22,28,78,124,3,495,27,0,2,1,0,0
41241,239,5071,10,10,9,9,0,0,19,0,0,0,0,0,0,0,0,0,0,0,0,2,1,0,0
41242,239,5071,173,84,99,8,29,36,181,5,12,7,13,17,20,54,81,2,221,12,0,2,1,0,0
41243,239,5071,3,1,1,3,0,0,6,0,0,0,0,0,0,0,0,0,0,0,0,2,1,0,0
41244,79,1942,466,257,367,18,25,50,484,7,126,86,171,133,257,898,1813,4,8612,478,0,2,5,5,0
41245,79,1942,507,281,342,29,59,88,536,10,53,29,57,63,86,336,514,5,2764,153,0,2,5,5,0
41246,31,1843,466,257,367,18,25,50,484,7,126,86,171,133,257,898,1813,4,8612,478,0,2,3,3,0
41247,54,640,647,139,84,35,284,233,682,0,0,0,0,0,0,0,0,0,0,0,0,2,0,20,0
41248,239,5071,2,2,2,0,0,0,2,0,0,0,0,0,0,0,0,0,0,0,0,2,1,0,0
41249,239,5071,99,48,90,1,3,5,100,0,0,0,0,0,0,0,0,0,0,0,0,2,1,0,0
41250,239,5071,8,5,5,2,0,1,10,0,0,0,0,0,0,0,0,0,0,0,0,2,1,0,0
41251,239,5071,1217,716,841,84,126,174,1301,14,185,118,215,199,333,1446,2542,8,20687,1149,0,2,1,0,0
41252,239,5071,160,89,115,0,13,31,160,7,15,11,17,22,28,78,124,3,495,27,0,2,1,0,0
41253,239,5071,10,10,9,9,0,0,19,0,0,0,0,0,0,0,0,0,0,0,0,2,1,0,0
41254,239,5071,173,84,99,8,29,36,181,5,12,7,13,17,20,54,81,2,221,12,0,2,1,0,0
41255,239,5071,3,1,1,3,0,0,6,0,0,0,0,0,0,0,0,0,0,0,0,2,1,0,0
41256,54,640,647,139,84,35,284,233,682,0,0,0,0,0,0,0,0,0,0,0,0,2,0,20,0
41257,79,1942,466,257,367,18,25,50,484,7,126,86,171,133,257,898,1813,4,8612,478,0,2,5,5,0
41258,79,1942,507,281,342,29,59,88,536,10,53,29,57,63,86,336,514,5,2764,153,0,2,5,5,0
41259,31,1843,466,257,367,18,25,50,484,7,126,86,171,133,257,898,1813,4,8612,478,0,2,3,3,0
41260,237,5056,2,2,2,0,0,0,2,0,0,0,0,0,0,0,0,0,0,0,0,2,3,1,0
41261,237,5056,99,48,90,1,3,5,100,0,0,0,0,0,0,0,0,0,0,0,0,2,3,1,0
41262,237,5056,8,5,5,2,0,1,10,0,0,0,0,0,0,0,0,0,0,0,0,2,3,1,0
41263,237,5056,1217,716,841,84,126,174,1301,14,185,118,215,199,333,1446,2542,8,20687,1149,0,2,3,1,0
41264,237,5056,160,89,115,0,13,31,160,7,15,11,17,22,28,78,124,3,495,27,0,2,3,1,0
41265,237,5056,10,10,9,9,0,0,19,0,0,0,0,0,0,0,0,0,0,0,0,2,3,1,0
41266,237,5056,173,84,99,8,29,36,181,5,12,7,13,17,20,54,81,2,221,12,0,2,3,1,0
41267,237,5056,3,1,1,3,0,0,6,0,0,0,0,0,0,0,0,0,0,0,0,2,3,1,0
41268,54,642,647,139,84,35,284,233,682,0,0,0,0,0,0,0,0,0,0,0,0,2,6,1,0
41269,30,1924,384,251,317,7,8,52,391,11,70,44,84,81,128,467,811,6,5355,297,0,2,30,0,0
41270,57,1473,339,213,244,17,9,65,356,10,42,26,48,52,74,259,421,5,2410,133,0,2,11,7,1
41271,78,4151,1293,570,1093,25,15,163,1318,10,195,123,241,205,364,1516,2795,6,17273,959,0,2,45,1,1
41272,57,1473,339,213,244,17,9,65,356,10,42,26,48,52,74,259,421,5,2410,133,0,2,11,7,0
41273,78,4151,1293,570,1093,25,15,163,1318,10,195,123,241,205,364,1516,2795,6,17273,959,0,2,45,1,0
41274,216,4974,182,127,129,0,0,53,182,5,39,21,42,44,63,217,343,2,926,51,0,2,5,5,0
41275,216,4974,1165,710,800,67,119,181,1232,18,243,153,282,261,435,2000,3492,10,36473,2026,1,2,5,5,0
41276,117,3166,1523,757,1297,19,12,193,1542,12,193,117,230,205,347,1508,2664,7,19053,1058,0,2,1,1,0
41277,117,3166,701,378,504,33,58,109,734,13,110,68,126,123,194,794,1346,7,10027,557,0,2,1,1,0
41278,142,3472,77,34,69,0,0,8,77,3,24,16,29,27,45,114,213,1,387,21,0,2,1,1,0
41279,142,3472,712,438,573,51,9,84,763,14,102,71,128,116,199,733,1364,8,11988,666,0,2,1,1,0
41280,30,669,125,97,103,3,0,19,128,9,25,17,27,34,44,144,223,4,1087,60,0,2,1,1,0
41281,22,367,102,57,55,5,16,25,107,5,17,10,18,22,28,81,124,2,330,18,0,2,1,1,0
41282,303,6685,72,33,56,0,4,12,72,1,1,1,1,2,2,0,2,0,1,0,0,2,3,3,0
41283,303,6685,1454,835,1044,76,110,219,1530,17,275,158,296,292,454,2297,3718,9,34017,1889,1,2,3,3,0
41284,40,784,1178,367,1042,6,15,115,1184,9,94,51,95,103,146,644,976,4,4439,246,0,2,2,2,0
41285,40,784,177,108,140,8,0,27,185,6,30,16,32,36,48,162,248,3,794,44,0,2,2,2,0
41286,147,5933,1782,648,1425,9,47,279,1791,8,171,97,189,179,286,1292,2140,4,9462,525,0,2,1,1,0
41287,69,3090,1020,354,843,12,15,144,1032,8,134,77,144,142,221,970,1580,4,6792,377,0,2,1,1,0
41288,21,637,424,94,331,4,0,89,428,1,5,5,5,6,10,11,25,0,12,0,0,2,1,1,0
41289,38,2315,334,251,279,10,4,40,344,5,127,74,143,132,217,899,1528,2,4303,239,0,2,1,1,0
41290,76,3969,1293,570,1093,25,15,163,1318,10,195,123,241,205,364,1516,2795,6,17273,959,0,2,1,1,0
41291,12,645,219,78,157,11,5,46,230,3,24,20,34,27,54,114,256,2,545,30,0,2,1,1,0
41292,216,4974,182,127,129,0,0,53,182,5,39,21,42,44,63,217,343,2,926,51,0,2,5,5,0
41293,216,4974,1165,710,800,67,119,181,1232,18,243,153,282,261,435,2000,3492,10,36473,2026,1,2,5,5,0
41294,117,3166,1523,757,1297,19,12,193,1542,12,193,117,230,205,347,1508,2664,7,19053,1058,0,2,1,1,0
41295,117,3166,701,378,504,33,58,109,734,13,110,68,126,123,194,794,1346,7,10027,557,0,2,1,1,0
41296,142,3472,77,34,69,0,0,8,77,3,24,16,29,27,45,114,213,1,387,21,0,2,1,1,0
41297,142,3472,712,438,573,51,9,84,763,14,102,71,128,116,199,733,1364,8,11988,666,0,2,1,1,0
41298,30,669,125,97,103,3,0,19,128,9,25,17,27,34,44,144,223,4,1087,60,0,2,1,1,0
41299,22,367,102,57,55,5,16,25,107,5,17,10,18,22,28,81,124,2,330,18,0,2,1,1,0
41300,303,6685,72,33,56,0,4,12,72,1,1,1,1,2,2,0,2,0,1,0,0,2,3,3,0
41301,303,6685,1454,835,1044,76,110,219,1530,17,275,158,296,292,454,2297,3718,9,34017,1889,1,2,3,3,0
41302,40,784,1178,367,1042,6,15,115,1184,9,94,51,95,103,146,644,976,4,4439,246,0,2,2,2,0
41303,40,784,177,108,140,8,0,27,185,6,30,16,32,36,48,162,248,3,794,44,0,2,2,2,0
41304,147,5933,1782,648,1425,9,47,279,1791,8,171,97,189,179,286,1292,2140,4,9462,525,0,2,1,1,0
41305,69,3090,1020,354,843,12,15,144,1032,8,134,77,144,142,221,970,1580,4,6792,377,0,2,1,1,0
41306,21,637,424,94,331,4,0,89,428,1,5,5,5,6,10,11,25,0,12,0,0,2,1,1,0
41307,38,2315,334,251,279,10,4,40,344,5,127,74,143,132,217,899,1528,2,4303,239,0,2,1,1,0
41308,78,4151,1293,570,1093,25,15,163,1318,10,195,123,241,205,364,1516,2795,6,17273,959,0,2,1,1,0
41309,12,645,219,78,157,11,5,46,230,3,24,20,34,27,54,114,256,2,545,30,0,2,1,1,0
41310,66,1699,53,23,39,0,0,13,53,2,8,4,8,10,12,26,39,1,39,2,0,2,3,2,0
41311,66,1699,515,298,307,33,80,99,548,12,63,44,77,75,121,419,753,7,5527,307,0,2,3,2,0
41312,120,5076,1513,682,1277,25,13,200,1538,11,199,116,219,210,335,1557,2584,6,15641,868,0,2,1,5,0
41313,294,6238,1943,715,1694,26,18,214,1969,12,185,120,237,197,357,1436,2721,7,20915,1161,0,2,7,1,0
41314,294,6238,1168,838,957,57,25,144,1225,19,348,224,416,367,640,3018,5452,11,61921,3440,1,2,7,1,0
41315,113,6713,1943,715,1694,26,18,214,1969,12,185,120,237,197,357,1436,2721,7,20915,1161,0,2,17,0,0
41316,113,6713,1943,715,1694,26,18,214,1969,12,185,120,237,197,357,1436,2721,7,20915,1161,0,2,2,2,0
41317,12,320,149,95,105,2,0,41,151,8,54,28,55,62,83,334,494,4,2013,111,0,2,8,7,0
41318,12,320,82,56,54,0,13,15,82,4,13,8,16,17,24,56,98,2,241,13,0,2,8,7,0
41319,121,2276,477,336,357,30,23,73,507,16,194,134,250,210,384,1538,2962,10,30538,1696,0,2,1,18,0
41320,73,2511,477,336,357,30,23,73,507,16,194,134,250,210,384,1538,2962,10,30538,1696,0,2,42,23,0
41321,49,1715,601,196,481,2,23,85,603,8,63,36,72,71,108,400,664,4,3036,168,0,2,1,0,0
41322,112,6693,1943,715,1694,26,18,214,1969,12,185,120,237,197,357,1436,2721,7,20915,1161,0,2,7,14,0
41323,12,320,149,95,105,2,0,41,151,8,54,28,55,62,83,334,494,4,2013,111,0,2,8,7,0
41324,12,320,82,56,54,0,13,15,82,4,13,8,16,17,24,56,98,2,241,13,0,2,8,7,0
41325,73,2511,477,336,357,30,23,73,507,16,194,134,250,210,384,1538,2962,10,30538,1696,0,2,43,41,0
41326,112,6693,1943,715,1694,26,18,214,1969,12,185,120,237,197,357,1436,2721,7,20915,1161,0,2,7,14,0
41327,296,6307,1943,715,1694,26,18,214,1969,12,185,120,237,197,357,1436,2721,7,20915,1161,0,2,16,5,0
41328,296,6307,1168,838,957,57,25,144,1225,19,348,224,416,367,640,3018,5452,11,61921,3440,1,2,16,5,0
41329,114,6826,1943,715,1694,26,18,214,1969,12,185,120,237,197,357,1436,2721,7,20915,1161,0,2,43,2,0
41330,114,2105,477,336,357,30,23,73,507,16,194,134,250,210,384,1538,2962,10,30538,1696,0,2,0,1,0
41331,114,2105,477,336,357,30,23,73,507,16,194,134,250,210,384,1538,2962,10,30538,1696,0,2,0,1,0
41332,217,5035,182,127,129,0,0,53,182,5,39,21,42,44,63,217,343,2,926,51,0,2,20,17,1
41333,217,5035,1165,710,800,67,119,181,1232,18,243,153,282,261,435,2000,3492,10,36473,2026,1,2,20,17,1
41334,103,2729,1455,414,1257,16,76,112,1471,5,41,23,46,46,69,231,381,2,1069,59,0,2,1,1,1
41335,103,2729,669,365,481,22,61,110,691,15,103,63,122,118,185,747,1273,8,11311,628,0,2,1,1,1
41336,261,6241,4293,999,3693,19,54,507,4312,9,155,88,170,164,258,1156,1898,4,9368,520,0,2,10,4,1
41337,261,6241,1482,859,1002,125,135,219,1607,16,219,134,251,235,385,1766,3032,9,27804,1544,1,2,10,4,1
41338,143,3505,77,34,69,0,0,8,77,3,24,16,29,27,45,114,213,1,387,21,0,2,9,4,1
41339,143,3505,712,438,573,51,9,84,763,14,102,71,128,116,199,733,1364,8,11988,666,0,2,9,4,1
41340,63,1828,53,23,39,0,0,13,53,2,8,4,8,10,12,26,39,1,39,2,0,2,39,16,1
41341,63,1828,515,298,307,33,80,99,548,12,63,44,77,75,121,419,753,7,5527,307,0,2,39,16,1
41342,303,6698,72,33,56,0,4,12,72,1,1,1,1,2,2,0,2,0,1,0,0,2,2,1,1
41343,303,6698,1454,835,1044,76,110,219,1530,17,275,158,296,292,454,2297,3718,9,34017,1889,1,2,2,1,1
41344,78,1979,466,257,367,18,25,50,484,7,126,86,171,133,257,898,1813,4,8612,478,0,2,15,5,1
41345,78,1979,507,281,342,29,59,88,536,10,53,29,57,63,86,336,514,5,2764,153,0,2,15,5,1
41346,87,1930,1043,504,840,53,9,147,1096,9,180,112,198,189,310,1377,2344,4,11604,644,0,2,3,3,1
41347,87,1930,383,288,292,26,6,62,409,11,65,38,67,76,105,429,656,5,3719,206,0,2,3,3,1
41348,148,7107,1392,870,1177,35,17,170,1427,14,494,280,531,508,811,4473,7289,7,54850,3047,2,2,1,1,1
41349,49,1715,601,196,481,2,23,85,603,8,63,36,72,71,108,400,664,4,3036,168,0,2,1,0,0
41350,217,5035,182,127,129,0,0,53,182,5,39,21,42,44,63,217,343,2,926,51,0,2,20,17,0
41351,217,5035,1165,710,800,67,119,181,1232,18,243,153,282,261,435,2000,3492,10,36473,2026,1,2,20,17,0
41352,103,2729,1455,414,1257,16,76,112,1471,5,41,23,46,46,69,231,381,2,1069,59,0,2,1,1,0
41353,103,2729,669,365,481,22,61,110,691,15,103,63,122,118,185,747,1273,8,11311,628,0,2,1,1,0
41354,261,6241,4293,999,3693,19,54,507,4312,9,155,88,170,164,258,1156,1898,4,9368,520,0,2,10,4,0
41355,261,6241,1482,859,1002,125,135,219,1607,16,219,134,251,235,385,1766,3032,9,27804,1544,1,2,10,4,0
41356,143,3505,77,34,69,0,0,8,77,3,24,16,29,27,45,114,213,1,387,21,0,2,9,4,0
41357,143,3505,712,438,573,51,9,84,763,14,102,71,128,116,199,733,1364,8,11988,666,0,2,9,4,0
41358,63,1828,53,23,39,0,0,13,53,2,8,4,8,10,12,26,39,1,39,2,0,2,39,16,0
41359,63,1828,515,298,307,33,80,99,548,12,63,44,77,75,121,419,753,7,5527,307,0,2,39,16,0
41360,303,6698,72,33,56,0,4,12,72,1,1,1,1,2,2,0,2,0,1,0,0,2,2,1,0
41361,303,6698,1454,835,1044,76,110,219,1530,17,275,158,296,292,454,2297,3718,9,34017,1889,1,2,2,1,0
41362,78,1979,466,257,367,18,25,50,484,7,126,86,171,133,257,898,1813,4,8612,478,0,2,15,5,0
41363,78,1979,507,281,342,29,59,88,536,10,53,29,57,63,86,336,514,5,2764,153,0,2,15,5,0
41364,87,1930,1043,504,840,53,9,147,1096,9,180,112,198,189,310,1377,2344,4,11604,644,0,2,3,3,0
41365,87,1930,383,288,292,26,6,62,409,11,65,38,67,76,105,429,656,5,3719,206,0,2,3,3,0
41366,148,7107,1392,870,1177,35,17,170,1427,14,494,280,531,508,811,4473,7289,7,54850,3047,2,2,1,1,0
41367,49,3865,996,429,845,24,10,117,1020,7,76,50,88,83,138,494,879,4,3565,198,0,2,5,0,0
41368,51,3873,996,429,845,24,10,117,1020,7,76,50,88,83,138,494,879,4,3565,198,0,2,24,16,0
41369,51,3885,996,429,845,24,10,117,1020,7,76,50,88,83,138,494,879,4,3565,198,0,2,4,2,0
41370,296,6307,1943,715,1694,26,18,214,1969,12,185,120,237,197,357,1436,2721,7,20915,1161,0,2,16,5,0
41371,296,6307,1168,838,957,57,25,144,1225,19,348,224,416,367,640,3018,5452,11,61921,3440,1,2,16,5,0
41372,113,6806,1943,715,1694,26,18,214,1969,12,185,120,237,197,357,1436,2721,7,20915,1161,0,2,41,0,0
41373,117,2969,773,422,505,30,103,129,803,14,77,46,83,91,129,535,839,7,6334,351,0,2,87,12,0
41374,3,501,149,67,118,4,0,27,153,1,17,14,28,18,42,69,175,0,144,8,0,2,66,2,0
41375,73,2511,477,336,357,30,23,73,507,16,194,134,250,210,384,1538,2962,10,30538,1696,0,2,5,4,1
41376,125,5319,1450,624,1228,12,26,181,1462,14,306,186,354,320,540,2580,4493,8,36391,2021,1,2,37,0,1
41377,56,1826,53,23,39,0,0,13,53,2,8,4,8,10,12,26,39,1,39,2,0,2,3,2,0
41378,56,1826,515,298,307,33,80,99,548,12,63,44,77,75,121,419,753,7,5527,307,0,2,3,2,0
41379,119,5003,1513,682,1277,25,13,200,1538,11,199,116,219,210,335,1557,2584,6,15641,868,0,2,1,14,0
41380,69,4372,520,294,400,33,13,81,553,10,261,204,367,271,571,2128,4614,7,32445,1802,1,2,30,12,0
41381,40,786,1178,367,1042,6,15,115,1184,9,94,51,95,103,146,644,976,4,4439,246,0,2,2,2,0
41382,40,786,177,108,140,8,0,27,185,6,30,16,32,36,48,162,248,3,794,44,0,2,2,2,0
41383,296,6305,1943,715,1694,26,18,214,1969,12,185,120,237,197,357,1436,2721,7,20915,1161,0,2,1,1,0
41384,296,6305,1168,838,957,57,25,144,1225,19,348,224,416,367,640,3018,5452,11,61921,3440,1,2,1,1,0
41385,79,3071,1178,367,1042,6,15,115,1184,9,94,51,95,103,146,644,976,4,4439,246,0,2,17,3,0
41386,51,3885,996,429,845,24,10,117,1020,7,76,50,88,83,138,494,879,4,3565,198,0,2,29,14,0
41387,217,5035,182,127,129,0,0,53,182,5,39,21,42,44,63,217,343,2,926,51,0,2,5,5,0
41388,217,5035,1165,710,800,67,119,181,1232,18,243,153,282,261,435,2000,3492,10,36473,2026,1,2,5,5,0
41389,73,2508,477,336,357,30,23,73,507,16,194,134,250,210,384,1538,2962,10,30538,1696,0,2,0,1,0
41390,57,1477,339,213,244,17,9,65,356,10,42,26,48,52,74,259,421,5,2410,133,0,2,11,7,0
41391,117,3166,1523,757,1297,19,12,193,1542,12,193,117,230,205,347,1508,2664,7,19053,1058,0,2,1,1,0
41392,117,3166,701,378,504,33,58,109,734,13,110,68,126,123,194,794,1346,7,10027,557,0,2,1,1,0
41393,143,3505,77,34,69,0,0,8,77,3,24,16,29,27,45,114,213,1,387,21,0,2,1,1,0
41394,143,3505,712,438,573,51,9,84,763,14,102,71,128,116,199,733,1364,8,11988,666,0,2,1,1,0
41395,30,669,125,97,103,3,0,19,128,9,25,17,27,34,44,144,223,4,1087,60,0,2,1,1,0
41396,22,367,102,57,55,5,16,25,107,5,17,10,18,22,28,81,124,2,330,18,0,2,1,1,0
41397,303,6698,72,33,56,0,4,12,72,1,1,1,1,2,2,0,2,0,1,0,0,2,3,3,0
41398,303,6698,1454,835,1044,76,110,219,1530,17,275,158,296,292,454,2297,3718,9,34017,1889,1,2,3,3,0
41399,40,786,1178,367,1042,6,15,115,1184,9,94,51,95,103,146,644,976,4,4439,246,0,2,2,2,0
41400,40,786,177,108,140,8,0,27,185,6,30,16,32,36,48,162,248,3,794,44,0,2,2,2,0
41401,147,5933,1782,648,1425,9,47,279,1791,8,171,97,189,179,286,1292,2140,4,9462,525,0,2,1,1,0
41402,69,3090,1020,354,843,12,15,144,1032,8,134,77,144,142,221,970,1580,4,6792,377,0,2,1,1,0
41403,21,637,424,94,331,4,0,89,428,1,5,5,5,6,10,11,25,0,12,0,0,2,1,1,0
41404,38,2315,334,251,279,10,4,40,344,5,127,74,143,132,217,899,1528,2,4303,239,0,2,1,1,0
41405,79,4230,1293,570,1093,25,15,163,1318,10,195,123,241,205,364,1516,2795,6,17273,959,0,2,46,2,0
41406,12,645,219,78,157,11,5,46,230,3,24,20,34,27,54,114,256,2,545,30,0,2,1,1,0
41407,119,5010,1513,682,1277,25,13,200,1538,11,199,116,219,210,335,1557,2584,6,15641,868,0,2,2,2,0
41408,239,5077,2,2,2,0,0,0,2,0,0,0,0,0,0,0,0,0,0,0,0,2,3,1,0
41409,239,5077,99,48,90,1,3,5,100,0,0,0,0,0,0,0,0,0,0,0,0,2,3,1,0
41410,239,5077,8,5,5,2,0,1,10,0,0,0,0,0,0,0,0,0,0,0,0,2,3,1,0
41411,239,5077,1217,716,841,84,126,174,1301,14,185,118,215,199,333,1446,2542,8,20687,1149,0,2,3,1,0
41412,239,5077,160,89,115,0,13,31,160,7,15,11,17,22,28,78,124,3,495,27,0,2,3,1,0
41413,239,5077,10,10,9,9,0,0,19,0,0,0,0,0,0,0,0,0,0,0,0,2,3,1,0
41414,239,5077,173,84,99,8,29,36,181,5,12,7,13,17,20,54,81,2,221,12,0,2,3,1,0
41415,239,5077,3,1,1,3,0,0,6,0,0,0,0,0,0,0,0,0,0,0,0,2,3,1,0
41416,54,642,647,139,84,35,284,233,682,0,0,0,0,0,0,0,0,0,0,0,0,2,6,1,0
41417,30,1924,384,251,317,7,8,52,391,11,70,44,84,81,128,467,811,6,5355,297,0,2,30,0,0
41418,306,6763,72,33,56,0,4,12,72,1,1,1,1,2,2,0,2,0,1,0,0,2,18,6,0
41419,306,6763,1454,835,1044,76,110,219,1530,17,275,158,296,292,454,2297,3718,9,34017,1889,1,2,18,6,0
41420,80,3116,1178,367,1042,6,15,115,1184,9,94,51,95,103,146,644,976,4,4439,246,0,2,23,0,0
41421,1,319,382,65,130,157,2,92,539,4,10,5,10,14,15,41,57,2,114,6,0,2,13,0,0
41422,13,539,124,78,88,2,3,26,126,4,13,7,13,17,20,56,81,2,163,9,0,2,7,0,0
41423,73,2511,477,336,357,30,23,73,507,16,194,134,250,210,384,1538,2962,10,30538,1696,0,2,5,4,0
41424,125,5319,1450,624,1228,12,26,181,1462,14,306,186,354,320,540,2580,4493,8,36391,2021,1,2,37,0,0
41425,8,310,103,47,73,2,12,15,105,5,16,9,17,21,26,75,114,2,303,16,0,2,2,2,0
41426,18,382,149,95,105,2,0,41,151,8,54,28,55,62,83,334,494,4,2013,111,0,2,23,9,0
41427,18,382,82,56,54,0,13,15,82,4,13,8,16,17,24,56,98,2,241,13,0,2,23,9,0
41428,148,7107,1392,870,1177,35,17,170,1427,14,494,280,531,508,811,4473,7289,7,54850,3047,2,2,2,2,0
41429,24,691,149,95,105,2,0,41,151,8,54,28,55,62,83,334,494,4,2013,111,0,2,75,3,0
41430,30,1422,373,158,315,8,0,51,381,5,76,44,79,81,123,486,779,2,2026,112,0,2,9,9,0
41431,24,694,149,95,105,2,0,41,151,8,54,28,55,62,83,334,494,4,2013,111,0,2,3,2,0
41432,143,3503,77,34,69,0,0,8,77,3,24,16,29,27,45,114,213,1,387,21,0,2,5,5,0
41433,143,3503,712,438,573,51,9,84,763,14,102,71,128,116,199,733,1364,8,11988,666,0,2,5,5,0
41434,143,3503,77,34,69,0,0,8,77,3,24,16,29,27,45,114,213,1,387,21,0,2,5,5,0
41435,143,3503,712,438,573,51,9,84,763,14,102,71,128,116,199,733,1364,8,11988,666,0,2,5,5,0
41436,100,2883,773,419,590,28,0,166,801,10,204,113,217,214,330,1598,2554,5,13587,754,0,2,24,19,0
41437,79,4230,1293,570,1093,25,15,163,1318,10,195,123,241,205,364,1516,2795,6,17273,959,0,2,1,1,0
41438,125,5340,1450,624,1228,12,26,181,1462,14,306,186,354,320,540,2580,4493,8,36391,2021,1,2,6,3,0
41439,148,7121,1392,870,1177,35,17,170,1427,14,494,280,531,508,811,4473,7289,7,54850,3047,2,2,4,2,0
41440,143,3505,77,34,69,0,0,8,77,3,24,16,29,27,45,114,213,1,387,21,0,2,0,1,0
41441,143,3505,712,438,573,51,9,84,763,14,102,71,128,116,199,733,1364,8,11988,666,0,2,0,1,0
41442,106,4685,1289,550,1043,56,32,155,1345,10,167,93,185,177,278,1266,2075,5,11498,638,0,2,8,2,0
41443,217,5035,182,127,129,0,0,53,182,5,39,21,42,44,63,217,343,2,926,51,0,2,5,5,0
41444,217,5035,1165,710,800,67,119,181,1232,18,243,153,282,261,435,2000,3492,10,36473,2026,1,2,5,5,0
41445,73,2508,477,336,357,30,23,73,507,16,194,134,250,210,384,1538,2962,10,30538,1696,0,2,0,1,0
41446,57,1477,339,213,244,17,9,65,356,10,42,26,48,52,74,259,421,5,2410,133,0,2,11,7,0
41447,117,3166,1523,757,1297,19,12,193,1542,12,193,117,230,205,347,1508,2664,7,19053,1058,0,2,1,1,0
41448,117,3166,701,378,504,33,58,109,734,13,110,68,126,123,194,794,1346,7,10027,557,0,2,1,1,0
41449,143,3503,77,34,69,0,0,8,77,3,24,16,29,27,45,114,213,1,387,21,0,2,1,1,0
41450,143,3503,712,438,573,51,9,84,763,14,102,71,128,116,199,733,1364,8,11988,666,0,2,1,1,0
41451,30,669,125,97,103,3,0,19,128,9,25,17,27,34,44,144,223,4,1087,60,0,2,1,1,0
41452,22,367,102,57,55,5,16,25,107,5,17,10,18,22,28,81,124,2,330,18,0,2,1,1,0
41453,303,6698,72,33,56,0,4,12,72,1,1,1,1,2,2,0,2,0,1,0,0,2,3,3,0
41454,303,6698,1454,835,1044,76,110,219,1530,17,275,158,296,292,454,2297,3718,9,34017,1889,1,2,3,3,0
41455,40,786,1178,367,1042,6,15,115,1184,9,94,51,95,103,146,644,976,4,4439,246,0,2,2,2,0
41456,40,786,177,108,140,8,0,27,185,6,30,16,32,36,48,162,248,3,794,44,0,2,2,2,0
41457,147,5933,1782,648,1425,9,47,279,1791,8,171,97,189,179,286,1292,2140,4,9462,525,0,2,1,1,0
41458,69,3090,1020,354,843,12,15,144,1032,8,134,77,144,142,221,970,1580,4,6792,377,0,2,1,1,0
41459,21,637,424,94,331,4,0,89,428,1,5,5,5,6,10,11,25,0,12,0,0,2,1,1,0
41460,38,2315,334,251,279,10,4,40,344,5,127,74,143,132,217,899,1528,2,4303,239,0,2,1,1,0
41461,79,4230,1293,570,1093,25,15,163,1318,10,195,123,241,205,364,1516,2795,6,17273,959,0,2,46,2,0
41462,12,645,219,78,157,11,5,46,230,3,24,20,34,27,54,114,256,2,545,30,0,2,1,1,0
41463,18,382,149,95,105,2,0,41,151,8,54,28,55,62,83,334,494,4,2013,111,0,2,23,9,0
41464,18,382,82,56,54,0,13,15,82,4,13,8,16,17,24,56,98,2,241,13,0,2,23,9,0
41465,148,7107,1392,870,1177,35,17,170,1427,14,494,280,531,508,811,4473,7289,7,54850,3047,2,2,2,2,0
41466,24,694,149,95,105,2,0,41,151,8,54,28,55,62,83,334,494,4,2013,111,0,2,76,3,0
41467,30,1422,373,158,315,8,0,51,381,5,76,44,79,81,123,486,779,2,2026,112,0,2,9,9,0
41468,61,1561,91,45,69,0,3,18,91,3,9,6,10,12,16,33,57,1,95,5,0,2,6,5,0
41469,61,1561,367,234,237,17,34,68,384,16,55,34,61,71,95,381,584,8,5183,287,0,2,6,5,0
41470,40,1853,442,244,305,14,16,103,456,11,68,45,75,79,120,452,756,6,4588,254,0,2,7,0,0
41471,61,1561,91,45,69,0,3,18,91,3,9,6,10,12,16,33,57,1,95,5,0,2,1,1,0
41472,61,1561,367,234,237,17,34,68,384,16,55,34,61,71,95,381,584,8,5183,287,0,2,1,1,0
41473,40,1859,442,244,305,14,16,103,456,11,68,45,75,79,120,452,756,6,4588,254,0,2,4,1,0
41474,2,222,37,13,25,0,6,6,37,1,2,1,2,3,3,2,4,0,2,0,0,2,16,5,0
41475,2,222,133,47,40,1,43,49,134,0,0,0,0,0,0,0,0,0,0,0,0,2,16,5,0
41476,58,1732,773,419,590,28,0,166,801,10,204,113,217,214,330,1598,2554,5,13587,754,0,2,50,23,1
41477,58,1732,421,273,302,44,34,57,465,17,81,59,107,98,166,583,1098,11,12329,684,0,2,50,23,1
41478,227,6311,722,423,573,19,0,135,741,12,172,101,199,184,300,1320,2257,6,15668,870,0,2,81,37,0
41479,227,6311,1508,847,911,44,250,301,1552,14,148,88,169,162,257,1120,1886,7,15077,837,0,2,81,37,0
41480,100,2883,773,419,590,28,0,166,801,10,204,113,217,214,330,1598,2554,5,13587,754,0,2,24,19,0
41481,143,3503,77,34,69,0,0,8,77,3,24,16,29,27,45,114,213,1,387,21,0,2,0,1,0
41482,143,3503,712,438,573,51,9,84,763,14,102,71,128,116,199,733,1364,8,11988,666,0,2,0,1,0
41483,106,4685,1289,550,1043,56,32,155,1345,10,167,93,185,177,278,1266,2075,5,11498,638,0,2,8,2,0
41484,148,7121,1392,870,1177,35,17,170,1427,14,494,280,531,508,811,4473,7289,7,54850,3047,2,2,4,2,0
41485,125,5340,1450,624,1228,12,26,181,1462,14,306,186,354,320,540,2580,4493,8,36391,2021,1,2,6,3,0
41486,58,1732,773,419,590,28,0,166,801,10,204,113,217,214,330,1598,2554,5,13587,754,0,2,50,23,0
41487,58,1732,421,273,302,44,34,57,465,17,81,59,107,98,166,583,1098,11,12329,684,0,2,50,23,0
41488,227,6311,722,423,573,19,0,135,741,12,172,101,199,184,300,1320,2257,6,15668,870,0,2,81,37,0
41489,227,6311,1508,847,911,44,250,301,1552,14,148,88,169,162,257,1120,1886,7,15077,837,0,2,81,37,0
41490,2,222,37,13,25,0,6,6,37,1,2,1,2,3,3,2,4,0,2,0,0,2,16,5,0
41491,2,222,133,47,40,1,43,49,134,0,0,0,0,0,0,0,0,0,0,0,0,2,16,5,0
41492,1,93,42,7,35,4,0,5,46,1,2,1,2,3,3,2,4,0,2,0,0,2,1,1,0
41493,1,93,11,6,10,0,0,1,11,2,4,2,4,6,6,10,15,1,15,0,0,2,1,1,0
41494,191,5617,1660,832,1314,41,38,274,1701,20,312,209,395,332,604,2671,5058,12,64042,3557,1,2,50,19,0
41495,191,5617,1057,646,719,113,100,145,1170,18,215,134,248,233,382,1740,3004,10,31186,1732,1,2,50,19,0
41496,191,6340,1660,832,1314,41,38,274,1701,20,312,209,395,332,604,2671,5058,12,64042,3557,1,2,22,12,0
41497,143,3505,77,34,69,0,0,8,77,3,24,16,29,27,45,114,213,1,387,21,0,2,1,0,0
41498,143,3505,712,438,573,51,9,84,763,14,102,71,128,116,199,733,1364,8,11988,666,0,2,1,0,0
41499,85,4935,1296,573,1062,40,33,157,1336,8,201,118,231,209,349,1561,2689,4,12365,686,0,2,2,2,0
41500,28,596,2,2,2,0,0,0,2,0,0,0,0,0,0,0,0,0,0,0,0,2,2,2,0
41501,28,596,99,48,90,1,3,5,100,0,0,0,0,0,0,0,0,0,0,0,0,2,2,2,0
41502,28,596,8,5,5,2,0,1,10,0,0,0,0,0,0,0,0,0,0,0,0,2,2,2,0
41503,28,596,1217,716,841,84,126,174,1301,14,185,118,215,199,333,1446,2542,8,20687,1149,0,2,2,2,0
41504,28,596,160,89,115,0,13,31,160,7,15,11,17,22,28,78,124,3,495,27,0,2,2,2,0
41505,28,596,10,10,9,9,0,0,19,0,0,0,0,0,0,0,0,0,0,0,0,2,2,2,0
41506,28,596,173,84,99,8,29,36,181,5,12,7,13,17,20,54,81,2,221,12,0,2,2,2,0
41507,28,596,3,1,1,3,0,0,6,0,0,0,0,0,0,0,0,0,0,0,0,2,2,2,0
41508,61,1561,91,45,69,0,3,18,91,3,9,6,10,12,16,33,57,1,95,5,0,2,6,5,0
41509,61,1561,367,234,237,17,34,68,384,16,55,34,61,71,95,381,584,8,5183,287,0,2,6,5,0
41510,40,1859,442,244,305,14,16,103,456,11,68,45,75,79,120,452,756,6,4588,254,0,2,11,1,0
41511,1,93,42,7,35,4,0,5,46,1,2,1,2,3,3,2,4,0,2,0,0,2,1,1,0
41512,1,93,11,6,10,0,0,1,11,2,4,2,4,6,6,10,15,1,15,0,0,2,1,1,0
41513,191,5617,1660,832,1314,41,38,274,1701,20,312,209,395,332,604,2671,5058,12,64042,3557,1,2,50,19,0
41514,191,5617,1057,646,719,113,100,145,1170,18,215,134,248,233,382,1740,3004,10,31186,1732,1,2,50,19,0
41515,191,6340,1660,832,1314,41,38,274,1701,20,312,209,395,332,604,2671,5058,12,64042,3557,1,2,22,12,0
41516,28,596,2,2,2,0,0,0,2,0,0,0,0,0,0,0,0,0,0,0,0,2,2,2,0
41517,28,596,99,48,90,1,3,5,100,0,0,0,0,0,0,0,0,0,0,0,0,2,2,2,0
41518,28,596,8,5,5,2,0,1,10,0,0,0,0,0,0,0,0,0,0,0,0,2,2,2,0
41519,28,596,1217,716,841,84,126,174,1301,14,185,118,215,199,333,1446,2542,8,20687,1149,0,2,2,2,0
41520,28,596,160,89,115,0,13,31,160,7,15,11,17,22,28,78,124,3,495,27,0,2,2,2,0
41521,28,596,10,10,9,9,0,0,19,0,0,0,0,0,0,0,0,0,0,0,0,2,2,2,0
41522,28,596,173,84,99,8,29,36,181,5,12,7,13,17,20,54,81,2,221,12,0,2,2,2,0
41523,28,596,3,1,1,3,0,0,6,0,0,0,0,0,0,0,0,0,0,0,0,2,2,2,0
41524,143,3505,77,34,69,0,0,8,77,3,24,16,29,27,45,114,213,1,387,21,0,2,1,0,0
41525,143,3505,712,438,573,51,9,84,763,14,102,71,128,116,199,733,1364,8,11988,666,0,2,1,0,0
41526,85,4935,1296,573,1062,40,33,157,1336,8,201,118,231,209,349,1561,2689,4,12365,686,0,2,2,2,0
41527,77,2606,477,336,357,30,23,73,507,16,194,134,250,210,384,1538,2962,10,30538,1696,0,2,23,9,0
41528,127,5419,1450,624,1228,12,26,181,1462,14,306,186,354,320,540,2580,4493,8,36391,2021,1,2,27,6,0
41529,302,6691,72,33,56,0,4,12,72,1,1,1,1,2,2,0,2,0,1,0,0,2,2,1,0
41530,302,6691,1454,835,1044,76,110,219,1530,17,275,158,296,292,454,2297,3718,9,34017,1889,1,2,2,1,0
41531,70,3147,1020,354,843,12,15,144,1032,8,134,77,144,142,221,970,1580,4,6792,377,0,2,15,0,0
41532,68,1510,402,202,227,24,74,80,426,12,52,33,61,64,94,339,564,7,3969,220,0,2,0,3,0
41533,68,1479,402,202,227,24,74,80,426,12,52,33,61,64,94,339,564,7,3969,220,0,2,14,14,0
41534,70,3140,1020,354,843,12,15,144,1032,8,134,77,144,142,221,970,1580,4,6792,377,0,2,6,0,0
41535,68,1479,402,202,227,24,74,80,426,12,52,33,61,64,94,339,564,7,3969,220,0,2,14,17,0
41536,70,3140,1020,354,843,12,15,144,1032,8,134,77,144,142,221,970,1580,4,6792,377,0,2,6,0,0
41537,302,6691,72,33,56,0,4,12,72,1,1,1,1,2,2,0,2,0,1,0,0,2,2,1,0
41538,302,6691,1454,835,1044,76,110,219,1530,17,275,158,296,292,454,2297,3718,9,34017,1889,1,2,2,1,0
41539,71,3197,1020,354,843,12,15,144,1032,8,134,77,144,142,221,970,1580,4,6792,377,0,2,15,0,0
41540,31,1070,74,35,59,1,0,14,75,3,14,7,14,17,21,58,85,1,128,7,0,2,3,2,0
41541,31,1070,245,125,200,5,7,34,250,7,30,17,34,37,51,166,265,3,1053,58,0,2,3,2,0
41542,31,1070,74,35,59,1,0,14,75,3,14,7,14,17,21,58,85,1,128,7,0,2,3,2,0
41543,31,1070,245,125,200,5,7,34,250,7,30,17,34,37,51,166,265,3,1053,58,0,2,3,2,0
41544,78,1993,466,257,367,18,25,50,484,7,126,86,171,133,257,898,1813,4,8612,478,0,2,4,4,1
41545,78,1993,507,281,342,29,59,88,536,10,53,29,57,63,86,336,514,5,2764,153,0,2,4,4,1
41546,296,6372,1943,715,1694,26,18,214,1969,12,185,120,237,197,357,1436,2721,7,20915,1161,0,2,30,20,1
41547,296,6372,1168,838,957,57,25,144,1225,19,348,224,416,367,640,3018,5452,11,61921,3440,1,2,30,20,1
41548,78,1993,466,257,367,18,25,50,484,7,126,86,171,133,257,898,1813,4,8612,478,0,2,4,4,0
41549,78,1993,507,281,342,29,59,88,536,10,53,29,57,63,86,336,514,5,2764,153,0,2,4,4,0
41550,296,6372,1943,715,1694,26,18,214,1969,12,185,120,237,197,357,1436,2721,7,20915,1161,0,2,30,20,0
41551,296,6372,1168,838,957,57,25,144,1225,19,348,224,416,367,640,3018,5452,11,61921,3440,1,2,30,20,0
41552,64,1418,207,111,150,11,0,50,218,5,26,19,36,31,55,133,272,3,943,52,0,2,41,0,1
41553,64,1418,410,198,237,31,55,97,441,11,63,38,72,74,110,414,683,6,4293,238,0,2,41,0,1
41554,55,1815,53,23,39,0,0,13,53,2,8,4,8,10,12,26,39,1,39,2,0,2,6,13,1
41555,55,1815,515,298,307,33,80,99,548,12,63,44,77,75,121,419,753,7,5527,307,0,2,6,13,1
41556,25,591,207,111,150,11,0,50,218,5,26,19,36,31,55,133,272,3,943,52,0,2,21,0,1
41557,77,2606,477,336,357,30,23,73,507,16,194,134,250,210,384,1538,2962,10,30538,1696,0,2,23,9,0
41558,127,5419,1450,624,1228,12,26,181,1462,14,306,186,354,320,540,2580,4493,8,36391,2021,1,2,27,6,0
41559,56,1884,53,23,39,0,0,13,53,2,8,4,8,10,12,26,39,1,39,2,0,2,20,11,0
41560,56,1884,515,298,307,33,80,99,548,12,63,44,77,75,121,419,753,7,5527,307,0,2,20,11,0
41561,64,1418,207,111,150,11,0,50,218,5,26,19,36,31,55,133,272,3,943,52,0,2,41,0,0
41562,64,1418,410,198,237,31,55,97,441,11,63,38,72,74,110,414,683,6,4293,238,0,2,41,0,0
41563,55,1815,53,23,39,0,0,13,53,2,8,4,8,10,12,26,39,1,39,2,0,2,6,13,0
41564,55,1815,515,298,307,33,80,99,548,12,63,44,77,75,121,419,753,7,5527,307,0,2,6,13,0
41565,25,591,207,111,150,11,0,50,218,5,26,19,36,31,55,133,272,3,943,52,0,2,21,0,0
41566,145,5858,1782,648,1425,9,47,279,1791,8,171,97,189,179,286,1292,2140,4,9462,525,0,2,0,21,0
41567,55,1873,53,23,39,0,0,13,53,2,8,4,8,10,12,26,39,1,39,2,0,2,20,11,0
41568,55,1873,515,298,307,33,80,99,548,12,63,44,77,75,121,419,753,7,5527,307,0,2,20,11,0
41569,227,6314,722,423,573,19,0,135,741,12,172,101,199,184,300,1320,2257,6,15668,870,0,2,2,1,0
41570,227,6314,1508,847,911,44,250,301,1552,14,148,88,169,162,257,1120,1886,7,15077,837,0,2,2,1,0
41571,227,6314,722,423,573,19,0,135,741,12,172,101,199,184,300,1320,2257,6,15668,870,0,2,2,1,0
41572,227,6314,1508,847,911,44,250,301,1552,14,148,88,169,162,257,1120,1886,7,15077,837,0,2,2,1,0
41573,227,6345,722,423,573,19,0,135,741,12,172,101,199,184,300,1320,2257,6,15668,870,0,2,11,4,0
41574,227,6345,1508,847,911,44,250,301,1552,14,148,88,169,162,257,1120,1886,7,15077,837,0,2,11,4,0
41575,127,5424,1450,624,1228,12,26,181,1462,14,306,186,354,320,540,2580,4493,8,36391,2021,1,2,8,1,0
41576,298,6416,1943,715,1694,26,18,214,1969,12,185,120,237,197,357,1436,2721,7,20915,1161,0,2,5,1,0
41577,298,6416,1168,838,957,57,25,144,1225,19,348,224,416,367,640,3018,5452,11,61921,3440,1,2,5,1,0
41578,85,4946,1296,573,1062,40,33,157,1336,8,201,118,231,209,349,1561,2689,4,12365,686,0,2,9,4,0
41579,114,6852,1943,715,1694,26,18,214,1969,12,185,120,237,197,357,1436,2721,7,20915,1161,0,2,25,1,0
41580,145,5858,1782,648,1425,9,47,279,1791,8,171,97,189,179,286,1292,2140,4,9462,525,0,2,0,21,0
41581,298,6416,1943,715,1694,26,18,214,1969,12,185,120,237,197,357,1436,2721,7,20915,1161,0,2,5,1,0
41582,298,6416,1168,838,957,57,25,144,1225,19,348,224,416,367,640,3018,5452,11,61921,3440,1,2,5,1,0
41583,85,4946,1296,573,1062,40,33,157,1336,8,201,118,231,209,349,1561,2689,4,12365,686,0,2,9,4,0
41584,114,6852,1943,715,1694,26,18,214,1969,12,185,120,237,197,357,1436,2721,7,20915,1161,0,2,25,1,0
41585,227,6345,722,423,573,19,0,135,741,12,172,101,199,184,300,1320,2257,6,15668,870,0,2,11,4,0
41586,227,6345,1508,847,911,44,250,301,1552,14,148,88,169,162,257,1120,1886,7,15077,837,0,2,11,4,0
41587,127,5424,1450,624,1228,12,26,181,1462,14,306,186,354,320,540,2580,4493,8,36391,2021,1,2,8,1,0
41588,23,625,601,196,481,2,23,85,603,8,63,36,72,71,108,400,664,4,3036,168,0,2,1,1,0
41589,23,625,156,79,106,5,16,28,161,5,14,8,15,19,23,64,97,2,261,14,0,2,1,1,0
41590,239,5077,2,2,2,0,0,0,2,0,0,0,0,0,0,0,0,0,0,0,0,2,1,1,0
41591,239,5077,99,48,90,1,3,5,100,0,0,0,0,0,0,0,0,0,0,0,0,2,1,1,0
41592,239,5077,8,5,5,2,0,1,10,0,0,0,0,0,0,0,0,0,0,0,0,2,1,1,0
41593,239,5077,1217,716,841,84,126,174,1301,14,185,118,215,199,333,1446,2542,8,20687,1149,0,2,1,1,0
41594,239,5077,160,89,115,0,13,31,160,7,15,11,17,22,28,78,124,3,495,27,0,2,1,1,0
41595,239,5077,10,10,9,9,0,0,19,0,0,0,0,0,0,0,0,0,0,0,0,2,1,1,0
41596,239,5077,173,84,99,8,29,36,181,5,12,7,13,17,20,54,81,2,221,12,0,2,1,1,0
41597,239,5077,3,1,1,3,0,0,6,0,0,0,0,0,0,0,0,0,0,0,0,2,1,1,0
41598,113,2326,463,295,324,28,62,57,491,12,134,82,154,146,236,989,1696,6,11700,650,0,2,1,1,0
41599,54,642,647,139,84,35,284,233,682,0,0,0,0,0,0,0,0,0,0,0,0,2,4,4,0
41600,296,6372,1943,715,1694,26,18,214,1969,12,185,120,237,197,357,1436,2721,7,20915,1161,0,2,1,1,0
41601,296,6372,1168,838,957,57,25,144,1225,19,348,224,416,367,640,3018,5452,11,61921,3440,1,2,1,1,0
41602,118,3197,1523,757,1297,19,12,193,1542,12,193,117,230,205,347,1508,2664,7,19053,1058,0,2,8,4,0
41603,118,3197,701,378,504,33,58,109,734,13,110,68,126,123,194,794,1346,7,10027,557,0,2,8,4,0
41604,7,265,75,38,59,1,3,12,76,2,4,2,4,6,6,10,15,1,15,0,0,2,29,0,0
41605,307,6777,72,33,56,0,4,12,72,1,1,1,1,2,2,0,2,0,1,0,0,2,6,0,0
41606,307,6777,1454,835,1044,76,110,219,1530,17,275,158,296,292,454,2297,3718,9,34017,1889,1,2,6,0,0
41607,149,5988,1782,648,1425,9,47,279,1791,8,171,97,189,179,286,1292,2140,4,9462,525,0,2,13,0,0
41608,307,6777,72,33,56,0,4,12,72,1,1,1,1,2,2,0,2,0,1,0,0,2,6,0,0
41609,307,6777,1454,835,1044,76,110,219,1530,17,275,158,296,292,454,2297,3718,9,34017,1889,1,2,6,0,0
41610,149,5988,1782,648,1425,9,47,279,1791,8,171,97,189,179,286,1292,2140,4,9462,525,0,2,13,0,0
41611,239,5077,2,2,2,0,0,0,2,0,0,0,0,0,0,0,0,0,0,0,0,2,1,1,0
41612,239,5077,99,48,90,1,3,5,100,0,0,0,0,0,0,0,0,0,0,0,0,2,1,1,0
41613,239,5077,8,5,5,2,0,1,10,0,0,0,0,0,0,0,0,0,0,0,0,2,1,1,0
41614,239,5077,1217,716,841,84,126,174,1301,14,185,118,215,199,333,1446,2542,8,20687,1149,0,2,1,1,0
41615,239,5077,160,89,115,0,13,31,160,7,15,11,17,22,28,78,124,3,495,27,0,2,1,1,0
41616,239,5077,10,10,9,9,0,0,19,0,0,0,0,0,0,0,0,0,0,0,0,2,1,1,0
41617,239,5077,173,84,99,8,29,36,181,5,12,7,13,17,20,54,81,2,221,12,0,2,1,1,0
41618,239,5077,3,1,1,3,0,0,6,0,0,0,0,0,0,0,0,0,0,0,0,2,1,1,0
41619,113,2326,463,295,324,28,62,57,491,12,134,82,154,146,236,989,1696,6,11700,650,0,2,1,1,0
41620,54,642,647,139,84,35,284,233,682,0,0,0,0,0,0,0,0,0,0,0,0,2,4,4,0
41621,298,6416,1943,715,1694,26,18,214,1969,12,185,120,237,197,357,1436,2721,7,20915,1161,0,2,1,1,0
41622,298,6416,1168,838,957,57,25,144,1225,19,348,224,416,367,640,3018,5452,11,61921,3440,1,2,1,1,0
41623,23,625,601,196,481,2,23,85,603,8,63,36,72,71,108,400,664,4,3036,168,0,2,1,1,0
41624,23,625,156,79,106,5,16,28,161,5,14,8,15,19,23,64,97,2,261,14,0,2,1,1,0
41625,118,3197,1523,757,1297,19,12,193,1542,12,193,117,230,205,347,1508,2664,7,19053,1058,0,2,8,4,0
41626,118,3197,701,378,504,33,58,109,734,13,110,68,126,123,194,794,1346,7,10027,557,0,2,8,4,0
41627,7,265,75,38,59,1,3,12,76,2,4,2,4,6,6,10,15,1,15,0,0,2,29,0,0
41628,239,5075,2,2,2,0,0,0,2,0,0,0,0,0,0,0,0,0,0,0,0,2,0,1,0
41629,239,5075,99,48,90,1,3,5,100,0,0,0,0,0,0,0,0,0,0,0,0,2,0,1,0
41630,239,5075,8,5,5,2,0,1,10,0,0,0,0,0,0,0,0,0,0,0,0,2,0,1,0
41631,239,5075,1217,716,841,84,126,174,1301,14,185,118,215,199,333,1446,2542,8,20687,1149,0,2,0,1,0
41632,239,5075,160,89,115,0,13,31,160,7,15,11,17,22,28,78,124,3,495,27,0,2,0,1,0
41633,239,5075,10,10,9,9,0,0,19,0,0,0,0,0,0,0,0,0,0,0,0,2,0,1,0
41634,239,5075,173,84,99,8,29,36,181,5,12,7,13,17,20,54,81,2,221,12,0,2,0,1,0
41635,239,5075,3,1,1,3,0,0,6,0,0,0,0,0,0,0,0,0,0,0,0,2,0,1,0
41636,7,265,75,38,59,1,3,12,76,2,4,2,4,6,6,10,15,1,15,0,0,2,1,1,0
41637,304,6699,72,33,56,0,4,12,72,1,1,1,1,2,2,0,2,0,1,0,0,2,6,18,0
41638,304,6699,1454,835,1044,76,110,219,1530,17,275,158,296,292,454,2297,3718,9,34017,1889,1,2,6,18,0
41639,79,3071,1178,367,1042,6,15,115,1184,9,94,51,95,103,146,644,976,4,4439,246,0,2,0,23,0
41640,87,5041,1296,573,1062,40,33,157,1336,8,201,118,231,209,349,1561,2689,4,12365,686,0,2,21,0,0
41641,304,6699,72,33,56,0,4,12,72,1,1,1,1,2,2,0,2,0,1,0,0,2,6,18,0
41642,304,6699,1454,835,1044,76,110,219,1530,17,275,158,296,292,454,2297,3718,9,34017,1889,1,2,6,18,0
41643,87,5041,1296,573,1062,40,33,157,1336,8,201,118,231,209,349,1561,2689,4,12365,686,0,2,21,0,0
41644,79,3071,1178,367,1042,6,15,115,1184,9,94,51,95,103,146,644,976,4,4439,246,0,2,0,23,0
41645,191,5619,1660,832,1314,41,38,274,1701,20,312,209,395,332,604,2671,5058,12,64042,3557,1,2,1,1,0
41646,191,5619,1057,646,719,113,100,145,1170,18,215,134,248,233,382,1740,3004,10,31186,1732,1,2,1,1,0
41647,239,5079,2,2,2,0,0,0,2,0,0,0,0,0,0,0,0,0,0,0,0,2,1,1,0
41648,239,5079,99,48,90,1,3,5,100,0,0,0,0,0,0,0,0,0,0,0,0,2,1,1,0
41649,239,5079,8,5,5,2,0,1,10,0,0,0,0,0,0,0,0,0,0,0,0,2,1,1,0
41650,239,5079,1217,716,841,84,126,174,1301,14,185,118,215,199,333,1446,2542,8,20687,1149,0,2,1,1,0
41651,239,5079,160,89,115,0,13,31,160,7,15,11,17,22,28,78,124,3,495,27,0,2,1,1,0
41652,239,5079,10,10,9,9,0,0,19,0,0,0,0,0,0,0,0,0,0,0,0,2,1,1,0
41653,239,5079,173,84,99,8,29,36,181,5,12,7,13,17,20,54,81,2,221,12,0,2,1,1,0
41654,239,5079,3,1,1,3,0,0,6,0,0,0,0,0,0,0,0,0,0,0,0,2,1,1,0
41655,191,6342,1660,832,1314,41,38,274,1701,20,312,209,395,332,604,2671,5058,12,64042,3557,1,2,1,1,0
41656,111,6058,1457,730,1242,11,6,188,1468,10,292,166,329,302,495,2424,4078,5,22973,1276,1,2,1,1,0
41657,46,2850,652,304,544,16,6,88,668,6,89,51,101,95,152,591,998,3,3399,188,0,2,1,1,0
41658,113,5659,1523,757,1297,19,12,193,1542,12,193,117,230,205,347,1508,2664,7,19053,1058,0,2,1,1,0
41659,51,3885,996,429,845,24,10,117,1020,7,76,50,88,83,138,494,879,4,3565,198,0,2,3,3,0
41660,191,5619,1660,832,1314,41,38,274,1701,20,312,209,395,332,604,2671,5058,12,64042,3557,1,2,1,1,0
41661,191,5619,1057,646,719,113,100,145,1170,18,215,134,248,233,382,1740,3004,10,31186,1732,1,2,1,1,0
41662,239,5079,2,2,2,0,0,0,2,0,0,0,0,0,0,0,0,0,0,0,0,2,1,1,0
41663,239,5079,99,48,90,1,3,5,100,0,0,0,0,0,0,0,0,0,0,0,0,2,1,1,0
41664,239,5079,8,5,5,2,0,1,10,0,0,0,0,0,0,0,0,0,0,0,0,2,1,1,0
41665,239,5079,1217,716,841,84,126,174,1301,14,185,118,215,199,333,1446,2542,8,20687,1149,0,2,1,1,0
41666,239,5079,160,89,115,0,13,31,160,7,15,11,17,22,28,78,124,3,495,27,0,2,1,1,0
41667,239,5079,10,10,9,9,0,0,19,0,0,0,0,0,0,0,0,0,0,0,0,2,1,1,0
41668,239,5079,173,84,99,8,29,36,181,5,12,7,13,17,20,54,81,2,221,12,0,2,1,1,0
41669,239,5079,3,1,1,3,0,0,6,0,0,0,0,0,0,0,0,0,0,0,0,2,1,1,0
41670,191,6342,1660,832,1314,41,38,274,1701,20,312,209,395,332,604,2671,5058,12,64042,3557,1,2,1,1,0
41671,111,6058,1457,730,1242,11,6,188,1468,10,292,166,329,302,495,2424,4078,5,22973,1276,1,2,1,1,0
41672,46,2850,652,304,544,16,6,88,668,6,89,51,101,95,152,591,998,3,3399,188,0,2,1,1,0
41673,113,5659,1523,757,1297,19,12,193,1542,12,193,117,230,205,347,1508,2664,7,19053,1058,0,2,1,1,0
41674,303,6705,72,33,56,0,4,12,72,1,1,1,1,2,2,0,2,0,1,0,0,2,6,0,0
41675,303,6705,1454,835,1044,76,110,219,1530,17,275,158,296,292,454,2297,3718,9,34017,1889,1,2,6,0,0
41676,147,5913,1782,648,1425,9,47,279,1791,8,171,97,189,179,286,1292,2140,4,9462,525,0,2,13,0,0
41677,87,5034,1296,573,1062,40,33,157,1336,8,201,118,231,209,349,1561,2689,4,12365,686,0,2,21,0,0
41678,304,6689,72,33,56,0,4,12,72,1,1,1,1,2,2,0,2,0,1,0,0,2,1,2,0
41679,304,6689,1454,835,1044,76,110,219,1530,17,275,158,296,292,454,2297,3718,9,34017,1889,1,2,1,2,0
41680,58,1732,773,419,590,28,0,166,801,10,204,113,217,214,330,1598,2554,5,13587,754,0,2,1,1,0
41681,58,1732,421,273,302,44,34,57,465,17,81,59,107,98,166,583,1098,11,12329,684,0,2,1,1,0
41682,191,5619,1660,832,1314,41,38,274,1701,20,312,209,395,332,604,2671,5058,12,64042,3557,1,2,3,2,0
41683,191,5619,1057,646,719,113,100,145,1170,18,215,134,248,233,382,1740,3004,10,31186,1732,1,2,3,2,0
41684,64,1418,207,111,150,11,0,50,218,5,26,19,36,31,55,133,272,3,943,52,0,2,5,2,0
41685,64,1418,410,198,237,31,55,97,441,11,63,38,72,74,110,414,683,6,4293,238,0,2,5,2,0
41686,80,1970,757,253,292,73,244,162,830,13,61,38,67,74,105,409,651,7,4654,258,0,2,1,1,0
41687,20,989,386,256,301,16,9,68,402,4,59,35,69,63,104,355,621,2,1453,80,0,2,3,3,0
41688,20,989,264,131,164,11,41,46,275,6,38,22,40,44,62,214,338,3,1068,59,0,2,3,3,0
41689,117,4986,1513,682,1277,25,13,200,1538,11,199,116,219,210,335,1557,2584,6,15641,868,0,2,0,2,0
41690,217,5015,182,127,129,0,0,53,182,5,39,21,42,44,63,217,343,2,926,51,0,2,0,2,0
41691,217,5015,1165,710,800,67,119,181,1232,18,243,153,282,261,435,2000,3492,10,36473,2026,1,2,0,2,0
41692,148,7106,1392,870,1177,35,17,170,1427,14,494,280,531,508,811,4473,7289,7,54850,3047,2,2,3,3,0
41693,100,2878,773,419,590,28,0,166,801,10,204,113,217,214,330,1598,2554,5,13587,754,0,2,1,1,0
41694,63,1383,207,111,150,11,0,50,218,5,26,19,36,31,55,133,272,3,943,52,0,2,0,15,0
41695,63,1383,410,198,237,31,55,97,441,11,63,38,72,74,110,414,683,6,4293,238,0,2,0,15,0
41696,262,6261,4293,999,3693,19,54,507,4312,9,155,88,170,164,258,1156,1898,4,9368,520,0,2,8,2,0
41697,262,6261,1482,859,1002,125,135,219,1607,16,219,134,251,235,385,1766,3032,9,27804,1544,1,2,8,2,0
41698,304,6734,72,33,56,0,4,12,72,1,1,1,1,2,2,0,2,0,1,0,0,2,15,2,0
41699,304,6734,1454,835,1044,76,110,219,1530,17,275,158,296,292,454,2297,3718,9,34017,1889,1,2,15,2,0
41700,217,5010,182,127,129,0,0,53,182,5,39,21,42,44,63,217,343,2,926,51,0,2,1,3,0
41701,217,5010,1165,710,800,67,119,181,1232,18,243,153,282,261,435,2000,3492,10,36473,2026,1,2,1,3,0
41702,143,6926,1392,870,1177,35,17,170,1427,14,494,280,531,508,811,4473,7289,7,54850,3047,2,2,8,55,0
41703,59,1754,773,419,590,28,0,166,801,10,204,113,217,214,330,1598,2554,5,13587,754,0,2,4,0,0
41704,59,1754,421,273,302,44,34,57,465,17,81,59,107,98,166,583,1098,11,12329,684,0,2,4,0,0
41705,53,1495,207,111,150,11,0,50,218,5,26,19,36,31,55,133,272,3,943,52,0,2,29,18,0
41706,53,1495,410,198,237,31,55,97,441,11,63,38,72,74,110,414,683,6,4293,238,0,2,29,18,0
41707,85,2063,996,429,845,24,10,117,1020,7,76,50,88,83,138,494,879,4,3565,198,0,2,2,1,0
41708,85,2063,456,277,329,12,42,72,468,13,85,50,97,98,147,592,972,7,7212,400,0,2,2,1,0
41709,85,2063,996,429,845,24,10,117,1020,7,76,50,88,83,138,494,879,4,3565,198,0,2,2,1,0
41710,85,2063,456,277,329,12,42,72,468,13,85,50,97,98,147,592,972,7,7212,400,0,2,2,1,0
41711,239,5079,2,2,2,0,0,0,2,0,0,0,0,0,0,0,0,0,0,0,0,2,2,2,0
41712,239,5079,99,48,90,1,3,5,100,0,0,0,0,0,0,0,0,0,0,0,0,2,2,2,0
41713,239,5079,8,5,5,2,0,1,10,0,0,0,0,0,0,0,0,0,0,0,0,2,2,2,0
41714,239,5079,1217,716,841,84,126,174,1301,14,185,118,215,199,333,1446,2542,8,20687,1149,0,2,2,2,0
41715,239,5079,160,89,115,0,13,31,160,7,15,11,17,22,28,78,124,3,495,27,0,2,2,2,0
41716,239,5079,10,10,9,9,0,0,19,0,0,0,0,0,0,0,0,0,0,0,0,2,2,2,0
41717,239,5079,173,84,99,8,29,36,181,5,12,7,13,17,20,54,81,2,221,12,0,2,2,2,0
41718,239,5079,3,1,1,3,0,0,6,0,0,0,0,0,0,0,0,0,0,0,0,2,2,2,0
41719,113,2328,463,295,324,28,62,57,491,12,134,82,154,146,236,989,1696,6,11700,650,0,2,1,1,0
41720,227,6346,722,423,573,19,0,135,741,12,172,101,199,184,300,1320,2257,6,15668,870,0,2,1,1,0
41721,227,6346,1508,847,911,44,250,301,1552,14,148,88,169,162,257,1120,1886,7,15077,837,0,2,1,1,0
41722,185,8005,4293,999,3693,19,54,507,4312,9,155,88,170,164,258,1156,1898,4,9368,520,0,2,3,3,0
41723,185,8005,1482,859,1002,125,135,219,1607,16,219,134,251,235,385,1766,3032,9,27804,1544,1,2,3,3,0
41724,30,921,256,139,192,9,7,47,265,4,23,12,24,27,36,112,171,2,357,19,0,2,1,1,0
41725,85,4954,1296,573,1062,40,33,157,1336,8,201,118,231,209,349,1561,2689,4,12365,686,0,2,4,4,0
41726,71,3199,1020,354,843,12,15,144,1032,8,134,77,144,142,221,970,1580,4,6792,377,0,2,1,1,0
41727,79,3073,1178,367,1042,6,15,115,1184,9,94,51,95,103,146,644,976,4,4439,246,0,2,1,1,0
41728,40,1861,442,244,305,14,16,103,456,11,68,45,75,79,120,452,756,6,4588,254,0,2,1,1,0
41729,51,2042,1098,241,925,5,10,155,1103,7,46,25,49,53,74,273,423,3,1580,87,0,2,1,1,0
41730,239,5079,2,2,2,0,0,0,2,0,0,0,0,0,0,0,0,0,0,0,0,2,2,2,0
41731,239,5079,99,48,90,1,3,5,100,0,0,0,0,0,0,0,0,0,0,0,0,2,2,2,0
41732,239,5079,8,5,5,2,0,1,10,0,0,0,0,0,0,0,0,0,0,0,0,2,2,2,0
41733,239,5079,1217,716,841,84,126,174,1301,14,185,118,215,199,333,1446,2542,8,20687,1149,0,2,2,2,0
41734,239,5079,160,89,115,0,13,31,160,7,15,11,17,22,28,78,124,3,495,27,0,2,2,2,0
41735,239,5079,10,10,9,9,0,0,19,0,0,0,0,0,0,0,0,0,0,0,0,2,2,2,0
41736,239,5079,173,84,99,8,29,36,181,5,12,7,13,17,20,54,81,2,221,12,0,2,2,2,0
41737,239,5079,3,1,1,3,0,0,6,0,0,0,0,0,0,0,0,0,0,0,0,2,2,2,0
41738,113,2328,463,295,324,28,62,57,491,12,134,82,154,146,236,989,1696,6,11700,650,0,2,1,1,0
41739,227,6346,722,423,573,19,0,135,741,12,172,101,199,184,300,1320,2257,6,15668,870,0,2,1,1,0
41740,227,6346,1508,847,911,44,250,301,1552,14,148,88,169,162,257,1120,1886,7,15077,837,0,2,1,1,0
41741,185,8005,4293,999,3693,19,54,507,4312,9,155,88,170,164,258,1156,1898,4,9368,520,0,2,3,3,0
41742,185,8005,1482,859,1002,125,135,219,1607,16,219,134,251,235,385,1766,3032,9,27804,1544,1,2,3,3,0
41743,30,921,256,139,192,9,7,47,265,4,23,12,24,27,36,112,171,2,357,19,0,2,1,1,0
41744,85,4954,1296,573,1062,40,33,157,1336,8,201,118,231,209,349,1561,2689,4,12365,686,0,2,4,4,0
41745,71,3199,1020,354,843,12,15,144,1032,8,134,77,144,142,221,970,1580,4,6792,377,0,2,1,1,0
41746,79,3073,1178,367,1042,6,15,115,1184,9,94,51,95,103,146,644,976,4,4439,246,0,2,1,1,0
41747,40,1861,442,244,305,14,16,103,456,11,68,45,75,79,120,452,756,6,4588,254,0,2,1,1,0
41748,51,2042,1098,241,925,5,10,155,1103,7,46,25,49,53,74,273,423,3,1580,87,0,2,1,1,0
41749,186,5483,182,127,129,0,0,53,182,5,39,21,42,44,63,217,343,2,926,51,0,2,153,87,1
41750,186,5483,1165,710,800,67,119,181,1232,18,243,153,282,261,435,2000,3492,10,36473,2026,1,2,153,87,1
41751,31,1010,182,127,129,0,0,53,182,5,39,21,42,44,63,217,343,2,926,51,0,2,29,28,1
41752,143,6943,1392,870,1177,35,17,170,1427,14,494,280,531,508,811,4473,7289,7,54850,3047,2,2,11,8,1
41753,100,3088,773,419,590,28,0,166,801,10,204,113,217,214,330,1598,2554,5,13587,754,0,2,106,91,1
41754,51,3863,996,429,845,24,10,117,1020,7,76,50,88,83,138,494,879,4,3565,198,0,2,53,150,0
41755,51,3873,996,429,845,24,10,117,1020,7,76,50,88,83,138,494,879,4,3565,198,0,2,2,1,0
41756,186,5483,182,127,129,0,0,53,182,5,39,21,42,44,63,217,343,2,926,51,0,2,153,91,0
41757,186,5483,1165,710,800,67,119,181,1232,18,243,153,282,261,435,2000,3492,10,36473,2026,1,2,153,91,0
41758,59,1754,773,419,590,28,0,166,801,10,204,113,217,214,330,1598,2554,5,13587,754,0,2,5,1,0
41759,59,1754,421,273,302,44,34,57,465,17,81,59,107,98,166,583,1098,11,12329,684,0,2,5,1,0
41760,191,5619,1660,832,1314,41,38,274,1701,20,312,209,395,332,604,2671,5058,12,64042,3557,1,2,3,2,0
41761,191,5619,1057,646,719,113,100,145,1170,18,215,134,248,233,382,1740,3004,10,31186,1732,1,2,3,2,0
41762,53,1495,207,111,150,11,0,50,218,5,26,19,36,31,55,133,272,3,943,52,0,2,34,35,0
41763,53,1495,410,198,237,31,55,97,441,11,63,38,72,74,110,414,683,6,4293,238,0,2,34,35,0
41764,262,6261,4293,999,3693,19,54,507,4312,9,155,88,170,164,258,1156,1898,4,9368,520,0,2,8,2,0
41765,262,6261,1482,859,1002,125,135,219,1607,16,219,134,251,235,385,1766,3032,9,27804,1544,1,2,8,2,0
41766,304,6734,72,33,56,0,4,12,72,1,1,1,1,2,2,0,2,0,1,0,0,2,15,2,0
41767,304,6734,1454,835,1044,76,110,219,1530,17,275,158,296,292,454,2297,3718,9,34017,1889,1,2,15,2,0
41768,80,1970,757,253,292,73,244,162,830,13,61,38,67,74,105,409,651,7,4654,258,0,2,1,1,0
41769,20,989,386,256,301,16,9,68,402,4,59,35,69,63,104,355,621,2,1453,80,0,2,3,3,0
41770,20,989,264,131,164,11,41,46,275,6,38,22,40,44,62,214,338,3,1068,59,0,2,3,3,0
41771,31,1010,182,127,129,0,0,53,182,5,39,21,42,44,63,217,343,2,926,51,0,2,29,28,0
41772,143,6943,1392,870,1177,35,17,170,1427,14,494,280,531,508,811,4473,7289,7,54850,3047,2,2,22,66,0
41773,100,3088,773,419,590,28,0,166,801,10,204,113,217,214,330,1598,2554,5,13587,754,0,2,107,92,0
41774,117,4986,1513,682,1277,25,13,200,1538,11,199,116,219,210,335,1557,2584,6,15641,868,0,2,0,2,0
41775,51,3873,996,429,845,24,10,117,1020,7,76,50,88,83,138,494,879,4,3565,198,0,2,58,154,0
41776,305,6748,72,33,56,0,4,12,72,1,1,1,1,2,2,0,2,0,1,0,0,2,6,0,0
41777,305,6748,1454,835,1044,76,110,219,1530,17,275,158,296,292,454,2297,3718,9,34017,1889,1,2,6,0,0
41778,147,5913,1782,648,1425,9,47,279,1791,8,171,97,189,179,286,1292,2140,4,9462,525,0,2,13,0,0
41779,87,5042,1296,573,1062,40,33,157,1336,8,201,118,231,209,349,1561,2689,4,12365,686,0,2,21,0,0
41780,5,119,110,30,77,3,13,16,113,4,21,15,30,25,45,100,208,2,597,33,0,2,2,1,0
41781,5,119,28,15,21,1,0,6,29,0,0,0,0,0,0,0,0,0,0,0,0,2,2,1,0
41782,305,6741,72,33,56,0,4,12,72,1,1,1,1,2,2,0,2,0,1,0,0,2,0,1,0
41783,305,6741,1454,835,1044,76,110,219,1530,17,275,158,296,292,454,2297,3718,9,34017,1889,1,2,0,1,0
41784,306,6756,72,33,56,0,4,12,72,1,1,1,1,2,2,0,2,0,1,0,0,2,8,5,0
41785,306,6756,1454,835,1044,76,110,219,1530,17,275,158,296,292,454,2297,3718,9,34017,1889,1,2,8,5,0
41786,87,5061,1296,573,1062,40,33,157,1336,8,201,118,231,209,349,1561,2689,4,12365,686,0,2,9,2,0
41787,306,6756,72,33,56,0,4,12,72,1,1,1,1,2,2,0,2,0,1,0,0,2,8,5,0
41788,306,6756,1454,835,1044,76,110,219,1530,17,275,158,296,292,454,2297,3718,9,34017,1889,1,2,8,5,0
41789,306,6749,72,33,56,0,4,12,72,1,1,1,1,2,2,0,2,0,1,0,0,2,0,1,0
41790,306,6749,1454,835,1044,76,110,219,1530,17,275,158,296,292,454,2297,3718,9,34017,1889,1,2,0,1,0
41791,305,6740,72,33,56,0,4,12,72,1,1,1,1,2,2,0,2,0,1,0,0,2,10,6,0
41792,305,6740,1454,835,1044,76,110,219,1530,17,275,158,296,292,454,2297,3718,9,34017,1889,1,2,10,6,0
41793,147,5922,1782,648,1425,9,47,279,1791,8,171,97,189,179,286,1292,2140,4,9462,525,0,2,2,2,0
41794,305,6740,72,33,56,0,4,12,72,1,1,1,1,2,2,0,2,0,1,0,0,2,10,6,0
41795,305,6740,1454,835,1044,76,110,219,1530,17,275,158,296,292,454,2297,3718,9,34017,1889,1,2,10,6,0
41796,147,5922,1782,648,1425,9,47,279,1791,8,171,97,189,179,286,1292,2140,4,9462,525,0,2,2,2,0
41797,239,5077,2,2,2,0,0,0,2,0,0,0,0,0,0,0,0,0,0,0,0,2,0,1,0
41798,239,5077,99,48,90,1,3,5,100,0,0,0,0,0,0,0,0,0,0,0,0,2,0,1,0
41799,239,5077,8,5,5,2,0,1,10,0,0,0,0,0,0,0,0,0,0,0,0,2,0,1,0
41800,239,5077,1217,716,841,84,126,174,1301,14,185,118,215,199,333,1446,2542,8,20687,1149,0,2,0,1,0
41801,239,5077,160,89,115,0,13,31,160,7,15,11,17,22,28,78,124,3,495,27,0,2,0,1,0
41802,239,5077,10,10,9,9,0,0,19,0,0,0,0,0,0,0,0,0,0,0,0,2,0,1,0
41803,239,5077,173,84,99,8,29,36,181,5,12,7,13,17,20,54,81,2,221,12,0,2,0,1,0
41804,239,5077,3,1,1,3,0,0,6,0,0,0,0,0,0,0,0,0,0,0,0,2,0,1,0
41805,7,265,75,38,59,1,3,12,76,2,4,2,4,6,6,10,15,1,15,0,0,2,1,1,0
41806,191,5605,1660,832,1314,41,38,274,1701,20,312,209,395,332,604,2671,5058,12,64042,3557,1,2,2,2,0
41807,191,5605,1057,646,719,113,100,145,1170,18,215,134,248,233,382,1740,3004,10,31186,1732,1,2,2,2,0
41808,5,119,110,30,77,3,13,16,113,4,21,15,30,25,45,100,208,2,597,33,0,2,2,1,0
41809,5,119,28,15,21,1,0,6,29,0,0,0,0,0,0,0,0,0,0,0,0,2,2,1,0
41810,304,6689,72,33,56,0,4,12,72,1,1,1,1,2,2,0,2,0,1,0,0,2,1,2,0
41811,304,6689,1454,835,1044,76,110,219,1530,17,275,158,296,292,454,2297,3718,9,34017,1889,1,2,1,2,0
41812,87,5061,1296,573,1062,40,33,157,1336,8,201,118,231,209,349,1561,2689,4,12365,686,0,2,9,2,0
41813,107,4605,1289,550,1043,56,32,155,1345,10,167,93,185,177,278,1266,2075,5,11498,638,0,2,0,1,0
41814,191,5605,1660,832,1314,41,38,274,1701,20,312,209,395,332,604,2671,5058,12,64042,3557,1,2,2,2,0
41815,191,5605,1057,646,719,113,100,145,1170,18,215,134,248,233,382,1740,3004,10,31186,1732,1,2,2,2,0
41816,304,6726,72,33,56,0,4,12,72,1,1,1,1,2,2,0,2,0,1,0,0,2,0,4,0
41817,304,6726,1454,835,1044,76,110,219,1530,17,275,158,296,292,454,2297,3718,9,34017,1889,1,2,0,4,0
41818,107,4605,1289,550,1043,56,32,155,1345,10,167,93,185,177,278,1266,2075,5,11498,638,0,2,0,1,0
41819,304,6726,72,33,56,0,4,12,72,1,1,1,1,2,2,0,2,0,1,0,0,2,0,4,0
41820,304,6726,1454,835,1044,76,110,219,1530,17,275,158,296,292,454,2297,3718,9,34017,1889,1,2,0,4,0
41821,69,1500,402,202,227,24,74,80,426,12,52,33,61,64,94,339,564,7,3969,220,0,2,12,7,0
41822,302,6686,72,33,56,0,4,12,72,1,1,1,1,2,2,0,2,0,1,0,0,2,0,10,0
41823,302,6686,1454,835,1044,76,110,219,1530,17,275,158,296,292,454,2297,3718,9,34017,1889,1,2,0,10,0
41824,147,5907,1782,648,1425,9,47,279,1791,8,171,97,189,179,286,1292,2140,4,9462,525,0,2,12,8,0
41825,304,6716,72,33,56,0,4,12,72,1,1,1,1,2,2,0,2,0,1,0,0,2,1,2,0
41826,304,6716,1454,835,1044,76,110,219,1530,17,275,158,296,292,454,2297,3718,9,34017,1889,1,2,1,2,0
41827,5,119,110,30,77,3,13,16,113,4,21,15,30,25,45,100,208,2,597,33,0,2,2,1,0
41828,5,119,28,15,21,1,0,6,29,0,0,0,0,0,0,0,0,0,0,0,0,2,2,1,0
41829,106,4666,1289,550,1043,56,32,155,1345,10,167,93,185,177,278,1266,2075,5,11498,638,0,2,0,1,0
41830,87,5062,1296,573,1062,40,33,157,1336,8,201,118,231,209,349,1561,2689,4,12365,686,0,2,9,2,0
41831,12,190,110,30,77,3,13,16,113,4,21,15,30,25,45,100,208,2,597,33,0,2,91,0,0
41832,189,5498,1660,832,1314,41,38,274,1701,20,312,209,395,332,604,2671,5058,12,64042,3557,1,2,0,31,0
41833,189,5498,1057,646,719,113,100,145,1170,18,215,134,248,233,382,1740,3004,10,31186,1732,1,2,0,31,0
41834,45,1597,601,196,481,2,23,85,603,8,63,36,72,71,108,400,664,4,3036,168,0,2,1,43,0
41835,69,1500,402,202,227,24,74,80,426,12,52,33,61,64,94,339,564,7,3969,220,0,2,12,7,0
41836,301,6672,72,33,56,0,4,12,72,1,1,1,1,2,2,0,2,0,1,0,0,2,0,10,0
41837,301,6672,1454,835,1044,76,110,219,1530,17,275,158,296,292,454,2297,3718,9,34017,1889,1,2,0,10,0
41838,147,5907,1782,648,1425,9,47,279,1791,8,171,97,189,179,286,1292,2140,4,9462,525,0,2,12,8,0
41839,301,6662,72,33,56,0,4,12,72,1,1,1,1,2,2,0,2,0,1,0,0,2,1,2,0
41840,301,6662,1454,835,1044,76,110,219,1530,17,275,158,296,292,454,2297,3718,9,34017,1889,1,2,1,2,0
41841,5,119,110,30,77,3,13,16,113,4,21,15,30,25,45,100,208,2,597,33,0,2,2,1,0
41842,5,119,28,15,21,1,0,6,29,0,0,0,0,0,0,0,0,0,0,0,0,2,2,1,0
41843,106,4666,1289,550,1043,56,32,155,1345,10,167,93,185,177,278,1266,2075,5,11498,638,0,2,0,1,0
41844,87,5062,1296,573,1062,40,33,157,1336,8,201,118,231,209,349,1561,2689,4,12365,686,0,2,9,2,0
41845,12,190,110,30,77,3,13,16,113,4,21,15,30,25,45,100,208,2,597,33,0,2,91,0,0
41846,1,93,42,7,35,4,0,5,46,1,2,1,2,3,3,2,4,0,2,0,0,2,1,1,0
41847,1,93,11,6,10,0,0,1,11,2,4,2,4,6,6,10,15,1,15,0,0,2,1,1,0
41848,186,5483,182,127,129,0,0,53,182,5,39,21,42,44,63,217,343,2,926,51,0,2,177,110,0
41849,186,5483,1165,710,800,67,119,181,1232,18,243,153,282,261,435,2000,3492,10,36473,2026,1,2,177,110,0
41850,59,1754,773,419,590,28,0,166,801,10,204,113,217,214,330,1598,2554,5,13587,754,0,2,54,23,0
41851,59,1754,421,273,302,44,34,57,465,17,81,59,107,98,166,583,1098,11,12329,684,0,2,54,23,0
41852,18,382,149,95,105,2,0,41,151,8,54,28,55,62,83,334,494,4,2013,111,0,2,30,15,0
41853,18,382,82,56,54,0,13,15,82,4,13,8,16,17,24,56,98,2,241,13,0,2,30,15,0
41854,28,596,2,2,2,0,0,0,2,0,0,0,0,0,0,0,0,0,0,0,0,2,2,2,0
41855,28,596,99,48,90,1,3,5,100,0,0,0,0,0,0,0,0,0,0,0,0,2,2,2,0
41856,28,596,8,5,5,2,0,1,10,0,0,0,0,0,0,0,0,0,0,0,0,2,2,2,0
41857,28,596,1217,716,841,84,126,174,1301,14,185,118,215,199,333,1446,2542,8,20687,1149,0,2,2,2,0
41858,28,596,160,89,115,0,13,31,160,7,15,11,17,22,28,78,124,3,495,27,0,2,2,2,0
41859,28,596,10,10,9,9,0,0,19,0,0,0,0,0,0,0,0,0,0,0,0,2,2,2,0
41860,28,596,173,84,99,8,29,36,181,5,12,7,13,17,20,54,81,2,221,12,0,2,2,2,0
41861,28,596,3,1,1,3,0,0,6,0,0,0,0,0,0,0,0,0,0,0,0,2,2,2,0
41862,191,5605,1660,832,1314,41,38,274,1701,20,312,209,395,332,604,2671,5058,12,64042,3557,1,2,93,47,0
41863,191,5605,1057,646,719,113,100,145,1170,18,215,134,248,233,382,1740,3004,10,31186,1732,1,2,93,47,0
41864,77,2606,477,336,357,30,23,73,507,16,194,134,250,210,384,1538,2962,10,30538,1696,0,2,101,45,0
41865,85,2063,996,429,845,24,10,117,1020,7,76,50,88,83,138,494,879,4,3565,198,0,2,11,4,0
41866,85,2063,456,277,329,12,42,72,468,13,85,50,97,98,147,592,972,7,7212,400,0,2,11,4,0
41867,161,3438,1513,682,1277,25,13,200,1538,11,199,116,219,210,335,1557,2584,6,15641,868,0,2,8,13,0
41868,161,3438,819,519,539,24,98,155,843,15,96,57,106,111,163,690,1107,8,9171,509,0,2,8,13,0
41869,53,1495,207,111,150,11,0,50,218,5,26,19,36,31,55,133,272,3,943,52,0,2,88,34,0
41870,53,1495,410,198,237,31,55,97,441,11,63,38,72,74,110,414,683,6,4293,238,0,2,88,34,0
41871,239,5077,2,2,2,0,0,0,2,0,0,0,0,0,0,0,0,0,0,0,0,2,22,14,0
41872,239,5077,99,48,90,1,3,5,100,0,0,0,0,0,0,0,0,0,0,0,0,2,22,14,0
41873,239,5077,8,5,5,2,0,1,10,0,0,0,0,0,0,0,0,0,0,0,0,2,22,14,0
41874,239,5077,1217,716,841,84,126,174,1301,14,185,118,215,199,333,1446,2542,8,20687,1149,0,2,22,14,0
41875,239,5077,160,89,115,0,13,31,160,7,15,11,17,22,28,78,124,3,495,27,0,2,22,14,0
41876,239,5077,10,10,9,9,0,0,19,0,0,0,0,0,0,0,0,0,0,0,0,2,22,14,0
41877,239,5077,173,84,99,8,29,36,181,5,12,7,13,17,20,54,81,2,221,12,0,2,22,14,0
41878,239,5077,3,1,1,3,0,0,6,0,0,0,0,0,0,0,0,0,0,0,0,2,22,14,0
41879,113,2328,463,295,324,28,62,57,491,12,134,82,154,146,236,989,1696,6,11700,650,0,2,2,2,0
41880,57,1477,339,213,244,17,9,65,356,10,42,26,48,52,74,259,421,5,2410,133,0,2,8,2,0
41881,103,2729,1455,414,1257,16,76,112,1471,5,41,23,46,46,69,231,381,2,1069,59,0,2,75,37,0
41882,103,2729,669,365,481,22,61,110,691,15,103,63,122,118,185,747,1273,8,11311,628,0,2,75,37,0
41883,262,6261,4293,999,3693,19,54,507,4312,9,155,88,170,164,258,1156,1898,4,9368,520,0,2,18,6,0
41884,262,6261,1482,859,1002,125,135,219,1607,16,219,134,251,235,385,1766,3032,9,27804,1544,1,2,18,6,0
41885,31,1070,74,35,59,1,0,14,75,3,14,7,14,17,21,58,85,1,128,7,0,2,3,2,0
41886,31,1070,245,125,200,5,7,34,250,7,30,17,34,37,51,166,265,3,1053,58,0,2,3,2,0
41887,54,642,647,139,84,35,284,233,682,0,0,0,0,0,0,0,0,0,0,0,0,2,10,25,0
41888,118,3197,1523,757,1297,19,12,193,1542,12,193,117,230,205,347,1508,2664,7,19053,1058,0,2,8,4,0
41889,118,3197,701,378,504,33,58,109,734,13,110,68,126,123,194,794,1346,7,10027,557,0,2,8,4,0
41890,117,2969,773,422,505,30,103,129,803,14,77,46,83,91,129,535,839,7,6334,351,0,2,103,23,0
41891,143,3505,77,34,69,0,0,8,77,3,24,16,29,27,45,114,213,1,387,21,0,2,19,11,0
41892,143,3505,712,438,573,51,9,84,763,14,102,71,128,116,199,733,1364,8,11988,666,0,2,19,11,0
41893,24,608,2,2,2,0,0,0,2,0,0,0,0,0,0,0,0,0,0,0,0,2,2,4,0
41894,24,608,99,48,90,1,3,5,100,0,0,0,0,0,0,0,0,0,0,0,0,2,2,4,0
41895,24,608,8,5,5,2,0,1,10,0,0,0,0,0,0,0,0,0,0,0,0,2,2,4,0
41896,24,608,1217,716,841,84,126,174,1301,14,185,118,215,199,333,1446,2542,8,20687,1149,0,2,2,4,0
41897,24,608,160,89,115,0,13,31,160,7,15,11,17,22,28,78,124,3,495,27,0,2,2,4,0
41898,24,608,10,10,9,9,0,0,19,0,0,0,0,0,0,0,0,0,0,0,0,2,2,4,0
41899,24,608,173,84,99,8,29,36,181,5,12,7,13,17,20,54,81,2,221,12,0,2,2,4,0
41900,24,608,3,1,1,3,0,0,6,0,0,0,0,0,0,0,0,0,0,0,0,2,2,4,0
41901,69,1500,402,202,227,24,74,80,426,12,52,33,61,64,94,339,564,7,3969,220,0,2,26,24,0
41902,55,1873,53,23,39,0,0,13,53,2,8,4,8,10,12,26,39,1,39,2,0,2,54,29,0
41903,55,1873,515,298,307,33,80,99,548,12,63,44,77,75,121,419,753,7,5527,307,0,2,54,29,0
41904,61,1561,91,45,69,0,3,18,91,3,9,6,10,12,16,33,57,1,95,5,0,2,44,28,0
41905,61,1561,367,234,237,17,34,68,384,16,55,34,61,71,95,381,584,8,5183,287,0,2,44,28,0
41906,227,6346,722,423,573,19,0,135,741,12,172,101,199,184,300,1320,2257,6,15668,870,0,2,182,77,0
41907,227,6346,1508,847,911,44,250,301,1552,14,148,88,169,162,257,1120,1886,7,15077,837,0,2,182,77,0
41908,301,6662,72,33,56,0,4,12,72,1,1,1,1,2,2,0,2,0,1,0,0,2,29,22,0
41909,301,6662,1454,835,1044,76,110,219,1530,17,275,158,296,292,454,2297,3718,9,34017,1889,1,2,29,22,0
41910,80,1970,757,253,292,73,244,162,830,13,61,38,67,74,105,409,651,7,4654,258,0,2,7,9,0
41911,20,989,386,256,301,16,9,68,402,4,59,35,69,63,104,355,621,2,1453,80,0,2,5,8,0
41912,20,989,264,131,164,11,41,46,275,6,38,22,40,44,62,214,338,3,1068,59,0,2,5,8,0
41913,78,1993,466,257,367,18,25,50,484,7,126,86,171,133,257,898,1813,4,8612,478,0,2,24,14,0
41914,78,1993,507,281,342,29,59,88,536,10,53,29,57,63,86,336,514,5,2764,153,0,2,24,14,0
41915,87,1930,1043,504,840,53,9,147,1096,9,180,112,198,189,310,1377,2344,4,11604,644,0,2,6,13,0
41916,87,1930,383,288,292,26,6,62,409,11,65,38,67,76,105,429,656,5,3719,206,0,2,6,13,0
41917,20,378,294,64,250,0,0,43,294,1,20,10,20,21,30,86,131,0,65,3,0,2,1,2,0
41918,20,378,78,46,62,3,0,14,81,3,8,4,8,11,12,28,41,1,62,3,0,2,1,2,0
41919,40,786,1178,367,1042,6,15,115,1184,9,94,51,95,103,146,644,976,4,4439,246,0,2,2,2,0
41920,40,786,177,108,140,8,0,27,185,6,30,16,32,36,48,162,248,3,794,44,0,2,2,2,0
41921,298,6416,1943,715,1694,26,18,214,1969,12,185,120,237,197,357,1436,2721,7,20915,1161,0,2,164,69,0
41922,298,6416,1168,838,957,57,25,144,1225,19,348,224,416,367,640,3018,5452,11,61921,3440,1,2,164,69,0
41923,18,704,442,244,305,14,16,103,456,11,68,45,75,79,120,452,756,6,4588,254,0,2,20,15,0
41924,18,704,182,102,99,11,40,35,193,3,11,6,11,14,17,42,64,1,97,5,0,2,20,15,0
41925,2,222,37,13,25,0,6,6,37,1,2,1,2,3,3,2,4,0,2,0,0,2,16,5,0
41926,2,222,133,47,40,1,43,49,134,0,0,0,0,0,0,0,0,0,0,0,0,2,16,5,0
41927,23,625,601,196,481,2,23,85,603,8,63,36,72,71,108,400,664,4,3036,168,0,2,6,2,0
41928,23,625,156,79,106,5,16,28,161,5,14,8,15,19,23,64,97,2,261,14,0,2,6,2,0
41929,106,4666,1289,550,1043,56,32,155,1345,10,167,93,185,177,278,1266,2075,5,11498,638,0,2,65,17,0
41930,31,1010,182,127,129,0,0,53,182,5,39,21,42,44,63,217,343,2,926,51,0,2,29,28,0
41931,143,6943,1392,870,1177,35,17,170,1427,14,494,280,531,508,811,4473,7289,7,54850,3047,2,2,45,75,0
41932,100,3088,773,419,590,28,0,166,801,10,204,113,217,214,330,1598,2554,5,13587,754,0,2,126,106,0
41933,17,400,127,75,83,2,11,30,129,4,14,7,14,18,21,61,87,2,175,9,0,2,4,1,0
41934,17,400,652,304,544,16,6,88,668,6,89,51,101,95,152,591,998,3,3399,188,0,2,4,1,0
41935,17,400,2,2,2,0,0,0,2,0,0,0,0,0,0,0,0,0,0,0,0,2,4,1,0
41936,17,400,8,5,5,0,0,3,8,0,0,0,0,0,0,0,0,0,0,0,0,2,4,1,0
41937,17,400,2,2,2,0,0,0,2,0,0,0,0,0,0,0,0,0,0,0,0,2,4,1,0
41938,17,400,14,8,8,0,0,6,14,0,0,0,0,0,0,0,0,0,0,0,0,2,4,1,0
41939,17,400,6,4,4,0,0,2,6,0,0,0,0,0,0,0,0,0,0,0,0,2,4,1,0
41940,17,400,6,4,4,0,0,2,6,1,2,1,2,3,3,2,4,0,2,0,0,2,4,1,0
41941,17,400,6,4,4,0,0,2,6,0,0,0,0,0,0,0,0,0,0,0,0,2,4,1,0
41942,17,400,7,5,5,0,0,2,7,0,0,0,0,0,0,0,0,0,0,0,0,2,4,1,0
41943,17,400,6,4,4,0,0,2,6,0,0,0,0,0,0,0,0,0,0,0,0,2,4,1,0
41944,17,400,10,6,6,0,0,4,10,0,0,0,0,0,0,0,0,0,0,0,0,2,4,1,0
41945,17,400,1,1,1,0,0,0,1,0,0,0,0,0,0,0,0,0,0,0,0,2,4,1,0
41946,17,400,1,1,1,0,0,0,1,0,0,0,0,0,0,0,0,0,0,0,0,2,4,1,0
41947,17,400,14,10,10,0,0,4,14,1,1,1,1,2,2,0,2,0,1,0,0,2,4,1,0
41948,17,400,46,26,30,3,0,12,49,3,6,3,6,9,9,20,28,1,42,2,0,2,4,1,0
41949,7,265,75,38,59,1,3,12,76,2,4,2,4,6,6,10,15,1,15,0,0,2,30,1,0
41950,24,694,149,95,105,2,0,41,151,8,54,28,55,62,83,334,494,4,2013,111,0,2,76,3,0
41951,15,696,139,89,101,2,0,35,141,7,54,34,62,61,96,330,569,4,2287,127,0,2,1,1,0
41952,3,501,149,67,118,4,0,27,153,1,17,14,28,18,42,69,175,0,144,8,0,2,66,2,0
41953,42,2589,1157,318,931,29,22,177,1186,6,104,63,125,110,188,712,1274,3,4596,255,0,2,8,8,0
41954,69,4372,520,294,400,33,13,81,553,10,261,204,367,271,571,2128,4614,7,32445,1802,1,2,61,48,0
41955,89,3928,1338,495,1086,10,64,173,1348,11,122,82,157,133,239,883,1686,7,11934,663,0,2,2,2,0
41956,185,8005,4293,999,3693,19,54,507,4312,9,155,88,170,164,258,1156,1898,4,9368,520,0,2,7,7,0
41957,185,8005,1482,859,1002,125,135,219,1607,16,219,134,251,235,385,1766,3032,9,27804,1544,1,2,7,7,0
41958,147,5907,1782,648,1425,9,47,279,1791,8,171,97,189,179,286,1292,2140,4,9462,525,0,2,14,31,0
41959,30,921,256,139,192,9,7,47,265,4,23,12,24,27,36,112,171,2,357,19,0,2,1,1,0
41960,6,322,180,34,164,0,0,16,180,1,12,6,12,13,18,43,66,0,33,1,0,2,2,2,0
41961,127,5424,1450,624,1228,12,26,181,1462,14,306,186,354,320,540,2580,4493,8,36391,2021,1,2,131,17,0
41962,191,6342,1660,832,1314,41,38,274,1701,20,312,209,395,332,604,2671,5058,12,64042,3557,1,2,115,37,0
41963,51,3873,996,429,845,24,10,117,1020,7,76,50,88,83,138,494,879,4,3565,198,0,2,84,165,0
41964,117,4986,1513,682,1277,25,13,200,1538,11,199,116,219,210,335,1557,2584,6,15641,868,0,2,17,36,0
41965,87,5062,1296,573,1062,40,33,157,1336,8,201,118,231,209,349,1561,2689,4,12365,686,0,2,24,19,0
41966,25,591,207,111,150,11,0,50,218,5,26,19,36,31,55,133,272,3,943,52,0,2,21,0,0
41967,111,6058,1457,730,1242,11,6,188,1468,10,292,166,329,302,495,2424,4078,5,22973,1276,1,2,9,4,0
41968,46,2850,652,304,544,16,6,88,668,6,89,51,101,95,152,591,998,3,3399,188,0,2,3,3,0
41969,81,3715,1455,414,1257,16,76,112,1471,5,41,23,46,46,69,231,381,2,1069,59,0,2,9,8,0
41970,8,310,103,47,73,2,12,15,105,5,16,9,17,21,26,75,114,2,303,16,0,2,2,2,0
41971,113,5659,1523,757,1297,19,12,193,1542,12,193,117,230,205,347,1508,2664,7,19053,1058,0,2,18,15,0
41972,71,3199,1020,354,843,12,15,144,1032,8,134,77,144,142,221,970,1580,4,6792,377,0,2,23,2,0
41973,3,96,35,12,22,4,5,6,39,1,2,1,2,3,3,2,4,0,2,0,0,2,1,0,0
41974,79,4230,1293,570,1093,25,15,163,1318,10,195,123,241,205,364,1516,2795,6,17273,959,0,2,29,7,0
41975,30,1924,384,251,317,7,8,52,391,11,70,44,84,81,128,467,811,6,5355,297,0,2,30,0,0
41976,62,3231,722,423,573,19,0,135,741,12,172,101,199,184,300,1320,2257,6,15668,870,0,2,115,11,0
41977,31,1843,466,257,367,18,25,50,484,7,126,86,171,133,257,898,1813,4,8612,478,0,2,3,3,0
41978,88,3442,1043,504,840,53,9,147,1096,9,180,112,198,189,310,1377,2344,4,11604,644,0,2,19,11,0
41979,12,463,295,56,236,0,4,54,295,2,9,5,10,11,15,30,51,1,57,3,0,2,2,2,0
41980,30,1422,373,158,315,8,0,51,381,5,76,44,79,81,123,486,779,2,2026,112,0,2,9,9,0
41981,12,572,294,64,250,0,0,43,294,1,20,10,20,21,30,86,131,0,65,3,0,3,1,1,0
41982,79,3073,1178,367,1042,6,15,115,1184,9,94,51,95,103,146,644,976,4,4439,246,0,2,20,6,0
41983,12,645,219,78,157,11,5,46,230,3,24,20,34,27,54,114,256,2,545,30,0,2,1,1,0
41984,114,6852,1943,715,1694,26,18,214,1969,12,185,120,237,197,357,1436,2721,7,20915,1161,0,2,206,53,0
41985,40,1861,442,244,305,14,16,103,456,11,68,45,75,79,120,452,756,6,4588,254,0,2,12,2,0
41986,51,2042,1098,241,925,5,10,155,1103,7,46,25,49,53,74,273,423,3,1580,87,0,2,25,13,0
41987,49,1715,601,196,481,2,23,85,603,8,63,36,72,71,108,400,664,4,3036,168,0,2,7,6,0
41988,227,6367,722,423,573,19,0,135,741,12,172,101,199,184,300,1320,2257,6,15668,870,0,2,21,17,1
41989,227,6367,1508,847,911,44,250,301,1552,14,148,88,169,162,257,1120,1886,7,15077,837,0,2,21,17,1
41990,63,3295,722,423,573,19,0,135,741,12,172,101,199,184,300,1320,2257,6,15668,870,0,2,9,1,1
41991,227,6367,722,423,573,19,0,135,741,12,172,101,199,184,300,1320,2257,6,15668,870,0,2,21,17,0
41992,227,6367,1508,847,911,44,250,301,1552,14,148,88,169,162,257,1120,1886,7,15077,837,0,2,21,17,0
41993,63,3295,722,423,573,19,0,135,741,12,172,101,199,184,300,1320,2257,6,15668,870,0,2,9,1,0
41994,1,303,382,65,130,157,2,92,539,4,10,5,10,14,15,41,57,2,114,6,0,2,1,1,0
41995,227,6370,722,423,573,19,0,135,741,12,172,101,199,184,300,1320,2257,6,15668,870,0,2,1,0,0
41996,227,6370,1508,847,911,44,250,301,1552,14,148,88,169,162,257,1120,1886,7,15077,837,0,2,1,0,0
41997,227,6370,722,423,573,19,0,135,741,12,172,101,199,184,300,1320,2257,6,15668,870,0,2,1,0,0
41998,227,6370,1508,847,911,44,250,301,1552,14,148,88,169,162,257,1120,1886,7,15077,837,0,2,1,0,0
41999,1,319,382,65,130,157,2,92,539,4,10,5,10,14,15,41,57,2,114,6,0,2,13,0,0
42000,13,539,124,78,88,2,3,26,126,4,13,7,13,17,20,56,81,2,163,9,0,2,7,0,0
42001,88,3448,1043,504,840,53,9,147,1096,9,180,112,198,189,310,1377,2344,4,11604,644,0,2,3,3,0
42002,88,1929,1043,504,840,53,9,147,1096,9,180,112,198,189,310,1377,2344,4,11604,644,0,2,6,1,0
42003,88,1929,383,288,292,26,6,62,409,11,65,38,67,76,105,429,656,5,3719,206,0,2,6,1,0
42004,88,1929,1043,504,840,53,9,147,1096,9,180,112,198,189,310,1377,2344,4,11604,644,0,2,6,1,0
42005,88,1929,383,288,292,26,6,62,409,11,65,38,67,76,105,429,656,5,3719,206,0,2,6,1,0
42006,88,3448,1043,504,840,53,9,147,1096,9,180,112,198,189,310,1377,2344,4,11604,644,0,2,3,3,0
42007,1,322,382,65,130,157,2,92,539,4,10,5,10,14,15,41,57,2,114,6,0,2,1,1,0
42008,145,3551,77,34,69,0,0,8,77,3,24,16,29,27,45,114,213,1,387,21,0,2,10,4,0
42009,145,3551,712,438,573,51,9,84,763,14,102,71,128,116,199,733,1364,8,11988,666,0,2,10,4,0
42010,4,216,77,34,69,0,0,8,77,3,24,16,29,27,45,114,213,1,387,21,0,0,52,0,0
42011,298,6420,1943,715,1694,26,18,214,1969,12,185,120,237,197,357,1436,2721,7,20915,1161,0,2,1,1,0
42012,298,6420,1168,838,957,57,25,144,1225,19,348,224,416,367,640,3018,5452,11,61921,3440,1,2,1,1,0
42013,145,3551,77,34,69,0,0,8,77,3,24,16,29,27,45,114,213,1,387,21,0,2,10,4,0
42014,145,3551,712,438,573,51,9,84,763,14,102,71,128,116,199,733,1364,8,11988,666,0,2,10,4,0
42015,4,216,77,34,69,0,0,8,77,3,24,16,29,27,45,114,213,1,387,21,0,0,52,0,0
42016,298,6420,1943,715,1694,26,18,214,1969,12,185,120,237,197,357,1436,2721,7,20915,1161,0,2,1,1,0
42017,298,6420,1168,838,957,57,25,144,1225,19,348,224,416,367,640,3018,5452,11,61921,3440,1,2,1,1,0
42018,105,2771,1455,414,1257,16,76,112,1471,5,41,23,46,46,69,231,381,2,1069,59,0,2,10,0,0
42019,105,2771,669,365,481,22,61,110,691,15,103,63,122,118,185,747,1273,8,11311,628,0,2,10,0,0
42020,83,3818,1455,414,1257,16,76,112,1471,5,41,23,46,46,69,231,381,2,1069,59,0,2,60,5,0
42021,105,2771,1455,414,1257,16,76,112,1471,5,41,23,46,46,69,231,381,2,1069,59,0,2,10,0,0
42022,105,2771,669,365,481,22,61,110,691,15,103,63,122,118,185,747,1273,8,11311,628,0,2,10,0,0
42023,83,3818,1455,414,1257,16,76,112,1471,5,41,23,46,46,69,231,381,2,1069,59,0,2,60,5,0
42024,239,5077,2,2,2,0,0,0,2,0,0,0,0,0,0,0,0,0,0,0,0,2,1,1,0
42025,239,5077,99,48,90,1,3,5,100,0,0,0,0,0,0,0,0,0,0,0,0,2,1,1,0
42026,239,5077,8,5,5,2,0,1,10,0,0,0,0,0,0,0,0,0,0,0,0,2,1,1,0
42027,239,5077,1217,716,841,84,126,174,1301,14,185,118,215,199,333,1446,2542,8,20687,1149,0,2,1,1,0
42028,239,5077,160,89,115,0,13,31,160,7,15,11,17,22,28,78,124,3,495,27,0,2,1,1,0
42029,239,5077,10,10,9,9,0,0,19,0,0,0,0,0,0,0,0,0,0,0,0,2,1,1,0
42030,239,5077,173,84,99,8,29,36,181,5,12,7,13,17,20,54,81,2,221,12,0,2,1,1,0
42031,239,5077,3,1,1,3,0,0,6,0,0,0,0,0,0,0,0,0,0,0,0,2,1,1,0
42032,118,3203,1523,757,1297,19,12,193,1542,12,193,117,230,205,347,1508,2664,7,19053,1058,0,2,1,0,0
42033,118,3203,701,378,504,33,58,109,734,13,110,68,126,123,194,794,1346,7,10027,557,0,2,1,0,0
42034,114,5827,1523,757,1297,19,12,193,1542,12,193,117,230,205,347,1508,2664,7,19053,1058,0,2,42,0,0
42035,119,3209,1523,757,1297,19,12,193,1542,12,193,117,230,205,347,1508,2664,7,19053,1058,0,2,2,1,0
42036,119,3209,701,378,504,33,58,109,734,13,110,68,126,123,194,794,1346,7,10027,557,0,2,2,1,0
42037,239,5077,2,2,2,0,0,0,2,0,0,0,0,0,0,0,0,0,0,0,0,2,1,1,0
42038,239,5077,99,48,90,1,3,5,100,0,0,0,0,0,0,0,0,0,0,0,0,2,1,1,0
42039,239,5077,8,5,5,2,0,1,10,0,0,0,0,0,0,0,0,0,0,0,0,2,1,1,0
42040,239,5077,1217,716,841,84,126,174,1301,14,185,118,215,199,333,1446,2542,8,20687,1149,0,2,1,1,0
42041,239,5077,160,89,115,0,13,31,160,7,15,11,17,22,28,78,124,3,495,27,0,2,1,1,0
42042,239,5077,10,10,9,9,0,0,19,0,0,0,0,0,0,0,0,0,0,0,0,2,1,1,0
42043,239,5077,173,84,99,8,29,36,181,5,12,7,13,17,20,54,81,2,221,12,0,2,1,1,0
42044,239,5077,3,1,1,3,0,0,6,0,0,0,0,0,0,0,0,0,0,0,0,2,1,1,0
42045,239,5077,2,2,2,0,0,0,2,0,0,0,0,0,0,0,0,0,0,0,0,2,1,1,0
42046,239,5077,99,48,90,1,3,5,100,0,0,0,0,0,0,0,0,0,0,0,0,2,1,1,0
42047,239,5077,8,5,5,2,0,1,10,0,0,0,0,0,0,0,0,0,0,0,0,2,1,1,0
42048,239,5077,1217,716,841,84,126,174,1301,14,185,118,215,199,333,1446,2542,8,20687,1149,0,2,1,1,0
42049,239,5077,160,89,115,0,13,31,160,7,15,11,17,22,28,78,124,3,495,27,0,2,1,1,0
42050,239,5077,10,10,9,9,0,0,19,0,0,0,0,0,0,0,0,0,0,0,0,2,1,1,0
42051,239,5077,173,84,99,8,29,36,181,5,12,7,13,17,20,54,81,2,221,12,0,2,1,1,0
42052,239,5077,3,1,1,3,0,0,6,0,0,0,0,0,0,0,0,0,0,0,0,2,1,1,0
42053,105,2771,1455,414,1257,16,76,112,1471,5,41,23,46,46,69,231,381,2,1069,59,0,2,10,0,0
42054,105,2771,669,365,481,22,61,110,691,15,103,63,122,118,185,747,1273,8,11311,628,0,2,10,0,0
42055,298,6420,1943,715,1694,26,18,214,1969,12,185,120,237,197,357,1436,2721,7,20915,1161,0,2,1,1,0
42056,298,6420,1168,838,957,57,25,144,1225,19,348,224,416,367,640,3018,5452,11,61921,3440,1,2,1,1,0
42057,83,3818,1455,414,1257,16,76,112,1471,5,41,23,46,46,69,231,381,2,1069,59,0,2,60,5,0
42058,118,3203,1523,757,1297,19,12,193,1542,12,193,117,230,205,347,1508,2664,7,19053,1058,0,2,1,0,0
42059,118,3203,701,378,504,33,58,109,734,13,110,68,126,123,194,794,1346,7,10027,557,0,2,1,0,0
42060,114,5827,1523,757,1297,19,12,193,1542,12,193,117,230,205,347,1508,2664,7,19053,1058,0,2,42,0,0
42061,119,3209,1523,757,1297,19,12,193,1542,12,193,117,230,205,347,1508,2664,7,19053,1058,0,2,2,1,0
42062,119,3209,701,378,504,33,58,109,734,13,110,68,126,123,194,794,1346,7,10027,557,0,2,2,1,0
42063,189,5498,1660,832,1314,41,38,274,1701,20,312,209,395,332,604,2671,5058,12,64042,3557,1,2,0,31,0
42064,189,5498,1057,646,719,113,100,145,1170,18,215,134,248,233,382,1740,3004,10,31186,1732,1,2,0,31,0
42065,45,1597,601,196,481,2,23,85,603,8,63,36,72,71,108,400,664,4,3036,168,0,2,1,43,0
42066,7,458,382,65,130,157,2,92,539,4,10,5,10,14,15,41,57,2,114,6,0,2,29,1,0
42067,14,567,124,78,88,2,3,26,126,4,13,7,13,17,20,56,81,2,163,9,0,2,5,3,0
42068,7,458,382,65,130,157,2,92,539,4,10,5,10,14,15,41,57,2,114,6,0,2,29,1,0
42069,14,567,124,78,88,2,3,26,126,4,13,7,13,17,20,56,81,2,163,9,0,2,5,3,0
42070,88,2116,996,429,845,24,10,117,1020,7,76,50,88,83,138,494,879,4,3565,198,0,2,20,7,0
42071,88,2116,456,277,329,12,42,72,468,13,85,50,97,98,147,592,972,7,7212,400,0,2,20,7,0
42072,51,3888,996,429,845,24,10,117,1020,7,76,50,88,83,138,494,879,4,3565,198,0,2,1,0,0
42073,88,2116,996,429,845,24,10,117,1020,7,76,50,88,83,138,494,879,4,3565,198,0,2,20,7,0
42074,88,2116,456,277,329,12,42,72,468,13,85,50,97,98,147,592,972,7,7212,400,0,2,20,7,0
42075,51,3888,996,429,845,24,10,117,1020,7,76,50,88,83,138,494,879,4,3565,198,0,2,1,0,0
42076,244,5149,2,2,2,0,0,0,2,0,0,0,0,0,0,0,0,0,0,0,0,2,52,1,0
42077,244,5149,99,48,90,1,3,5,100,0,0,0,0,0,0,0,0,0,0,0,0,2,52,1,0
42078,244,5149,8,5,5,2,0,1,10,0,0,0,0,0,0,0,0,0,0,0,0,2,52,1,0
42079,244,5149,1217,716,841,84,126,174,1301,14,185,118,215,199,333,1446,2542,8,20687,1149,0,2,52,1,0
42080,244,5149,160,89,115,0,13,31,160,7,15,11,17,22,28,78,124,3,495,27,0,2,52,1,0
42081,244,5149,10,10,9,9,0,0,19,0,0,0,0,0,0,0,0,0,0,0,0,2,52,1,0
42082,244,5149,173,84,99,8,29,36,181,5,12,7,13,17,20,54,81,2,221,12,0,2,52,1,0
42083,244,5149,3,1,1,3,0,0,6,0,0,0,0,0,0,0,0,0,0,0,0,2,52,1,0
42084,111,6090,1457,730,1242,11,6,188,1468,10,292,166,329,302,495,2424,4078,5,22973,1276,1,2,11,5,0
42085,244,5149,2,2,2,0,0,0,2,0,0,0,0,0,0,0,0,0,0,0,0,2,52,1,0
42086,244,5149,99,48,90,1,3,5,100,0,0,0,0,0,0,0,0,0,0,0,0,2,52,1,0
42087,244,5149,8,5,5,2,0,1,10,0,0,0,0,0,0,0,0,0,0,0,0,2,52,1,0
42088,244,5149,1217,716,841,84,126,174,1301,14,185,118,215,199,333,1446,2542,8,20687,1149,0,2,52,1,0
42089,244,5149,160,89,115,0,13,31,160,7,15,11,17,22,28,78,124,3,495,27,0,2,52,1,0
42090,244,5149,10,10,9,9,0,0,19,0,0,0,0,0,0,0,0,0,0,0,0,2,52,1,0
42091,244,5149,173,84,99,8,29,36,181,5,12,7,13,17,20,54,81,2,221,12,0,2,52,1,0
42092,244,5149,3,1,1,3,0,0,6,0,0,0,0,0,0,0,0,0,0,0,0,2,52,1,0
42093,111,6090,1457,730,1242,11,6,188,1468,10,292,166,329,302,495,2424,4078,5,22973,1276,1,2,11,5,0
42094,119,3209,1523,757,1297,19,12,193,1542,12,193,117,230,205,347,1508,2664,7,19053,1058,0,2,2,0,0
42095,119,3209,701,378,504,33,58,109,734,13,110,68,126,123,194,794,1346,7,10027,557,0,2,2,0,0
42096,114,5827,1523,757,1297,19,12,193,1542,12,193,117,230,205,347,1508,2664,7,19053,1058,0,2,42,0,0
42097,87,3421,1043,504,840,53,9,147,1096,9,180,112,198,189,310,1377,2344,4,11604,644,0,2,1,4,0
42098,299,6663,72,33,56,0,4,12,72,1,1,1,1,2,2,0,2,0,1,0,0,2,18,8,0
42099,299,6663,1454,835,1044,76,110,219,1530,17,275,158,296,292,454,2297,3718,9,34017,1889,1,2,18,8,0
42100,299,6663,72,33,56,0,4,12,72,1,1,1,1,2,2,0,2,0,1,0,0,2,18,8,0
42101,299,6663,1454,835,1044,76,110,219,1530,17,275,158,296,292,454,2297,3718,9,34017,1889,1,2,18,8,0
42102,227,6379,722,423,573,19,0,135,741,12,172,101,199,184,300,1320,2257,6,15668,870,0,2,1,1,1
42103,227,6379,1508,847,911,44,250,301,1552,14,148,88,169,162,257,1120,1886,7,15077,837,0,2,1,1,1
42104,64,3325,722,423,573,19,0,135,741,12,172,101,199,184,300,1320,2257,6,15668,870,0,2,20,0,1
42105,14,367,105,62,62,2,14,27,107,4,12,8,12,16,20,51,80,2,160,8,0,3,8,2,0
42106,14,367,105,62,62,2,14,27,107,4,12,8,12,16,20,51,80,2,160,8,0,3,8,2,0
42107,87,3421,1043,504,840,53,9,147,1096,9,180,112,198,189,310,1377,2344,4,11604,644,0,2,1,4,0
42108,227,6379,722,423,573,19,0,135,741,12,172,101,199,184,300,1320,2257,6,15668,870,0,2,1,1,0
42109,227,6379,1508,847,911,44,250,301,1552,14,148,88,169,162,257,1120,1886,7,15077,837,0,2,1,1,0
42110,64,3325,722,423,573,19,0,135,741,12,172,101,199,184,300,1320,2257,6,15668,870,0,2,20,0,0
42111,189,5498,1660,832,1314,41,38,274,1701,20,312,209,395,332,604,2671,5058,12,64042,3557,1,2,6,4,0
42112,189,5498,1057,646,719,113,100,145,1170,18,215,134,248,233,382,1740,3004,10,31186,1732,1,2,6,4,0
42113,228,6397,722,423,573,19,0,135,741,12,172,101,199,184,300,1320,2257,6,15668,870,0,2,9,4,0
42114,228,6397,1508,847,911,44,250,301,1552,14,148,88,169,162,257,1120,1886,7,15077,837,0,2,9,4,0
42115,64,3340,722,423,573,19,0,135,741,12,172,101,199,184,300,1320,2257,6,15668,870,0,2,7,5,0
42116,189,5498,1660,832,1314,41,38,274,1701,20,312,209,395,332,604,2671,5058,12,64042,3557,1,2,6,4,0
42117,189,5498,1057,646,719,113,100,145,1170,18,215,134,248,233,382,1740,3004,10,31186,1732,1,2,6,4,0
42118,228,6397,722,423,573,19,0,135,741,12,172,101,199,184,300,1320,2257,6,15668,870,0,2,9,4,0
42119,228,6397,1508,847,911,44,250,301,1552,14,148,88,169,162,257,1120,1886,7,15077,837,0,2,9,4,0
42120,64,3340,722,423,573,19,0,135,741,12,172,101,199,184,300,1320,2257,6,15668,870,0,2,7,5,0
42121,7,458,382,65,130,157,2,92,539,4,10,5,10,14,15,41,57,2,114,6,0,2,2,2,0
42122,7,458,382,65,130,157,2,92,539,4,10,5,10,14,15,41,57,2,114,6,0,2,2,2,0
42123,80,2023,466,257,367,18,25,50,484,7,126,86,171,133,257,898,1813,4,8612,478,0,2,10,4,1
42124,80,2023,507,281,342,29,59,88,536,10,53,29,57,63,86,336,514,5,2764,153,0,2,10,4,1
42125,33,2003,466,257,367,18,25,50,484,7,126,86,171,133,257,898,1813,4,8612,478,0,2,62,0,1
42126,33,2003,466,257,367,18,25,50,484,7,126,86,171,133,257,898,1813,4,8612,478,0,2,9,15,1
42127,80,2023,466,257,367,18,25,50,484,7,126,86,171,133,257,898,1813,4,8612,478,0,2,10,4,0
42128,80,2023,507,281,342,29,59,88,536,10,53,29,57,63,86,336,514,5,2764,153,0,2,10,4,0
42129,33,2003,466,257,367,18,25,50,484,7,126,86,171,133,257,898,1813,4,8612,478,0,2,56,0,0
42130,301,6450,1943,715,1694,26,18,214,1969,12,185,120,237,197,357,1436,2721,7,20915,1161,0,2,14,8,0
42131,301,6450,1168,838,957,57,25,144,1225,19,348,224,416,367,640,3018,5452,11,61921,3440,1,2,14,8,0
42132,114,6860,1943,715,1694,26,18,214,1969,12,185,120,237,197,357,1436,2721,7,20915,1161,0,2,11,0,0
42133,11,629,219,78,157,11,5,46,230,3,24,20,34,27,54,114,256,2,545,30,0,2,3,5,0
42134,37,816,167,116,138,4,5,22,171,8,48,30,56,56,86,292,499,4,2330,129,0,2,1,1,0
42135,111,6108,1457,730,1242,11,6,188,1468,10,292,166,329,302,495,2424,4078,5,22973,1276,1,2,9,9,0
42136,186,5483,182,127,129,0,0,53,182,5,39,21,42,44,63,217,343,2,926,51,0,2,1,1,1
42137,186,5483,1165,710,800,67,119,181,1232,18,243,153,282,261,435,2000,3492,10,36473,2026,1,2,1,1,1
42138,28,598,2,2,2,0,0,0,2,0,0,0,0,0,0,0,0,0,0,0,0,2,1,1,1
42139,28,598,99,48,90,1,3,5,100,0,0,0,0,0,0,0,0,0,0,0,0,2,1,1,1
42140,28,598,8,5,5,2,0,1,10,0,0,0,0,0,0,0,0,0,0,0,0,2,1,1,1
42141,28,598,1217,716,841,84,126,174,1301,14,185,118,215,199,333,1446,2542,8,20687,1149,0,2,1,1,1
42142,28,598,160,89,115,0,13,31,160,7,15,11,17,22,28,78,124,3,495,27,0,2,1,1,1
42143,28,598,10,10,9,9,0,0,19,0,0,0,0,0,0,0,0,0,0,0,0,2,1,1,1
42144,28,598,173,84,99,8,29,36,181,5,12,7,13,17,20,54,81,2,221,12,0,2,1,1,1
42145,28,598,3,1,1,3,0,0,6,0,0,0,0,0,0,0,0,0,0,0,0,2,1,1,1
42146,189,5498,1660,832,1314,41,38,274,1701,20,312,209,395,332,604,2671,5058,12,64042,3557,1,2,2,3,1
42147,189,5498,1057,646,719,113,100,145,1170,18,215,134,248,233,382,1740,3004,10,31186,1732,1,2,2,3,1
42148,53,1495,207,111,150,11,0,50,218,5,26,19,36,31,55,133,272,3,943,52,0,2,2,5,1
42149,53,1495,410,198,237,31,55,97,441,11,63,38,72,74,110,414,683,6,4293,238,0,2,2,5,1
42150,105,2773,1455,414,1257,16,76,112,1471,5,41,23,46,46,69,231,381,2,1069,59,0,2,3,1,1
42151,105,2773,669,365,481,22,61,110,691,15,103,63,122,118,185,747,1273,8,11311,628,0,2,3,1,1
42152,228,6399,722,423,573,19,0,135,741,12,172,101,199,184,300,1320,2257,6,15668,870,0,2,1,1,1
42153,228,6399,1508,847,911,44,250,301,1552,14,148,88,169,162,257,1120,1886,7,15077,837,0,2,1,1,1
42154,80,2025,466,257,367,18,25,50,484,7,126,86,171,133,257,898,1813,4,8612,478,0,2,1,1,1
42155,80,2025,507,281,342,29,59,88,536,10,53,29,57,63,86,336,514,5,2764,153,0,2,1,1,1
42156,88,1931,1043,504,840,53,9,147,1096,9,180,112,198,189,310,1377,2344,4,11604,644,0,2,1,1,1
42157,88,1931,383,288,292,26,6,62,409,11,65,38,67,76,105,429,656,5,3719,206,0,2,1,1,1
42158,100,3089,773,419,590,28,0,166,801,10,204,113,217,214,330,1598,2554,5,13587,754,0,2,2,6,1
42159,37,816,167,116,138,4,5,22,171,8,48,30,56,56,86,292,499,4,2330,129,0,2,1,1,0
42160,111,6108,1457,730,1242,11,6,188,1468,10,292,166,329,302,495,2424,4078,5,22973,1276,1,2,9,9,0
42161,186,5483,182,127,129,0,0,53,182,5,39,21,42,44,63,217,343,2,926,51,0,2,1,1,0
42162,186,5483,1165,710,800,67,119,181,1232,18,243,153,282,261,435,2000,3492,10,36473,2026,1,2,1,1,0
42163,28,598,2,2,2,0,0,0,2,0,0,0,0,0,0,0,0,0,0,0,0,2,1,1,0
42164,28,598,99,48,90,1,3,5,100,0,0,0,0,0,0,0,0,0,0,0,0,2,1,1,0
42165,28,598,8,5,5,2,0,1,10,0,0,0,0,0,0,0,0,0,0,0,0,2,1,1,0
42166,28,598,1217,716,841,84,126,174,1301,14,185,118,215,199,333,1446,2542,8,20687,1149,0,2,1,1,0
42167,28,598,160,89,115,0,13,31,160,7,15,11,17,22,28,78,124,3,495,27,0,2,1,1,0
42168,28,598,10,10,9,9,0,0,19,0,0,0,0,0,0,0,0,0,0,0,0,2,1,1,0
42169,28,598,173,84,99,8,29,36,181,5,12,7,13,17,20,54,81,2,221,12,0,2,1,1,0
42170,28,598,3,1,1,3,0,0,6,0,0,0,0,0,0,0,0,0,0,0,0,2,1,1,0
42171,189,5498,1660,832,1314,41,38,274,1701,20,312,209,395,332,604,2671,5058,12,64042,3557,1,2,2,3,0
42172,189,5498,1057,646,719,113,100,145,1170,18,215,134,248,233,382,1740,3004,10,31186,1732,1,2,2,3,0
42173,53,1495,207,111,150,11,0,50,218,5,26,19,36,31,55,133,272,3,943,52,0,2,2,5,0
42174,53,1495,410,198,237,31,55,97,441,11,63,38,72,74,110,414,683,6,4293,238,0,2,2,5,0
42175,105,2773,1455,414,1257,16,76,112,1471,5,41,23,46,46,69,231,381,2,1069,59,0,2,3,1,0
42176,105,2773,669,365,481,22,61,110,691,15,103,63,122,118,185,747,1273,8,11311,628,0,2,3,1,0
42177,228,6399,722,423,573,19,0,135,741,12,172,101,199,184,300,1320,2257,6,15668,870,0,2,1,1,0
42178,228,6399,1508,847,911,44,250,301,1552,14,148,88,169,162,257,1120,1886,7,15077,837,0,2,1,1,0
42179,80,2025,466,257,367,18,25,50,484,7,126,86,171,133,257,898,1813,4,8612,478,0,2,1,1,0
42180,80,2025,507,281,342,29,59,88,536,10,53,29,57,63,86,336,514,5,2764,153,0,2,1,1,0
42181,88,1931,1043,504,840,53,9,147,1096,9,180,112,198,189,310,1377,2344,4,11604,644,0,2,1,1,0
42182,88,1931,383,288,292,26,6,62,409,11,65,38,67,76,105,429,656,5,3719,206,0,2,1,1,0
42183,100,3089,773,419,590,28,0,166,801,10,204,113,217,214,330,1598,2554,5,13587,754,0,2,2,6,0
42184,1,101,42,7,35,4,0,5,46,1,2,1,2,3,3,2,4,0,2,0,0,2,4,1,0
42185,1,101,11,6,10,0,0,1,11,2,4,2,4,6,6,10,15,1,15,0,0,2,4,1,0
42186,53,1495,207,111,150,11,0,50,218,5,26,19,36,31,55,133,272,3,943,52,0,2,1,1,0
42187,53,1495,410,198,237,31,55,97,441,11,63,38,72,74,110,414,683,6,4293,238,0,2,1,1,0
42188,30,921,256,139,192,9,7,47,265,4,23,12,24,27,36,112,171,2,357,19,0,2,1,1,0
42189,1,92,36,13,19,2,6,9,38,1,2,1,2,3,3,2,4,0,2,0,0,0,36,0,0
42190,55,1873,53,23,39,0,0,13,53,2,8,4,8,10,12,26,39,1,39,2,0,2,1,1,0
42191,55,1873,515,298,307,33,80,99,548,12,63,44,77,75,121,419,753,7,5527,307,0,2,1,1,0
42192,53,1495,207,111,150,11,0,50,218,5,26,19,36,31,55,133,272,3,943,52,0,2,1,1,0
42193,53,1495,410,198,237,31,55,97,441,11,63,38,72,74,110,414,683,6,4293,238,0,2,1,1,0
42194,30,921,256,139,192,9,7,47,265,4,23,12,24,27,36,112,171,2,357,19,0,2,1,1,0
42195,1,92,36,13,19,2,6,9,38,1,2,1,2,3,3,2,4,0,2,0,0,0,36,0,0
42196,55,1873,53,23,39,0,0,13,53,2,8,4,8,10,12,26,39,1,39,2,0,2,1,1,0
42197,55,1873,515,298,307,33,80,99,548,12,63,44,77,75,121,419,753,7,5527,307,0,2,1,1,0
42198,1,101,42,7,35,4,0,5,46,1,2,1,2,3,3,2,4,0,2,0,0,2,4,1,0
42199,1,101,11,6,10,0,0,1,11,2,4,2,4,6,6,10,15,1,15,0,0,2,4,1,0
42200,301,6450,1943,715,1694,26,18,214,1969,12,185,120,237,197,357,1436,2721,7,20915,1161,0,2,14,8,0
42201,301,6450,1168,838,957,57,25,144,1225,19,348,224,416,367,640,3018,5452,11,61921,3440,1,2,14,8,0
42202,114,6860,1943,715,1694,26,18,214,1969,12,185,120,237,197,357,1436,2721,7,20915,1161,0,2,11,0,0
42203,26,621,207,111,150,11,0,50,218,5,26,19,36,31,55,133,272,3,943,52,0,2,9,3,0
42204,26,621,207,111,150,11,0,50,218,5,26,19,36,31,55,133,272,3,943,52,0,2,9,3,0
42205,15,385,105,62,62,2,14,27,107,4,12,8,12,16,20,51,80,2,160,8,0,2,6,4,0
42206,15,385,105,62,62,2,14,27,107,4,12,8,12,16,20,51,80,2,160,8,0,2,6,4,0
42207,267,6383,4293,999,3693,19,54,507,4312,9,155,88,170,164,258,1156,1898,4,9368,520,0,2,56,3,1
42208,267,6383,1482,859,1002,125,135,219,1607,16,219,134,251,235,385,1766,3032,9,27804,1544,1,2,56,3,1
42209,186,8051,4293,999,3693,19,54,507,4312,9,155,88,170,164,258,1156,1898,4,9368,520,0,2,132,0,1
42210,186,8051,1482,859,1002,125,135,219,1607,16,219,134,251,235,385,1766,3032,9,27804,1544,1,2,132,0,1
42211,267,6383,4293,999,3693,19,54,507,4312,9,155,88,170,164,258,1156,1898,4,9368,520,0,2,56,3,0
42212,267,6383,1482,859,1002,125,135,219,1607,16,219,134,251,235,385,1766,3032,9,27804,1544,1,2,56,3,0
42213,186,8051,4293,999,3693,19,54,507,4312,9,155,88,170,164,258,1156,1898,4,9368,520,0,2,132,0,0
42214,186,8051,1482,859,1002,125,135,219,1607,16,219,134,251,235,385,1766,3032,9,27804,1544,1,2,132,0,0
42215,7,464,382,65,130,157,2,92,539,4,10,5,10,14,15,41,57,2,114,6,0,2,2,1,0
42216,186,5489,182,127,129,0,0,53,182,5,39,21,42,44,63,217,343,2,926,51,0,2,2,1,0
42217,186,5489,1165,710,800,67,119,181,1232,18,243,153,282,261,435,2000,3492,10,36473,2026,1,2,2,1,0
42218,53,1517,207,111,150,11,0,50,218,5,26,19,36,31,55,133,272,3,943,52,0,2,7,1,0
42219,53,1517,410,198,237,31,55,97,441,11,63,38,72,74,110,414,683,6,4293,238,0,2,7,1,0
42220,244,5155,2,2,2,0,0,0,2,0,0,0,0,0,0,0,0,0,0,0,0,2,2,1,0
42221,244,5155,99,48,90,1,3,5,100,0,0,0,0,0,0,0,0,0,0,0,0,2,2,1,0
42222,244,5155,8,5,5,2,0,1,10,0,0,0,0,0,0,0,0,0,0,0,0,2,2,1,0
42223,244,5155,1217,716,841,84,126,174,1301,14,185,118,215,199,333,1446,2542,8,20687,1149,0,2,2,1,0
42224,244,5155,160,89,115,0,13,31,160,7,15,11,17,22,28,78,124,3,495,27,0,2,2,1,0
42225,244,5155,10,10,9,9,0,0,19,0,0,0,0,0,0,0,0,0,0,0,0,2,2,1,0
42226,244,5155,173,84,99,8,29,36,181,5,12,7,13,17,20,54,81,2,221,12,0,2,2,1,0
42227,244,5155,3,1,1,3,0,0,6,0,0,0,0,0,0,0,0,0,0,0,0,2,2,1,0
42228,37,822,167,116,138,4,5,22,171,8,48,30,56,56,86,292,499,4,2330,129,0,2,2,1,0
42229,105,2779,1455,414,1257,16,76,112,1471,5,41,23,46,46,69,231,381,2,1069,59,0,2,2,1,0
42230,105,2779,669,365,481,22,61,110,691,15,103,63,122,118,185,747,1273,8,11311,628,0,2,2,1,0
42231,267,6389,4293,999,3693,19,54,507,4312,9,155,88,170,164,258,1156,1898,4,9368,520,0,2,2,1,0
42232,267,6389,1482,859,1002,125,135,219,1607,16,219,134,251,235,385,1766,3032,9,27804,1544,1,2,2,1,0
42233,55,1879,53,23,39,0,0,13,53,2,8,4,8,10,12,26,39,1,39,2,0,2,2,1,0
42234,55,1879,515,298,307,33,80,99,548,12,63,44,77,75,121,419,753,7,5527,307,0,2,2,1,0
42235,12,575,205,80,86,16,53,53,221,7,18,10,19,25,29,94,134,3,497,27,0,2,3,1,0
42236,228,6405,722,423,573,19,0,135,741,12,172,101,199,184,300,1320,2257,6,15668,870,0,2,3,2,0
42237,228,6405,1508,847,911,44,250,301,1552,14,148,88,169,162,257,1120,1886,7,15077,837,0,2,3,2,0
42238,80,1976,757,253,292,73,244,162,830,13,61,38,67,74,105,409,651,7,4654,258,0,2,2,1,0
42239,20,995,386,256,301,16,9,68,402,4,59,35,69,63,104,355,621,2,1453,80,0,2,2,1,0
42240,20,995,264,131,164,11,41,46,275,6,38,22,40,44,62,214,338,3,1068,59,0,2,2,1,0
42241,88,1937,1043,504,840,53,9,147,1096,9,180,112,198,189,310,1377,2344,4,11604,644,0,2,2,1,0
42242,88,1937,383,288,292,26,6,62,409,11,65,38,67,76,105,429,656,5,3719,206,0,2,2,1,0
42243,2,228,37,13,25,0,6,6,37,1,2,1,2,3,3,2,4,0,2,0,0,2,2,1,0
42244,2,228,133,47,40,1,43,49,134,0,0,0,0,0,0,0,0,0,0,0,0,2,2,1,0
42245,111,6082,1457,730,1242,11,6,188,1468,10,292,166,329,302,495,2424,4078,5,22973,1276,1,2,19,25,0
42246,7,464,382,65,130,157,2,92,539,4,10,5,10,14,15,41,57,2,114,6,0,2,2,1,0
42247,186,5489,182,127,129,0,0,53,182,5,39,21,42,44,63,217,343,2,926,51,0,2,2,1,0
42248,186,5489,1165,710,800,67,119,181,1232,18,243,153,282,261,435,2000,3492,10,36473,2026,1,2,2,1,0
42249,53,1517,207,111,150,11,0,50,218,5,26,19,36,31,55,133,272,3,943,52,0,2,7,1,0
42250,53,1517,410,198,237,31,55,97,441,11,63,38,72,74,110,414,683,6,4293,238,0,2,7,1,0
42251,244,5155,2,2,2,0,0,0,2,0,0,0,0,0,0,0,0,0,0,0,0,2,2,1,0
42252,244,5155,99,48,90,1,3,5,100,0,0,0,0,0,0,0,0,0,0,0,0,2,2,1,0
42253,244,5155,8,5,5,2,0,1,10,0,0,0,0,0,0,0,0,0,0,0,0,2,2,1,0
42254,244,5155,1217,716,841,84,126,174,1301,14,185,118,215,199,333,1446,2542,8,20687,1149,0,2,2,1,0
42255,244,5155,160,89,115,0,13,31,160,7,15,11,17,22,28,78,124,3,495,27,0,2,2,1,0
42256,244,5155,10,10,9,9,0,0,19,0,0,0,0,0,0,0,0,0,0,0,0,2,2,1,0
42257,244,5155,173,84,99,8,29,36,181,5,12,7,13,17,20,54,81,2,221,12,0,2,2,1,0
42258,244,5155,3,1,1,3,0,0,6,0,0,0,0,0,0,0,0,0,0,0,0,2,2,1,0
42259,37,822,167,116,138,4,5,22,171,8,48,30,56,56,86,292,499,4,2330,129,0,2,2,1,0
42260,105,2779,1455,414,1257,16,76,112,1471,5,41,23,46,46,69,231,381,2,1069,59,0,2,2,1,0
42261,105,2779,669,365,481,22,61,110,691,15,103,63,122,118,185,747,1273,8,11311,628,0,2,2,1,0
42262,267,6389,4293,999,3693,19,54,507,4312,9,155,88,170,164,258,1156,1898,4,9368,520,0,2,2,1,0
42263,267,6389,1482,859,1002,125,135,219,1607,16,219,134,251,235,385,1766,3032,9,27804,1544,1,2,2,1,0
42264,55,1879,53,23,39,0,0,13,53,2,8,4,8,10,12,26,39,1,39,2,0,2,2,1,0
42265,55,1879,515,298,307,33,80,99,548,12,63,44,77,75,121,419,753,7,5527,307,0,2,2,1,0
42266,12,575,205,80,86,16,53,53,221,7,18,10,19,25,29,94,134,3,497,27,0,2,3,1,0
42267,228,6405,722,423,573,19,0,135,741,12,172,101,199,184,300,1320,2257,6,15668,870,0,2,3,2,0
42268,228,6405,1508,847,911,44,250,301,1552,14,148,88,169,162,257,1120,1886,7,15077,837,0,2,3,2,0
42269,80,1976,757,253,292,73,244,162,830,13,61,38,67,74,105,409,651,7,4654,258,0,2,2,1,0
42270,20,995,386,256,301,16,9,68,402,4,59,35,69,63,104,355,621,2,1453,80,0,2,2,1,0
42271,20,995,264,131,164,11,41,46,275,6,38,22,40,44,62,214,338,3,1068,59,0,2,2,1,0
42272,88,1937,1043,504,840,53,9,147,1096,9,180,112,198,189,310,1377,2344,4,11604,644,0,2,2,1,0
42273,88,1937,383,288,292,26,6,62,409,11,65,38,67,76,105,429,656,5,3719,206,0,2,2,1,0
42274,2,228,37,13,25,0,6,6,37,1,2,1,2,3,3,2,4,0,2,0,0,2,2,1,0
42275,2,228,133,47,40,1,43,49,134,0,0,0,0,0,0,0,0,0,0,0,0,2,2,1,0
42276,35,2036,466,257,367,18,25,50,484,7,126,86,171,133,257,898,1813,4,8612,478,0,2,39,12,0
42277,35,2036,466,257,367,18,25,50,484,7,126,86,171,133,257,898,1813,4,8612,478,0,2,39,12,0
42278,106,4662,1289,550,1043,56,32,155,1345,10,167,93,185,177,278,1266,2075,5,11498,638,0,2,2,2,0
42279,17,398,127,75,83,2,11,30,129,4,14,7,14,18,21,61,87,2,175,9,0,2,1,1,0
42280,17,398,652,304,544,16,6,88,668,6,89,51,101,95,152,591,998,3,3399,188,0,2,1,1,0
42281,17,398,2,2,2,0,0,0,2,0,0,0,0,0,0,0,0,0,0,0,0,2,1,1,0
42282,17,398,8,5,5,0,0,3,8,0,0,0,0,0,0,0,0,0,0,0,0,2,1,1,0
42283,17,398,2,2,2,0,0,0,2,0,0,0,0,0,0,0,0,0,0,0,0,2,1,1,0
42284,17,398,14,8,8,0,0,6,14,0,0,0,0,0,0,0,0,0,0,0,0,2,1,1,0
42285,17,398,6,4,4,0,0,2,6,0,0,0,0,0,0,0,0,0,0,0,0,2,1,1,0
42286,17,398,6,4,4,0,0,2,6,1,2,1,2,3,3,2,4,0,2,0,0,2,1,1,0
42287,17,398,6,4,4,0,0,2,6,0,0,0,0,0,0,0,0,0,0,0,0,2,1,1,0
42288,17,398,7,5,5,0,0,2,7,0,0,0,0,0,0,0,0,0,0,0,0,2,1,1,0
42289,17,398,6,4,4,0,0,2,6,0,0,0,0,0,0,0,0,0,0,0,0,2,1,1,0
42290,17,398,10,6,6,0,0,4,10,0,0,0,0,0,0,0,0,0,0,0,0,2,1,1,0
42291,17,398,1,1,1,0,0,0,1,0,0,0,0,0,0,0,0,0,0,0,0,2,1,1,0
42292,17,398,1,1,1,0,0,0,1,0,0,0,0,0,0,0,0,0,0,0,0,2,1,1,0
42293,17,398,14,10,10,0,0,4,14,1,1,1,1,2,2,0,2,0,1,0,0,2,1,1,0
42294,17,398,46,26,30,3,0,12,49,3,6,3,6,9,9,20,28,1,42,2,0,2,1,1,0
42295,42,2587,1157,318,931,29,22,177,1186,6,104,63,125,110,188,712,1274,3,4596,255,0,2,1,1,0
42296,89,3918,1338,495,1086,10,64,173,1348,11,122,82,157,133,239,883,1686,7,11934,663,0,2,5,5,0
42297,186,8049,4293,999,3693,19,54,507,4312,9,155,88,170,164,258,1156,1898,4,9368,520,0,2,2,2,0
42298,186,8049,1482,859,1002,125,135,219,1607,16,219,134,251,235,385,1766,3032,9,27804,1544,1,2,2,2,0
42299,147,5899,1782,648,1425,9,47,279,1791,8,171,97,189,179,286,1292,2140,4,9462,525,0,2,4,4,0
42300,127,5420,1450,624,1228,12,26,181,1462,14,306,186,354,320,540,2580,4493,8,36391,2021,1,2,2,2,0
42301,117,4982,1513,682,1277,25,13,200,1538,11,199,116,219,210,335,1557,2584,6,15641,868,0,2,2,2,0
42302,87,5056,1296,573,1062,40,33,157,1336,8,201,118,231,209,349,1561,2689,4,12365,686,0,2,3,3,0
42303,46,2848,652,304,544,16,6,88,668,6,89,51,101,95,152,591,998,3,3399,188,0,2,1,1,0
42304,8,308,103,47,73,2,12,15,105,5,16,9,17,21,26,75,114,2,303,16,0,2,1,1,0
42305,8,267,74,35,59,1,0,14,75,3,14,7,14,17,21,58,85,1,128,7,0,2,1,1,0
42306,71,3197,1020,354,843,12,15,144,1032,8,134,77,144,142,221,970,1580,4,6792,377,0,2,1,1,0
42307,38,2311,334,251,279,10,4,40,344,5,127,74,143,132,217,899,1528,2,4303,239,0,2,2,2,0
42308,79,4224,1293,570,1093,25,15,163,1318,10,195,123,241,205,364,1516,2795,6,17273,959,0,2,3,3,0
42309,30,1922,384,251,317,7,8,52,391,11,70,44,84,81,128,467,811,6,5355,297,0,2,1,1,0
42310,114,6854,1943,715,1694,26,18,214,1969,12,185,120,237,197,357,1436,2721,7,20915,1161,0,2,3,3,0
42311,106,4662,1289,550,1043,56,32,155,1345,10,167,93,185,177,278,1266,2075,5,11498,638,0,2,2,2,0
42312,17,398,127,75,83,2,11,30,129,4,14,7,14,18,21,61,87,2,175,9,0,2,1,1,0
42313,17,398,652,304,544,16,6,88,668,6,89,51,101,95,152,591,998,3,3399,188,0,2,1,1,0
42314,17,398,2,2,2,0,0,0,2,0,0,0,0,0,0,0,0,0,0,0,0,2,1,1,0
42315,17,398,8,5,5,0,0,3,8,0,0,0,0,0,0,0,0,0,0,0,0,2,1,1,0
42316,17,398,2,2,2,0,0,0,2,0,0,0,0,0,0,0,0,0,0,0,0,2,1,1,0
42317,17,398,14,8,8,0,0,6,14,0,0,0,0,0,0,0,0,0,0,0,0,2,1,1,0
42318,17,398,6,4,4,0,0,2,6,0,0,0,0,0,0,0,0,0,0,0,0,2,1,1,0
42319,17,398,6,4,4,0,0,2,6,1,2,1,2,3,3,2,4,0,2,0,0,2,1,1,0
42320,17,398,6,4,4,0,0,2,6,0,0,0,0,0,0,0,0,0,0,0,0,2,1,1,0
42321,17,398,7,5,5,0,0,2,7,0,0,0,0,0,0,0,0,0,0,0,0,2,1,1,0
42322,17,398,6,4,4,0,0,2,6,0,0,0,0,0,0,0,0,0,0,0,0,2,1,1,0
42323,17,398,10,6,6,0,0,4,10,0,0,0,0,0,0,0,0,0,0,0,0,2,1,1,0
42324,17,398,1,1,1,0,0,0,1,0,0,0,0,0,0,0,0,0,0,0,0,2,1,1,0
42325,17,398,1,1,1,0,0,0,1,0,0,0,0,0,0,0,0,0,0,0,0,2,1,1,0
42326,17,398,14,10,10,0,0,4,14,1,1,1,1,2,2,0,2,0,1,0,0,2,1,1,0
42327,17,398,46,26,30,3,0,12,49,3,6,3,6,9,9,20,28,1,42,2,0,2,1,1,0
42328,42,2587,1157,318,931,29,22,177,1186,6,104,63,125,110,188,712,1274,3,4596,255,0,2,1,1,0
42329,89,3918,1338,495,1086,10,64,173,1348,11,122,82,157,133,239,883,1686,7,11934,663,0,2,5,5,0
42330,186,8049,4293,999,3693,19,54,507,4312,9,155,88,170,164,258,1156,1898,4,9368,520,0,2,2,2,0
42331,186,8049,1482,859,1002,125,135,219,1607,16,219,134,251,235,385,1766,3032,9,27804,1544,1,2,2,2,0
42332,147,5899,1782,648,1425,9,47,279,1791,8,171,97,189,179,286,1292,2140,4,9462,525,0,2,4,4,0
42333,127,5420,1450,624,1228,12,26,181,1462,14,306,186,354,320,540,2580,4493,8,36391,2021,1,2,2,2,0
42334,117,4982,1513,682,1277,25,13,200,1538,11,199,116,219,210,335,1557,2584,6,15641,868,0,2,2,2,0
42335,87,5056,1296,573,1062,40,33,157,1336,8,201,118,231,209,349,1561,2689,4,12365,686,0,2,3,3,0
42336,46,2848,652,304,544,16,6,88,668,6,89,51,101,95,152,591,998,3,3399,188,0,2,1,1,0
42337,8,308,103,47,73,2,12,15,105,5,16,9,17,21,26,75,114,2,303,16,0,2,1,1,0
42338,8,267,74,35,59,1,0,14,75,3,14,7,14,17,21,58,85,1,128,7,0,2,1,1,0
42339,71,3197,1020,354,843,12,15,144,1032,8,134,77,144,142,221,970,1580,4,6792,377,0,2,1,1,0
42340,38,2311,334,251,279,10,4,40,344,5,127,74,143,132,217,899,1528,2,4303,239,0,2,2,2,0
42341,79,4224,1293,570,1093,25,15,163,1318,10,195,123,241,205,364,1516,2795,6,17273,959,0,2,3,3,0
42342,30,1922,384,251,317,7,8,52,391,11,70,44,84,81,128,467,811,6,5355,297,0,2,1,1,0
42343,114,6854,1943,715,1694,26,18,214,1969,12,185,120,237,197,357,1436,2721,7,20915,1161,0,2,3,3,0
42344,14,566,124,78,88,2,3,26,126,4,13,7,13,17,20,56,81,2,163,9,0,2,1,1,0
42345,228,6419,722,423,573,19,0,135,741,12,172,101,199,184,300,1320,2257,6,15668,870,0,2,6,2,0
42346,228,6419,1508,847,911,44,250,301,1552,14,148,88,169,162,257,1120,1886,7,15077,837,0,2,6,2,0
42347,228,6419,722,423,573,19,0,135,741,12,172,101,199,184,300,1320,2257,6,15668,870,0,2,6,2,0
42348,228,6419,1508,847,911,44,250,301,1552,14,148,88,169,162,257,1120,1886,7,15077,837,0,2,6,2,0
42349,14,566,124,78,88,2,3,26,126,4,13,7,13,17,20,56,81,2,163,9,0,2,1,1,0
42350,11,629,219,78,157,11,5,46,230,3,24,20,34,27,54,114,256,2,545,30,0,2,3,5,0
42351,111,6082,1457,730,1242,11,6,188,1468,10,292,166,329,302,495,2424,4078,5,22973,1276,1,2,19,25,0
42352,267,6395,4293,999,3693,19,54,507,4312,9,155,88,170,164,258,1156,1898,4,9368,520,0,2,1,1,0
42353,267,6395,1482,859,1002,125,135,219,1607,16,219,134,251,235,385,1766,3032,9,27804,1544,1,2,1,1,0
42354,55,1888,53,23,39,0,0,13,53,2,8,4,8,10,12,26,39,1,39,2,0,2,1,1,0
42355,55,1888,515,298,307,33,80,99,548,12,63,44,77,75,121,419,753,7,5527,307,0,2,1,1,0
42356,80,2027,466,257,367,18,25,50,484,7,126,86,171,133,257,898,1813,4,8612,478,0,2,1,1,0
42357,80,2027,507,281,342,29,59,88,536,10,53,29,57,63,86,336,514,5,2764,153,0,2,1,1,0
42358,267,6395,4293,999,3693,19,54,507,4312,9,155,88,170,164,258,1156,1898,4,9368,520,0,2,1,1,0
42359,267,6395,1482,859,1002,125,135,219,1607,16,219,134,251,235,385,1766,3032,9,27804,1544,1,2,1,1,0
42360,55,1888,53,23,39,0,0,13,53,2,8,4,8,10,12,26,39,1,39,2,0,2,1,1,0
42361,55,1888,515,298,307,33,80,99,548,12,63,44,77,75,121,419,753,7,5527,307,0,2,1,1,0
42362,80,2027,466,257,367,18,25,50,484,7,126,86,171,133,257,898,1813,4,8612,478,0,2,1,1,0
42363,80,2027,507,281,342,29,59,88,536,10,53,29,57,63,86,336,514,5,2764,153,0,2,1,1,0
42364,262,6273,4293,999,3693,19,54,507,4312,9,155,88,170,164,258,1156,1898,4,9368,520,0,2,3,56,0
42365,262,6273,1482,859,1002,125,135,219,1607,16,219,134,251,235,385,1766,3032,9,27804,1544,1,2,3,56,0
42366,185,8003,4293,999,3693,19,54,507,4312,9,155,88,170,164,258,1156,1898,4,9368,520,0,2,0,132,0
42367,185,8003,1482,859,1002,125,135,219,1607,16,219,134,251,235,385,1766,3032,9,27804,1544,1,2,0,132,0
42368,117,4992,1513,682,1277,25,13,200,1538,11,199,116,219,210,335,1557,2584,6,15641,868,0,2,2,0,0
42369,115,6857,1943,715,1694,26,18,214,1969,12,185,120,237,197,357,1436,2721,7,20915,1161,0,2,17,15,0
42370,117,4992,1513,682,1277,25,13,200,1538,11,199,116,219,210,335,1557,2584,6,15641,868,0,2,2,0,0
42371,115,6857,1943,715,1694,26,18,214,1969,12,185,120,237,197,357,1436,2721,7,20915,1161,0,2,17,15,0
42372,118,7014,1943,715,1694,26,18,214,1969,12,185,120,237,197,357,1436,2721,7,20915,1161,0,2,65,4,0
42373,118,7014,1943,715,1694,26,18,214,1969,12,185,120,237,197,357,1436,2721,7,20915,1161,0,2,65,4,0
42374,143,6921,1392,870,1177,35,17,170,1427,14,494,280,531,508,811,4473,7289,7,54850,3047,2,2,0,2,0
42375,145,3560,77,34,69,0,0,8,77,3,24,16,29,27,45,114,213,1,387,21,0,2,4,0,0
42376,145,3560,712,438,573,51,9,84,763,14,102,71,128,116,199,733,1364,8,11988,666,0,2,4,0,0
42377,55,1890,53,23,39,0,0,13,53,2,8,4,8,10,12,26,39,1,39,2,0,2,1,1,0
42378,55,1890,515,298,307,33,80,99,548,12,63,44,77,75,121,419,753,7,5527,307,0,2,1,1,0
42379,186,5549,182,127,129,0,0,53,182,5,39,21,42,44,63,217,343,2,926,51,0,2,10,10,0
42380,186,5549,1165,710,800,67,119,181,1232,18,243,153,282,261,435,2000,3492,10,36473,2026,1,2,10,10,0
42381,105,2787,1455,414,1257,16,76,112,1471,5,41,23,46,46,69,231,381,2,1069,59,0,2,3,1,0
42382,105,2787,669,365,481,22,61,110,691,15,103,63,122,118,185,747,1273,8,11311,628,0,2,3,1,0
42383,267,6401,4293,999,3693,19,54,507,4312,9,155,88,170,164,258,1156,1898,4,9368,520,0,2,1,1,0
42384,267,6401,1482,859,1002,125,135,219,1607,16,219,134,251,235,385,1766,3032,9,27804,1544,1,2,1,1,0
42385,143,6949,1392,870,1177,35,17,170,1427,14,494,280,531,508,811,4473,7289,7,54850,3047,2,2,1,1,0
42386,143,6921,1392,870,1177,35,17,170,1427,14,494,280,531,508,811,4473,7289,7,54850,3047,2,2,0,2,0
42387,186,5491,182,127,129,0,0,53,182,5,39,21,42,44,63,217,343,2,926,51,0,2,1,1,0
42388,186,5491,1165,710,800,67,119,181,1232,18,243,153,282,261,435,2000,3492,10,36473,2026,1,2,1,1,0
42389,88,1967,1043,504,840,53,9,147,1096,9,180,112,198,189,310,1377,2344,4,11604,644,0,2,7,2,0
42390,88,1967,383,288,292,26,6,62,409,11,65,38,67,76,105,429,656,5,3719,206,0,2,7,2,0
42391,186,5491,182,127,129,0,0,53,182,5,39,21,42,44,63,217,343,2,926,51,0,2,1,1,0
42392,186,5491,1165,710,800,67,119,181,1232,18,243,153,282,261,435,2000,3492,10,36473,2026,1,2,1,1,0
42393,88,1967,1043,504,840,53,9,147,1096,9,180,112,198,189,310,1377,2344,4,11604,644,0,2,7,2,0
42394,88,1967,383,288,292,26,6,62,409,11,65,38,67,76,105,429,656,5,3719,206,0,2,7,2,0
42395,53,1523,207,111,150,11,0,50,218,5,26,19,36,31,55,133,272,3,943,52,0,2,4,2,0
42396,53,1523,410,198,237,31,55,97,441,11,63,38,72,74,110,414,683,6,4293,238,0,2,4,2,0
42397,37,822,167,116,138,4,5,22,171,8,48,30,56,56,86,292,499,4,2330,129,0,2,3,1,0
42398,186,5551,182,127,129,0,0,53,182,5,39,21,42,44,63,217,343,2,926,51,0,2,10,10,0
42399,186,5551,1165,710,800,67,119,181,1232,18,243,153,282,261,435,2000,3492,10,36473,2026,1,2,10,10,0
42400,105,2787,1455,414,1257,16,76,112,1471,5,41,23,46,46,69,231,381,2,1069,59,0,2,3,1,0
42401,105,2787,669,365,481,22,61,110,691,15,103,63,122,118,185,747,1273,8,11311,628,0,2,3,1,0
42402,267,6401,4293,999,3693,19,54,507,4312,9,155,88,170,164,258,1156,1898,4,9368,520,0,2,1,1,0
42403,267,6401,1482,859,1002,125,135,219,1607,16,219,134,251,235,385,1766,3032,9,27804,1544,1,2,1,1,0
42404,145,3560,77,34,69,0,0,8,77,3,24,16,29,27,45,114,213,1,387,21,0,2,4,0,0
42405,145,3560,712,438,573,51,9,84,763,14,102,71,128,116,199,733,1364,8,11988,666,0,2,4,0,0
42406,55,1890,53,23,39,0,0,13,53,2,8,4,8,10,12,26,39,1,39,2,0,2,1,1,0
42407,55,1890,515,298,307,33,80,99,548,12,63,44,77,75,121,419,753,7,5527,307,0,2,1,1,0
42408,143,6927,1392,870,1177,35,17,170,1427,14,494,280,531,508,811,4473,7289,7,54850,3047,2,2,1,1,0
42409,53,1523,207,111,150,11,0,50,218,5,26,19,36,31,55,133,272,3,943,52,0,2,4,2,0
42410,53,1523,410,198,237,31,55,97,441,11,63,38,72,74,110,414,683,6,4293,238,0,2,4,2,0
42411,37,822,167,116,138,4,5,22,171,8,48,30,56,56,86,292,499,4,2330,129,0,2,3,1,0
42412,113,2328,463,295,324,28,62,57,491,12,134,82,154,146,236,989,1696,6,11700,650,0,2,4,4,1
42413,37,865,167,116,138,4,5,22,171,8,48,30,56,56,86,292,499,4,2330,129,0,2,5,2,1
42414,105,2791,1455,414,1257,16,76,112,1471,5,41,23,46,46,69,231,381,2,1069,59,0,2,1,1,1
42415,105,2791,669,365,481,22,61,110,691,15,103,63,122,118,185,747,1273,8,11311,628,0,2,1,1,1
42416,267,6409,4293,999,3693,19,54,507,4312,9,155,88,170,164,258,1156,1898,4,9368,520,0,2,7,4,1
42417,267,6409,1482,859,1002,125,135,219,1607,16,219,134,251,235,385,1766,3032,9,27804,1544,1,2,7,4,1
42418,145,3575,77,34,69,0,0,8,77,3,24,16,29,27,45,114,213,1,387,21,0,2,4,4,1
42419,145,3575,712,438,573,51,9,84,763,14,102,71,128,116,199,733,1364,8,11988,666,0,2,4,4,1
42420,55,1909,53,23,39,0,0,13,53,2,8,4,8,10,12,26,39,1,39,2,0,2,1,0,1
42421,55,1909,515,298,307,33,80,99,548,12,63,44,77,75,121,419,753,7,5527,307,0,2,1,0,1
42422,89,3918,1338,495,1086,10,64,173,1348,11,122,82,157,133,239,883,1686,7,11934,663,0,2,3,3,1
42423,113,2328,463,295,324,28,62,57,491,12,134,82,154,146,236,989,1696,6,11700,650,0,2,4,4,0
42424,37,865,167,116,138,4,5,22,171,8,48,30,56,56,86,292,499,4,2330,129,0,2,5,2,0
42425,105,2791,1455,414,1257,16,76,112,1471,5,41,23,46,46,69,231,381,2,1069,59,0,2,1,1,0
42426,105,2791,669,365,481,22,61,110,691,15,103,63,122,118,185,747,1273,8,11311,628,0,2,1,1,0
42427,267,6409,4293,999,3693,19,54,507,4312,9,155,88,170,164,258,1156,1898,4,9368,520,0,2,7,4,0
42428,267,6409,1482,859,1002,125,135,219,1607,16,219,134,251,235,385,1766,3032,9,27804,1544,1,2,7,4,0
42429,145,3575,77,34,69,0,0,8,77,3,24,16,29,27,45,114,213,1,387,21,0,2,4,4,0
42430,145,3575,712,438,573,51,9,84,763,14,102,71,128,116,199,733,1364,8,11988,666,0,2,4,4,0
42431,55,1909,53,23,39,0,0,13,53,2,8,4,8,10,12,26,39,1,39,2,0,2,1,0,0
42432,55,1909,515,298,307,33,80,99,548,12,63,44,77,75,121,419,753,7,5527,307,0,2,1,0,0
42433,89,3918,1338,495,1086,10,64,173,1348,11,122,82,157,133,239,883,1686,7,11934,663,0,2,3,3,0
42434,59,1750,773,419,590,28,0,166,801,10,204,113,217,214,330,1598,2554,5,13587,754,0,2,2,3,0
42435,59,1750,421,273,302,44,34,57,465,17,81,59,107,98,166,583,1098,11,12329,684,0,2,2,3,0
42436,186,5566,182,127,129,0,0,53,182,5,39,21,42,44,63,217,343,2,926,51,0,2,2,2,1
42437,186,5566,1165,710,800,67,119,181,1232,18,243,153,282,261,435,2000,3492,10,36473,2026,1,2,2,2,1
42438,62,2102,773,419,590,28,0,166,801,10,204,113,217,214,330,1598,2554,5,13587,754,0,2,68,9,1
42439,62,2102,421,273,302,44,34,57,465,17,81,59,107,98,166,583,1098,11,12329,684,0,2,68,9,1
42440,102,3170,773,419,590,28,0,166,801,10,204,113,217,214,330,1598,2554,5,13587,754,0,2,16,0,1
42441,64,3430,722,423,573,19,0,135,741,12,172,101,199,184,300,1320,2257,6,15668,870,0,2,69,65,1
42442,20,1004,386,256,301,16,9,68,402,4,59,35,69,63,104,355,621,2,1453,80,0,2,3,3,0
42443,20,1004,264,131,164,11,41,46,275,6,38,22,40,44,62,214,338,3,1068,59,0,2,3,3,0
42444,46,1995,386,256,301,16,9,68,402,4,59,35,69,63,104,355,621,2,1453,80,0,2,61,57,0
42445,81,2060,466,257,367,18,25,50,484,7,126,86,171,133,257,898,1813,4,8612,478,0,2,8,1,0
42446,81,2060,507,281,342,29,59,88,536,10,53,29,57,63,86,336,514,5,2764,153,0,2,8,1,0
42447,87,3572,1043,504,840,53,9,147,1096,9,180,112,198,189,310,1377,2344,4,11604,644,0,2,95,74,0
42448,186,5566,182,127,129,0,0,53,182,5,39,21,42,44,63,217,343,2,926,51,0,2,2,2,0
42449,186,5566,1165,710,800,67,119,181,1232,18,243,153,282,261,435,2000,3492,10,36473,2026,1,2,2,2,0
42450,62,2102,773,419,590,28,0,166,801,10,204,113,217,214,330,1598,2554,5,13587,754,0,2,70,12,0
42451,62,2102,421,273,302,44,34,57,465,17,81,59,107,98,166,583,1098,11,12329,684,0,2,70,12,0
42452,20,1004,386,256,301,16,9,68,402,4,59,35,69,63,104,355,621,2,1453,80,0,2,3,3,0
42453,20,1004,264,131,164,11,41,46,275,6,38,22,40,44,62,214,338,3,1068,59,0,2,3,3,0
42454,81,2060,466,257,367,18,25,50,484,7,126,86,171,133,257,898,1813,4,8612,478,0,2,8,1,0
42455,81,2060,507,281,342,29,59,88,536,10,53,29,57,63,86,336,514,5,2764,153,0,2,8,1,0
42456,102,3170,773,419,590,28,0,166,801,10,204,113,217,214,330,1598,2554,5,13587,754,0,2,16,0,0
42457,64,3430,722,423,573,19,0,135,741,12,172,101,199,184,300,1320,2257,6,15668,870,0,2,69,65,0
42458,46,1995,386,256,301,16,9,68,402,4,59,35,69,63,104,355,621,2,1453,80,0,2,61,57,0
42459,87,3572,1043,504,840,53,9,147,1096,9,180,112,198,189,310,1377,2344,4,11604,644,0,2,95,74,0
42460,262,6287,4293,999,3693,19,54,507,4312,9,155,88,170,164,258,1156,1898,4,9368,520,0,2,3,56,0
42461,262,6287,1482,859,1002,125,135,219,1607,16,219,134,251,235,385,1766,3032,9,27804,1544,1,2,3,56,0
42462,185,8003,4293,999,3693,19,54,507,4312,9,155,88,170,164,258,1156,1898,4,9368,520,0,2,0,132,0
42463,185,8003,1482,859,1002,125,135,219,1607,16,219,134,251,235,385,1766,3032,9,27804,1544,1,2,0,132,0
42464,113,2328,463,295,324,28,62,57,491,12,134,82,154,146,236,989,1696,6,11700,650,0,2,4,4,0
42465,37,822,167,116,138,4,5,22,171,8,48,30,56,56,86,292,499,4,2330,129,0,2,2,5,0
42466,105,2787,1455,414,1257,16,76,112,1471,5,41,23,46,46,69,231,381,2,1069,59,0,2,1,1,0
42467,105,2787,669,365,481,22,61,110,691,15,103,63,122,118,185,747,1273,8,11311,628,0,2,1,1,0
42468,262,6279,4293,999,3693,19,54,507,4312,9,155,88,170,164,258,1156,1898,4,9368,520,0,2,4,7,0
42469,262,6279,1482,859,1002,125,135,219,1607,16,219,134,251,235,385,1766,3032,9,27804,1544,1,2,4,7,0
42470,145,3560,77,34,69,0,0,8,77,3,24,16,29,27,45,114,213,1,387,21,0,2,4,4,0
42471,145,3560,712,438,573,51,9,84,763,14,102,71,128,116,199,733,1364,8,11988,666,0,2,4,4,0
42472,55,1890,53,23,39,0,0,13,53,2,8,4,8,10,12,26,39,1,39,2,0,2,0,1,0
42473,55,1890,515,298,307,33,80,99,548,12,63,44,77,75,121,419,753,7,5527,307,0,2,0,1,0
42474,89,3918,1338,495,1086,10,64,173,1348,11,122,82,157,133,239,883,1686,7,11934,663,0,2,3,3,0
42475,22,666,424,94,331,4,0,89,428,1,5,5,5,6,10,11,25,0,12,0,0,2,14,0,0
42476,113,2328,463,295,324,28,62,57,491,12,134,82,154,146,236,989,1696,6,11700,650,0,2,4,4,0
42477,37,822,167,116,138,4,5,22,171,8,48,30,56,56,86,292,499,4,2330,129,0,2,2,5,0
42478,105,2787,1455,414,1257,16,76,112,1471,5,41,23,46,46,69,231,381,2,1069,59,0,2,1,1,0
42479,105,2787,669,365,481,22,61,110,691,15,103,63,122,118,185,747,1273,8,11311,628,0,2,1,1,0
42480,262,6279,4293,999,3693,19,54,507,4312,9,155,88,170,164,258,1156,1898,4,9368,520,0,2,4,7,0
42481,262,6279,1482,859,1002,125,135,219,1607,16,219,134,251,235,385,1766,3032,9,27804,1544,1,2,4,7,0
42482,145,3560,77,34,69,0,0,8,77,3,24,16,29,27,45,114,213,1,387,21,0,2,4,4,0
42483,145,3560,712,438,573,51,9,84,763,14,102,71,128,116,199,733,1364,8,11988,666,0,2,4,4,0
42484,55,1890,53,23,39,0,0,13,53,2,8,4,8,10,12,26,39,1,39,2,0,2,0,1,0
42485,55,1890,515,298,307,33,80,99,548,12,63,44,77,75,121,419,753,7,5527,307,0,2,0,1,0
42486,89,3918,1338,495,1086,10,64,173,1348,11,122,82,157,133,239,883,1686,7,11934,663,0,2,3,3,0
42487,22,666,424,94,331,4,0,89,428,1,5,5,5,6,10,11,25,0,12,0,0,2,14,0,0
42488,186,5566,182,127,129,0,0,53,182,5,39,21,42,44,63,217,343,2,926,51,0,2,3,2,0
42489,186,5566,1165,710,800,67,119,181,1232,18,243,153,282,261,435,2000,3492,10,36473,2026,1,2,3,2,0
42490,62,2105,773,419,590,28,0,166,801,10,204,113,217,214,330,1598,2554,5,13587,754,0,2,1,1,1
42491,62,2105,421,273,302,44,34,57,465,17,81,59,107,98,166,583,1098,11,12329,684,0,2,1,1,1
42492,186,5566,182,127,129,0,0,53,182,5,39,21,42,44,63,217,343,2,926,51,0,2,3,2,0
42493,186,5566,1165,710,800,67,119,181,1232,18,243,153,282,261,435,2000,3492,10,36473,2026,1,2,3,2,0
42494,51,3916,996,429,845,24,10,117,1020,7,76,50,88,83,138,494,879,4,3565,198,0,2,2,0,0
42495,51,3916,996,429,845,24,10,117,1020,7,76,50,88,83,138,494,879,4,3565,198,0,2,2,0,0
42496,228,6422,722,423,573,19,0,135,741,12,172,101,199,184,300,1320,2257,6,15668,870,0,2,2,0,0
42497,228,6422,1508,847,911,44,250,301,1552,14,148,88,169,162,257,1120,1886,7,15077,837,0,2,2,0,0
42498,64,3443,722,423,573,19,0,135,741,12,172,101,199,184,300,1320,2257,6,15668,870,0,2,3,1,0
42499,87,3578,1043,504,840,53,9,147,1096,9,180,112,198,189,310,1377,2344,4,11604,644,0,2,8,6,0
42500,87,3578,1043,504,840,53,9,147,1096,9,180,112,198,189,310,1377,2344,4,11604,644,0,2,8,6,0
42501,228,6422,722,423,573,19,0,135,741,12,172,101,199,184,300,1320,2257,6,15668,870,0,2,2,0,0
42502,228,6422,1508,847,911,44,250,301,1552,14,148,88,169,162,257,1120,1886,7,15077,837,0,2,2,0,0
42503,64,3443,722,423,573,19,0,135,741,12,172,101,199,184,300,1320,2257,6,15668,870,0,2,3,1,0
42504,145,3599,77,34,69,0,0,8,77,3,24,16,29,27,45,114,213,1,387,21,0,2,16,5,0
42505,145,3599,712,438,573,51,9,84,763,14,102,71,128,116,199,733,1364,8,11988,666,0,2,16,5,0
42506,145,3599,77,34,69,0,0,8,77,3,24,16,29,27,45,114,213,1,387,21,0,2,16,5,0
42507,145,3599,712,438,573,51,9,84,763,14,102,71,128,116,199,733,1364,8,11988,666,0,2,16,5,0
42508,22,703,424,94,331,4,0,89,428,1,5,5,5,6,10,11,25,0,12,0,0,2,33,3,0
42509,113,2328,463,295,324,28,62,57,491,12,134,82,154,146,236,989,1696,6,11700,650,0,2,4,4,1
42510,37,865,167,116,138,4,5,22,171,8,48,30,56,56,86,292,499,4,2330,129,0,2,5,2,1
42511,105,2791,1455,414,1257,16,76,112,1471,5,41,23,46,46,69,231,381,2,1069,59,0,2,1,1,1
42512,105,2791,669,365,481,22,61,110,691,15,103,63,122,118,185,747,1273,8,11311,628,0,2,1,1,1
42513,262,6287,4293,999,3693,19,54,507,4312,9,155,88,170,164,258,1156,1898,4,9368,520,0,2,7,4,1
42514,262,6287,1482,859,1002,125,135,219,1607,16,219,134,251,235,385,1766,3032,9,27804,1544,1,2,7,4,1
42515,145,3614,77,34,69,0,0,8,77,3,24,16,29,27,45,114,213,1,387,21,0,2,4,4,1
42516,145,3614,712,438,573,51,9,84,763,14,102,71,128,116,199,733,1364,8,11988,666,0,2,4,4,1
42517,55,1909,53,23,39,0,0,13,53,2,8,4,8,10,12,26,39,1,39,2,0,2,1,0,1
42518,55,1909,515,298,307,33,80,99,548,12,63,44,77,75,121,419,753,7,5527,307,0,2,1,0,1
42519,56,1916,53,23,39,0,0,13,53,2,8,4,8,10,12,26,39,1,39,2,0,2,4,2,0
42520,56,1916,515,298,307,33,80,99,548,12,63,44,77,75,121,419,753,7,5527,307,0,2,4,2,0
42521,22,710,424,94,331,4,0,89,428,1,5,5,5,6,10,11,25,0,12,0,0,2,4,1,0
42522,53,1539,207,111,150,11,0,50,218,5,26,19,36,31,55,133,272,3,943,52,0,2,1,1,0
42523,53,1539,410,198,237,31,55,97,441,11,63,38,72,74,110,414,683,6,4293,238,0,2,1,1,0
42524,299,6679,72,33,56,0,4,12,72,1,1,1,1,2,2,0,2,0,1,0,0,2,6,4,0
42525,299,6679,1454,835,1044,76,110,219,1530,17,275,158,296,292,454,2297,3718,9,34017,1889,1,2,6,4,0
42526,114,5837,1523,757,1297,19,12,193,1542,12,193,117,230,205,347,1508,2664,7,19053,1058,0,2,2,1,0
42527,114,5837,1523,757,1297,19,12,193,1542,12,193,117,230,205,347,1508,2664,7,19053,1058,0,2,2,1,0
42528,89,3913,1338,495,1086,10,64,173,1348,11,122,82,157,133,239,883,1686,7,11934,663,0,2,5,5,0
42529,127,5419,1450,624,1228,12,26,181,1462,14,306,186,354,320,540,2580,4493,8,36391,2021,1,2,1,1,0
42530,51,3915,996,429,845,24,10,117,1020,7,76,50,88,83,138,494,879,4,3565,198,0,2,1,1,0
42531,114,5832,1523,757,1297,19,12,193,1542,12,193,117,230,205,347,1508,2664,7,19053,1058,0,2,4,4,0
42532,30,1920,384,251,317,7,8,52,391,11,70,44,84,81,128,467,811,6,5355,297,0,2,1,1,0
42533,89,3913,1338,495,1086,10,64,173,1348,11,122,82,157,133,239,883,1686,7,11934,663,0,2,5,5,0
42534,127,5419,1450,624,1228,12,26,181,1462,14,306,186,354,320,540,2580,4493,8,36391,2021,1,2,1,1,0
42535,51,3915,996,429,845,24,10,117,1020,7,76,50,88,83,138,494,879,4,3565,198,0,2,1,1,0
42536,114,5832,1523,757,1297,19,12,193,1542,12,193,117,230,205,347,1508,2664,7,19053,1058,0,2,4,4,0
42537,30,1920,384,251,317,7,8,52,391,11,70,44,84,81,128,467,811,6,5355,297,0,2,1,1,0
42538,112,6130,1457,730,1242,11,6,188,1468,10,292,166,329,302,495,2424,4078,5,22973,1276,1,2,26,0,0
42539,300,6694,72,33,56,0,4,12,72,1,1,1,1,2,2,0,2,0,1,0,0,2,6,1,0
42540,300,6694,1454,835,1044,76,110,219,1530,17,275,158,296,292,454,2297,3718,9,34017,1889,1,2,6,1,0
42541,62,2105,773,419,590,28,0,166,801,10,204,113,217,214,330,1598,2554,5,13587,754,0,2,1,1,0
42542,62,2105,421,273,302,44,34,57,465,17,81,59,107,98,166,583,1098,11,12329,684,0,2,1,1,0
42543,56,1923,53,23,39,0,0,13,53,2,8,4,8,10,12,26,39,1,39,2,0,2,6,5,0
42544,56,1923,515,298,307,33,80,99,548,12,63,44,77,75,121,419,753,7,5527,307,0,2,6,5,0
42545,53,1539,207,111,150,11,0,50,218,5,26,19,36,31,55,133,272,3,943,52,0,2,1,1,0
42546,53,1539,410,198,237,31,55,97,441,11,63,38,72,74,110,414,683,6,4293,238,0,2,1,1,0
42547,113,2328,463,295,324,28,62,57,491,12,134,82,154,146,236,989,1696,6,11700,650,0,2,4,4,0
42548,37,865,167,116,138,4,5,22,171,8,48,30,56,56,86,292,499,4,2330,129,0,2,5,2,0
42549,105,2791,1455,414,1257,16,76,112,1471,5,41,23,46,46,69,231,381,2,1069,59,0,2,1,1,0
42550,105,2791,669,365,481,22,61,110,691,15,103,63,122,118,185,747,1273,8,11311,628,0,2,1,1,0
42551,262,6287,4293,999,3693,19,54,507,4312,9,155,88,170,164,258,1156,1898,4,9368,520,0,2,7,4,0
42552,262,6287,1482,859,1002,125,135,219,1607,16,219,134,251,235,385,1766,3032,9,27804,1544,1,2,7,4,0
42553,145,3614,77,34,69,0,0,8,77,3,24,16,29,27,45,114,213,1,387,21,0,2,4,4,0
42554,145,3614,712,438,573,51,9,84,763,14,102,71,128,116,199,733,1364,8,11988,666,0,2,4,4,0
42555,56,1923,53,23,39,0,0,13,53,2,8,4,8,10,12,26,39,1,39,2,0,2,6,2,0
42556,56,1923,515,298,307,33,80,99,548,12,63,44,77,75,121,419,753,7,5527,307,0,2,6,2,0
42557,300,6694,72,33,56,0,4,12,72,1,1,1,1,2,2,0,2,0,1,0,0,2,12,5,0
42558,300,6694,1454,835,1044,76,110,219,1530,17,275,158,296,292,454,2297,3718,9,34017,1889,1,2,12,5,0
42559,22,710,424,94,331,4,0,89,428,1,5,5,5,6,10,11,25,0,12,0,0,2,37,4,0
42560,186,5528,182,127,129,0,0,53,182,5,39,21,42,44,63,217,343,2,926,51,0,2,12,11,0
42561,186,5528,1165,710,800,67,119,181,1232,18,243,153,282,261,435,2000,3492,10,36473,2026,1,2,12,11,0
42562,88,2118,996,429,845,24,10,117,1020,7,76,50,88,83,138,494,879,4,3565,198,0,2,2,1,0
42563,88,2118,456,277,329,12,42,72,468,13,85,50,97,98,147,592,972,7,7212,400,0,2,2,1,0
42564,244,5153,2,2,2,0,0,0,2,0,0,0,0,0,0,0,0,0,0,0,0,2,5,4,0
42565,244,5153,99,48,90,1,3,5,100,0,0,0,0,0,0,0,0,0,0,0,0,2,5,4,0
42566,244,5153,8,5,5,2,0,1,10,0,0,0,0,0,0,0,0,0,0,0,0,2,5,4,0
42567,244,5153,1217,716,841,84,126,174,1301,14,185,118,215,199,333,1446,2542,8,20687,1149,0,2,5,4,0
42568,244,5153,160,89,115,0,13,31,160,7,15,11,17,22,28,78,124,3,495,27,0,2,5,4,0
42569,244,5153,10,10,9,9,0,0,19,0,0,0,0,0,0,0,0,0,0,0,0,2,5,4,0
42570,244,5153,173,84,99,8,29,36,181,5,12,7,13,17,20,54,81,2,221,12,0,2,5,4,0
42571,244,5153,3,1,1,3,0,0,6,0,0,0,0,0,0,0,0,0,0,0,0,2,5,4,0
42572,105,2795,1455,414,1257,16,76,112,1471,5,41,23,46,46,69,231,381,2,1069,59,0,2,3,2,0
42573,105,2795,669,365,481,22,61,110,691,15,103,63,122,118,185,747,1273,8,11311,628,0,2,3,2,0
42574,262,6289,4293,999,3693,19,54,507,4312,9,155,88,170,164,258,1156,1898,4,9368,520,0,2,2,1,0
42575,262,6289,1482,859,1002,125,135,219,1607,16,219,134,251,235,385,1766,3032,9,27804,1544,1,2,2,1,0
42576,81,2062,466,257,367,18,25,50,484,7,126,86,171,133,257,898,1813,4,8612,478,0,2,2,1,0
42577,81,2062,507,281,342,29,59,88,536,10,53,29,57,63,86,336,514,5,2764,153,0,2,2,1,0
42578,143,6921,1392,870,1177,35,17,170,1427,14,494,280,531,508,811,4473,7289,7,54850,3047,2,2,4,3,0
42579,3,495,149,67,118,4,0,27,153,1,17,14,28,18,42,69,175,0,144,8,0,2,3,4,0
42580,186,5528,182,127,129,0,0,53,182,5,39,21,42,44,63,217,343,2,926,51,0,2,12,11,0
42581,186,5528,1165,710,800,67,119,181,1232,18,243,153,282,261,435,2000,3492,10,36473,2026,1,2,12,11,0
42582,88,2118,996,429,845,24,10,117,1020,7,76,50,88,83,138,494,879,4,3565,198,0,2,2,1,0
42583,88,2118,456,277,329,12,42,72,468,13,85,50,97,98,147,592,972,7,7212,400,0,2,2,1,0
42584,244,5153,2,2,2,0,0,0,2,0,0,0,0,0,0,0,0,0,0,0,0,2,5,4,0
42585,244,5153,99,48,90,1,3,5,100,0,0,0,0,0,0,0,0,0,0,0,0,2,5,4,0
42586,244,5153,8,5,5,2,0,1,10,0,0,0,0,0,0,0,0,0,0,0,0,2,5,4,0
42587,244,5153,1217,716,841,84,126,174,1301,14,185,118,215,199,333,1446,2542,8,20687,1149,0,2,5,4,0
42588,244,5153,160,89,115,0,13,31,160,7,15,11,17,22,28,78,124,3,495,27,0,2,5,4,0
42589,244,5153,10,10,9,9,0,0,19,0,0,0,0,0,0,0,0,0,0,0,0,2,5,4,0
42590,244,5153,173,84,99,8,29,36,181,5,12,7,13,17,20,54,81,2,221,12,0,2,5,4,0
42591,244,5153,3,1,1,3,0,0,6,0,0,0,0,0,0,0,0,0,0,0,0,2,5,4,0
42592,105,2795,1455,414,1257,16,76,112,1471,5,41,23,46,46,69,231,381,2,1069,59,0,2,3,2,0
42593,105,2795,669,365,481,22,61,110,691,15,103,63,122,118,185,747,1273,8,11311,628,0,2,3,2,0
42594,262,6289,4293,999,3693,19,54,507,4312,9,155,88,170,164,258,1156,1898,4,9368,520,0,2,2,1,0
42595,262,6289,1482,859,1002,125,135,219,1607,16,219,134,251,235,385,1766,3032,9,27804,1544,1,2,2,1,0
42596,81,2062,466,257,367,18,25,50,484,7,126,86,171,133,257,898,1813,4,8612,478,0,2,2,1,0
42597,81,2062,507,281,342,29,59,88,536,10,53,29,57,63,86,336,514,5,2764,153,0,2,2,1,0
42598,143,6921,1392,870,1177,35,17,170,1427,14,494,280,531,508,811,4473,7289,7,54850,3047,2,2,4,3,0
42599,3,495,149,67,118,4,0,27,153,1,17,14,28,18,42,69,175,0,144,8,0,2,3,4,0
42600,144,7018,1392,870,1177,35,17,170,1427,14,494,280,531,508,811,4473,7289,7,54850,3047,2,2,33,7,0
42601,186,8037,4293,999,3693,19,54,507,4312,9,155,88,170,164,258,1156,1898,4,9368,520,0,2,35,0,0
42602,186,8037,1482,859,1002,125,135,219,1607,16,219,134,251,235,385,1766,3032,9,27804,1544,1,2,35,0,0
42603,186,8037,4293,999,3693,19,54,507,4312,9,155,88,170,164,258,1156,1898,4,9368,520,0,2,35,0,0
42604,186,8037,1482,859,1002,125,135,219,1607,16,219,134,251,235,385,1766,3032,9,27804,1544,1,2,35,0,0
42605,144,7018,1392,870,1177,35,17,170,1427,14,494,280,531,508,811,4473,7289,7,54850,3047,2,2,33,7,0
42606,161,3439,1513,682,1277,25,13,200,1538,11,199,116,219,210,335,1557,2584,6,15641,868,0,2,1,1,0
42607,161,3439,819,519,539,24,98,155,843,15,96,57,106,111,163,690,1107,8,9171,509,0,2,1,1,0
42608,118,5010,1513,682,1277,25,13,200,1538,11,199,116,219,210,335,1557,2584,6,15641,868,0,2,5,0,0
42609,161,3439,1513,682,1277,25,13,200,1538,11,199,116,219,210,335,1557,2584,6,15641,868,0,2,1,1,0
42610,161,3439,819,519,539,24,98,155,843,15,96,57,106,111,163,690,1107,8,9171,509,0,2,1,1,0
42611,118,5010,1513,682,1277,25,13,200,1538,11,199,116,219,210,335,1557,2584,6,15641,868,0,2,5,0,0
42612,145,3612,77,34,69,0,0,8,77,3,24,16,29,27,45,114,213,1,387,21,0,2,2,2,0
42613,145,3612,712,438,573,51,9,84,763,14,102,71,128,116,199,733,1364,8,11988,666,0,2,2,2,0
42614,145,3612,77,34,69,0,0,8,77,3,24,16,29,27,45,114,213,1,387,21,0,2,2,2,0
42615,145,3612,712,438,573,51,9,84,763,14,102,71,128,116,199,733,1364,8,11988,666,0,2,2,2,0
42616,112,6130,1457,730,1242,11,6,188,1468,10,292,166,329,302,495,2424,4078,5,22973,1276,1,2,26,0,0
42617,145,3620,77,34,69,0,0,8,77,3,24,16,29,27,45,114,213,1,387,21,0,2,1,1,0
42618,145,3620,712,438,573,51,9,84,763,14,102,71,128,116,199,733,1364,8,11988,666,0,2,1,1,0
42619,300,6703,72,33,56,0,4,12,72,1,1,1,1,2,2,0,2,0,1,0,0,2,2,2,0
42620,300,6703,1454,835,1044,76,110,219,1530,17,275,158,296,292,454,2297,3718,9,34017,1889,1,2,2,2,0
42621,162,3459,1513,682,1277,25,13,200,1538,11,199,116,219,210,335,1557,2584,6,15641,868,0,2,3,3,1
42622,162,3459,819,519,539,24,98,155,843,15,96,57,106,111,163,690,1107,8,9171,509,0,2,3,3,1
42623,119,5094,1513,682,1277,25,13,200,1538,11,199,116,219,210,335,1557,2584,6,15641,868,0,2,12,0,1
42624,42,2587,1157,318,931,29,22,177,1186,6,104,63,125,110,188,712,1274,3,4596,255,0,2,1,1,0
42625,300,6695,72,33,56,0,4,12,72,1,1,1,1,2,2,0,2,0,1,0,0,2,12,4,0
42626,300,6695,1454,835,1044,76,110,219,1530,17,275,158,296,292,454,2297,3718,9,34017,1889,1,2,12,4,0
42627,300,6695,72,33,56,0,4,12,72,1,1,1,1,2,2,0,2,0,1,0,0,2,1,1,0
42628,300,6695,1454,835,1044,76,110,219,1530,17,275,158,296,292,454,2297,3718,9,34017,1889,1,2,1,1,0
42629,137,3410,77,34,69,0,0,8,77,3,24,16,29,27,45,114,213,1,387,21,0,2,1,38,0
42630,137,3410,712,438,573,51,9,84,763,14,102,71,128,116,199,733,1364,8,11988,666,0,2,1,38,0
42631,65,2152,53,23,39,0,0,13,53,2,8,4,8,10,12,26,39,1,39,2,0,2,41,0,0
42632,65,2152,515,298,307,33,80,99,548,12,63,44,77,75,121,419,753,7,5527,307,0,2,41,0,0
42633,294,6553,72,33,56,0,4,12,72,1,1,1,1,2,2,0,2,0,1,0,0,2,1,26,0
42634,294,6553,1454,835,1044,76,110,219,1530,17,275,158,296,292,454,2297,3718,9,34017,1889,1,2,1,26,0
42635,42,2587,1157,318,931,29,22,177,1186,6,104,63,125,110,188,712,1274,3,4596,255,0,2,1,1,0
42636,162,3473,1513,682,1277,25,13,200,1538,11,199,116,219,210,335,1557,2584,6,15641,868,0,2,7,8,1
42637,162,3473,819,519,539,24,98,155,843,15,96,57,106,111,163,690,1107,8,9171,509,0,2,7,8,1
42638,119,5100,1513,682,1277,25,13,200,1538,11,199,116,219,210,335,1557,2584,6,15641,868,0,2,2,1,1
42639,119,5113,1513,682,1277,25,13,200,1538,11,199,116,219,210,335,1557,2584,6,15641,868,0,2,2,1,0
42640,119,7063,1943,715,1694,26,18,214,1969,12,185,120,237,197,357,1436,2721,7,20915,1161,0,2,9,0,0
42641,162,3471,1513,682,1277,25,13,200,1538,11,199,116,219,210,335,1557,2584,6,15641,868,0,2,7,7,0
42642,162,3471,819,519,539,24,98,155,843,15,96,57,106,111,163,690,1107,8,9171,509,0,2,7,7,0
42643,66,3522,722,423,573,19,0,135,741,12,172,101,199,184,300,1320,2257,6,15668,870,0,2,10,0,0
42644,119,7063,1943,715,1694,26,18,214,1969,12,185,120,237,197,357,1436,2721,7,20915,1161,0,2,9,0,0
42645,137,3416,77,34,69,0,0,8,77,3,24,16,29,27,45,114,213,1,387,21,0,2,1,1,0
42646,137,3416,712,438,573,51,9,84,763,14,102,71,128,116,199,733,1364,8,11988,666,0,2,1,1,0
42647,65,2176,53,23,39,0,0,13,53,2,8,4,8,10,12,26,39,1,39,2,0,2,6,3,0
42648,65,2176,515,298,307,33,80,99,548,12,63,44,77,75,121,419,753,7,5527,307,0,2,6,3,0
42649,294,6559,72,33,56,0,4,12,72,1,1,1,1,2,2,0,2,0,1,0,0,2,1,1,0
42650,294,6559,1454,835,1044,76,110,219,1530,17,275,158,296,292,454,2297,3718,9,34017,1889,1,2,1,1,0
42651,162,3471,1513,682,1277,25,13,200,1538,11,199,116,219,210,335,1557,2584,6,15641,868,0,2,11,12,0
42652,162,3471,819,519,539,24,98,155,843,15,96,57,106,111,163,690,1107,8,9171,509,0,2,11,12,0
42653,119,5113,1513,682,1277,25,13,200,1538,11,199,116,219,210,335,1557,2584,6,15641,868,0,2,15,1,0
42654,228,6434,722,423,573,19,0,135,741,12,172,101,199,184,300,1320,2257,6,15668,870,0,2,4,3,0
42655,228,6434,1508,847,911,44,250,301,1552,14,148,88,169,162,257,1120,1886,7,15077,837,0,2,4,3,0
42656,225,6470,722,423,573,19,0,135,741,12,172,101,199,184,300,1320,2257,6,15668,870,0,2,10,3,0
42657,225,6470,1508,847,911,44,250,301,1552,14,148,88,169,162,257,1120,1886,7,15077,837,0,2,10,3,0
42658,244,5157,2,2,2,0,0,0,2,0,0,0,0,0,0,0,0,0,0,0,0,2,7,0,0
42659,244,5157,99,48,90,1,3,5,100,0,0,0,0,0,0,0,0,0,0,0,0,2,7,0,0
42660,244,5157,8,5,5,2,0,1,10,0,0,0,0,0,0,0,0,0,0,0,0,2,7,0,0
42661,244,5157,1217,716,841,84,126,174,1301,14,185,118,215,199,333,1446,2542,8,20687,1149,0,2,7,0,0
42662,244,5157,160,89,115,0,13,31,160,7,15,11,17,22,28,78,124,3,495,27,0,2,7,0,0
42663,244,5157,10,10,9,9,0,0,19,0,0,0,0,0,0,0,0,0,0,0,0,2,7,0,0
42664,244,5157,173,84,99,8,29,36,181,5,12,7,13,17,20,54,81,2,221,12,0,2,7,0,0
42665,244,5157,3,1,1,3,0,0,6,0,0,0,0,0,0,0,0,0,0,0,0,2,7,0,0
42666,225,6476,722,423,573,19,0,135,741,12,172,101,199,184,300,1320,2257,6,15668,870,0,2,2,1,0
42667,225,6476,1508,847,911,44,250,301,1552,14,148,88,169,162,257,1120,1886,7,15077,837,0,2,2,1,0
42668,87,5086,1296,573,1062,40,33,157,1336,8,201,118,231,209,349,1561,2689,4,12365,686,0,2,8,4,0
42669,244,5157,2,2,2,0,0,0,2,0,0,0,0,0,0,0,0,0,0,0,0,2,7,0,0
42670,244,5157,99,48,90,1,3,5,100,0,0,0,0,0,0,0,0,0,0,0,0,2,7,0,0
42671,244,5157,8,5,5,2,0,1,10,0,0,0,0,0,0,0,0,0,0,0,0,2,7,0,0
42672,244,5157,1217,716,841,84,126,174,1301,14,185,118,215,199,333,1446,2542,8,20687,1149,0,2,7,0,0
42673,244,5157,160,89,115,0,13,31,160,7,15,11,17,22,28,78,124,3,495,27,0,2,7,0,0
42674,244,5157,10,10,9,9,0,0,19,0,0,0,0,0,0,0,0,0,0,0,0,2,7,0,0
42675,244,5157,173,84,99,8,29,36,181,5,12,7,13,17,20,54,81,2,221,12,0,2,7,0,0
42676,244,5157,3,1,1,3,0,0,6,0,0,0,0,0,0,0,0,0,0,0,0,2,7,0,0
42677,225,6476,722,423,573,19,0,135,741,12,172,101,199,184,300,1320,2257,6,15668,870,0,2,14,5,0
42678,225,6476,1508,847,911,44,250,301,1552,14,148,88,169,162,257,1120,1886,7,15077,837,0,2,14,5,0
42679,87,5086,1296,573,1062,40,33,157,1336,8,201,118,231,209,349,1561,2689,4,12365,686,0,2,8,4,0
42680,80,1976,757,253,292,73,244,162,830,13,61,38,67,74,105,409,651,7,4654,258,0,2,1,1,0
42681,186,5527,182,127,129,0,0,53,182,5,39,21,42,44,63,217,343,2,926,51,0,2,2,3,0
42682,186,5527,1165,710,800,67,119,181,1232,18,243,153,282,261,435,2000,3492,10,36473,2026,1,2,2,3,0
42683,186,5527,182,127,129,0,0,53,182,5,39,21,42,44,63,217,343,2,926,51,0,2,2,3,0
42684,186,5527,1165,710,800,67,119,181,1232,18,243,153,282,261,435,2000,3492,10,36473,2026,1,2,2,3,0
42685,80,1976,757,253,292,73,244,162,830,13,61,38,67,74,105,409,651,7,4654,258,0,2,1,1,0
42686,120,7094,1943,715,1694,26,18,214,1969,12,185,120,237,197,357,1436,2721,7,20915,1161,0,2,14,7,0
42687,262,6283,4293,999,3693,19,54,507,4312,9,155,88,170,164,258,1156,1898,4,9368,520,0,2,3,2,0
42688,262,6283,1482,859,1002,125,135,219,1607,16,219,134,251,235,385,1766,3032,9,27804,1544,1,2,3,2,0
42689,186,8102,4293,999,3693,19,54,507,4312,9,155,88,170,164,258,1156,1898,4,9368,520,0,2,18,1,0
42690,186,8102,1482,859,1002,125,135,219,1607,16,219,134,251,235,385,1766,3032,9,27804,1544,1,2,18,1,0
42691,262,6280,4293,999,3693,19,54,507,4312,9,155,88,170,164,258,1156,1898,4,9368,520,0,2,1,2,0
42692,262,6280,1482,859,1002,125,135,219,1607,16,219,134,251,235,385,1766,3032,9,27804,1544,1,2,1,2,0
42693,51,1103,447,308,343,6,5,95,453,7,96,59,111,103,170,651,1136,4,4600,255,0,2,2,1,0
42694,51,1103,322,174,179,16,74,51,338,10,41,26,46,51,72,252,408,5,2291,127,0,2,2,1,0
42695,262,6289,4293,999,3693,19,54,507,4312,9,155,88,170,164,258,1156,1898,4,9368,520,0,2,3,1,0
42696,262,6289,1482,859,1002,125,135,219,1607,16,219,134,251,235,385,1766,3032,9,27804,1544,1,2,3,1,0
42697,187,8092,4293,999,3693,19,54,507,4312,9,155,88,170,164,258,1156,1898,4,9368,520,0,2,32,0,0
42698,187,8092,1482,859,1002,125,135,219,1607,16,219,134,251,235,385,1766,3032,9,27804,1544,1,2,32,0,0
42699,262,6280,4293,999,3693,19,54,507,4312,9,155,88,170,164,258,1156,1898,4,9368,520,0,2,4,4,0
42700,262,6280,1482,859,1002,125,135,219,1607,16,219,134,251,235,385,1766,3032,9,27804,1544,1,2,4,4,0
42701,186,8102,4293,999,3693,19,54,507,4312,9,155,88,170,164,258,1156,1898,4,9368,520,0,2,18,1,0
42702,186,8102,1482,859,1002,125,135,219,1607,16,219,134,251,235,385,1766,3032,9,27804,1544,1,2,18,1,0
42703,51,1103,447,308,343,6,5,95,453,7,96,59,111,103,170,651,1136,4,4600,255,0,2,2,1,0
42704,51,1103,322,174,179,16,74,51,338,10,41,26,46,51,72,252,408,5,2291,127,0,2,2,1,0
42705,262,6280,4293,999,3693,19,54,507,4312,9,155,88,170,164,258,1156,1898,4,9368,520,0,2,3,1,0
42706,262,6280,1482,859,1002,125,135,219,1607,16,219,134,251,235,385,1766,3032,9,27804,1544,1,2,3,1,0
42707,187,8157,4293,999,3693,19,54,507,4312,9,155,88,170,164,258,1156,1898,4,9368,520,0,2,32,0,0
42708,187,8157,1482,859,1002,125,135,219,1607,16,219,134,251,235,385,1766,3032,9,27804,1544,1,2,32,0,0
42709,66,3522,722,423,573,19,0,135,741,12,172,101,199,184,300,1320,2257,6,15668,870,0,2,10,0,0
42710,33,1148,182,127,129,0,0,53,182,5,39,21,42,44,63,217,343,2,926,51,0,2,33,0,0
42711,100,3049,773,419,590,28,0,166,801,10,204,113,217,214,330,1598,2554,5,13587,754,0,2,0,30,0
42712,33,1151,182,127,129,0,0,53,182,5,39,21,42,44,63,217,343,2,926,51,0,2,1,1,0
42713,120,7094,1943,715,1694,26,18,214,1969,12,185,120,237,197,357,1436,2721,7,20915,1161,0,2,14,7,0
42714,33,1151,182,127,129,0,0,53,182,5,39,21,42,44,63,217,343,2,926,51,0,2,33,0,0
42715,100,3049,773,419,590,28,0,166,801,10,204,113,217,214,330,1598,2554,5,13587,754,0,2,0,30,0
42716,33,1085,182,127,129,0,0,53,182,5,39,21,42,44,63,217,343,2,926,51,0,2,24,23,0
42717,15,391,105,62,62,2,14,27,107,4,12,8,12,16,20,51,80,2,160,8,0,2,1,1,0
42718,33,1085,182,127,129,0,0,53,182,5,39,21,42,44,63,217,343,2,926,51,0,2,24,23,0
42719,15,391,105,62,62,2,14,27,107,4,12,8,12,16,20,51,80,2,160,8,0,2,1,1,0
42720,31,944,182,127,129,0,0,53,182,5,39,21,42,44,63,217,343,2,926,51,0,2,0,33,0
42721,102,3186,773,419,590,28,0,166,801,10,204,113,217,214,330,1598,2554,5,13587,754,0,2,31,1,0
42722,15,391,105,62,62,2,14,27,107,4,12,8,12,16,20,51,80,2,160,8,0,2,3,1,0
42723,31,944,182,127,129,0,0,53,182,5,39,21,42,44,63,217,343,2,926,51,0,2,0,33,0
42724,102,3186,773,419,590,28,0,166,801,10,204,113,217,214,330,1598,2554,5,13587,754,0,2,31,1,0
42725,15,391,105,62,62,2,14,27,107,4,12,8,12,16,20,51,80,2,160,8,0,2,3,1,0
42726,137,3416,77,34,69,0,0,8,77,3,24,16,29,27,45,114,213,1,387,21,0,2,2,39,0
42727,137,3416,712,438,573,51,9,84,763,14,102,71,128,116,199,733,1364,8,11988,666,0,2,2,39,0
42728,65,2176,53,23,39,0,0,13,53,2,8,4,8,10,12,26,39,1,39,2,0,2,44,0,0
42729,65,2176,515,298,307,33,80,99,548,12,63,44,77,75,121,419,753,7,5527,307,0,2,44,0,0
42730,294,6559,72,33,56,0,4,12,72,1,1,1,1,2,2,0,2,0,1,0,0,2,14,31,0
42731,294,6559,1454,835,1044,76,110,219,1530,17,275,158,296,292,454,2297,3718,9,34017,1889,1,2,14,31,0
42732,28,617,2,2,2,0,0,0,2,0,0,0,0,0,0,0,0,0,0,0,0,2,5,1,0
42733,28,617,99,48,90,1,3,5,100,0,0,0,0,0,0,0,0,0,0,0,0,2,5,1,0
42734,28,617,8,5,5,2,0,1,10,0,0,0,0,0,0,0,0,0,0,0,0,2,5,1,0
42735,28,617,1217,716,841,84,126,174,1301,14,185,118,215,199,333,1446,2542,8,20687,1149,0,2,5,1,0
42736,28,617,160,89,115,0,13,31,160,7,15,11,17,22,28,78,124,3,495,27,0,2,5,1,0
42737,28,617,10,10,9,9,0,0,19,0,0,0,0,0,0,0,0,0,0,0,0,2,5,1,0
42738,28,617,173,84,99,8,29,36,181,5,12,7,13,17,20,54,81,2,221,12,0,2,5,1,0
42739,28,617,3,1,1,3,0,0,6,0,0,0,0,0,0,0,0,0,0,0,0,2,5,1,0
42740,54,672,647,139,84,35,284,233,682,0,0,0,0,0,0,0,0,0,0,0,0,2,9,1,0
42741,117,2982,773,422,505,30,103,129,803,14,77,46,83,91,129,535,839,7,6334,351,0,2,2,1,0
42742,137,3440,77,34,69,0,0,8,77,3,24,16,29,27,45,114,213,1,387,21,0,2,4,1,0
42743,137,3440,712,438,573,51,9,84,763,14,102,71,128,116,199,733,1364,8,11988,666,0,2,4,1,0
42744,301,6452,1943,715,1694,26,18,214,1969,12,185,120,237,197,357,1436,2721,7,20915,1161,0,2,1,1,0
42745,301,6452,1168,838,957,57,25,144,1225,19,348,224,416,367,640,3018,5452,11,61921,3440,1,2,1,1,0
42746,23,646,601,196,481,2,23,85,603,8,63,36,72,71,108,400,664,4,3036,168,0,2,3,1,0
42747,23,646,156,79,106,5,16,28,161,5,14,8,15,19,23,64,97,2,261,14,0,2,3,1,0
42748,28,617,2,2,2,0,0,0,2,0,0,0,0,0,0,0,0,0,0,0,0,2,5,1,0
42749,28,617,99,48,90,1,3,5,100,0,0,0,0,0,0,0,0,0,0,0,0,2,5,1,0
42750,28,617,8,5,5,2,0,1,10,0,0,0,0,0,0,0,0,0,0,0,0,2,5,1,0
42751,28,617,1217,716,841,84,126,174,1301,14,185,118,215,199,333,1446,2542,8,20687,1149,0,2,5,1,0
42752,28,617,160,89,115,0,13,31,160,7,15,11,17,22,28,78,124,3,495,27,0,2,5,1,0
42753,28,617,10,10,9,9,0,0,19,0,0,0,0,0,0,0,0,0,0,0,0,2,5,1,0
42754,28,617,173,84,99,8,29,36,181,5,12,7,13,17,20,54,81,2,221,12,0,2,5,1,0
42755,28,617,3,1,1,3,0,0,6,0,0,0,0,0,0,0,0,0,0,0,0,2,5,1,0
42756,54,672,647,139,84,35,284,233,682,0,0,0,0,0,0,0,0,0,0,0,0,2,9,1,0
42757,117,2982,773,422,505,30,103,129,803,14,77,46,83,91,129,535,839,7,6334,351,0,2,2,1,0
42758,137,3440,77,34,69,0,0,8,77,3,24,16,29,27,45,114,213,1,387,21,0,2,4,1,0
42759,137,3440,712,438,573,51,9,84,763,14,102,71,128,116,199,733,1364,8,11988,666,0,2,4,1,0
42760,301,6452,1943,715,1694,26,18,214,1969,12,185,120,237,197,357,1436,2721,7,20915,1161,0,2,1,1,0
42761,301,6452,1168,838,957,57,25,144,1225,19,348,224,416,367,640,3018,5452,11,61921,3440,1,2,1,1,0
42762,23,646,601,196,481,2,23,85,603,8,63,36,72,71,108,400,664,4,3036,168,0,2,3,1,0
42763,23,646,156,79,106,5,16,28,161,5,14,8,15,19,23,64,97,2,261,14,0,2,3,1,0
42764,294,6572,72,33,56,0,4,12,72,1,1,1,1,2,2,0,2,0,1,0,0,2,15,12,0
42765,294,6572,1454,835,1044,76,110,219,1530,17,275,158,296,292,454,2297,3718,9,34017,1889,1,2,15,12,0
42766,262,6280,4293,999,3693,19,54,507,4312,9,155,88,170,164,258,1156,1898,4,9368,520,0,2,1,2,0
42767,262,6280,1482,859,1002,125,135,219,1607,16,219,134,251,235,385,1766,3032,9,27804,1544,1,2,1,2,0
42768,53,1539,207,111,150,11,0,50,218,5,26,19,36,31,55,133,272,3,943,52,0,2,5,5,0
42769,53,1539,410,198,237,31,55,97,441,11,63,38,72,74,110,414,683,6,4293,238,0,2,5,5,0
42770,262,6280,4293,999,3693,19,54,507,4312,9,155,88,170,164,258,1156,1898,4,9368,520,0,2,1,2,0
42771,262,6280,1482,859,1002,125,135,219,1607,16,219,134,251,235,385,1766,3032,9,27804,1544,1,2,1,2,0
42772,53,1539,207,111,150,11,0,50,218,5,26,19,36,31,55,133,272,3,943,52,0,2,5,5,0
42773,53,1539,410,198,237,31,55,97,441,11,63,38,72,74,110,414,683,6,4293,238,0,2,5,5,0
42774,294,6572,72,33,56,0,4,12,72,1,1,1,1,2,2,0,2,0,1,0,0,2,15,12,0
42775,294,6572,1454,835,1044,76,110,219,1530,17,275,158,296,292,454,2297,3718,9,34017,1889,1,2,15,12,0
42776,7,464,382,65,130,157,2,92,539,4,10,5,10,14,15,41,57,2,114,6,0,2,1,1,0
42777,294,6565,72,33,56,0,4,12,72,1,1,1,1,2,2,0,2,0,1,0,0,2,1,1,0
42778,294,6565,1454,835,1044,76,110,219,1530,17,275,158,296,292,454,2297,3718,9,34017,1889,1,2,1,1,0
42779,124,3469,77,34,69,0,0,8,77,3,24,16,29,27,45,114,213,1,387,21,0,2,12,7,0
42780,124,3469,712,438,573,51,9,84,763,14,102,71,128,116,199,733,1364,8,11988,666,0,2,12,7,0
42781,124,3511,77,34,69,0,0,8,77,3,24,16,29,27,45,114,213,1,387,21,0,2,8,3,0
42782,124,3511,712,438,573,51,9,84,763,14,102,71,128,116,199,733,1364,8,11988,666,0,2,8,3,0
42783,5,319,77,34,69,0,0,8,77,3,24,16,29,27,45,114,213,1,387,21,0,2,25,0,0
42784,3,97,35,12,22,4,5,6,39,1,2,1,2,3,3,2,4,0,2,0,0,2,6,0,0
42785,63,2130,773,419,590,28,0,166,801,10,204,113,217,214,330,1598,2554,5,13587,754,0,2,8,0,1
42786,63,2130,421,273,302,44,34,57,465,17,81,59,107,98,166,583,1098,11,12329,684,0,2,8,0,1
42787,52,1508,207,111,150,11,0,50,218,5,26,19,36,31,55,133,272,3,943,52,0,2,4,8,1
42788,52,1508,410,198,237,31,55,97,441,11,63,38,72,74,110,414,683,6,4293,238,0,2,4,8,1
42789,262,6282,4293,999,3693,19,54,507,4312,9,155,88,170,164,258,1156,1898,4,9368,520,0,2,1,1,1
42790,262,6282,1482,859,1002,125,135,219,1607,16,219,134,251,235,385,1766,3032,9,27804,1544,1,2,1,1,1
42791,69,1502,402,202,227,24,74,80,426,12,52,33,61,64,94,339,564,7,3969,220,0,2,1,1,1
42792,65,2178,53,23,39,0,0,13,53,2,8,4,8,10,12,26,39,1,39,2,0,2,1,1,1
42793,65,2178,515,298,307,33,80,99,548,12,63,44,77,75,121,419,753,7,5527,307,0,2,1,1,1
42794,294,6567,72,33,56,0,4,12,72,1,1,1,1,2,2,0,2,0,1,0,0,2,1,1,1
42795,294,6567,1454,835,1044,76,110,219,1530,17,275,158,296,292,454,2297,3718,9,34017,1889,1,2,1,1,1
42796,187,5537,182,127,129,0,0,53,182,5,39,21,42,44,63,217,343,2,926,51,0,2,2,0,0
42797,187,5537,1165,710,800,67,119,181,1232,18,243,153,282,261,435,2000,3492,10,36473,2026,1,2,2,0,0
42798,103,3235,773,419,590,28,0,166,801,10,204,113,217,214,330,1598,2554,5,13587,754,0,2,8,0,0
42799,63,2124,773,419,590,28,0,166,801,10,204,113,217,214,330,1598,2554,5,13587,754,0,2,5,6,0
42800,63,2124,421,273,302,44,34,57,465,17,81,59,107,98,166,583,1098,11,12329,684,0,2,5,6,0
42801,52,1512,207,111,150,11,0,50,218,5,26,19,36,31,55,133,272,3,943,52,0,2,2,2,0
42802,52,1512,410,198,237,31,55,97,441,11,63,38,72,74,110,414,683,6,4293,238,0,2,2,2,0
42803,51,1472,207,111,150,11,0,50,218,5,26,19,36,31,55,133,272,3,943,52,0,2,0,7,0
42804,51,1472,410,198,237,31,55,97,441,11,63,38,72,74,110,414,683,6,4293,238,0,2,0,7,0
42805,27,637,2,2,2,0,0,0,2,0,0,0,0,0,0,0,0,0,0,0,0,2,6,4,0
42806,27,637,99,48,90,1,3,5,100,0,0,0,0,0,0,0,0,0,0,0,0,2,6,4,0
42807,27,637,8,5,5,2,0,1,10,0,0,0,0,0,0,0,0,0,0,0,0,2,6,4,0
42808,27,637,1217,716,841,84,126,174,1301,14,185,118,215,199,333,1446,2542,8,20687,1149,0,2,6,4,0
42809,27,637,160,89,115,0,13,31,160,7,15,11,17,22,28,78,124,3,495,27,0,2,6,4,0
42810,27,637,10,10,9,9,0,0,19,0,0,0,0,0,0,0,0,0,0,0,0,2,6,4,0
42811,27,637,173,84,99,8,29,36,181,5,12,7,13,17,20,54,81,2,221,12,0,2,6,4,0
42812,27,637,3,1,1,3,0,0,6,0,0,0,0,0,0,0,0,0,0,0,0,2,6,4,0
42813,244,5161,2,2,2,0,0,0,2,0,0,0,0,0,0,0,0,0,0,0,0,2,4,1,0
42814,244,5161,99,48,90,1,3,5,100,0,0,0,0,0,0,0,0,0,0,0,0,2,4,1,0
42815,244,5161,8,5,5,2,0,1,10,0,0,0,0,0,0,0,0,0,0,0,0,2,4,1,0
42816,244,5161,1217,716,841,84,126,174,1301,14,185,118,215,199,333,1446,2542,8,20687,1149,0,2,4,1,0
42817,244,5161,160,89,115,0,13,31,160,7,15,11,17,22,28,78,124,3,495,27,0,2,4,1,0
42818,244,5161,10,10,9,9,0,0,19,0,0,0,0,0,0,0,0,0,0,0,0,2,4,1,0
42819,244,5161,173,84,99,8,29,36,181,5,12,7,13,17,20,54,81,2,221,12,0,2,4,1,0
42820,244,5161,3,1,1,3,0,0,6,0,0,0,0,0,0,0,0,0,0,0,0,2,4,1,0
42821,127,5438,1450,624,1228,12,26,181,1462,14,306,186,354,320,540,2580,4493,8,36391,2021,1,2,13,4,0
42822,106,4668,1289,550,1043,56,32,155,1345,10,167,93,185,177,278,1266,2075,5,11498,638,0,2,2,0,0
42823,18,430,127,75,83,2,11,30,129,4,14,7,14,18,21,61,87,2,175,9,0,2,7,0,0
42824,18,430,652,304,544,16,6,88,668,6,89,51,101,95,152,591,998,3,3399,188,0,2,7,0,0
42825,18,430,2,2,2,0,0,0,2,0,0,0,0,0,0,0,0,0,0,0,0,2,7,0,0
42826,18,430,8,5,5,0,0,3,8,0,0,0,0,0,0,0,0,0,0,0,0,2,7,0,0
42827,18,430,2,2,2,0,0,0,2,0,0,0,0,0,0,0,0,0,0,0,0,2,7,0,0
42828,18,430,14,8,8,0,0,6,14,0,0,0,0,0,0,0,0,0,0,0,0,2,7,0,0
42829,18,430,6,4,4,0,0,2,6,0,0,0,0,0,0,0,0,0,0,0,0,2,7,0,0
42830,18,430,6,4,4,0,0,2,6,1,2,1,2,3,3,2,4,0,2,0,0,2,7,0,0
42831,18,430,6,4,4,0,0,2,6,0,0,0,0,0,0,0,0,0,0,0,0,2,7,0,0
42832,18,430,7,5,5,0,0,2,7,0,0,0,0,0,0,0,0,0,0,0,0,2,7,0,0
42833,18,430,6,4,4,0,0,2,6,0,0,0,0,0,0,0,0,0,0,0,0,2,7,0,0
42834,18,430,10,6,6,0,0,4,10,0,0,0,0,0,0,0,0,0,0,0,0,2,7,0,0
42835,18,430,1,1,1,0,0,0,1,0,0,0,0,0,0,0,0,0,0,0,0,2,7,0,0
42836,18,430,1,1,1,0,0,0,1,0,0,0,0,0,0,0,0,0,0,0,0,2,7,0,0
42837,18,430,14,10,10,0,0,4,14,1,1,1,1,2,2,0,2,0,1,0,0,2,7,0,0
42838,18,430,46,26,30,3,0,12,49,3,6,3,6,9,9,20,28,1,42,2,0,2,7,0,0
42839,8,275,74,35,59,1,0,14,75,3,14,7,14,17,21,58,85,1,128,7,0,2,1,0,0
42840,114,5840,1523,757,1297,19,12,193,1542,12,193,117,230,205,347,1508,2664,7,19053,1058,0,2,1,0,0
42841,120,7110,1943,715,1694,26,18,214,1969,12,185,120,237,197,357,1436,2721,7,20915,1161,0,2,2,0,0
42842,3,97,35,12,22,4,5,6,39,1,2,1,2,3,3,2,4,0,2,0,0,2,6,0,0
42843,187,5537,182,127,129,0,0,53,182,5,39,21,42,44,63,217,343,2,926,51,0,2,2,0,0
42844,187,5537,1165,710,800,67,119,181,1232,18,243,153,282,261,435,2000,3492,10,36473,2026,1,2,2,0,0
42845,63,2124,773,419,590,28,0,166,801,10,204,113,217,214,330,1598,2554,5,13587,754,0,2,13,6,0
42846,63,2124,421,273,302,44,34,57,465,17,81,59,107,98,166,583,1098,11,12329,684,0,2,13,6,0
42847,51,1472,207,111,150,11,0,50,218,5,26,19,36,31,55,133,272,3,943,52,0,2,0,11,0
42848,51,1472,410,198,237,31,55,97,441,11,63,38,72,74,110,414,683,6,4293,238,0,2,0,11,0
42849,262,6282,4293,999,3693,19,54,507,4312,9,155,88,170,164,258,1156,1898,4,9368,520,0,2,1,1,0
42850,262,6282,1482,859,1002,125,135,219,1607,16,219,134,251,235,385,1766,3032,9,27804,1544,1,2,1,1,0
42851,69,1502,402,202,227,24,74,80,426,12,52,33,61,64,94,339,564,7,3969,220,0,2,1,1,0
42852,65,2178,53,23,39,0,0,13,53,2,8,4,8,10,12,26,39,1,39,2,0,2,1,1,0
42853,65,2178,515,298,307,33,80,99,548,12,63,44,77,75,121,419,753,7,5527,307,0,2,1,1,0
42854,294,6567,72,33,56,0,4,12,72,1,1,1,1,2,2,0,2,0,1,0,0,2,1,1,0
42855,294,6567,1454,835,1044,76,110,219,1530,17,275,158,296,292,454,2297,3718,9,34017,1889,1,2,1,1,0
42856,103,3235,773,419,590,28,0,166,801,10,204,113,217,214,330,1598,2554,5,13587,754,0,2,8,0,0
42857,225,6476,722,423,573,19,0,135,741,12,172,101,199,184,300,1320,2257,6,15668,870,0,2,4,4,0
42858,225,6476,1508,847,911,44,250,301,1552,14,148,88,169,162,257,1120,1886,7,15077,837,0,2,4,4,0
42859,119,3209,1523,757,1297,19,12,193,1542,12,193,117,230,205,347,1508,2664,7,19053,1058,0,2,1,1,0
42860,119,3209,701,378,504,33,58,109,734,13,110,68,126,123,194,794,1346,7,10027,557,0,2,1,1,0
42861,124,3511,77,34,69,0,0,8,77,3,24,16,29,27,45,114,213,1,387,21,0,2,20,10,0
42862,124,3511,712,438,573,51,9,84,763,14,102,71,128,116,199,733,1364,8,11988,666,0,2,20,10,0
42863,5,319,77,34,69,0,0,8,77,3,24,16,29,27,45,114,213,1,387,21,0,2,25,0,0
